,Unnamed: 0,Name,ID,Season,Club,AppearancesH,StartsH,SubsH,MinsH,GoalsH,AssistsH,AppearancesA,StartsA,SubsA,MinsA,GoalsA,AssistsA,Appearances,Starts,Subs,Mins,Goals,Assists,PointsWonH,PointsWonA,PointsWon,GCGoalsH,GCGoalsA,GCGoals,PenaltiesH,PenaltiesA,Penalties,OwnGoalsH,OwnGoalsA,OwnGoals,LastUpdate
0,1,Aaron Connolly,2427,"[2019, 2020]",Brighton & Hove Albion,17,10,7,933,2,0,17,10,7,866,2,0,34,20,14,1799,4,0,0.0,3.0,3.0,0,1,1,0,0,0,0,0,0,2020-12-27 19:15:002020-12-27 19:15:00
1,35,Aaron Cresswell,2199,"[2014, 2015, 2016, 2017, 2018, 2019, 2020]",West Ham United,103,101,2,8967,4,0,101,98,3,8732,4,0,204,199,5,17699,8,0,3.0,4.0,7.0,2,4,6,0,0,0,0,0,0,2020-12-27 19:15:002020-12-27 19:15:002020-12-27 19:15:002020-12-27 19:15:002020-12-27 19:15:002020-12-27 19:15:002020-12-27 19:15:00
2,19,Aaron Doran,3624,"[2008, 2010]",Blackburn Rovers,0,0,0,0,0,0,2,0,2,70,0,0,2,0,2,70,0,0,0.0,0.0,0.0,0,0,0,0,0,0,0,0,0,2020-12-27 19:15:002020-12-27 19:15:00
3,65,Aaron Hughes,1561,"[2000, 2001, 2002, 2003, 2004]",Newcastle United,77,74,3,6558,2,0,75,73,2,6536,0,0,152,147,5,13094,2,0,3.0,0.0,3.0,1,0,1,0,0,0,0,0,0,2020-12-27 19:15:002020-12-27 19:15:002020-12-27 19:15:002020-12-27 19:15:002020-12-27 19:15:00
4,33,Aaron Hughes,1561,"[2005, 2006]",Aston Villa,23,23,0,2070,0,0,29,25,4,2060,0,0,52,48,4,4130,0,0,0.0,0.0,0.0,0,0,0,0,0,0,0,0,0,2020-12-27 19:15:002020-12-27 19:15:00
5,147,Aaron Hughes,1561,"[2007, 2008, 2009, 2010, 2011, 2012, 2013]",Fulham FC,93,91,2,8123,1,0,96,93,3,8493,0,0,189,184,5,16616,1,0,0.0,0.0,0.0,1,0,1,0,0,0,0,0,0,2020-12-27 19:15:002020-12-27 19:15:002020-12-27 19:15:002020-12-27 19:15:002020-12-27 19:15:002020-12-27 19:15:002020-12-27 19:15:00
6,25,Aaron Lennon,1052,[2003],Leeds United,5,0,5,81,0,0,6,0,6,125,0,0,11,0,11,206,0,0,0.0,0.0,0.0,0,0,0,0,0,0,0,0,0,2020-12-27 19:15:00
7,243,Aaron Lennon,1052,"[2005, 2007, 2008, 2009, 2010, 2011, 2012, 2013]",Tottenham Hotspur,114,97,17,8539,16,0,113,96,17,8483,7,0,227,193,34,17022,23,0,9.0,8.0,17.0,8,6,14,0,0,0,0,0,0,2020-12-27 19:15:002020-12-27 19:15:002020-12-27 19:15:002020-12-27 19:15:002020-12-27 19:15:002020-12-27 19:15:002020-12-27 19:15:002020-12-27 19:15:00
8,27,Aaron Lennon,1052,[2006],Watford FC,1,1,0,90,0,0,0,0,0,0,0,0,1,1,0,90,0,0,0.0,0.0,0.0,0,0,0,0,0,0,0,0,0,2020-12-27 19:15:00
9,146,Aaron Lennon,1052,"[2014, 2015, 2016, 2017]",Everton FC,30,21,9,1834,3,0,35,23,12,2077,4,0,65,44,21,3911,7,0,0.0,3.0,3.0,2,2,4,0,0,0,0,0,0,2020-12-27 19:15:002020-12-27 19:15:002020-12-27 19:15:002020-12-27 19:15:00
10,79,Aaron Lennon,1052,"[2018, 2019]",Burnley FC,16,7,9,713,1,0,16,11,5,990,0,0,32,18,14,1703,1,0,0.0,0.0,0.0,0,0,0,0,0,0,0,0,0,2020-12-27 19:15:002020-12-27 19:15:00
11,41,Aaron McLean,3795,[2013],Hull City,0,0,0,0,0,0,1,0,1,6,0,0,1,0,1,6,0,0,0.0,0.0,0.0,0,0,0,0,0,0,0,0,0,2020-12-27 19:15:00
12,42,Aaron Mitchell,4500,[2014],Queens Park Rangers,0,0,0,0,0,0,0,0,0,0,0,0,0,0,0,0,0,0,0.0,0.0,0.0,0,0,0,0,0,0,0,0,0,2020-12-27 19:15:00
13,225,Aaron Mokoena,2008,"[2004, 2005, 2006, 2007, 2008]",Blackburn Rovers,53,26,27,2498,0,0,46,28,18,2645,0,0,99,54,45,5143,0,0,0.0,0.0,0.0,0,0,0,0,0,0,0,0,0,2020-12-27 19:15:002020-12-27 19:15:002020-12-27 19:15:002020-12-27 19:15:002020-12-27 19:15:00
14,48,Aaron Mokoena,2008,[2009],Portsmouth FC,12,12,0,922,0,0,11,9,2,808,0,0,23,21,2,1730,0,0,0.0,0.0,0.0,0,0,0,0,0,0,0,0,0,2020-12-27 19:15:00
15,99,Aaron Mooy,2430,"[2017, 2018]",Huddersfield Town,34,32,2,2825,3,0,31,27,4,2572,4,0,65,59,6,5397,7,0,3.0,0.0,3.0,2,1,3,1,1,2,0,0,0,2020-12-27 19:15:002020-12-27 19:15:00
16,51,Aaron Mooy,2430,[2019],Brighton & Hove Albion,16,12,4,1010,1,0,15,13,2,1135,1,0,31,25,6,2145,2,0,0.0,0.0,0.0,0,0,0,0,0,0,0,0,0,2020-12-27 19:15:00
17,159,Aaron Ramsdale,3339,"[2016, 2017, 2019]",AFC Bournemouth,18,18,0,1620,0,0,19,19,0,1710,0,0,37,37,0,3330,0,0,0.0,0.0,0.0,0,0,0,0,0,0,0,0,0,2020-12-27 19:15:002020-12-27 19:15:002020-12-27 19:15:00
18,55,Aaron Ramsdale,3339,[2020],Sheffield United,8,8,0,720,0,0,7,7,0,630,0,0,15,15,0,1350,0,0,0.0,0.0,0.0,0,0,0,0,0,0,0,0,0,2020-12-27 19:15:00
19,671,Aaron Ramsey,1501,"[2008, 2009, 2010, 2011, 2012, 2013, 2014, 2015, 2016, 2017, 2018]",Arsenal FC,126,82,44,7730,19,0,133,97,36,8794,21,0,259,179,80,16524,40,0,9.0,3.0,12.0,8,10,18,0,0,0,0,0,0,2020-12-27 19:15:002020-12-27 19:15:002020-12-27 19:15:002020-12-27 19:15:002020-12-27 19:15:002020-12-27 19:15:002020-12-27 19:15:002020-12-27 19:15:002020-12-27 19:15:002020-12-27 19:15:002020-12-27 19:15:00
20,67,Aaron Rowe,4070,[2018],Huddersfield Town,1,0,1,14,0,0,1,1,0,55,0,0,2,1,1,69,0,0,0.0,0.0,0.0,0,0,0,0,0,0,0,0,0,2020-12-27 19:15:00
21,207,Aaron Wan-Bissaka,2702,"[2016, 2017, 2018]",Crystal Palace,22,22,0,1978,0,0,20,20,0,1800,0,0,42,42,0,3778,0,0,0.0,0.0,0.0,0,0,0,0,0,0,0,0,0,2020-12-27 19:15:002020-12-27 19:15:002020-12-27 19:15:00
22,143,Aaron Wan-Bissaka,2702,"[2019, 2020]",Manchester United,24,23,1,2114,0,0,23,23,0,2037,1,0,47,46,1,4151,1,0,0.0,0.0,0.0,0,0,0,0,0,0,0,0,0,2020-12-27 19:15:002020-12-27 19:15:00
23,73,Aaron Wilbraham,3048,[2011],Norwich City,4,1,3,133,0,0,7,1,6,173,1,0,11,2,9,306,1,0,0.0,0.0,0.0,0,0,0,0,0,0,0,0,0,2020-12-27 19:15:00
24,74,Aaron Wilbraham,3048,[2013],Crystal Palace,4,1,3,80,0,0,0,0,0,0,0,0,4,1,3,80,0,0,0.0,0.0,0.0,0,0,0,0,0,0,0,0,0,2020-12-27 19:15:00
25,151,Abdelhamid Sabiri,3194,"[2017, 2018]",Huddersfield Town,1,1,0,82,0,0,6,2,4,198,0,0,7,3,4,280,0,0,0.0,0.0,0.0,0,0,0,0,0,0,0,0,0,2020-12-27 19:15:002020-12-27 19:15:00
26,155,Abdeslam Ouaddou,3848,"[2001, 2002]",Fulham FC,9,7,2,704,0,0,10,5,5,520,0,0,19,12,7,1224,0,0,0.0,0.0,0.0,0,0,0,0,0,0,0,0,0,2020-12-27 19:15:002020-12-27 19:15:00
27,79,Abdisalam Ibrahim,4045,[2009],Manchester City,1,0,1,14,0,0,0,0,0,0,0,0,1,0,1,14,0,0,0.0,0.0,0.0,0,0,0,0,0,0,0,0,0,2020-12-27 19:15:00
28,326,Abdoulaye Doucouré,1922,"[2016, 2017, 2018, 2019]",Watford FC,67,62,5,5633,9,0,62,59,3,5278,8,0,129,121,8,10911,17,0,2.0,0.0,2.0,4,6,10,0,0,0,0,0,0,2020-12-27 19:15:002020-12-27 19:15:002020-12-27 19:15:002020-12-27 19:15:00
29,84,Abdoulaye Doucouré,1922,[2020],Everton FC,7,7,0,593,0,0,8,8,0,679,1,0,15,15,0,1272,1,0,0.0,0.0,0.0,0,0,0,0,0,0,0,0,0,2020-12-27 19:15:00
30,171,Abdoulaye Faye,1714,"[2005, 2006]",Bolton Wanderers,28,26,2,2353,3,0,31,26,5,2173,0,0,59,52,7,4526,3,0,0.0,0.0,0.0,3,0,3,0,0,0,0,0,0,2020-12-27 19:15:002020-12-27 19:15:00
31,87,Abdoulaye Faye,1714,[2007],Newcastle United,10,10,0,874,1,0,12,10,2,780,0,0,22,20,2,1654,1,0,0.0,0.0,0.0,0,0,0,0,0,0,0,0,0,2020-12-27 19:15:00
32,267,Abdoulaye Faye,1714,"[2008, 2009, 2010]",Stoke City,40,39,1,3456,3,0,38,36,2,3022,3,0,78,75,3,6478,6,0,0.0,1.0,1.0,2,2,4,0,0,0,0,0,0,2020-12-27 19:15:002020-12-27 19:15:002020-12-27 19:15:00
33,91,Abdoulaye Faye,1714,[2013],Hull City,2,2,0,180,0,0,1,1,0,90,0,0,3,3,0,270,0,0,0.0,0.0,0.0,0,0,0,0,0,0,0,0,0,2020-12-27 19:15:00
34,185,Abdoulaye Méïté,1712,"[2006, 2007]",Bolton Wanderers,28,28,0,2520,0,0,28,28,0,2409,0,0,56,56,0,4929,0,0,0.0,0.0,0.0,0,0,0,0,0,0,0,0,0,2020-12-27 19:15:002020-12-27 19:15:00
35,189,Abdoulaye Méïté,1712,"[2008, 2010]",West Bromwich Albion,11,11,0,924,0,0,17,17,0,1379,0,0,28,28,0,2303,0,0,0.0,0.0,0.0,0,0,0,0,0,0,0,0,0,2020-12-27 19:15:002020-12-27 19:15:00
36,96,Abdul Rahman Baba,3504,[2015],Chelsea FC,6,5,1,495,0,0,9,6,3,522,0,0,15,11,4,1017,0,0,0.0,0.0,0.0,0,0,0,0,0,0,0,0,0,2020-12-27 19:15:00
37,294,Abdul Razak,1421,"[2010, 2011, 2012]",Manchester City,5,0,5,14,0,0,0,0,0,0,0,0,5,0,5,14,0,0,0.0,0.0,0.0,0,0,0,0,0,0,0,0,0,2020-12-27 19:15:002020-12-27 19:15:002020-12-27 19:15:00
38,201,Abel Hernández,2227,"[2014, 2016]",Hull City,29,19,10,1676,6,0,20,12,8,1063,2,0,49,31,18,2739,8,0,0.0,0.0,0.0,5,1,6,1,0,1,0,0,0,2020-12-27 19:15:002020-12-27 19:15:00
39,205,Abel Xavier,2824,"[2000, 2001]",Everton FC,10,9,1,679,0,0,13,12,1,1105,0,0,23,21,2,1784,0,0,0.0,0.0,0.0,0,0,0,0,0,0,0,0,0,2020-12-27 19:15:002020-12-27 19:15:00
40,104,Abel Xavier,2824,[2002],Liverpool FC,2,2,0,180,0,0,2,2,0,180,0,0,4,4,0,360,0,0,0.0,0.0,0.0,0,0,0,0,0,0,0,0,0,2020-12-27 19:15:00
41,211,Abel Xavier,2824,"[2005, 2006]",Middlesbrough FC,10,10,0,898,1,0,8,8,0,720,0,0,18,18,0,1618,1,0,0.0,0.0,0.0,0,0,0,0,0,0,0,0,0,2020-12-27 19:15:002020-12-27 19:15:00
42,1115,Abou Diaby,2434,"[2005, 2006, 2007, 2008, 2009, 2010, 2011, 2012, 2013, 2014]",Arsenal FC,61,41,20,3525,10,0,61,49,12,4243,4,0,122,90,32,7768,14,0,3.0,3.0,6.0,3,3,6,0,0,0,0,0,0,2020-12-27 19:15:002020-12-27 19:15:002020-12-27 19:15:002020-12-27 19:15:002020-12-27 19:15:002020-12-27 19:15:002020-12-27 19:15:002020-12-27 19:15:002020-12-27 19:15:002020-12-27 19:15:00
43,235,Aboubakar Kamara,3910,"[2018, 2020]",Fulham FC,13,5,8,650,1,0,8,2,6,318,2,0,21,7,14,968,3,0,0.0,0.0,0.0,1,0,1,0,1,1,0,0,0,2020-12-27 19:15:002020-12-27 19:15:00
44,239,Adalberto Peñaranda,3638,"[2018, 2019]",Watford FC,0,0,0,0,0,0,0,0,0,0,0,0,0,0,0,0,0,0,0.0,0.0,0.0,0,0,0,0,0,0,0,0,0,2020-12-27 19:15:002020-12-27 19:15:00
45,243,Adam Armstrong,3561,"[2013, 2014]",Newcastle United,7,0,7,106,0,0,8,1,7,127,0,0,15,1,14,233,0,0,0.0,0.0,0.0,0,0,0,0,0,0,0,0,0,2020-12-27 19:15:002020-12-27 19:15:00
46,123,Adam Blakeman,4400,[2011],Bolton Wanderers,0,0,0,0,0,0,0,0,0,0,0,0,0,0,0,0,0,0,0.0,0.0,0.0,0,0,0,0,0,0,0,0,0,2020-12-27 19:15:00
47,249,Adam Bolder,3867,"[2000, 2001]",Derby County,5,0,5,105,0,0,8,2,6,308,0,0,13,2,11,413,0,0,0.0,0.0,0.0,0,0,0,0,0,0,0,0,0,2020-12-27 19:15:002020-12-27 19:15:00
48,126,Adam Campbell,3487,[2012],Newcastle United,3,0,3,22,0,0,0,0,0,0,0,0,3,0,3,22,0,0,0.0,0.0,0.0,0,0,0,0,0,0,0,0,0,2020-12-27 19:15:00
49,127,Adam Chambers,3377,[2002],West Bromwich Albion,8,6,2,547,0,0,5,4,1,348,0,0,13,10,3,895,0,0,0.0,0.0,0.0,0,0,0,0,0,0,0,0,0,2020-12-27 19:15:00
50,128,Adam Clayton,3006,[2016],Middlesbrough FC,18,18,0,1528,0,0,16,14,2,1278,0,0,34,32,2,2806,0,0,0.0,0.0,0.0,0,0,0,0,0,0,0,0,0,2020-12-27 19:15:00
51,259,Adam Drury,2384,"[2004, 2011]",Norwich City,22,21,1,1847,1,0,22,21,1,1786,0,0,44,42,2,3633,1,0,0.0,0.0,0.0,0,0,0,0,0,0,0,0,0,2020-12-27 19:15:002020-12-27 19:15:00
52,263,Adam Federici,1014,"[2006, 2012]",Reading FC,12,12,0,1080,0,0,11,9,2,921,0,0,23,21,2,2001,0,0,0.0,0.0,0.0,0,0,0,0,0,0,0,0,0,2020-12-27 19:15:002020-12-27 19:15:00
53,267,Adam Federici,1014,"[2015, 2016]",AFC Bournemouth,2,2,0,136,0,0,6,6,0,540,0,0,8,8,0,676,0,0,0.0,0.0,0.0,0,0,0,0,0,0,0,0,0,2020-12-27 19:15:002020-12-27 19:15:00
54,271,Adam Forshaw,3007,"[2010, 2011]",Everton FC,0,0,0,0,0,0,1,0,1,8,0,0,1,0,1,8,0,0,0.0,0.0,0.0,0,0,0,0,0,0,0,0,0,2020-12-27 19:15:002020-12-27 19:15:00
55,137,Adam Forshaw,3007,[2016],Middlesbrough FC,17,15,2,1355,0,0,17,15,2,1345,0,0,34,30,4,2700,0,0,0.0,0.0,0.0,0,0,0,0,0,0,0,0,0,2020-12-27 19:15:00
56,277,Adam Green,3657,"[2003, 2004]",Fulham FC,5,5,0,450,0,0,2,2,0,180,0,0,7,7,0,630,0,0,0.0,0.0,0.0,0,0,0,0,0,0,0,0,0,2020-12-27 19:15:002020-12-27 19:15:00
57,281,Adam Hammill,3431,"[2010, 2011]",Wolverhampton Wanderers,12,5,7,457,0,0,7,5,2,431,0,0,19,10,9,888,0,0,0.0,0.0,0.0,0,0,0,0,0,0,0,0,0,2020-12-27 19:15:002020-12-27 19:15:00
58,142,Adam Henley,4008,[2011],Blackburn Rovers,2,1,1,112,0,0,5,3,2,358,0,0,7,4,3,470,0,0,0.0,0.0,0.0,0,0,0,0,0,0,0,0,0,2020-12-27 19:15:00
59,143,Adam Idah,1839,[2019],Norwich City,6,0,6,69,0,0,6,1,5,150,0,0,12,1,11,219,0,0,0.0,0.0,0.0,0,0,0,0,0,0,0,0,0,2020-12-27 19:15:00
60,582,Adam Johnson,1405,"[2005, 2006, 2007, 2008]",Middlesbrough FC,35,13,22,1442,1,0,34,11,23,1179,1,0,69,24,45,2621,2,0,0.0,0.0,0.0,0,1,1,0,0,0,0,0,0,2020-12-27 19:15:002020-12-27 19:15:002020-12-27 19:15:002020-12-27 19:15:00
61,447,Adam Johnson,1405,"[2009, 2010, 2011]",Manchester City,35,25,10,2271,7,0,38,14,24,1574,4,0,73,39,34,3845,11,0,6.0,1.0,7.0,3,2,5,0,0,0,0,0,0,2020-12-27 19:15:002020-12-27 19:15:002020-12-27 19:15:00
62,610,Adam Johnson,1405,"[2012, 2013, 2014, 2015]",Sunderland AFC,61,49,12,4330,10,0,61,48,13,4280,9,0,122,97,25,8610,19,0,7.0,3.0,10.0,7,4,11,1,2,3,0,0,0,2020-12-27 19:15:002020-12-27 19:15:002020-12-27 19:15:002020-12-27 19:15:00
63,155,Adam King,4488,[2013],Swansea City,0,0,0,0,0,0,0,0,0,0,0,0,0,0,0,0,0,0,0.0,0.0,0.0,0,0,0,0,0,0,0,0,0,2020-12-27 19:15:00
64,313,Adam Lallana,1190,"[2012, 2013]",Southampton FC,34,33,1,2700,7,0,34,30,4,2636,5,0,68,63,5,5336,12,0,4.0,1.0,5.0,5,2,7,0,0,0,0,0,0,2020-12-27 19:15:002020-12-27 19:15:00
65,963,Adam Lallana,1190,"[2014, 2015, 2016, 2017, 2018, 2019]",Liverpool FC,67,45,22,3893,12,0,60,36,24,3380,6,0,127,81,46,7273,18,0,0.0,4.0,4.0,6,5,11,0,0,0,0,0,0,2020-12-27 19:15:002020-12-27 19:15:002020-12-27 19:15:002020-12-27 19:15:002020-12-27 19:15:002020-12-27 19:15:00
66,164,Adam Lallana,1190,[2020],Brighton & Hove Albion,6,5,1,388,0,0,7,5,2,382,0,0,13,10,3,770,0,0,0.0,0.0,0.0,0,0,0,0,0,0,0,0,0,2020-12-27 19:15:00
67,165,Adam Le Fondre,1983,[2012],Reading FC,18,5,13,750,8,0,16,6,10,739,4,0,34,11,23,1489,12,0,5.0,3.0,8.0,6,3,9,3,0,3,0,0,0,2020-12-27 19:15:00
68,166,Adam Legzdins,4378,[2017],Burnley FC,0,0,0,0,0,0,0,0,0,0,0,0,0,0,0,0,0,0,0.0,0.0,0.0,0,0,0,0,0,0,0,0,0,2020-12-27 19:15:00
69,335,Adam Masina,2089,"[2018, 2019]",Watford FC,21,15,6,1398,1,0,19,16,3,1425,0,0,40,31,9,2823,1,0,0.0,0.0,0.0,1,0,1,0,0,0,0,0,0,2020-12-27 19:15:002020-12-27 19:15:00
70,169,Adam Matthews,4442,[2015],Sunderland AFC,0,0,0,0,0,0,1,0,1,36,0,0,1,0,1,36,0,0,0.0,0.0,0.0,0,0,0,0,0,0,0,0,0,2020-12-27 19:15:00
71,170,Adam Mitchell,4040,[2012],Sunderland AFC,0,0,0,0,0,0,1,0,1,2,0,0,1,0,1,2,0,0,0.0,0.0,0.0,0,0,0,0,0,0,0,0,0,2020-12-27 19:15:00
72,171,Adam Morgan,4375,[2012],Liverpool FC,0,0,0,0,0,0,0,0,0,0,0,0,0,0,0,0,0,0,0.0,0.0,0.0,0,0,0,0,0,0,0,0,0,2020-12-27 19:15:00
73,345,Adam Murray,3835,"[2000, 2001]",Derby County,9,3,6,315,0,0,8,3,5,308,0,0,17,6,11,623,0,0,0.0,0.0,0.0,0,0,0,0,0,0,0,0,0,2020-12-27 19:15:002020-12-27 19:15:00
74,174,Adam Reach,4410,[2016],Middlesbrough FC,0,0,0,0,0,0,0,0,0,0,0,0,0,0,0,0,0,0,0.0,0.0,0.0,0,0,0,0,0,0,0,0,0,2020-12-27 19:15:00
75,175,Adam Reed,4451,[2010],Sunderland AFC,0,0,0,0,0,0,0,0,0,0,0,0,0,0,0,0,0,0,0.0,0.0,0.0,0,0,0,0,0,0,0,0,0,2020-12-27 19:15:00
76,176,Adam Smith,1004,[2011],Tottenham Hotspur,1,0,1,14,0,0,0,0,0,0,0,0,1,0,1,14,0,0,0.0,0.0,0.0,0,0,0,0,0,0,0,0,0,2020-12-27 19:15:00
77,177,Adam Smith,1004,[2014],Leicester City,0,0,0,0,0,0,0,0,0,0,0,0,0,0,0,0,0,0,0.0,0.0,0.0,0,0,0,0,0,0,0,0,0,2020-12-27 19:15:00
78,900,Adam Smith,1004,"[2015, 2016, 2017, 2018, 2019]",AFC Bournemouth,72,64,8,5895,4,0,71,63,8,5529,1,0,143,127,16,11424,5,0,0.0,0.0,0.0,0,1,1,0,0,0,0,0,0,2020-12-27 19:15:002020-12-27 19:15:002020-12-27 19:15:002020-12-27 19:15:002020-12-27 19:15:00
79,367,Adam Webster,2417,"[2019, 2020]",Brighton & Hove Albion,21,21,0,1836,0,0,24,24,0,2094,3,0,45,45,0,3930,3,0,0.0,0.0,0.0,0,3,3,0,0,0,0,0,0,2020-12-27 19:15:002020-12-27 19:15:00
80,185,Adama Diakhaby,3808,[2018],Huddersfield Town,8,4,4,347,0,0,4,2,2,206,0,0,12,6,6,553,0,0,0.0,0.0,0.0,0,0,0,0,0,0,0,0,0,2020-12-27 19:15:00
81,186,Adama Diomandé,2736,[2016],Hull City,10,7,3,628,2,0,12,6,6,540,0,0,22,13,9,1168,2,0,0.0,0.0,0.0,2,0,2,0,0,0,0,0,0,2020-12-27 19:15:00
82,187,Adama Traoré,1871,[2015],Aston Villa,5,0,5,56,0,0,5,0,5,129,0,0,10,0,10,185,0,0,0.0,0.0,0.0,0,0,0,0,0,0,0,0,0,2020-12-27 19:15:00
83,188,Adama Traoré,1871,[2016],Middlesbrough FC,15,7,8,766,0,0,12,9,3,771,0,0,27,16,11,1537,0,0,0.0,0.0,0.0,0,0,0,0,0,0,0,0,0,2020-12-27 19:15:00
84,570,Adama Traoré,1871,"[2018, 2019, 2020]",Wolverhampton Wanderers,39,19,20,2000,2,0,42,24,18,2343,3,0,81,43,38,4343,5,0,0.0,3.0,3.0,1,2,3,0,0,0,0,0,0,2020-12-27 19:15:002020-12-27 19:15:002020-12-27 19:15:00
85,385,Ade Akinbiyi,1311,"[2000, 2001]",Leicester City,29,25,4,2122,9,0,29,24,5,2149,2,0,58,49,9,4271,11,0,3.0,0.0,3.0,7,1,8,0,0,0,0,0,0,2020-12-27 19:15:002020-12-27 19:15:00
86,194,Ade Akinbiyi,1311,[2006],Sheffield United,2,1,1,94,0,0,1,1,0,90,0,0,3,2,1,184,0,0,0.0,0.0,0.0,0,0,0,0,0,0,0,0,0,2020-12-27 19:15:00
87,588,Adel Taarabt,2165,"[2006, 2007, 2008]",Tottenham Hotspur,4,0,4,70,0,0,5,0,5,86,0,0,9,0,9,156,0,0,0.0,0.0,0.0,0,0,0,0,0,0,0,0,0,2020-12-27 19:15:002020-12-27 19:15:002020-12-27 19:15:00
88,598,Adel Taarabt,2165,"[2011, 2012, 2014]",Queens Park Rangers,37,27,10,2518,5,0,28,25,3,2051,2,0,65,52,13,4569,7,0,3.0,0.0,3.0,3,0,3,0,0,0,0,0,0,2020-12-27 19:15:002020-12-27 19:15:002020-12-27 19:15:00
89,200,Adel Taarabt,2165,[2013],Fulham FC,7,4,3,309,0,0,5,3,2,286,0,0,12,7,5,595,0,0,0.0,0.0,0.0,0,0,0,0,0,0,0,0,0,2020-12-27 19:15:00
90,609,Ademola Lookman,3116,"[2016, 2017, 2018]",Everton FC,20,4,16,549,1,0,16,3,13,495,0,0,36,7,29,1044,1,0,0.0,0.0,0.0,0,0,0,0,0,0,0,0,0,2020-12-27 19:15:002020-12-27 19:15:002020-12-27 19:15:00
91,205,Ademola Lookman,3116,[2020],Fulham FC,6,6,0,538,0,0,6,5,1,473,2,0,12,11,1,1011,2,0,0.0,0.0,0.0,0,2,2,0,0,0,0,0,0,2020-12-27 19:15:00
92,413,Adil Nabi,4241,"[2012, 2014]",West Bromwich Albion,0,0,0,0,0,0,0,0,0,0,0,0,0,0,0,0,0,0,0.0,0.0,0.0,0,0,0,0,0,0,0,0,0,2020-12-27 19:15:002020-12-27 19:15:00
93,627,Adlène Guédioura,3130,"[2009, 2010, 2011]",Wolverhampton Wanderers,17,8,9,785,2,0,16,5,11,447,0,0,33,13,20,1232,2,0,3.0,0.0,3.0,1,0,1,0,0,0,0,0,0,2020-12-27 19:15:002020-12-27 19:15:002020-12-27 19:15:00
94,423,Adlène Guédioura,3130,"[2013, 2014]",Crystal Palace,6,3,3,296,0,0,9,1,8,145,0,0,15,4,11,441,0,0,0.0,0.0,0.0,0,0,0,0,0,0,0,0,0,2020-12-27 19:15:002020-12-27 19:15:00
95,427,Adlène Guédioura,3130,"[2015, 2016]",Watford FC,14,6,8,575,0,0,16,6,10,568,0,0,30,12,18,1143,0,0,0.0,0.0,0.0,0,0,0,0,0,0,0,0,0,2020-12-27 19:15:002020-12-27 19:15:00
96,866,Adnan Januzaj,2259,"[2012, 2013, 2014, 2015]",Manchester United,26,12,14,1354,1,0,24,12,12,1281,4,0,50,24,26,2635,5,0,0.0,6.0,6.0,0,3,3,0,0,0,0,0,0,2020-12-27 19:15:002020-12-27 19:15:002020-12-27 19:15:002020-12-27 19:15:00
97,219,Adnan Januzaj,2259,[2016],Sunderland AFC,12,10,2,901,0,0,13,8,5,729,0,0,25,18,7,1630,0,0,0.0,0.0,0.0,0,0,0,0,0,0,0,0,0,2020-12-27 19:15:00
98,1126,Adrian Mariappa,1917,"[2006, 2016, 2017, 2018, 2019]",Watford FC,45,37,8,3496,0,0,55,45,10,4295,0,0,100,82,18,7791,0,0,0.0,0.0,0.0,0,0,0,0,0,0,0,0,0,2020-12-27 19:15:002020-12-27 19:15:002020-12-27 19:15:002020-12-27 19:15:002020-12-27 19:15:00
99,221,Adrian Mariappa,1917,[2012],Reading FC,15,15,0,1350,0,0,14,14,0,1260,1,0,29,29,0,2610,1,0,0.0,0.0,0.0,0,0,0,0,0,0,0,0,0,2020-12-27 19:15:00
100,669,Adrian Mariappa,1917,"[2013, 2014, 2015]",Crystal Palace,15,12,3,1209,1,0,23,21,2,1909,0,0,38,33,5,3118,1,0,0.0,0.0,0.0,1,0,1,0,0,0,0,0,0,2020-12-27 19:15:002020-12-27 19:15:002020-12-27 19:15:00
101,459,Adrian Mutu,2371,"[2003, 2004]",Chelsea FC,13,12,1,990,4,0,13,8,5,726,2,0,26,20,6,1716,6,0,3.0,3.0,6.0,3,1,4,0,0,0,0,0,0,2020-12-27 19:15:002020-12-27 19:15:00
102,463,Adrien Silva,2565,"[2017, 2018]",Leicester City,9,6,3,500,0,0,5,4,1,350,0,0,14,10,4,850,0,0,0.0,0.0,0.0,0,0,0,0,0,0,0,0,0,2020-12-27 19:15:002020-12-27 19:15:00
103,1413,Adrián,2309,"[2013, 2014, 2015, 2016, 2017, 2018]",West Ham United,64,64,0,5760,0,0,62,62,0,5580,0,0,126,126,0,11340,0,0,0.0,0.0,0.0,0,0,0,0,0,0,0,0,0,2020-12-27 19:15:002020-12-27 19:15:002020-12-27 19:15:002020-12-27 19:15:002020-12-27 19:15:002020-12-27 19:15:00
104,479,Adrián,2309,"[2019, 2020]",Liverpool FC,7,5,2,513,0,0,6,6,0,540,0,0,13,11,2,1053,0,0,0.0,0.0,0.0,0,0,0,0,0,0,0,0,0,2020-12-27 19:15:002020-12-27 19:15:00
105,241,Adrián Bernabé,1052,[2020],Manchester City,0,0,0,0,0,0,0,0,0,0,0,0,0,0,0,0,0,0,0.0,0.0,0.0,0,0,0,0,0,0,0,0,0,2020-12-27 19:15:00
106,485,Afonso Alves,2219,"[2007, 2008]",Middlesbrough FC,23,16,7,1470,8,0,19,15,4,1349,2,0,42,31,11,2819,10,0,0.0,0.0,0.0,5,2,7,1,0,1,0,0,0,2020-12-27 19:15:002020-12-27 19:15:00
107,735,Agustín Delgado,3369,"[2001, 2002, 2003]",Southampton FC,6,1,5,197,1,0,5,1,4,107,0,0,11,2,9,304,1,0,0.0,0.0,0.0,0,0,0,0,0,0,0,0,0,2020-12-27 19:15:002020-12-27 19:15:002020-12-27 19:15:00
108,247,Ahmad Elrich,3267,[2005],Fulham FC,4,1,3,90,0,0,2,1,1,67,0,0,6,2,4,157,0,0,0.0,0.0,0.0,0,0,0,0,0,0,0,0,0,2020-12-27 19:15:00
109,747,Ahmed Elmohamady,1690,"[2010, 2011, 2012]",Sunderland AFC,29,18,11,1799,1,0,27,15,12,1451,0,0,56,33,23,3250,1,0,1.0,0.0,1.0,1,0,1,0,0,0,0,0,0,2020-12-27 19:15:002020-12-27 19:15:002020-12-27 19:15:00
110,756,Ahmed Elmohamady,1690,"[2013, 2014, 2016]",Hull City,54,52,2,4671,3,0,55,52,3,4660,1,0,109,104,5,9331,4,0,0.0,0.0,0.0,2,1,3,0,0,0,0,0,0,2020-12-27 19:15:002020-12-27 19:15:002020-12-27 19:15:00
111,509,Ahmed Elmohamady,1690,"[2019, 2020]",Aston Villa,15,7,8,695,0,0,8,5,3,460,1,0,23,12,11,1155,1,0,0.0,1.0,1.0,0,1,1,0,0,0,0,0,0,2020-12-27 19:15:002020-12-27 19:15:00
112,256,Ahmed Fathi,4351,[2006],Sheffield United,2,1,1,108,0,0,1,1,0,90,0,0,3,2,1,198,0,0,0.0,0.0,0.0,0,0,0,0,0,0,0,0,0,2020-12-27 19:15:00
113,515,Ahmed Hegazy,1656,"[2017, 2020]",West Bromwich Albion,20,20,0,1800,2,0,19,19,0,1677,0,0,39,39,0,3477,2,0,3.0,0.0,3.0,2,0,2,0,0,0,0,0,0,2020-12-27 19:15:002020-12-27 19:15:00
114,519,Ahmed Musa,2669,"[2016, 2017]",Leicester City,8,4,4,317,1,0,13,3,10,436,1,0,21,7,14,753,2,0,0.0,1.0,1.0,1,1,2,0,0,0,0,0,0,2020-12-27 19:15:002020-12-27 19:15:00
115,261,Aidan Davison,3975,[2000],Bradford City,0,0,0,0,0,0,2,2,0,180,0,0,2,2,0,180,0,0,0.0,0.0,0.0,0,0,0,0,0,0,0,0,0,2020-12-27 19:15:00
116,789,Aiden McGeady,2242,"[2013, 2014, 2015]",Everton FC,15,7,8,612,0,0,17,7,10,743,1,0,32,14,18,1355,1,0,0.0,0.0,0.0,0,1,1,0,0,0,0,0,0,2020-12-27 19:15:002020-12-27 19:15:002020-12-27 19:15:00
117,531,Aiden O’Neill,1260,"[2016, 2017]",Burnley FC,1,0,1,1,0,0,2,0,2,82,0,0,3,0,3,83,0,0,0.0,0.0,0.0,0,0,0,0,0,0,0,0,0,2020-12-27 19:15:002020-12-27 19:15:00
118,1617,Ainsley Maitland-Niles,1473,"[2014, 2016, 2017, 2018, 2019, 2020]",Arsenal FC,28,18,10,1769,0,0,33,20,13,1996,1,0,61,38,23,3765,1,0,0.0,0.0,0.0,0,1,1,0,0,0,0,0,0,2020-12-27 19:15:002020-12-27 19:15:002020-12-27 19:15:002020-12-27 19:15:002020-12-27 19:15:002020-12-27 19:15:00
119,273,Aki Riihilahti,2026,[2004],Crystal Palace,15,14,1,1180,2,0,15,13,2,1008,1,0,30,27,3,2188,3,0,1.0,0.0,1.0,1,1,2,0,0,0,0,0,0,2020-12-27 19:15:00
120,274,Akin Famewo,3723,[2019],Norwich City,0,0,0,0,0,0,1,0,1,1,0,0,1,0,1,1,0,0,0.0,0.0,0.0,0,0,0,0,0,0,0,0,0,2020-12-27 19:15:00
121,275,Akwasi Asante,4243,[2010],Birmingham City,0,0,0,0,0,0,0,0,0,0,0,0,0,0,0,0,0,0,0.0,0.0,0.0,0,0,0,0,0,0,0,0,0,2020-12-27 19:15:00
122,276,Al Bangura,3605,[2006],Watford FC,8,6,2,517,0,0,8,6,2,567,0,0,16,12,4,1084,0,0,0.0,0.0,0.0,0,0,0,0,0,0,0,0,0,2020-12-27 19:15:00
123,277,Alain Goma,1080,[2000],Newcastle United,9,8,1,765,0,0,10,10,0,802,1,0,19,18,1,1567,1,0,0.0,0.0,0.0,0,0,0,0,0,0,0,0,0,2020-12-27 19:15:00
124,1400,Alain Goma,1080,"[2001, 2002, 2003, 2004, 2005]",Fulham FC,55,55,0,4830,0,0,52,50,2,4561,0,0,107,105,2,9391,0,0,0.0,0.0,0.0,0,0,0,0,0,0,0,0,0,2020-12-27 19:15:002020-12-27 19:15:002020-12-27 19:15:002020-12-27 19:15:002020-12-27 19:15:00
125,852,Alan Blayney,4311,"[2002, 2003, 2004]",Southampton FC,2,2,0,180,0,0,1,1,0,90,0,0,3,3,0,270,0,0,0.0,0.0,0.0,0,0,0,0,0,0,0,0,0,2020-12-27 19:15:002020-12-27 19:15:002020-12-27 19:15:00
126,862,Alan Hutton,2172,"[2007, 2008, 2010]",Tottenham Hotspur,23,18,5,1715,1,0,20,20,0,1789,1,0,43,38,5,3504,2,0,0.0,0.0,0.0,0,0,0,0,0,0,0,0,0,2020-12-27 19:15:002020-12-27 19:15:002020-12-27 19:15:00
127,288,Alan Hutton,2172,[2009],Sunderland AFC,6,6,0,540,0,0,5,5,0,450,0,0,11,11,0,990,0,0,0.0,0.0,0.0,0,0,0,0,0,0,0,0,0,2020-12-27 19:15:00
128,873,Alan Hutton,2172,"[2011, 2014, 2015]",Aston Villa,46,40,6,3633,1,0,43,42,1,3714,0,0,89,82,7,7347,1,0,3.0,0.0,3.0,1,0,1,0,0,0,0,0,0,2020-12-27 19:15:002020-12-27 19:15:002020-12-27 19:15:00
129,293,Alan Judge,4080,[2010],Blackburn Rovers,0,0,0,0,0,0,0,0,0,0,0,0,0,0,0,0,0,0,0.0,0.0,0.0,0,0,0,0,0,0,0,0,0,2020-12-27 19:15:00
130,589,Alan Kelly,4362,"[2001, 2002]",Blackburn Rovers,1,1,0,90,0,0,2,2,0,180,0,0,3,3,0,270,0,0,0.0,0.0,0.0,0,0,0,0,0,0,0,0,0,2020-12-27 19:15:002020-12-27 19:15:00
131,891,Alan Mahon,1347,"[2001, 2002, 2003]",Blackburn Rovers,9,5,4,530,1,0,9,6,3,518,0,0,18,11,7,1048,1,0,0.0,0.0,0.0,1,0,1,0,0,0,0,0,0,2020-12-27 19:15:002020-12-27 19:15:002020-12-27 19:15:00
132,299,Alan Mahon,1347,[2005],Wigan Athletic,3,2,1,172,0,0,3,3,0,210,1,0,6,5,1,382,1,0,0.0,0.0,0.0,0,0,0,0,0,0,0,0,0,2020-12-27 19:15:00
133,300,Alan Maybury,4268,[2001],Leeds United,0,0,0,0,0,0,1,0,1,15,0,0,1,0,1,15,0,0,0.0,0.0,0.0,0,0,0,0,0,0,0,0,0,2020-12-27 19:15:00
134,301,Alan Miller,4526,[2000],Coventry City,0,0,0,0,0,0,1,0,1,67,0,0,1,0,1,67,0,0,0.0,0.0,0.0,0,0,0,0,0,0,0,0,0,2020-12-27 19:15:00
135,909,Alan O'Brien,4157,"[2004, 2005, 2006]",Newcastle United,3,2,1,208,0,0,3,0,3,42,0,0,6,2,4,250,0,0,0.0,0.0,0.0,0,0,0,0,0,0,0,0,0,2020-12-27 19:15:002020-12-27 19:15:002020-12-27 19:15:00
136,305,Alan Quinn,2586,[2006],Sheffield United,9,5,4,495,0,0,10,6,4,473,0,0,19,11,8,968,0,0,0.0,0.0,0.0,0,0,0,0,0,0,0,0,0,2020-12-27 19:15:00
137,613,Alan Rogers,3165,"[2001, 2003]",Leicester City,10,7,3,704,0,0,11,9,2,833,0,0,21,16,5,1537,0,0,0.0,0.0,0.0,0,0,0,0,0,0,0,0,0,2020-12-27 19:15:002020-12-27 19:15:00
138,1863,Alan Shearer,1948,"[2000, 2001, 2002, 2003, 2004, 2005]",Newcastle United,94,93,1,8302,47,0,87,84,3,7391,37,0,181,177,4,15693,84,0,23.0,13.0,36.0,25,27,52,11,12,23,0,0,0,2020-12-27 19:15:002020-12-27 19:15:002020-12-27 19:15:002020-12-27 19:15:002020-12-27 19:15:002020-12-27 19:15:00
139,1262,Alan Smith,1300,"[2000, 2001, 2002, 2003]",Leeds United,54,47,7,4301,18,0,56,52,4,4540,9,0,110,99,11,8841,27,0,6.0,4.0,10.0,9,7,16,1,0,1,0,0,0,2020-12-27 19:15:002020-12-27 19:15:002020-12-27 19:15:002020-12-27 19:15:00
140,957,Alan Smith,1300,"[2004, 2005, 2006]",Manchester United,31,20,11,1871,3,0,29,22,7,2025,4,0,60,42,18,3896,7,0,1.0,1.0,2.0,2,3,5,0,0,0,0,0,0,2020-12-27 19:15:002020-12-27 19:15:002020-12-27 19:15:00
141,1290,Alan Smith,1300,"[2007, 2008, 2010, 2011]",Newcastle United,22,15,7,1369,0,0,29,21,8,1927,0,0,51,36,15,3296,0,0,0.0,0.0,0.0,0,0,0,0,0,0,0,0,0,2020-12-27 19:15:002020-12-27 19:15:002020-12-27 19:15:002020-12-27 19:15:00
142,2296,Alan Stubbs,2795,"[2001, 2002, 2003, 2004, 2005, 2006, 2007]",Everton FC,89,84,5,7325,3,0,75,71,4,6270,3,0,164,155,9,13595,6,0,0.0,0.0,0.0,3,1,4,0,0,0,0,0,0,2020-12-27 19:15:002020-12-27 19:15:002020-12-27 19:15:002020-12-27 19:15:002020-12-27 19:15:002020-12-27 19:15:002020-12-27 19:15:00
143,665,Alan Tate,2807,"[2011, 2012]",Swansea City,2,1,1,72,0,0,6,2,4,253,0,0,8,3,5,325,0,0,0.0,0.0,0.0,0,0,0,0,0,0,0,0,0,2020-12-27 19:15:002020-12-27 19:15:00
144,1005,Alan Wright,2766,"[2000, 2001, 2002]",Aston Villa,35,33,2,2958,1,0,30,30,0,2600,0,0,65,63,2,5558,1,0,0.0,0.0,0.0,0,0,0,0,0,0,0,0,0,2020-12-27 19:15:002020-12-27 19:15:002020-12-27 19:15:00
145,337,Alan Wright,2766,[2003],Middlesbrough FC,1,1,0,90,0,0,1,1,0,90,0,0,2,2,0,180,0,0,0.0,0.0,0.0,0,0,0,0,0,0,0,0,0,2020-12-27 19:15:00
146,338,Alan Wright,2766,[2006],Sheffield United,0,0,0,0,0,0,1,1,0,90,0,0,1,1,0,90,0,0,0.0,0.0,0.0,0,0,0,0,0,0,0,0,0,2020-12-27 19:15:00
147,339,Albert Adomah,3943,[2016],Middlesbrough FC,1,1,0,90,0,0,1,0,1,31,0,0,2,1,1,121,0,0,0.0,0.0,0.0,0,0,0,0,0,0,0,0,0,2020-12-27 19:15:00
148,1023,Albert Ferrer,3179,"[2000, 2001, 2002]",Chelsea FC,11,9,2,696,0,0,9,7,2,612,0,0,20,16,4,1308,0,0,0.0,0.0,0.0,0,0,0,0,0,0,0,0,0,2020-12-27 19:15:002020-12-27 19:15:002020-12-27 19:15:00
149,343,Albert Jarrett,4441,[2006],Watford FC,0,0,0,0,0,0,1,0,1,19,0,0,1,0,1,19,0,0,0.0,0.0,0.0,0,0,0,0,0,0,0,0,0,2020-12-27 19:15:00
150,344,Albert Riera,1890,[2005],Manchester City,7,7,0,579,1,0,8,5,3,489,0,0,15,12,3,1068,1,0,0.0,0.0,0.0,1,0,1,0,0,0,0,0,0,2020-12-27 19:15:00
151,691,Albert Riera,1890,"[2008, 2009]",Liverpool FC,24,21,3,1663,3,0,16,12,4,888,0,0,40,33,7,2551,3,0,0.0,0.0,0.0,2,0,2,0,0,0,0,0,0,2020-12-27 19:15:002020-12-27 19:15:00
152,347,Alberto Aquilani,2055,[2009],Liverpool FC,10,6,4,521,1,0,8,3,5,295,0,0,18,9,9,816,1,0,0.0,0.0,0.0,0,0,0,0,0,0,0,0,0,2020-12-27 19:15:00
153,1750,Alberto Moreno,2128,"[2014, 2015, 2016, 2017, 2018]",Liverpool FC,46,38,8,3446,2,0,43,33,10,2987,1,0,89,71,18,6433,3,0,0.0,0.0,0.0,2,0,2,0,0,0,0,0,0,2020-12-27 19:15:002020-12-27 19:15:002020-12-27 19:15:002020-12-27 19:15:002020-12-27 19:15:00
154,353,Alberto Paloschi,3029,[2015],Swansea City,4,4,0,299,0,0,6,3,3,370,2,0,10,7,3,669,2,0,0.0,1.0,1.0,0,2,2,0,0,0,0,0,0,2020-12-27 19:15:00
155,354,Albian Ajeti,2353,[2019],West Ham United,5,0,5,78,0,0,4,0,4,53,0,0,9,0,9,131,0,0,0.0,0.0,0.0,0,0,0,0,0,0,0,0,0,2020-12-27 19:15:00
156,355,Alec Chamberlain,4316,[2006],Watford FC,1,0,1,1,0,0,0,0,0,0,0,0,1,0,1,1,0,0,0.0,0.0,0.0,0,0,0,0,0,0,0,0,0,2020-12-27 19:15:00
157,713,Aleix García,3128,"[2015, 2016]",Manchester City,2,0,2,19,0,0,2,1,1,56,0,0,4,1,3,75,0,0,0.0,0.0,0.0,0,0,0,0,0,0,0,0,0,2020-12-27 19:15:002020-12-27 19:15:00
158,1077,Alejandro Faurlín,2166,"[2011, 2012, 2014]",Queens Park Rangers,17,16,1,1350,0,0,16,15,1,1325,1,0,33,31,2,2675,1,0,0.0,0.0,0.0,0,0,0,0,0,0,0,0,0,2020-12-27 19:15:002020-12-27 19:15:002020-12-27 19:15:00
159,361,Aleksandar Dragović,2567,[2017],Leicester City,6,3,3,384,0,0,5,4,1,382,0,0,11,7,4,766,0,0,0.0,0.0,0.0,0,0,0,0,0,0,0,0,0,2020-12-27 19:15:00
160,2555,Aleksandar Kolarov,1366,"[2010, 2011, 2012, 2013, 2014, 2015, 2016]",Manchester City,81,69,12,6140,6,0,84,60,24,5751,5,0,165,129,36,11891,11,0,1.0,0.0,1.0,2,2,4,0,0,0,0,0,0,2020-12-27 19:15:002020-12-27 19:15:002020-12-27 19:15:002020-12-27 19:15:002020-12-27 19:15:002020-12-27 19:15:002020-12-27 19:15:00
161,739,Aleksandar Mitrović,2285,"[2015, 2017]",Newcastle United,21,11,10,1187,6,0,19,11,8,1113,4,0,40,22,18,2300,10,0,4.0,0.0,4.0,3,4,7,1,1,2,0,0,0,2020-12-27 19:15:002020-12-27 19:15:00
162,743,Aleksandar Mitrović,2285,"[2018, 2020]",Fulham FC,25,21,4,1965,8,0,25,24,1,2106,5,0,50,45,5,4071,13,0,7.0,3.0,10.0,7,3,10,0,2,2,0,0,0,2020-12-27 19:15:002020-12-27 19:15:00
163,373,Aleksandar Rodić,4131,[2004],Portsmouth FC,2,0,2,27,0,0,2,1,1,91,0,0,4,1,3,118,0,0,0.0,0.0,0.0,0,0,0,0,0,0,0,0,0,2020-12-27 19:15:00
164,374,Aleksandar Tonev,4048,[2013],Aston Villa,9,3,6,305,0,0,8,3,5,291,0,0,17,6,11,596,0,0,0.0,0.0,0.0,0,0,0,0,0,0,0,0,0,2020-12-27 19:15:00
165,375,Aleksey Smertin,1072,[2003],Portsmouth FC,12,12,0,1013,0,0,14,11,3,1054,0,0,26,23,3,2067,0,0,0.0,0.0,0.0,0,0,0,0,0,0,0,0,0,2020-12-27 19:15:00
166,376,Aleksey Smertin,1072,[2004],Chelsea FC,8,5,3,351,0,0,8,6,2,431,0,0,16,11,5,782,0,0,0.0,0.0,0.0,0,0,0,0,0,0,0,0,0,2020-12-27 19:15:00
167,377,Aleksey Smertin,1072,[2005],Charlton Athletic,9,9,0,742,0,0,9,9,0,785,0,0,18,18,0,1527,0,0,0.0,0.0,0.0,0,0,0,0,0,0,0,0,0,2020-12-27 19:15:00
168,757,Aleksey Smertin,1072,"[2006, 2007]",Fulham FC,12,10,2,858,2,0,10,7,3,666,0,0,22,17,5,1524,2,0,3.0,0.0,3.0,1,0,1,0,0,0,0,0,0,2020-12-27 19:15:002020-12-27 19:15:00
169,1143,Alen Bokšić,2699,"[2000, 2001, 2002]",Middlesbrough FC,37,32,5,2834,9,0,30,26,4,2182,13,0,67,58,9,5016,22,0,1.0,7.0,8.0,4,9,13,2,2,4,0,0,0,2020-12-27 19:15:002020-12-27 19:15:002020-12-27 19:15:00
170,767,Alessandro Diamanti,1287,"[2009, 2010]",West Ham United,14,10,4,1005,6,0,14,8,6,826,1,0,28,18,10,1831,7,0,1.0,0.0,1.0,5,1,6,4,0,4,0,0,0,2020-12-27 19:15:002020-12-27 19:15:00
171,385,Alessandro Diamanti,1287,[2015],Watford FC,2,0,2,50,0,0,1,0,1,14,0,0,3,0,3,64,0,0,0.0,0.0,0.0,0,0,0,0,0,0,0,0,0,2020-12-27 19:15:00
172,1942,Alessandro Pistone,1799,"[2000, 2001, 2002, 2004, 2005]",Everton FC,39,35,4,3021,1,0,42,38,4,3285,0,0,81,73,8,6306,1,0,0.0,0.0,0.0,1,0,1,0,0,0,0,0,0,2020-12-27 19:15:002020-12-27 19:15:002020-12-27 19:15:002020-12-27 19:15:002020-12-27 19:15:00
173,389,Alessandro Pistone,1799,[2003],Leeds United,1,1,0,90,0,0,0,0,0,0,0,0,1,1,0,90,0,0,0.0,0.0,0.0,0,0,0,0,0,0,0,0,0,2020-12-27 19:15:00
174,1970,Alex,2269,"[2007, 2008, 2009, 2010, 2011]",Chelsea FC,40,34,6,3157,5,0,45,37,8,3414,2,0,85,71,14,6571,7,0,0.0,0.0,0.0,4,1,5,0,0,0,0,0,0,2020-12-27 19:15:002020-12-27 19:15:002020-12-27 19:15:002020-12-27 19:15:002020-12-27 19:15:00
175,397,Alex Baptiste,3591,[2010],Blackpool FC,11,10,1,906,0,0,10,9,1,823,2,0,21,19,2,1729,2,0,0.0,0.0,0.0,0,1,1,0,0,0,0,0,0,2020-12-27 19:15:00
176,398,Alex Baptiste,3591,[2016],Middlesbrough FC,0,0,0,0,0,0,0,0,0,0,0,0,0,0,0,0,0,0,0.0,0.0,0.0,0,0,0,0,0,0,0,0,0,2020-12-27 19:15:00
177,399,Alex Bruce,2222,[2005],Birmingham City,1,0,1,2,0,0,5,3,2,274,0,0,6,3,3,276,0,0,0.0,0.0,0.0,0,0,0,0,0,0,0,0,0,2020-12-27 19:15:00
178,801,Alex Bruce,2222,"[2013, 2014]",Hull City,16,14,2,1174,0,0,26,22,4,1868,0,0,42,36,6,3042,0,0,0.0,0.0,0.0,0,0,0,0,0,0,0,0,0,2020-12-27 19:15:002020-12-27 19:15:00
179,402,Alex Cochrane,4541,[2019],Brighton & Hove Albion,0,0,0,0,0,0,0,0,0,0,0,0,0,0,0,0,0,0,0.0,0.0,0.0,0,0,0,0,0,0,0,0,0,2020-12-27 19:15:00
180,403,Alex Dobre,4270,[2019],AFC Bournemouth,0,0,0,0,0,0,0,0,0,0,0,0,0,0,0,0,0,0,0.0,0.0,0.0,0,0,0,0,0,0,0,0,0,2020-12-27 19:15:00
181,1622,Alex Iwobi,1462,"[2015, 2016, 2017, 2018]",Arsenal FC,48,29,19,2575,8,0,51,40,11,3275,3,0,99,69,30,5850,11,0,0.0,0.0,0.0,0,2,2,0,0,0,0,0,0,2020-12-27 19:15:002020-12-27 19:15:002020-12-27 19:15:002020-12-27 19:15:00
182,817,Alex Iwobi,1462,"[2019, 2020]",Everton FC,19,12,7,1126,1,0,20,15,5,1273,0,0,39,27,12,2399,1,0,0.0,0.0,0.0,1,0,1,0,0,0,0,0,0,2020-12-27 19:15:002020-12-27 19:15:00
183,410,Alex McCarthy,1032,[2012],Reading FC,6,6,0,540,0,0,7,7,0,630,0,0,13,13,0,1170,0,0,0.0,0.0,0.0,0,0,0,0,0,0,0,0,0,2020-12-27 19:15:00
184,411,Alex McCarthy,1032,[2014],Queens Park Rangers,2,1,1,146,0,0,1,1,0,90,0,0,3,2,1,236,0,0,0.0,0.0,0.0,0,0,0,0,0,0,0,0,0,2020-12-27 19:15:00
185,412,Alex McCarthy,1032,[2015],Crystal Palace,4,4,0,360,0,0,3,3,0,270,0,0,7,7,0,630,0,0,0.0,0.0,0.0,0,0,0,0,0,0,0,0,0,2020-12-27 19:15:00
186,2075,Alex McCarthy,1032,"[2016, 2017, 2018, 2019, 2020]",Southampton FC,42,42,0,3780,0,0,44,44,0,3960,0,0,86,86,0,7740,0,0,0.0,0.0,0.0,0,0,0,0,0,0,0,0,0,2020-12-27 19:15:002020-12-27 19:15:002020-12-27 19:15:002020-12-27 19:15:002020-12-27 19:15:00
187,418,Alex Nimely-Tchuimeni,3595,[2009],Manchester City,0,0,0,0,0,0,1,0,1,7,0,0,1,0,1,7,0,0,0.0,0.0,0.0,0,0,0,0,0,0,0,0,0,2020-12-27 19:15:00
188,419,Alex Nyarko,2825,[2000],Everton FC,8,7,1,600,0,0,13,11,2,975,1,0,21,18,3,1575,1,0,0.0,0.0,0.0,0,0,0,0,0,0,0,0,0,2020-12-27 19:15:00
189,420,Alex Nyarko,2825,[2003],Leeds United,1,0,1,35,0,0,0,0,0,0,0,0,1,0,1,35,0,0,0.0,0.0,0.0,0,0,0,0,0,0,0,0,0,2020-12-27 19:15:00
190,2541,Alex Oxlade-Chamberlain,1184,"[2011, 2012, 2013, 2014, 2015, 2016]",Arsenal FC,63,31,32,2827,7,0,64,34,30,3260,2,0,127,65,62,6087,9,0,1.0,0.0,1.0,3,0,3,0,0,0,0,0,0,2020-12-27 19:15:002020-12-27 19:15:002020-12-27 19:15:002020-12-27 19:15:002020-12-27 19:15:002020-12-27 19:15:00
191,1714,Alex Oxlade-Chamberlain,1184,"[2017, 2018, 2019, 2020]",Liverpool FC,31,13,18,1331,4,0,35,18,17,1684,3,0,66,31,35,3015,7,0,0.0,0.0,0.0,2,1,3,0,0,0,0,0,0,2020-12-27 19:15:002020-12-27 19:15:002020-12-27 19:15:002020-12-27 19:15:00
192,1730,Alex Palmer,3860,"[2014, 2015, 2016, 2017]",West Bromwich Albion,0,0,0,0,0,0,0,0,0,0,0,0,0,0,0,0,0,0,0.0,0.0,0.0,0,0,0,0,0,0,0,0,0,2020-12-27 19:15:002020-12-27 19:15:002020-12-27 19:15:002020-12-27 19:15:00
193,435,Alex Pearce,1987,[2012],Reading FC,8,8,0,720,0,0,11,10,1,925,0,0,19,18,1,1645,0,0,0.0,0.0,0.0,0,0,0,0,0,0,0,0,0,2020-12-27 19:15:00
194,436,Alex Pike,3964,[2016],West Ham United,0,0,0,0,0,0,0,0,0,0,0,0,0,0,0,0,0,0,0.0,0.0,0.0,0,0,0,0,0,0,0,0,0,2020-12-27 19:15:00
195,437,Alex Pritchard,3028,[2013],Tottenham Hotspur,1,0,1,7,0,0,0,0,0,0,0,0,1,0,1,7,0,0,0.0,0.0,0.0,0,0,0,0,0,0,0,0,0,2020-12-27 19:15:00
196,438,Alex Pritchard,3028,[2015],West Bromwich Albion,1,0,1,17,0,0,1,0,1,44,0,0,2,0,2,61,0,0,0.0,0.0,0.0,0,0,0,0,0,0,0,0,0,2020-12-27 19:15:00
197,879,Alex Pritchard,3028,"[2017, 2018]",Huddersfield Town,21,19,2,1513,2,0,23,19,4,1581,1,0,44,38,6,3094,3,0,0.0,1.0,1.0,2,1,3,0,0,0,0,0,0,2020-12-27 19:15:002020-12-27 19:15:00
198,883,Alex Rae,1097,"[2000, 2001]",Sunderland AFC,9,8,1,695,1,0,8,8,0,720,1,0,17,16,1,1415,2,0,0.0,3.0,3.0,1,1,2,0,0,0,0,0,0,2020-12-27 19:15:002020-12-27 19:15:00
199,443,Alex Rae,1097,[2003],Wolverhampton Wanderers,16,12,4,1154,2,0,17,15,2,1372,3,0,33,27,6,2526,5,0,0.0,0.0,0.0,2,1,3,0,0,0,0,0,0,2020-12-27 19:15:00
200,444,Alex Rúnarsson,1057,[2020],Arsenal FC,0,0,0,0,0,0,0,0,0,0,0,0,0,0,0,0,0,0,0.0,0.0,0.0,0,0,0,0,0,0,0,0,0,2020-12-27 19:15:00
201,445,Alex Smith,2556,[2012],Fulham FC,1,0,1,1,0,0,0,0,0,0,0,0,1,0,1,1,0,0,0.0,0.0,0.0,0,0,0,0,0,0,0,0,0,2020-12-27 19:15:00
202,446,Alex Smithies,3151,[2018],Cardiff City,0,0,0,0,0,0,0,0,0,0,0,0,0,0,0,0,0,0,0.0,0.0,0.0,0,0,0,0,0,0,0,0,0,2020-12-27 19:15:00
203,2702,Alex Song,1233,"[2005, 2007, 2008, 2009, 2010, 2011]",Arsenal FC,67,57,10,5029,4,0,68,62,6,5580,3,0,135,119,16,10609,7,0,3.0,0.0,3.0,2,0,2,0,0,0,0,0,0,2020-12-27 19:15:002020-12-27 19:15:002020-12-27 19:15:002020-12-27 19:15:002020-12-27 19:15:002020-12-27 19:15:00
204,448,Alex Song,1233,[2006],Charlton Athletic,6,6,0,445,0,0,6,6,0,540,0,0,12,12,0,985,0,0,0.0,0.0,0.0,0,0,0,0,0,0,0,0,0,2020-12-27 19:15:00
205,909,Alex Song,1233,"[2014, 2015]",West Ham United,18,18,0,1478,0,0,22,15,7,1429,0,0,40,33,7,2907,0,0,0.0,0.0,0.0,0,0,0,0,0,0,0,0,0,2020-12-27 19:15:002020-12-27 19:15:00
206,456,Alex Telles,1025,[2020],Manchester United,2,1,1,120,0,0,3,3,0,264,0,0,5,4,1,384,0,0,0.0,0.0,0.0,0,0,0,0,0,0,0,0,0,2020-12-27 19:15:00
207,915,Alexander Büttner,3712,"[2012, 2013]",Manchester United,8,5,3,493,1,0,5,4,1,386,1,0,13,9,4,879,2,0,0.0,0.0,0.0,0,0,0,0,0,0,0,0,0,2020-12-27 19:15:002020-12-27 19:15:00
208,919,Alexander Cleland,3926,"[2000, 2001]",Everton FC,3,1,2,176,0,0,5,1,4,116,0,0,8,2,6,292,0,0,0.0,0.0,0.0,0,0,0,0,0,0,0,0,0,2020-12-27 19:15:002020-12-27 19:15:00
209,1386,Alexander Kačaniklić,2555,"[2011, 2012, 2013]",Fulham FC,24,15,9,1248,2,0,22,18,4,1488,3,0,46,33,13,2736,5,0,0.0,3.0,3.0,0,3,3,0,0,0,0,0,0,2020-12-27 19:15:002020-12-27 19:15:002020-12-27 19:15:00
210,464,Alexander Manninger,3714,[2000],Arsenal FC,4,4,0,360,0,0,6,6,0,540,0,0,10,10,0,900,0,0,0.0,0.0,0.0,0,0,0,0,0,0,0,0,0,2020-12-27 19:15:00
211,465,Alexander Manninger,3714,[2016],Liverpool FC,0,0,0,0,0,0,0,0,0,0,0,0,0,0,0,0,0,0,0.0,0.0,0.0,0,0,0,0,0,0,0,0,0,2020-12-27 19:15:00
212,933,Alexander Sørloth,2703,"[2017, 2018]",Crystal Palace,10,2,8,301,0,0,6,2,4,232,0,0,16,4,12,533,0,0,0.0,0.0,0.0,0,0,0,0,0,0,0,0,0,2020-12-27 19:15:002020-12-27 19:15:00
213,1878,Alexander Tettey,1830,"[2012, 2013, 2015, 2019]",Norwich City,50,43,7,3734,3,0,51,46,5,3953,1,0,101,89,12,7687,4,0,3.0,0.0,3.0,2,0,2,0,0,0,0,0,0,2020-12-27 19:15:002020-12-27 19:15:002020-12-27 19:15:002020-12-27 19:15:00
214,472,Alexandre Jankewitz,4476,[2019],Southampton FC,0,0,0,0,0,0,0,0,0,0,0,0,0,0,0,0,0,0,0.0,0.0,0.0,0,0,0,0,0,0,0,0,0,2020-12-27 19:15:00
215,1898,Alexandre Lacazette,1481,"[2017, 2018, 2019, 2020]",Arsenal FC,56,47,9,3945,30,0,53,37,16,3401,11,0,109,84,25,7346,41,0,5.0,3.0,8.0,16,7,23,3,0,3,0,0,0,2020-12-27 19:15:002020-12-27 19:15:002020-12-27 19:15:002020-12-27 19:15:00
216,477,Alexandre Pato,3507,[2015],Chelsea FC,0,0,0,0,0,0,2,1,1,131,1,0,2,1,1,131,1,0,0.0,0.0,0.0,0,0,0,0,1,1,0,0,0,2020-12-27 19:15:00
217,957,Alexis Mac Allister,2508,"[2019, 2020]",Brighton & Hove Albion,5,2,3,205,0,0,8,2,6,208,1,0,13,4,9,413,1,0,0.0,1.0,1.0,0,1,1,0,0,0,0,0,0,2020-12-27 19:15:002020-12-27 19:15:00
218,480,Alexis Nicolas,4321,[2003],Chelsea FC,2,1,1,91,0,0,0,0,0,0,0,0,2,1,1,91,0,0,0.0,0.0,0.0,0,0,0,0,0,0,0,0,0,2020-12-27 19:15:00
219,1446,Alexis Sánchez,1505,"[2014, 2015, 2016]",Arsenal FC,51,47,4,4182,24,0,51,50,1,4349,29,0,102,97,5,8531,53,0,6.0,2.0,8.0,14,14,28,2,0,2,0,0,0,2020-12-27 19:15:002020-12-27 19:15:002020-12-27 19:15:00
220,969,Alexis Sánchez,1505,"[2017, 2018]",Manchester United,17,10,7,993,3,0,16,12,4,1022,0,0,33,22,11,2015,3,0,3.0,0.0,3.0,1,0,1,0,0,0,0,0,0,2020-12-27 19:15:002020-12-27 19:15:00
221,486,Alf-Inge Håland,3307,[2000],Manchester City,17,17,0,1450,2,0,16,16,0,1412,1,0,33,33,0,2862,3,0,0.0,0.0,0.0,0,1,1,0,0,0,0,0,0,2020-12-27 19:15:00
222,487,Alfie Jones,4256,[2018],Southampton FC,0,0,0,0,0,0,0,0,0,0,0,0,0,0,0,0,0,0,0.0,0.0,0.0,0,0,0,0,0,0,0,0,0,2020-12-27 19:15:00
223,488,Alfie Lewis,4548,[2019],West Ham United,0,0,0,0,0,0,0,0,0,0,0,0,0,0,0,0,0,0,0.0,0.0,0.0,0,0,0,0,0,0,0,0,0,2020-12-27 19:15:00
224,979,Alfie Mawson,3189,"[2016, 2017]",Swansea City,33,33,0,2970,4,0,32,32,0,2880,2,0,65,65,0,5850,6,0,3.0,0.0,3.0,3,1,4,0,0,0,0,0,0,2020-12-27 19:15:002020-12-27 19:15:00
225,491,Alfie Mawson,3189,[2018],Fulham FC,8,7,1,547,0,0,7,6,1,584,0,0,15,13,2,1131,0,0,0.0,0.0,0.0,0,0,0,0,0,0,0,0,0,2020-12-27 19:15:00
226,1479,Alfie Whiteman,3399,"[2017, 2018, 2019]",Tottenham Hotspur,0,0,0,0,0,0,0,0,0,0,0,0,0,0,0,0,0,0,0.0,0.0,0.0,0,0,0,0,0,0,0,0,0,2020-12-27 19:15:002020-12-27 19:15:002020-12-27 19:15:00
227,495,Alfred N'Diaye,3764,[2012],Sunderland AFC,8,7,1,591,0,0,8,8,0,707,0,0,16,15,1,1298,0,0,0.0,0.0,0.0,0,0,0,0,0,0,0,0,0,2020-12-27 19:15:00
228,496,Alfred N'Diaye,3764,[2016],Hull City,8,8,0,669,1,0,7,7,0,608,0,0,15,15,0,1277,1,0,0.0,0.0,0.0,1,0,1,0,0,0,0,0,0,2020-12-27 19:15:00
229,497,Ali Al Habsi,2877,[2007],Bolton Wanderers,2,2,0,180,0,0,6,6,0,540,0,0,8,8,0,720,0,0,0.0,0.0,0.0,0,0,0,0,0,0,0,0,0,2020-12-27 19:15:00
230,1497,Ali Al Habsi,2877,"[2010, 2011, 2012]",Wigan Athletic,50,50,0,4500,0,0,51,51,0,4590,0,0,101,101,0,9090,0,0,0.0,0.0,0.0,0,0,0,0,0,0,0,0,0,2020-12-27 19:15:002020-12-27 19:15:002020-12-27 19:15:00
231,501,Ali Benarbia,3204,[2002],Manchester City,17,10,7,992,3,0,15,10,5,981,0,0,32,20,12,1973,3,0,0.0,0.0,0.0,2,0,2,0,0,0,0,0,0,2020-12-27 19:15:00
232,502,Ali Gabr,1664,[2017],West Bromwich Albion,0,0,0,0,0,0,0,0,0,0,0,0,0,0,0,0,0,0,0.0,0.0,0.0,0,0,0,0,0,0,0,0,0,2020-12-27 19:15:00
233,1007,Ali Koiki,4188,"[2018, 2019]",Burnley FC,0,0,0,0,0,0,0,0,0,0,0,0,0,0,0,0,0,0,0.0,0.0,0.0,0,0,0,0,0,0,0,0,0,2020-12-27 19:15:002020-12-27 19:15:00
234,1518,Aliaksandr Hleb,2433,"[2005, 2006, 2007]",Arsenal FC,44,35,9,3110,5,0,42,35,7,2895,2,0,86,70,16,6005,7,0,3.0,0.0,3.0,3,0,3,0,0,0,0,0,0,2020-12-27 19:15:002020-12-27 19:15:002020-12-27 19:15:00
235,508,Aliaksandr Hleb,2433,[2010],Birmingham City,10,5,5,499,0,0,9,8,1,598,1,0,19,13,6,1097,1,0,0.0,0.0,0.0,0,1,1,0,0,0,0,0,0,2020-12-27 19:15:00
236,1019,Aliou Cissé,2622,"[2002, 2003]",Birmingham City,19,13,6,1196,0,0,17,13,4,1219,0,0,36,26,10,2415,0,0,0.0,0.0,0.0,0,0,0,0,0,0,0,0,0,2020-12-27 19:15:002020-12-27 19:15:00
237,1023,Aliou Cissé,2622,"[2004, 2005]",Portsmouth FC,10,5,5,516,0,0,13,9,4,807,0,0,23,14,9,1323,0,0,0.0,0.0,0.0,0,0,0,0,0,0,0,0,0,2020-12-27 19:15:002020-12-27 19:15:00
238,1542,Alireza Jahanbakhsh,2431,"[2018, 2019, 2020]",Brighton & Hove Albion,21,7,14,776,2,0,18,9,9,727,0,0,39,16,23,1503,2,0,1.0,0.0,1.0,2,0,2,0,0,0,0,0,0,2020-12-27 19:15:002020-12-27 19:15:002020-12-27 19:15:00
239,1551,Alisson,2084,"[2018, 2019, 2020]",Liverpool FC,40,40,0,3549,0,0,39,39,0,3510,0,0,79,79,0,7059,0,0,0.0,0.0,0.0,0,0,0,0,0,0,0,0,0,2020-12-27 19:15:002020-12-27 19:15:002020-12-27 19:15:00
240,519,Allan,1000,[2020],Everton FC,5,5,0,450,0,0,7,7,0,580,0,0,12,12,0,1030,0,0,0.0,0.0,0.0,0,0,0,0,0,0,0,0,0,2020-12-27 19:15:00
241,520,Allan Johnston,3683,[2001],Middlesbrough FC,9,7,2,550,1,0,8,6,2,436,0,0,17,13,4,986,1,0,0.0,0.0,0.0,0,0,0,0,0,0,0,0,0,2020-12-27 19:15:00
242,1043,Allan McGregor,2221,"[2013, 2014]",Hull City,27,27,0,2386,0,0,25,25,0,2250,0,0,52,52,0,4636,0,0,0.0,0.0,0.0,0,0,0,0,0,0,0,0,0,2020-12-27 19:15:002020-12-27 19:15:00
243,523,Allan Nyom,1654,[2015],Watford FC,15,12,3,1060,0,0,17,17,0,1415,0,0,32,29,3,2475,0,0,0.0,0.0,0.0,0,0,0,0,0,0,0,0,0,2020-12-27 19:15:00
244,1049,Allan Nyom,1654,"[2016, 2017]",West Bromwich Albion,31,26,5,2389,0,0,30,28,2,2557,0,0,61,54,7,4946,0,0,0.0,0.0,0.0,0,0,0,0,0,0,0,0,0,2020-12-27 19:15:002020-12-27 19:15:00
245,1053,Allan Saint-Maximin,2473,"[2019, 2020]",Newcastle United,20,17,3,1372,2,0,14,14,0,1090,2,0,34,31,3,2462,4,0,0.0,3.0,3.0,2,2,4,0,0,0,0,0,0,2020-12-27 19:15:002020-12-27 19:15:00
246,528,Almen Abdi,3185,[2015],Watford FC,16,10,6,862,1,0,16,15,1,1125,1,0,32,25,7,1987,2,0,0.0,0.0,0.0,1,0,1,0,0,0,0,0,0,2020-12-27 19:15:00
247,1059,Alou Diarra,3094,"[2012, 2013]",West Ham United,1,0,1,8,0,0,5,2,3,243,0,0,6,2,4,251,0,0,0.0,0.0,0.0,0,0,0,0,0,0,0,0,0,2020-12-27 19:15:002020-12-27 19:15:00
248,2130,Alpay Özalan,2765,"[2000, 2001, 2002, 2003]",Aston Villa,30,29,1,2499,1,0,25,24,1,2167,0,0,55,53,2,4666,1,0,0.0,0.0,0.0,1,0,1,0,0,0,0,0,0,2020-12-27 19:15:002020-12-27 19:15:002020-12-27 19:15:002020-12-27 19:15:00
249,535,Alphonse Aréola,1009,[2020],Fulham FC,7,7,0,630,0,0,7,7,0,630,0,0,14,14,0,1260,0,0,0.0,0.0,0.0,0,0,0,0,0,0,0,0,0,2020-12-27 19:15:00
250,1073,Alton Thelwell,3022,"[2000, 2001]",Tottenham Hotspur,10,5,5,584,0,0,7,7,0,585,0,0,17,12,5,1169,0,0,0.0,0.0,0.0,0,0,0,0,0,0,0,0,0,2020-12-27 19:15:002020-12-27 19:15:00
251,1077,Alun Armstrong,2725,"[2000, 2001]",Ipswich Town,27,19,8,1652,7,0,25,17,8,1446,4,0,52,36,16,3098,11,0,1.0,6.0,7.0,4,4,8,0,0,0,0,0,0,2020-12-27 19:15:002020-12-27 19:15:00
252,540,Aly Cissokho,1422,[2013],Liverpool FC,7,6,1,555,0,0,8,6,2,536,0,0,15,12,3,1091,0,0,0.0,0.0,0.0,0,0,0,0,0,0,0,0,0,2020-12-27 19:15:00
253,1083,Aly Cissokho,1422,"[2014, 2015]",Aston Villa,22,21,1,1920,0,0,21,21,0,1833,0,0,43,42,1,3753,0,0,0.0,0.0,0.0,0,0,0,0,0,0,0,0,0,2020-12-27 19:15:002020-12-27 19:15:00
254,543,Amaury Bischoff,4395,[2008],Arsenal FC,0,0,0,0,0,0,1,0,1,26,0,0,1,0,1,26,0,0,0.0,0.0,0.0,0,0,0,0,0,0,0,0,0,2020-12-27 19:15:00
255,1089,Amdy Faye,1070,"[2003, 2004]",Portsmouth FC,24,22,2,1992,0,0,23,22,1,1818,0,0,47,44,3,3810,0,0,0.0,0.0,0.0,0,0,0,0,0,0,0,0,0,2020-12-27 19:15:002020-12-27 19:15:00
256,546,Amdy Faye,1070,[2005],Newcastle United,11,6,5,678,0,0,11,8,3,661,0,0,22,14,8,1339,0,0,0.0,0.0,0.0,0,0,0,0,0,0,0,0,0,2020-12-27 19:15:00
257,547,Amdy Faye,1070,[2006],Charlton Athletic,13,10,3,873,0,0,15,15,0,1216,1,0,28,25,3,2089,1,0,0.0,3.0,3.0,0,1,1,0,0,0,0,0,0,2020-12-27 19:15:00
258,1097,Amdy Faye,1070,"[2008, 2009]",Stoke City,14,11,3,987,0,0,10,10,0,738,0,0,24,21,3,1725,0,0,0.0,0.0,0.0,0,0,0,0,0,0,0,0,0,2020-12-27 19:15:002020-12-27 19:15:00
259,1653,Amine Linganzi,4358,"[2009, 2010, 2011]",Blackburn Rovers,0,0,0,0,0,0,2,1,1,84,0,0,2,1,1,84,0,0,0.0,0.0,0.0,0,0,0,0,0,0,0,0,0,2020-12-27 19:15:002020-12-27 19:15:002020-12-27 19:15:00
260,553,Amr Zaki,3656,[2008],Wigan Athletic,13,10,3,935,3,0,15,11,4,1044,7,0,28,21,7,1979,10,0,4.0,3.0,7.0,2,4,6,2,2,4,0,0,0,2020-12-27 19:15:00
261,554,Amr Zaki,3656,[2009],Hull City,3,0,3,69,0,0,3,2,1,157,0,0,6,2,4,226,0,0,0.0,0.0,0.0,0,0,0,0,0,0,0,0,0,2020-12-27 19:15:00
262,2785,Ander Herrera,1644,"[2014, 2015, 2016, 2017, 2018]",Manchester United,65,43,22,4077,7,0,68,50,18,4570,5,0,133,93,40,8647,12,0,0.0,1.0,1.0,2,2,4,1,0,1,0,0,0,2020-12-27 19:15:002020-12-27 19:15:002020-12-27 19:15:002020-12-27 19:15:002020-12-27 19:15:00
263,2810,Anders Lindegaard,2319,"[2010, 2011, 2012, 2013, 2014]",Manchester United,9,9,0,810,0,0,10,10,0,900,0,0,19,19,0,1710,0,0,0.0,0.0,0.0,0,0,0,0,0,0,0,0,0,2020-12-27 19:15:002020-12-27 19:15:002020-12-27 19:15:002020-12-27 19:15:002020-12-27 19:15:00
264,565,Anders Lindegaard,2319,[2015],West Bromwich Albion,0,0,0,0,0,0,0,0,0,0,0,0,0,0,0,0,0,0,0.0,0.0,0.0,0,0,0,0,0,0,0,0,0,2020-12-27 19:15:00
265,566,Anders Lindegaard,2319,[2017],Burnley FC,0,0,0,0,0,0,0,0,0,0,0,0,0,0,0,0,0,0,0.0,0.0,0.0,0,0,0,0,0,0,0,0,0,2020-12-27 19:15:00
266,2274,Anders Svensson,2053,"[2001, 2002, 2003, 2004]",Southampton FC,60,46,14,4144,7,0,60,46,14,3943,3,0,120,92,28,8087,10,0,1.0,0.0,1.0,6,2,8,0,0,0,0,0,0,2020-12-27 19:15:002020-12-27 19:15:002020-12-27 19:15:002020-12-27 19:15:00
267,571,Anderson,2018,[2006],Everton FC,1,0,1,2,0,0,0,0,0,0,0,0,1,0,1,2,0,0,0.0,0.0,0.0,0,0,0,0,0,0,0,0,0,2020-12-27 19:15:00
268,4604,Anderson,2018,"[2007, 2008, 2009, 2010, 2011, 2012, 2013, 2014]",Manchester United,59,41,18,3635,3,0,44,27,17,2376,2,0,103,68,35,6011,5,0,0.0,0.0,0.0,2,2,4,0,0,0,0,0,0,2020-12-27 19:15:002020-12-27 19:15:002020-12-27 19:15:002020-12-27 19:15:002020-12-27 19:15:002020-12-27 19:15:002020-12-27 19:15:002020-12-27 19:15:00
269,580,Andi Zeqiri,1060,[2020],Brighton & Hove Albion,1,0,1,18,0,0,0,0,0,0,0,0,1,0,1,18,0,0,0.0,0.0,0.0,0,0,0,0,0,0,0,0,0,2020-12-27 19:15:00
270,1163,Andranik Teymourian,2038,"[2006, 2007]",Bolton Wanderers,10,3,7,395,0,0,10,4,6,508,2,0,20,7,13,903,2,0,0.0,0.0,0.0,0,1,1,0,0,0,0,0,0,2020-12-27 19:15:002020-12-27 19:15:00
271,583,Andranik Teymourian,2038,[2008],Fulham FC,1,0,1,9,0,0,0,0,0,0,0,0,1,0,1,9,0,0,0.0,0.0,0.0,0,0,0,0,0,0,0,0,0,2020-12-27 19:15:00
272,584,Andre Gray,1925,[2016],Burnley FC,14,12,2,1035,5,0,18,14,4,1232,4,0,32,26,6,2267,9,0,3.0,0.0,3.0,2,3,5,0,2,2,0,0,0,2020-12-27 19:15:00
273,1758,Andre Gray,1925,"[2017, 2018, 2019]",Watford FC,38,21,17,1927,8,0,45,15,30,1674,6,0,83,36,47,3601,14,0,7.0,0.0,7.0,5,3,8,0,0,0,0,0,0,2020-12-27 19:15:002020-12-27 19:15:002020-12-27 19:15:00
274,1767,Andre Wisdom,2625,"[2010, 2012, 2013]",Liverpool FC,7,6,1,552,0,0,7,7,0,545,0,0,14,13,1,1097,0,0,0.0,0.0,0.0,0,0,0,0,0,0,0,0,0,2020-12-27 19:15:002020-12-27 19:15:002020-12-27 19:15:00
275,591,Andre Wisdom,2625,[2014],West Bromwich Albion,12,12,0,1051,0,0,12,10,2,920,0,0,24,22,2,1971,0,0,0.0,0.0,0.0,0,0,0,0,0,0,0,0,0,2020-12-27 19:15:00
276,592,Andre Wisdom,2625,[2015],Norwich City,6,6,0,496,0,0,4,3,1,328,0,0,10,9,1,824,0,0,0.0,0.0,0.0,0,0,0,0,0,0,0,0,0,2020-12-27 19:15:00
277,1187,Andrea Dossena,3629,"[2008, 2009]",Liverpool FC,6,6,0,498,0,0,12,7,5,598,1,0,18,13,5,1096,1,0,0.0,0.0,0.0,0,0,0,0,0,0,0,0,0,2020-12-27 19:15:002020-12-27 19:15:00
278,595,Andrea Dossena,3629,[2013],Sunderland AFC,2,2,0,180,0,0,5,4,1,356,0,0,7,6,1,536,0,0,0.0,0.0,0.0,0,0,0,0,0,0,0,0,0,2020-12-27 19:15:00
279,596,Andrea Ranocchia,3763,[2016],Hull City,8,8,0,720,1,0,8,7,1,610,1,0,16,15,1,1330,2,0,3.0,0.0,3.0,1,0,1,0,0,0,0,0,0,2020-12-27 19:15:00
280,3597,Andreas Christensen,1854,"[2012, 2014, 2017, 2018, 2019, 2020]",Chelsea FC,31,26,5,2303,0,0,30,28,2,2509,0,0,61,54,7,4812,0,0,0.0,0.0,0.0,0,0,0,0,0,0,0,0,0,2020-12-27 19:15:002020-12-27 19:15:002020-12-27 19:15:002020-12-27 19:15:002020-12-27 19:15:002020-12-27 19:15:00
281,603,Andreas Cornelius,3539,[2013],Cardiff City,6,0,6,75,0,0,2,0,2,32,0,0,8,0,8,107,0,0,0.0,0.0,0.0,0,0,0,0,0,0,0,0,0,2020-12-27 19:15:00
282,604,Andreas Granqvist,2343,[2007],Blackburn Rovers,0,0,0,0,0,0,1,0,1,1,0,0,1,0,1,1,0,0,0.0,0.0,0.0,0,0,0,0,0,0,0,0,0,2020-12-27 19:15:00
283,1211,Andreas Isaksson,3677,"[2006, 2007]",Manchester City,8,7,1,685,0,0,11,10,1,944,0,0,19,17,2,1629,0,0,0.0,0.0,0.0,0,0,0,0,0,0,0,0,0,2020-12-27 19:15:002020-12-27 19:15:00
284,607,Andreas Jakobsson,3532,[2004],Southampton FC,14,12,2,906,1,0,12,11,1,1035,1,0,26,23,3,1941,2,0,1.0,0.0,1.0,1,1,2,0,0,0,0,0,0,2020-12-27 19:15:00
285,1217,Andreas Johansson,1821,"[2005, 2006]",Wigan Athletic,11,4,7,404,1,0,17,6,11,672,3,0,28,10,18,1076,4,0,0.0,1.0,1.0,1,3,4,0,0,0,0,0,0,2020-12-27 19:15:002020-12-27 19:15:00
286,2446,Andreas Pereira,2190,"[2014, 2015, 2018, 2019]",Manchester United,24,15,9,1323,2,0,21,9,12,855,0,0,45,24,21,2178,2,0,0.0,0.0,0.0,2,0,2,0,0,0,0,0,0,2020-12-27 19:15:002020-12-27 19:15:002020-12-27 19:15:002020-12-27 19:15:00
287,3080,Andreas Weimann,1441,"[2010, 2011, 2012, 2013, 2014]",Aston Villa,57,43,14,3739,12,0,55,38,17,3417,5,0,112,81,31,7156,17,0,6.0,3.0,9.0,8,4,12,0,0,0,0,0,0,2020-12-27 19:15:002020-12-27 19:15:002020-12-27 19:15:002020-12-27 19:15:002020-12-27 19:15:00
288,1239,Andrej Kramarić,2531,"[2014, 2015]",Leicester City,8,2,6,246,1,0,7,4,3,350,1,0,15,6,9,596,2,0,0.0,0.0,0.0,0,0,0,0,0,0,0,0,0,2020-12-27 19:15:002020-12-27 19:15:00
289,1243,Andrejs Štolcers,3646,"[2001, 2002]",Fulham FC,5,0,5,43,0,0,5,0,5,38,0,0,10,0,10,81,0,0,0.0,0.0,0.0,0,0,0,0,0,0,0,0,0,2020-12-27 19:15:002020-12-27 19:15:00
290,623,Andrew Crofts,3045,[2011],Norwich City,13,7,6,650,0,0,11,6,5,637,0,0,24,13,11,1287,0,0,0.0,0.0,0.0,0,0,0,0,0,0,0,0,0,2020-12-27 19:15:00
291,3759,Andrew Davies,2295,"[2002, 2003, 2004, 2005, 2006, 2007]",Middlesbrough FC,24,17,7,1661,0,0,28,21,7,2044,0,0,52,38,14,3705,0,0,0.0,0.0,0.0,0,0,0,0,0,0,0,0,0,2020-12-27 19:15:002020-12-27 19:15:002020-12-27 19:15:002020-12-27 19:15:002020-12-27 19:15:002020-12-27 19:15:00
292,630,Andrew Davies,2295,[2008],Stoke City,1,0,1,16,0,0,1,0,1,32,0,0,2,0,2,48,0,0,0.0,0.0,0.0,0,0,0,0,0,0,0,0,0,2020-12-27 19:15:00
293,631,Andrew Eleftheriou,3930,[2016],Watford FC,1,0,1,51,0,0,0,0,0,0,0,0,1,0,1,51,0,0,0.0,0.0,0.0,0,0,0,0,0,0,0,0,0,2020-12-27 19:15:00
294,632,Andrew Myers,2841,[2000],Bradford City,9,7,2,647,0,0,8,5,3,505,1,0,17,12,5,1152,1,0,0.0,0.0,0.0,0,1,1,0,0,0,0,0,0,2020-12-27 19:15:00
295,1267,Andrew Robertson,1181,"[2014, 2016]",Hull City,31,25,6,2234,1,0,26,23,3,2028,0,0,57,48,9,4262,1,0,0.0,0.0,0.0,1,0,1,0,0,0,0,0,0,2020-12-27 19:15:002020-12-27 19:15:00
296,2546,Andrew Robertson,1181,"[2017, 2018, 2019, 2020]",Liverpool FC,57,56,1,5027,3,0,52,51,1,4598,1,0,109,107,2,9625,4,0,0.0,0.0,0.0,2,1,3,0,0,0,0,0,0,2020-12-27 19:15:002020-12-27 19:15:002020-12-27 19:15:002020-12-27 19:15:00
297,639,Andrew Surman,1006,[2009],Wolverhampton Wanderers,2,1,1,98,0,0,5,2,3,218,0,0,7,3,4,316,0,0,0.0,0.0,0.0,0,0,0,0,0,0,0,0,0,2020-12-27 19:15:00
298,1281,Andrew Surman,1006,"[2011, 2012]",Norwich City,15,12,3,1066,2,0,14,13,1,1120,2,0,29,25,4,2186,4,0,0.0,0.0,0.0,1,2,3,0,0,0,0,0,0,2020-12-27 19:15:002020-12-27 19:15:00
299,3220,Andrew Surman,1006,"[2015, 2016, 2017, 2018, 2019]",AFC Bournemouth,47,44,3,3969,1,0,61,53,8,4825,1,0,108,97,11,8794,2,0,0.0,0.0,0.0,1,1,2,0,0,0,0,0,0,2020-12-27 19:15:002020-12-27 19:15:002020-12-27 19:15:002020-12-27 19:15:002020-12-27 19:15:00
300,2594,Andrew Taylor,2574,"[2005, 2006, 2007, 2008]",Middlesbrough FC,43,39,4,3554,0,0,49,40,9,3741,0,0,92,79,13,7295,0,0,0.0,0.0,0.0,0,0,0,0,0,0,0,0,0,2020-12-27 19:15:002020-12-27 19:15:002020-12-27 19:15:002020-12-27 19:15:00
301,651,Andrew Taylor,2574,[2013],Cardiff City,11,11,0,943,0,0,7,7,0,630,0,0,18,18,0,1573,0,0,0.0,0.0,0.0,0,0,0,0,0,0,0,0,0,2020-12-27 19:15:00
302,3270,Andrey Arshavin,2750,"[2008, 2009, 2010, 2011, 2012]",Arsenal FC,52,34,18,3143,10,0,52,35,17,3023,13,0,104,69,35,6166,23,0,3.0,6.0,9.0,5,10,15,1,0,1,0,0,0,2020-12-27 19:15:002020-12-27 19:15:002020-12-27 19:15:002020-12-27 19:15:002020-12-27 19:15:00
303,657,Andrey Kanchelskis,3312,[2000],Manchester City,4,3,1,250,0,0,5,3,2,343,0,0,9,6,3,593,0,0,0.0,0.0,0.0,0,0,0,0,0,0,0,0,0,2020-12-27 19:15:00
304,658,Andrey Kanchelskis,3312,[2002],Southampton FC,1,0,1,34,0,0,0,0,0,0,0,0,1,0,1,34,0,0,0.0,0.0,0.0,0,0,0,0,0,0,0,0,0,2020-12-27 19:15:00
305,1980,Andrey Yarmolenko,2352,"[2018, 2019, 2020]",West Ham United,20,10,10,950,4,0,19,5,14,647,3,0,39,15,24,1597,7,0,4.0,0.0,4.0,3,2,5,0,0,0,0,0,0,2020-12-27 19:15:002020-12-27 19:15:002020-12-27 19:15:00
306,1989,Andriy Shevchenko,1765,"[2006, 2007, 2009]",Chelsea FC,25,17,8,1430,8,0,23,13,10,1126,1,0,48,30,18,2556,9,0,0.0,0.0,0.0,5,1,6,1,0,1,0,0,0,2020-12-27 19:15:002020-12-27 19:15:002020-12-27 19:15:00
307,1331,Andriy Voronin,2746,"[2007, 2009]",Liverpool FC,11,4,7,385,3,0,16,10,6,936,2,0,27,14,13,1321,5,0,0.0,0.0,0.0,1,1,2,0,0,0,0,0,0,2020-12-27 19:15:002020-12-27 19:15:00
308,2006,Andros Townsend,1176,"[2011, 2013, 2014]",Tottenham Hotspur,23,15,8,1282,2,0,19,7,12,695,1,0,42,22,20,1977,3,0,0.0,0.0,0.0,0,1,1,1,0,1,0,0,0,2020-12-27 19:15:002020-12-27 19:15:002020-12-27 19:15:00
309,668,Andros Townsend,1176,[2012],Queens Park Rangers,7,7,0,569,1,0,5,5,0,450,1,0,12,12,0,1019,2,0,0.0,0.0,0.0,1,1,2,0,0,0,0,0,0,2020-12-27 19:15:00
310,671,Andros Townsend,1176,[2015],Newcastle United,6,6,0,515,2,0,7,6,1,574,2,0,13,12,1,1089,4,0,3.0,0.0,3.0,1,0,1,0,0,0,0,0,0,2020-12-27 19:15:00
311,3370,Andros Townsend,1176,"[2016, 2017, 2018, 2019, 2020]",Crystal Palace,72,60,12,5303,7,0,75,64,11,5595,6,0,147,124,23,10898,13,0,0.0,0.0,0.0,3,4,7,0,0,0,0,0,0,2020-12-27 19:15:002020-12-27 19:15:002020-12-27 19:15:002020-12-27 19:15:002020-12-27 19:15:00
312,1355,André Anguissa,3909,"[2018, 2020]",Fulham FC,18,12,6,1151,0,0,19,17,2,1583,0,0,37,29,8,2734,0,0,0.0,0.0,0.0,0,0,0,0,0,0,0,0,0,2020-12-27 19:15:002020-12-27 19:15:00
313,1360,André Ayew,2274,"[2015, 2017]",Swansea City,24,23,1,2012,8,0,22,21,1,1879,4,0,46,44,2,3891,12,0,1.0,6.0,7.0,5,3,8,0,0,0,0,0,0,2020-12-27 19:15:002020-12-27 19:15:00
314,680,André Ayew,2274,[2016],West Ham United,11,6,5,609,1,0,14,10,4,831,5,0,25,16,9,1440,6,0,0.0,4.0,4.0,0,5,5,0,0,0,0,0,0,2020-12-27 19:15:00
315,1365,André Bikey,2548,"[2006, 2007]",Reading FC,20,9,11,1136,3,0,16,11,5,976,0,0,36,20,16,2112,3,0,3.0,0.0,3.0,3,0,3,0,0,0,0,0,0,2020-12-27 19:15:002020-12-27 19:15:00
316,684,André Bikey,2548,[2009],Burnley FC,15,15,0,1246,1,0,13,11,2,941,0,0,28,26,2,2187,1,0,0.0,0.0,0.0,0,0,0,0,0,0,0,0,0,2020-12-27 19:15:00
317,685,André Carrillo,1926,[2017],Watford FC,15,7,8,748,1,0,13,9,4,789,0,0,28,16,12,1537,1,0,0.0,0.0,0.0,1,0,1,0,0,0,0,0,0,2020-12-27 19:15:00
318,2061,André Gomes,3115,"[2018, 2019, 2020]",Everton FC,27,24,3,2002,1,0,29,22,7,1966,0,0,56,46,10,3968,1,0,0.0,0.0,0.0,1,0,1,0,0,0,0,0,0,2020-12-27 19:15:002020-12-27 19:15:002020-12-27 19:15:00
319,1379,André Green,4182,"[2014, 2015]",Aston Villa,1,0,1,28,0,0,1,0,1,29,0,0,2,0,2,57,0,0,0.0,0.0,0.0,0,0,0,0,0,0,0,0,0,2020-12-27 19:15:002020-12-27 19:15:00
320,2076,André Ooijer,2108,"[2006, 2007, 2008]",Blackburn Rovers,40,37,3,3255,1,0,38,35,3,3080,1,0,78,72,6,6335,2,0,3.0,3.0,6.0,1,1,2,0,0,0,0,0,0,2020-12-27 19:15:002020-12-27 19:15:002020-12-27 19:15:00
321,1389,André Santos,2751,"[2011, 2012]",Arsenal FC,12,5,7,648,0,0,11,8,3,759,2,0,23,13,10,1407,2,0,0.0,0.0,0.0,0,2,2,0,0,0,0,0,0,2020-12-27 19:15:002020-12-27 19:15:00
322,1393,André Schürrle,1540,"[2013, 2014]",Chelsea FC,19,9,10,799,2,0,25,11,14,965,9,0,44,20,24,1764,11,0,0.0,0.0,0.0,1,6,7,0,0,0,0,0,0,2020-12-27 19:15:002020-12-27 19:15:00
323,698,André Schürrle,1540,[2018],Fulham FC,12,11,1,829,3,0,12,10,2,823,3,0,24,21,3,1652,6,0,0.0,0.0,0.0,2,3,5,0,0,0,0,0,0,2020-12-27 19:15:00
324,699,Andrés D'Alessandro,3237,[2005],Portsmouth FC,8,8,0,651,0,0,5,5,0,426,1,0,13,13,0,1077,1,0,0.0,0.0,0.0,0,1,1,0,0,0,0,0,0,2020-12-27 19:15:00
325,700,Andy Barrowman,4379,[2003],Birmingham City,1,0,1,3,0,0,0,0,0,0,0,0,1,0,1,3,0,0,0.0,0.0,0.0,0,0,0,0,0,0,0,0,0,2020-12-27 19:15:00
326,701,Andy Booth,3870,[2000],West Ham United,1,1,0,90,0,0,0,0,0,0,0,0,1,1,0,90,0,0,0.0,0.0,0.0,0,0,0,0,0,0,0,0,0,2020-12-27 19:15:00
327,1405,Andy Campbell,2074,"[2000, 2001]",Middlesbrough FC,4,1,3,129,0,0,7,4,3,383,0,0,11,5,6,512,0,0,0.0,0.0,0.0,0,0,0,0,0,0,0,0,0,2020-12-27 19:15:002020-12-27 19:15:00
328,3548,Andy Carroll,1779,"[2006, 2007, 2008, 2019, 2020]",Newcastle United,25,5,20,693,1,0,24,7,17,880,2,0,49,12,37,1573,3,0,1.0,1.0,2.0,1,1,2,0,0,0,0,0,0,2020-12-27 19:15:002020-12-27 19:15:002020-12-27 19:15:002020-12-27 19:15:002020-12-27 19:15:00
329,2124,Andy Carroll,1779,"[2010, 2011, 2012]",Liverpool FC,22,12,10,1237,2,0,22,14,8,1293,4,0,44,26,18,2530,6,0,0.0,3.0,3.0,1,3,4,0,0,0,0,0,0,2020-12-27 19:15:002020-12-27 19:15:002020-12-27 19:15:00
330,4275,Andy Carroll,1779,"[2013, 2014, 2015, 2016, 2017, 2018]",West Ham United,53,30,23,3191,16,0,50,32,18,2991,10,0,103,62,41,6182,26,0,10.0,0.0,10.0,12,9,21,0,1,1,0,0,0,2020-12-27 19:15:002020-12-27 19:15:002020-12-27 19:15:002020-12-27 19:15:002020-12-27 19:15:002020-12-27 19:15:00
331,718,Andy Cole,1113,[2000],Manchester United,10,9,1,754,5,0,8,5,3,507,4,0,18,14,4,1261,9,0,0.0,4.0,4.0,3,3,6,0,0,0,0,0,0,2020-12-27 19:15:00
332,2160,Andy Cole,1113,"[2001, 2002, 2003]",Blackburn Rovers,38,36,2,3234,12,0,41,34,7,3277,15,0,79,70,9,6511,27,0,1.0,5.0,6.0,5,10,15,0,0,0,0,0,0,2020-12-27 19:15:002020-12-27 19:15:002020-12-27 19:15:00
333,722,Andy Cole,1113,[2004],Fulham FC,16,14,2,1230,7,0,13,13,0,1104,5,0,29,27,2,2334,12,0,0.0,3.0,3.0,4,4,8,0,1,1,0,0,0,2020-12-27 19:15:00
334,723,Andy Cole,1113,[2005],Manchester City,12,12,0,1024,5,0,10,8,2,745,4,0,22,20,2,1769,9,0,3.0,3.0,6.0,2,2,4,0,0,0,0,0,0,2020-12-27 19:15:00
335,724,Andy Cole,1113,[2006],Portsmouth FC,10,2,8,284,2,0,8,3,5,386,1,0,18,5,13,670,3,0,1.0,0.0,1.0,1,0,1,0,0,0,0,0,0,2020-12-27 19:15:00
336,725,Andy Cole,1113,[2007],Sunderland AFC,3,2,1,126,0,0,4,1,3,110,0,0,7,3,4,236,0,0,0.0,0.0,0.0,0,0,0,0,0,0,0,0,0,2020-12-27 19:15:00
337,1453,Andy Dawson,1606,"[2008, 2009]",Hull City,30,30,0,2616,2,0,30,30,0,2493,0,0,60,60,0,5109,2,0,0.0,0.0,0.0,0,0,0,0,0,0,0,0,0,2020-12-27 19:15:002020-12-27 19:15:00
338,728,Andy Goram,4126,[2000],Manchester United,1,1,0,66,0,0,1,1,0,58,0,0,2,2,0,124,0,0,0.0,0.0,0.0,0,0,0,0,0,0,0,0,0,2020-12-27 19:15:00
339,729,Andy Gray,3222,[2005],Sunderland AFC,11,8,3,594,1,0,10,5,5,530,0,0,21,13,8,1124,1,0,0.0,0.0,0.0,1,0,1,0,0,0,0,0,0,2020-12-27 19:15:00
340,2926,Andy Griffin,1578,"[2000, 2001, 2002, 2003]",Newcastle United,25,21,4,1929,1,0,25,19,6,1743,0,0,50,40,10,3672,1,0,0.0,0.0,0.0,1,0,1,0,0,0,0,0,0,2020-12-27 19:15:002020-12-27 19:15:002020-12-27 19:15:002020-12-27 19:15:00
341,1469,Andy Griffin,1578,"[2004, 2005]",Portsmouth FC,19,15,4,1442,0,0,25,23,2,1938,0,0,44,38,6,3380,0,0,0.0,0.0,0.0,0,0,0,0,0,0,0,0,0,2020-12-27 19:15:002020-12-27 19:15:00
342,736,Andy Griffin,1578,[2007],Derby County,6,6,0,468,0,0,9,7,2,681,0,0,15,13,2,1149,0,0,0.0,0.0,0.0,0,0,0,0,0,0,0,0,0,2020-12-27 19:15:00
343,737,Andy Griffin,1578,[2008],Stoke City,9,8,1,732,0,0,11,9,2,867,0,0,20,17,3,1599,0,0,0.0,0.0,0.0,0,0,0,0,0,0,0,0,0,2020-12-27 19:15:00
344,738,Andy Hunt,3842,[2000],Charlton Athletic,4,4,0,329,2,0,4,4,0,351,2,0,8,8,0,680,4,0,0.0,0.0,0.0,2,2,4,0,0,0,0,0,0,2020-12-27 19:15:00
345,2220,Andy Impey,1304,"[2000, 2001, 2003]",Leicester City,36,30,6,2678,0,0,36,29,7,2688,0,0,72,59,13,5366,0,0,0.0,0.0,0.0,0,0,0,0,0,0,0,0,0,2020-12-27 19:15:002020-12-27 19:15:002020-12-27 19:15:00
346,2229,Andy Johnson,1322,"[2002, 2004, 2005]",West Bromwich Albion,32,31,1,2636,1,0,29,28,1,2492,0,0,61,59,2,5128,1,0,1.0,0.0,1.0,1,0,1,0,0,0,0,0,0,2020-12-27 19:15:002020-12-27 19:15:002020-12-27 19:15:00
347,1491,Andy Johnson,1322,"[2006, 2007]",Everton FC,29,24,5,2174,9,0,30,26,4,2205,8,0,59,50,9,4379,17,0,7.0,3.0,10.0,6,5,11,0,1,1,0,0,0,2020-12-27 19:15:002020-12-27 19:15:00
348,2994,Andy Johnson,1322,"[2008, 2009, 2010, 2011]",Fulham FC,39,30,9,2765,9,0,42,30,12,2804,4,0,81,60,21,5569,13,0,0.0,2.0,2.0,4,4,8,0,0,0,0,0,0,2020-12-27 19:15:002020-12-27 19:15:002020-12-27 19:15:002020-12-27 19:15:00
349,751,Andy Johnson,1322,[2012],Queens Park Rangers,2,1,1,45,0,0,1,1,0,90,0,0,3,2,1,135,0,0,0.0,0.0,0.0,0,0,0,0,0,0,0,0,0,2020-12-27 19:15:00
350,752,Andy Johnson,1322,[2014],Crystal Palace,0,0,0,0,0,0,0,0,0,0,0,0,0,0,0,0,0,0,0.0,0.0,0.0,0,0,0,0,0,0,0,0,0,2020-12-27 19:15:00
351,1507,Andy Keogh,3519,"[2009, 2010]",Wolverhampton Wanderers,6,4,2,362,0,0,8,4,4,423,1,0,14,8,6,785,1,0,0.0,3.0,3.0,0,1,1,0,0,0,0,0,0,2020-12-27 19:15:002020-12-27 19:15:00
352,3026,Andy King,2523,"[2014, 2015, 2016, 2017]",Leicester City,38,20,18,2044,5,0,45,25,20,2354,1,0,83,45,38,4398,6,0,3.0,0.0,3.0,2,0,2,0,0,0,0,0,0,2020-12-27 19:15:002020-12-27 19:15:002020-12-27 19:15:002020-12-27 19:15:00
353,759,Andy Lonergan,4159,[2019],Liverpool FC,0,0,0,0,0,0,0,0,0,0,0,0,0,0,0,0,0,0,0.0,0.0,0.0,0,0,0,0,0,0,0,0,0,2020-12-27 19:15:00
354,760,Andy Marriott,4505,[2002],Birmingham City,0,0,0,0,0,0,1,1,0,90,0,0,1,1,0,90,0,0,0.0,0.0,0.0,0,0,0,0,0,0,0,0,0,2020-12-27 19:15:00
355,761,Andy Marshall,3291,[2001],Ipswich Town,7,7,0,630,0,0,6,6,0,540,0,0,13,13,0,1170,0,0,0.0,0.0,0.0,0,0,0,0,0,0,0,0,0,2020-12-27 19:15:00
356,2289,Andy Marshall,3291,"[2010, 2011, 2012]",Aston Villa,0,0,0,0,0,0,0,0,0,0,0,0,0,0,0,0,0,0,0.0,0.0,0.0,0,0,0,0,0,0,0,0,0,2020-12-27 19:15:002020-12-27 19:15:002020-12-27 19:15:00
357,1531,Andy Melville,2894,"[2001, 2002]",Fulham FC,27,27,0,2406,0,0,27,26,1,2389,0,0,54,53,1,4795,0,0,0.0,0.0,0.0,0,0,0,0,0,0,0,0,0,2020-12-27 19:15:002020-12-27 19:15:00
358,767,Andy Melville,2894,[2003],Middlesbrough FC,1,1,0,90,0,0,0,0,0,0,0,0,1,1,0,90,0,0,0.0,0.0,0.0,0,0,0,0,0,0,0,0,0,2020-12-27 19:15:00
359,768,Andy Morrison,4329,[2000],Manchester City,2,2,0,126,0,0,1,1,0,90,0,0,3,3,0,216,0,0,0.0,0.0,0.0,0,0,0,0,0,0,0,0,0,2020-12-27 19:15:00
360,769,Andy O'Brien,2160,[2000],Bradford City,8,8,0,639,0,0,10,9,1,861,0,0,18,17,1,1500,0,0,0.0,0.0,0.0,0,0,0,0,0,0,0,0,0,2020-12-27 19:15:00
361,3086,Andy O'Brien,2160,"[2001, 2002, 2003, 2004]",Newcastle United,51,48,3,4361,3,0,54,51,3,4525,2,0,105,99,6,8886,5,0,0.0,0.0,0.0,2,2,4,0,0,0,0,0,0,2020-12-27 19:15:002020-12-27 19:15:002020-12-27 19:15:002020-12-27 19:15:00
362,1549,Andy O'Brien,2160,"[2005, 2006]",Portsmouth FC,13,13,0,1170,0,0,19,17,2,1546,0,0,32,30,2,2716,0,0,0.0,0.0,0.0,0,0,0,0,0,0,0,0,0,2020-12-27 19:15:002020-12-27 19:15:00
363,3110,Andy O'Brien,2160,"[2007, 2008, 2009, 2010]",Bolton Wanderers,34,31,3,2823,0,0,36,33,3,2960,1,0,70,64,6,5783,1,0,0.0,0.0,0.0,0,0,0,0,0,0,0,0,0,2020-12-27 19:15:002020-12-27 19:15:002020-12-27 19:15:002020-12-27 19:15:00
364,1561,Andy Oakes,3354,"[2000, 2001]",Derby County,12,12,0,1080,0,0,12,12,0,942,0,0,24,24,0,2022,0,0,0.0,0.0,0.0,0,0,0,0,0,0,0,0,0,2020-12-27 19:15:002020-12-27 19:15:00
365,782,Andy Oakes,3354,[2004],Bolton Wanderers,1,1,0,90,0,0,0,0,0,0,0,0,1,1,0,90,0,0,0.0,0.0,0.0,0,0,0,0,0,0,0,0,0,2020-12-27 19:15:00
366,1567,Andy Reid,1220,"[2004, 2005]",Tottenham Hotspur,14,9,5,844,1,0,12,11,1,842,0,0,26,20,6,1686,1,0,0.0,0.0,0.0,0,0,0,0,0,0,0,0,0,2020-12-27 19:15:002020-12-27 19:15:00
367,785,Andy Reid,1220,[2006],Charlton Athletic,8,8,0,660,1,0,8,7,1,548,1,0,16,15,1,1208,2,0,1.0,0.0,1.0,1,1,2,0,0,0,0,0,0,2020-12-27 19:15:00
368,2361,Andy Reid,1220,"[2007, 2008, 2009]",Sunderland AFC,36,29,7,2519,4,0,29,19,10,1832,0,0,65,48,17,4351,4,0,3.0,0.0,3.0,2,0,2,0,0,0,0,0,0,2020-12-27 19:15:002020-12-27 19:15:002020-12-27 19:15:00
369,789,Andy Reid,1220,[2010],Blackpool FC,4,2,2,181,0,0,1,0,1,9,0,0,5,2,3,190,0,0,0.0,0.0,0.0,0,0,0,0,0,0,0,0,0,2020-12-27 19:15:00
370,790,Andy Todd,1672,[2000],Charlton Athletic,13,10,3,941,1,0,10,9,1,808,0,0,23,19,4,1749,1,0,0.0,0.0,0.0,1,0,1,0,0,0,0,0,0,2020-12-27 19:15:00
371,791,Andy Todd,1672,[2001],Sunderland AFC,1,0,1,6,0,0,0,0,0,0,0,0,1,0,1,6,0,0,0.0,0.0,0.0,0,0,0,0,0,0,0,0,0,2020-12-27 19:15:00
372,3970,Andy Todd,1672,"[2002, 2003, 2004, 2005, 2006]",Blackburn Rovers,41,36,5,3320,2,0,47,42,5,3830,2,0,88,78,10,7150,4,0,1.0,0.0,1.0,2,1,3,0,0,0,0,0,0,2020-12-27 19:15:002020-12-27 19:15:002020-12-27 19:15:002020-12-27 19:15:002020-12-27 19:15:00
373,797,Andy Todd,1672,[2007],Derby County,9,6,3,639,1,0,10,8,2,736,0,0,19,14,5,1375,1,0,1.0,0.0,1.0,1,0,1,0,0,0,0,0,0,2020-12-27 19:15:00
374,798,Andy Webster,3528,[2006],Wigan Athletic,2,1,1,119,0,0,2,2,0,155,0,0,4,3,1,274,0,0,0.0,0.0,0.0,0,0,0,0,0,0,0,0,0,2020-12-27 19:15:00
375,799,Andy Welsh,3223,[2005],Sunderland AFC,9,8,1,718,0,0,5,4,1,326,0,0,14,12,2,1044,0,0,0.0,0.0,0.0,0,0,0,0,0,0,0,0,0,2020-12-27 19:15:00
376,5621,Andy Wilkinson,1553,"[2008, 2009, 2010, 2011, 2012, 2013, 2014]",Stoke City,60,53,7,4622,0,0,63,50,13,4488,0,0,123,103,20,9110,0,0,0.0,0.0,0.0,0,0,0,0,0,0,0,0,0,2020-12-27 19:15:002020-12-27 19:15:002020-12-27 19:15:002020-12-27 19:15:002020-12-27 19:15:002020-12-27 19:15:002020-12-27 19:15:00
377,2424,Andy van der Meyde,3520,"[2005, 2006, 2008]",Everton FC,13,7,6,560,0,0,7,5,2,351,0,0,20,12,8,911,0,0,0.0,0.0,0.0,0,0,0,0,0,0,0,0,0,2020-12-27 19:15:002020-12-27 19:15:002020-12-27 19:15:00
378,2433,Angel Gomes,3278,"[2016, 2018, 2019]",Manchester United,4,0,4,37,0,0,1,0,1,9,0,0,5,0,5,46,0,0,0.0,0.0,0.0,0,0,0,0,0,0,0,0,0,2020-12-27 19:15:002020-12-27 19:15:002020-12-27 19:15:00
379,4893,Angelo Ogbonna,2201,"[2015, 2016, 2017, 2018, 2019, 2020]",West Ham United,75,72,3,6364,4,0,76,74,2,6671,2,0,151,146,5,13035,6,0,0.0,3.0,3.0,2,2,4,0,0,0,0,0,0,2020-12-27 19:15:002020-12-27 19:15:002020-12-27 19:15:002020-12-27 19:15:002020-12-27 19:15:002020-12-27 19:15:00
380,1639,Angelos Basinas,3403,"[2008, 2009]",Portsmouth FC,8,5,3,520,0,0,7,5,2,477,0,0,15,10,5,997,0,0,0.0,0.0,0.0,0,0,0,0,0,0,0,0,0,2020-12-27 19:15:002020-12-27 19:15:00
381,821,Angus Gunn,2159,[2016],Manchester City,0,0,0,0,0,0,0,0,0,0,0,0,0,0,0,0,0,0,0.0,0.0,0.0,0,0,0,0,0,0,0,0,0,2020-12-27 19:15:00
382,1645,Angus Gunn,2159,"[2018, 2019]",Southampton FC,11,11,0,990,0,0,11,11,0,990,0,0,22,22,0,1980,0,0,0.0,0.0,0.0,0,0,0,0,0,0,0,0,0,2020-12-27 19:15:002020-12-27 19:15:00
383,3302,Anthony Barness,3068,"[2001, 2002, 2003, 2004]",Bolton Wanderers,38,27,11,2524,0,0,35,29,6,2652,0,0,73,56,17,5176,0,0,0.0,0.0,0.0,0,0,0,0,0,0,0,0,0,2020-12-27 19:15:002020-12-27 19:15:002020-12-27 19:15:002020-12-27 19:15:00
384,2487,Anthony Driscoll-Glennon,3756,"[2018, 2019, 2020]",Burnley FC,0,0,0,0,0,0,0,0,0,0,0,0,0,0,0,0,0,0,0.0,0.0,0.0,0,0,0,0,0,0,0,0,0,2020-12-27 19:15:002020-12-27 19:15:002020-12-27 19:15:00
385,831,Anthony Forde,3887,[2011],Wolverhampton Wanderers,2,1,1,65,0,0,4,2,2,178,0,0,6,3,3,243,0,0,0.0,0.0,0.0,0,0,0,0,0,0,0,0,0,2020-12-27 19:15:00
386,6684,Anthony Gardner,1120,"[2000, 2001, 2002, 2003, 2004, 2005, 2006, 2007]",Tottenham Hotspur,50,42,8,3903,2,0,62,50,12,4669,0,0,112,92,20,8572,2,0,3.0,0.0,3.0,2,0,2,0,0,0,0,0,0,2020-12-27 19:15:002020-12-27 19:15:002020-12-27 19:15:002020-12-27 19:15:002020-12-27 19:15:002020-12-27 19:15:002020-12-27 19:15:002020-12-27 19:15:00
387,1681,Anthony Gardner,1120,"[2008, 2009]",Hull City,16,16,0,1440,0,0,14,14,0,1260,0,0,30,30,0,2700,0,0,0.0,0.0,0.0,0,0,0,0,0,0,0,0,0,2020-12-27 19:15:002020-12-27 19:15:00
388,12005,Anthony Gomez Mancini,1001,[2020],Burnley FC,0,0,0,0,0,0,0,0,0,0,0,0,0,0,0,0,0,0,0.0,0.0,0.0,0,0,0,0,0,0,0,0,0,2020-12-27 19:15:00
389,1685,Anthony Gordon,2450,"[2019, 2020]",Everton FC,5,3,2,273,0,0,9,2,7,253,0,0,14,5,9,526,0,0,0.0,0.0,0.0,0,0,0,0,0,0,0,0,0,2020-12-27 19:15:002020-12-27 19:15:00
390,844,Anthony Grant,4327,[2004],Chelsea FC,0,0,0,0,0,0,1,0,1,1,0,0,1,0,1,1,0,0,0.0,0.0,0.0,0,0,0,0,0,0,0,0,0,2020-12-27 19:15:00
391,845,Anthony Knockaert,2482,[2014],Leicester City,7,3,4,291,0,0,2,0,2,40,0,0,9,3,6,331,0,0,0.0,0.0,0.0,0,0,0,0,0,0,0,0,0,2020-12-27 19:15:00
392,1693,Anthony Knockaert,2482,"[2017, 2018]",Brighton & Hove Albion,32,25,7,2288,4,0,31,20,11,2001,1,0,63,45,18,4289,5,0,0.0,3.0,3.0,2,1,3,0,0,0,0,0,0,2020-12-27 19:15:002020-12-27 19:15:00
393,848,Anthony Knockaert,2482,[2020],Fulham FC,0,0,0,0,0,0,0,0,0,0,0,0,0,0,0,0,0,0,0.0,0.0,0.0,0,0,0,0,0,0,0,0,0,2020-12-27 19:15:00
394,1699,Anthony Le Tallec,3111,"[2003, 2004]",Liverpool FC,8,1,7,219,0,0,8,3,5,323,0,0,16,4,12,542,0,0,0.0,0.0,0.0,0,0,0,0,0,0,0,0,0,2020-12-27 19:15:002020-12-27 19:15:00
395,851,Anthony Le Tallec,3111,[2005],Sunderland AFC,13,6,7,695,2,0,14,6,8,536,1,0,27,12,15,1231,3,0,0.0,0.0,0.0,1,1,2,0,0,0,0,0,0,2020-12-27 19:15:00
396,5127,Anthony Martial,1647,"[2015, 2016, 2017, 2018, 2019, 2020]",Manchester United,76,57,19,5159,29,0,79,66,13,5652,23,0,155,123,32,10811,52,0,6.0,3.0,9.0,13,15,28,1,1,2,0,0,0,2020-12-27 19:15:002020-12-27 19:15:002020-12-27 19:15:002020-12-27 19:15:002020-12-27 19:15:002020-12-27 19:15:00
397,858,Anthony McNamee,3604,[2006],Watford FC,5,3,2,229,0,0,2,1,1,120,0,0,7,4,3,349,0,0,0.0,0.0,0.0,0,0,0,0,0,0,0,0,0,2020-12-27 19:15:00
398,859,Anthony Modeste,4100,[2011],Blackburn Rovers,4,2,2,218,0,0,5,1,4,168,0,0,9,3,6,386,0,0,0.0,0.0,0.0,0,0,0,0,0,0,0,0,0,2020-12-27 19:15:00
399,2583,Anthony Pilkington,1376,"[2011, 2012, 2013]",Norwich City,36,30,6,2489,8,0,39,28,11,2472,6,0,75,58,17,4961,14,0,3.0,0.0,3.0,4,6,10,0,0,0,0,0,0,2020-12-27 19:15:002020-12-27 19:15:002020-12-27 19:15:00
400,863,Anthony Réveillère,2524,[2014],Sunderland AFC,9,8,1,697,0,0,7,7,0,630,0,0,16,15,1,1327,0,0,0.0,0.0,0.0,0,0,0,0,0,0,0,0,0,2020-12-27 19:15:00
401,1729,Anthony Stokes,3488,"[2007, 2008]",Sunderland AFC,11,5,6,508,1,0,11,3,8,274,0,0,22,8,14,782,1,0,3.0,0.0,3.0,1,0,1,0,0,0,0,0,0,2020-12-27 19:15:002020-12-27 19:15:00
402,866,Anthony Vanden Borre,3617,[2009],Portsmouth FC,8,6,2,598,0,0,11,9,2,759,0,0,19,15,4,1357,0,0,0.0,0.0,0.0,0,0,0,0,0,0,0,0,0,2020-12-27 19:15:00
403,2604,Antoine Sibierski,1810,"[2003, 2004, 2005]",Manchester City,45,33,12,2889,6,0,39,23,16,2112,5,0,84,56,28,5001,11,0,1.0,0.0,1.0,3,3,6,1,0,1,0,0,0,2020-12-27 19:15:002020-12-27 19:15:002020-12-27 19:15:00
404,870,Antoine Sibierski,1810,[2006],Newcastle United,11,4,7,573,3,0,14,9,5,785,0,0,25,13,12,1358,3,0,3.0,0.0,3.0,2,0,2,0,0,0,0,0,0,2020-12-27 19:15:00
405,1743,Antoine Sibierski,1810,"[2007, 2008]",Wigan Athletic,15,6,9,553,2,0,17,4,13,476,2,0,32,10,22,1029,4,0,3.0,3.0,6.0,1,1,2,1,0,1,0,0,0,2020-12-27 19:15:002020-12-27 19:15:00
406,2622,Antolín Alcaráz,2235,"[2010, 2011, 2012]",Wigan Athletic,34,33,1,3008,2,0,35,34,1,2917,1,0,69,67,2,5925,3,0,1.0,3.0,4.0,2,1,3,0,0,0,0,0,0,2020-12-27 19:15:002020-12-27 19:15:002020-12-27 19:15:00
407,1753,Antolín Alcaráz,2235,"[2013, 2014]",Everton FC,8,5,3,484,0,0,6,6,0,540,0,0,14,11,3,1024,0,0,0.0,0.0,0.0,0,0,0,0,0,0,0,0,0,2020-12-27 19:15:002020-12-27 19:15:00
408,2637,Anton Ferdinand,1686,"[2005, 2006, 2007]",West Ham United,45,43,2,3781,3,0,42,40,2,3552,1,0,87,83,4,7333,4,0,3.0,1.0,4.0,3,1,4,0,0,0,0,0,0,2020-12-27 19:15:002020-12-27 19:15:002020-12-27 19:15:00
409,2646,Anton Ferdinand,1686,"[2008, 2009, 2010]",Sunderland AFC,40,33,7,3242,0,0,42,40,2,3422,0,0,82,73,9,6664,0,0,0.0,0.0,0.0,0,0,0,0,0,0,0,0,0,2020-12-27 19:15:002020-12-27 19:15:002020-12-27 19:15:00
410,1769,Anton Ferdinand,1686,"[2011, 2012]",Queens Park Rangers,23,21,2,1898,0,0,21,20,1,1767,0,0,44,41,3,3665,0,0,0.0,0.0,0.0,0,0,0,0,0,0,0,0,0,2020-12-27 19:15:002020-12-27 19:15:00
411,886,Antonee Robinson,1010,[2020],Fulham FC,6,6,0,540,0,0,6,6,0,540,0,0,12,12,0,1080,0,0,0.0,0.0,0.0,0,0,0,0,0,0,0,0,0,2020-12-27 19:15:00
412,887,Antonio Barreca,4119,[2018],Newcastle United,0,0,0,0,0,0,1,0,1,4,0,0,1,0,1,4,0,0,0.0,0.0,0.0,0,0,0,0,0,0,0,0,0,2020-12-27 19:15:00
413,888,Antonio Luna,1444,[2013],Aston Villa,10,10,0,833,0,0,7,6,1,549,1,0,17,16,1,1382,1,0,0.0,0.0,0.0,0,0,0,0,0,0,0,0,0,2020-12-27 19:15:00
414,889,Antonio Nocerino,3535,[2013],West Ham United,5,0,5,51,0,0,5,2,3,205,0,0,10,2,8,256,0,0,0.0,0.0,0.0,0,0,0,0,0,0,0,0,0,2020-12-27 19:15:00
415,3566,Antonio Rüdiger,1845,"[2017, 2018, 2019, 2020]",Chelsea FC,41,39,2,3596,3,0,40,39,1,3414,2,0,81,78,3,7010,5,0,3.0,1.0,4.0,3,2,5,0,0,0,0,0,0,2020-12-27 19:15:002020-12-27 19:15:002020-12-27 19:15:002020-12-27 19:15:00
416,1790,Antonio Valencia,1641,"[2006, 2008]",Wigan Athletic,26,24,2,2025,3,0,26,23,3,2038,1,0,52,47,5,4063,4,0,0.0,0.0,0.0,1,0,1,0,0,0,0,0,0,2020-12-27 19:15:002020-12-27 19:15:00
417,895,Antonio Valencia,1641,[2007],Blackburn Rovers,0,0,0,0,0,0,1,1,0,90,0,0,1,1,0,90,0,0,0.0,0.0,0.0,0,0,0,0,0,0,0,0,0,2020-12-27 19:15:00
418,9015,Antonio Valencia,1641,"[2009, 2010, 2011, 2012, 2013, 2014, 2015, 2016, 2017, 2018]",Manchester United,121,105,16,9614,9,0,120,99,21,9196,8,0,241,204,37,18810,17,0,0.0,0.0,0.0,3,5,8,0,0,0,0,0,0,2020-12-27 19:15:002020-12-27 19:15:002020-12-27 19:15:002020-12-27 19:15:002020-12-27 19:15:002020-12-27 19:15:002020-12-27 19:15:002020-12-27 19:15:002020-12-27 19:15:002020-12-27 19:15:00
419,2724,Antti Niemi,1559,"[2002, 2003, 2004]",Southampton FC,37,37,0,3326,0,0,41,41,0,3606,0,0,78,78,0,6932,0,0,0.0,0.0,0.0,0,0,0,0,0,0,0,0,0,2020-12-27 19:15:002020-12-27 19:15:002020-12-27 19:15:00
420,2733,Antti Niemi,1559,"[2005, 2006, 2007]",Fulham FC,33,33,0,2941,0,0,27,27,0,2430,0,0,60,60,0,5371,0,0,0.0,0.0,0.0,0,0,0,0,0,0,0,0,0,2020-12-27 19:15:002020-12-27 19:15:002020-12-27 19:15:00
421,1827,Anwar El Ghazi,2855,"[2019, 2020]",Aston Villa,21,17,4,1401,5,0,20,12,8,975,3,0,41,29,12,2376,8,0,0.0,3.0,3.0,1,2,3,1,2,3,0,0,0,2020-12-27 19:15:002020-12-27 19:15:00
422,3666,Apostolos Vellios,3259,"[2010, 2011, 2012, 2013]",Everton FC,15,1,14,224,1,0,7,1,6,115,2,0,22,2,20,339,3,0,0.0,0.0,0.0,1,0,1,0,0,0,0,0,0,2020-12-27 19:15:002020-12-27 19:15:002020-12-27 19:15:002020-12-27 19:15:00
423,2760,Arbeloa,2744,"[2006, 2007, 2008]",Liverpool FC,35,34,1,2973,1,0,31,29,2,2584,1,0,66,63,3,5557,2,0,0.0,0.0,0.0,0,1,1,0,0,0,0,0,0,2020-12-27 19:15:002020-12-27 19:15:002020-12-27 19:15:00
424,922,Arbeloa,2744,[2016],West Ham United,3,1,2,256,0,0,0,0,0,0,0,0,3,1,2,256,0,0,0.0,0.0,0.0,0,0,0,0,0,0,0,0,0,2020-12-27 19:15:00
425,923,Archie Mair,3725,[2019],Norwich City,0,0,0,0,0,0,0,0,0,0,0,0,0,0,0,0,0,0,0.0,0.0,0.0,0,0,0,0,0,0,0,0,0,2020-12-27 19:15:00
426,924,Aristote Nsiala,4474,[2010],Everton FC,0,0,0,0,0,0,0,0,0,0,0,0,0,0,0,0,0,0,0.0,0.0,0.0,0,0,0,0,0,0,0,0,0,2020-12-27 19:15:00
427,925,Ariza Makukula,2537,[2008],Bolton Wanderers,3,2,1,126,0,0,3,2,1,167,0,0,6,4,2,293,0,0,0.0,0.0,0.0,0,0,0,0,0,0,0,0,0,2020-12-27 19:15:00
428,1853,Arjan de Zeeuw,1067,"[2003, 2004]",Portsmouth FC,35,35,0,3028,3,0,32,32,0,2880,1,0,67,67,0,5908,4,0,0.0,3.0,3.0,1,1,2,0,0,0,0,0,0,2020-12-27 19:15:002020-12-27 19:15:00
429,1857,Arjan de Zeeuw,1067,"[2005, 2006]",Wigan Athletic,29,29,0,2544,0,0,23,23,0,1883,0,0,52,52,0,4427,0,0,0.0,0.0,0.0,0,0,0,0,0,0,0,0,0,2020-12-27 19:15:002020-12-27 19:15:00
430,2793,Arjen Robben,1767,"[2004, 2005, 2006]",Chelsea FC,35,25,10,2217,7,0,32,26,6,2213,8,0,67,51,16,4430,15,0,3.0,9.0,12.0,1,7,8,0,0,0,0,0,0,2020-12-27 19:15:002020-12-27 19:15:002020-12-27 19:15:00
431,1868,Armand Traoré,1238,"[2007, 2009]",Arsenal FC,6,5,1,450,0,0,6,5,1,456,0,0,12,10,2,906,0,0,0.0,0.0,0.0,0,0,0,0,0,0,0,0,0,2020-12-27 19:15:002020-12-27 19:15:00
432,934,Armand Traoré,1238,[2008],Portsmouth FC,11,7,4,649,1,0,8,7,1,624,0,0,19,14,5,1273,1,0,0.0,0.0,0.0,0,0,0,0,0,0,0,0,0,2020-12-27 19:15:00
433,2811,Armand Traoré,1238,"[2011, 2012, 2014]",Queens Park Rangers,31,25,6,2194,0,0,34,24,10,2299,0,0,65,49,16,4493,0,0,0.0,0.0,0.0,0,0,0,0,0,0,0,0,0,2020-12-27 19:15:002020-12-27 19:15:002020-12-27 19:15:00
434,939,Armando Broja,4110,[2019],Chelsea FC,1,0,1,4,0,0,0,0,0,0,0,0,1,0,1,4,0,0,0.0,0.0,0.0,0,0,0,0,0,0,0,0,0,2020-12-27 19:15:00
435,1881,Arnar Gunnlaugsson,2831,"[2000, 2001]",Leicester City,11,3,8,438,3,0,8,0,8,200,0,0,19,3,16,638,3,0,3.0,0.0,3.0,2,0,2,0,0,0,0,0,0,2020-12-27 19:15:002020-12-27 19:15:00
436,942,Arnaut Danjuma,3342,[2019],AFC Bournemouth,7,3,4,320,0,0,7,3,4,306,0,0,14,6,8,626,0,0,0.0,0.0,0.0,0,0,0,0,0,0,0,0,0,2020-12-27 19:15:00
437,2832,Arnold Mvuemba,3449,"[2006, 2007, 2008]",Portsmouth FC,6,1,5,104,0,0,15,4,11,568,1,0,21,5,16,672,1,0,0.0,0.0,0.0,0,0,0,0,0,0,0,0,0,2020-12-27 19:15:002020-12-27 19:15:002020-12-27 19:15:00
438,946,Aro Murić,2700,[2018],Manchester City,0,0,0,0,0,0,0,0,0,0,0,0,0,0,0,0,0,0,0.0,0.0,0.0,0,0,0,0,0,0,0,0,0,2020-12-27 19:15:00
439,1895,Aron Gunnarsson,3147,"[2013, 2018]",Cardiff City,24,20,4,1845,2,0,27,24,3,1971,0,0,51,44,7,3816,2,0,0.0,0.0,0.0,2,0,2,0,0,0,0,0,0,2020-12-27 19:15:002020-12-27 19:15:00
440,949,Arouna Koné,2237,[2012],Wigan Athletic,17,16,1,1463,5,0,17,16,1,1468,6,0,34,32,2,2931,11,0,6.0,0.0,6.0,3,2,5,0,0,0,0,0,0,2020-12-27 19:15:00
441,3806,Arouna Koné,2237,"[2013, 2014, 2015, 2016]",Everton FC,26,12,14,1238,4,0,22,11,11,973,2,0,48,23,25,2211,6,0,1.0,0.0,1.0,1,2,3,0,0,0,0,0,0,2020-12-27 19:15:002020-12-27 19:15:002020-12-27 19:15:002020-12-27 19:15:00
442,4780,Arthur Masuaku,2209,"[2016, 2017, 2018, 2019, 2020]",West Ham United,44,34,10,3047,0,0,47,38,9,3431,0,0,91,72,19,6478,0,0,0.0,0.0,0.0,0,0,0,0,0,0,0,0,0,2020-12-27 19:15:002020-12-27 19:15:002020-12-27 19:15:002020-12-27 19:15:002020-12-27 19:15:00
443,959,Artim Shakiri,4288,[2004],West Bromwich Albion,1,1,0,75,0,0,2,1,1,104,0,0,3,2,1,179,0,0,0.0,0.0,0.0,0,0,0,0,0,0,0,0,0,2020-12-27 19:15:00
444,1921,Artur Boruc,1000,"[2012, 2013]",Southampton FC,23,23,0,2026,0,0,26,26,0,2308,0,0,49,49,0,4334,0,0,0.0,0.0,0.0,0,0,0,0,0,0,0,0,0,2020-12-27 19:15:002020-12-27 19:15:00
445,4820,Artur Boruc,1000,"[2015, 2016, 2017, 2018, 2019]",AFC Bournemouth,42,42,0,3780,0,0,37,37,0,3330,0,0,79,79,0,7110,0,0,0.0,0.0,0.0,0,0,0,0,0,0,0,0,0,2020-12-27 19:15:002020-12-27 19:15:002020-12-27 19:15:002020-12-27 19:15:002020-12-27 19:15:00
446,967,Arturo Lupoli,4561,[2005],Arsenal FC,0,0,0,0,0,0,1,0,1,8,0,0,1,0,1,8,0,0,0.0,0.0,0.0,0,0,0,0,0,0,0,0,0,2020-12-27 19:15:00
447,968,Aruna Dindane,3404,[2009],Portsmouth FC,9,9,0,757,6,0,10,9,1,719,2,0,19,18,1,1476,8,0,1.0,1.0,2.0,3,1,4,1,0,1,0,0,0,2020-12-27 19:15:00
448,1939,Asamoah Gyan,1689,"[2010, 2011]",Sunderland AFC,15,11,4,991,6,0,19,12,7,1241,4,0,34,23,11,2232,10,0,1.0,1.0,2.0,4,3,7,0,0,0,0,0,0,2020-12-27 19:15:002020-12-27 19:15:00
449,1943,Ashkan Dejagah,3351,"[2012, 2013]",Fulham FC,22,11,11,1139,4,0,21,15,6,1358,1,0,43,26,17,2497,5,0,3.0,0.0,3.0,4,1,5,0,0,0,0,0,0,2020-12-27 19:15:002020-12-27 19:15:00
450,5853,Ashley Barnes,1491,"[2014, 2016, 2017, 2018, 2019, 2020]",Burnley FC,83,59,24,5375,20,0,83,61,22,5488,19,0,166,120,46,10863,39,0,16.0,6.0,22.0,13,14,27,2,3,5,0,0,0,2020-12-27 19:15:002020-12-27 19:15:002020-12-27 19:15:002020-12-27 19:15:002020-12-27 19:15:002020-12-27 19:15:00
451,5889,Ashley Cole,1523,"[2000, 2001, 2002, 2003, 2004, 2005]",Arsenal FC,73,71,2,6313,3,0,78,75,3,6701,5,0,151,146,5,13014,8,0,3.0,5.0,8.0,3,4,7,0,0,0,0,0,0,2020-12-27 19:15:002020-12-27 19:15:002020-12-27 19:15:002020-12-27 19:15:002020-12-27 19:15:002020-12-27 19:15:00
452,7908,Ashley Cole,1523,"[2006, 2007, 2008, 2009, 2010, 2011, 2012, 2013]",Chelsea FC,113,108,5,9639,5,0,114,111,3,9891,2,0,227,219,8,19530,7,0,3.0,0.0,3.0,2,0,2,0,0,0,0,0,0,2020-12-27 19:15:002020-12-27 19:15:002020-12-27 19:15:002020-12-27 19:15:002020-12-27 19:15:002020-12-27 19:15:002020-12-27 19:15:002020-12-27 19:15:00
453,993,Ashley Fletcher,2642,[2016],West Ham United,11,1,10,220,0,0,5,1,4,134,0,0,16,2,14,354,0,0,0.0,0.0,0.0,0,0,0,0,0,0,0,0,0,2020-12-27 19:15:00
454,994,Ashley Ward,3257,[2000],Bradford City,15,10,5,987,3,0,12,8,4,772,1,0,27,18,9,1759,4,0,0.0,0.0,0.0,2,0,2,0,0,0,0,0,0,2020-12-27 19:15:00
455,3986,Ashley Westwood,1440,"[2012, 2013, 2014, 2015]",Aston Villa,60,58,2,5052,3,0,63,60,3,5304,2,0,123,118,5,10356,5,0,0.0,1.0,1.0,1,2,3,0,0,0,0,0,0,2020-12-27 19:15:002020-12-27 19:15:002020-12-27 19:15:002020-12-27 19:15:00
456,5005,Ashley Westwood,1440,"[2016, 2017, 2018, 2019, 2020]",Burnley FC,53,49,4,4412,1,0,58,49,9,4477,4,0,111,98,13,8889,5,0,3.0,0.0,3.0,1,4,5,0,0,0,0,0,0,2020-12-27 19:15:002020-12-27 19:15:002020-12-27 19:15:002020-12-27 19:15:002020-12-27 19:15:00
457,5030,Ashley Williams,1061,"[2011, 2012, 2013, 2014, 2015]",Swansea City,92,92,0,8259,1,0,89,89,0,8010,3,0,181,181,0,16269,4,0,3.0,3.0,6.0,1,1,2,0,0,0,0,0,0,2020-12-27 19:15:002020-12-27 19:15:002020-12-27 19:15:002020-12-27 19:15:002020-12-27 19:15:00
458,2019,Ashley Williams,1061,"[2016, 2017]",Everton FC,30,27,3,2433,2,0,30,28,2,2563,0,0,60,55,5,4996,2,0,3.0,0.0,3.0,1,0,1,0,0,0,0,0,0,2020-12-27 19:15:002020-12-27 19:15:00
459,1011,Ashley Young,1619,[2006],Watford FC,7,7,0,630,3,0,10,10,0,900,0,0,17,17,0,1530,3,0,1.0,0.0,1.0,1,0,1,0,0,0,0,0,0,2020-12-27 19:15:00
460,4054,Ashley Young,1619,"[2007, 2008, 2009, 2010]",Aston Villa,70,70,0,6240,13,0,66,66,0,5898,14,0,136,136,0,12138,27,0,2.0,6.0,8.0,9,10,19,2,3,5,0,0,0,2020-12-27 19:15:002020-12-27 19:15:002020-12-27 19:15:002020-12-27 19:15:00
461,9180,Ashley Young,1619,"[2011, 2012, 2013, 2014, 2015, 2016, 2017, 2018, 2019]",Manchester United,86,73,13,6468,8,0,106,83,23,7335,7,0,192,156,36,13803,15,0,0.0,3.0,3.0,2,2,4,0,0,0,0,0,0,2020-12-27 19:15:002020-12-27 19:15:002020-12-27 19:15:002020-12-27 19:15:002020-12-27 19:15:002020-12-27 19:15:002020-12-27 19:15:002020-12-27 19:15:002020-12-27 19:15:00
462,1025,Asmir Begović,1036,[2008],Portsmouth FC,1,1,0,90,0,0,1,1,0,90,0,0,2,2,0,180,0,0,0.0,0.0,0.0,0,0,0,0,0,0,0,0,0,2020-12-27 19:15:00
463,6171,Asmir Begović,1036,"[2009, 2010, 2011, 2012, 2013, 2014]",Stoke City,80,80,0,7200,1,0,80,78,2,7091,0,0,160,158,2,14291,1,0,0.0,0.0,0.0,1,0,1,0,0,0,0,0,0,2020-12-27 19:15:002020-12-27 19:15:002020-12-27 19:15:002020-12-27 19:15:002020-12-27 19:15:002020-12-27 19:15:00
464,2065,Asmir Begović,1036,"[2015, 2016]",Chelsea FC,9,7,2,677,0,0,10,10,0,900,0,0,19,17,2,1577,0,0,0.0,0.0,0.0,0,0,0,0,0,0,0,0,0,2020-12-27 19:15:002020-12-27 19:15:00
465,2069,Asmir Begović,1036,"[2017, 2018]",AFC Bournemouth,31,31,0,2790,0,0,31,31,0,2790,0,0,62,62,0,5580,0,0,0.0,0.0,0.0,0,0,0,0,0,0,0,0,0,2020-12-27 19:15:002020-12-27 19:15:00
466,5190,Axel Tuanzebe,3211,"[2015, 2016, 2017, 2019, 2020]",Manchester United,3,2,1,181,0,0,9,4,5,359,0,0,12,6,6,540,0,0,0.0,0.0,0.0,0,0,0,0,0,0,1,0,1,2020-12-27 19:15:002020-12-27 19:15:002020-12-27 19:15:002020-12-27 19:15:002020-12-27 19:15:00
467,4170,Aymeric Laporte,2413,"[2017, 2018, 2019, 2020]",Manchester City,30,29,1,2526,0,0,33,32,1,2802,4,0,63,61,2,5328,4,0,0.0,1.0,1.0,0,3,3,0,0,0,0,0,0,2020-12-27 19:15:002020-12-27 19:15:002020-12-27 19:15:002020-12-27 19:15:00
468,4186,Ayoze Pérez,2288,"[2014, 2015, 2017, 2018]",Newcastle United,72,52,20,4909,21,0,71,57,14,4934,12,0,143,109,34,9843,33,0,13.0,15.0,28.0,13,8,21,0,0,0,0,0,0,2020-12-27 19:15:002020-12-27 19:15:002020-12-27 19:15:002020-12-27 19:15:00
469,2099,Ayoze Pérez,2288,"[2019, 2020]",Leicester City,22,16,6,1238,3,0,19,16,3,1233,6,0,41,32,9,2471,9,0,0.0,0.0,0.0,1,3,4,1,0,1,0,0,0,2020-12-27 19:15:002020-12-27 19:15:00
470,1051,Azar Karadaş,2966,[2005],Portsmouth FC,7,2,5,210,1,0,10,2,8,277,0,0,17,4,13,487,1,0,1.0,0.0,1.0,1,0,1,0,0,0,0,0,0,2020-12-27 19:15:00
471,9504,Azpilicueta,1535,"[2012, 2013, 2014, 2015, 2016, 2017, 2018, 2019, 2020]",Chelsea FC,137,132,5,11795,5,0,139,135,4,12165,3,0,276,267,9,23960,8,0,0.0,0.0,0.0,5,2,7,0,0,0,0,0,0,2020-12-27 19:15:002020-12-27 19:15:002020-12-27 19:15:002020-12-27 19:15:002020-12-27 19:15:002020-12-27 19:15:002020-12-27 19:15:002020-12-27 19:15:002020-12-27 19:15:00
472,7448,Bacary Sagna,1596,"[2007, 2008, 2009, 2010, 2011, 2012, 2013]",Arsenal FC,104,98,6,8609,2,0,106,105,1,9250,2,0,210,203,7,17859,4,0,0.0,0.0,0.0,0,2,2,0,0,0,0,0,0,2020-12-27 19:15:002020-12-27 19:15:002020-12-27 19:15:002020-12-27 19:15:002020-12-27 19:15:002020-12-27 19:15:002020-12-27 19:15:00
473,3207,Bacary Sagna,1596,"[2014, 2015, 2016]",Manchester City,23,20,3,1889,0,0,31,29,2,2643,0,0,54,49,5,4532,0,0,0.0,0.0,0.0,0,0,0,0,0,0,0,0,0,2020-12-27 19:15:002020-12-27 19:15:002020-12-27 19:15:00
474,1071,Badou N'Diaye,3323,[2017],Stoke City,5,5,0,439,1,0,7,7,0,611,1,0,12,12,0,1050,2,0,0.0,0.0,0.0,1,1,2,0,0,0,0,0,0,2020-12-27 19:15:00
475,2145,Bafétimbi Gomis,1704,"[2014, 2015]",Swansea City,31,17,14,1601,7,0,33,19,14,1736,6,0,64,36,28,3337,13,0,9.0,7.0,16.0,5,5,10,0,1,1,0,0,0,2020-12-27 19:15:002020-12-27 19:15:00
476,2149,Bailey Peacock-Farrell,2677,"[2019, 2020]",Burnley FC,0,0,0,0,0,0,1,1,0,90,0,0,1,1,0,90,0,0,0.0,0.0,0.0,0,0,0,0,0,0,0,0,0,2020-12-27 19:15:002020-12-27 19:15:00
477,2153,Baily Cargill,3289,"[2015, 2016]",AFC Bournemouth,0,0,0,0,0,0,1,0,1,12,0,0,1,0,1,12,0,0,0.0,0.0,0.0,0,0,0,0,0,0,0,0,0,2020-12-27 19:15:002020-12-27 19:15:00
478,4318,Bakary Sako,2253,"[2015, 2016, 2017, 2018]",Crystal Palace,22,4,18,623,3,0,25,11,14,1094,2,0,47,15,32,1717,5,0,6.0,0.0,6.0,3,1,4,0,0,0,0,0,0,2020-12-27 19:15:002020-12-27 19:15:002020-12-27 19:15:002020-12-27 19:15:00
479,1082,Barragán,3005,[2016],Middlesbrough FC,14,14,0,1183,0,0,12,12,0,1013,0,0,26,26,0,2196,0,0,0.0,0.0,0.0,0,0,0,0,0,0,0,0,0,2020-12-27 19:15:00
480,3252,Barry Bannan,1975,"[2010, 2011, 2012]",Aston Villa,34,20,14,1935,0,0,29,14,15,1485,1,0,63,34,29,3420,1,0,0.0,0.0,0.0,0,1,1,0,1,1,0,0,0,2020-12-27 19:15:002020-12-27 19:15:002020-12-27 19:15:00
481,2173,Barry Bannan,1975,"[2013, 2014]",Crystal Palace,10,8,2,571,0,0,12,7,5,572,1,0,22,15,7,1143,1,0,0.0,3.0,3.0,0,1,1,0,0,0,0,0,0,2020-12-27 19:15:002020-12-27 19:15:00
482,2177,Barry Ferguson,1782,"[2003, 2004]",Blackburn Rovers,18,18,0,1587,1,0,17,16,1,1423,2,0,35,34,1,3010,3,0,0.0,0.0,0.0,1,2,3,0,0,0,0,0,0,2020-12-27 19:15:002020-12-27 19:15:00
483,2181,Barry Ferguson,1782,"[2009, 2010]",Birmingham City,37,37,0,3330,0,0,35,35,0,3150,0,0,72,72,0,6480,0,0,0.0,0.0,0.0,0,0,0,0,0,0,0,0,0,2020-12-27 19:15:002020-12-27 19:15:00
484,3279,Barry Hayles,2897,"[2001, 2002, 2003]",Fulham FC,39,22,17,2201,8,0,30,17,13,1579,5,0,69,39,30,3780,13,0,1.0,0.0,1.0,5,1,6,0,0,0,0,0,0,2020-12-27 19:15:002020-12-27 19:15:002020-12-27 19:15:00
485,1095,Barry Quinn,2100,[2000],Leeds United,1,1,0,51,0,0,0,0,0,0,0,0,1,1,0,51,0,0,0.0,0.0,0.0,0,0,0,0,0,0,0,0,0,2020-12-27 19:15:00
486,1096,Bartosz Kapustka,4025,[2016],Leicester City,0,0,0,0,0,0,0,0,0,0,0,0,0,0,0,0,0,0,0.0,0.0,0.0,0,0,0,0,0,0,0,0,0,2020-12-27 19:15:00
487,2195,Bastian Schweinsteiger,2803,"[2015, 2016]",Manchester United,9,7,2,619,0,0,9,6,3,583,1,0,18,13,5,1202,1,0,0.0,1.0,1.0,0,1,1,0,0,0,0,0,0,2020-12-27 19:15:002020-12-27 19:15:00
488,1099,Bebé,3794,[2010],Manchester United,1,0,1,81,0,0,1,0,1,10,0,0,2,0,2,91,0,0,0.0,0.0,0.0,0,0,0,0,0,0,0,0,0,2020-12-27 19:15:00
489,3303,Belletti,2432,"[2007, 2008, 2009]",Chelsea FC,30,15,15,1719,3,0,24,14,10,1405,2,0,54,29,25,3124,5,0,0.0,0.0,0.0,3,0,3,0,0,0,0,0,0,2020-12-27 19:15:002020-12-27 19:15:002020-12-27 19:15:00
490,1103,Ben Alnwick,4272,[2005],Sunderland AFC,3,3,0,270,0,0,2,2,0,180,0,0,5,5,0,450,0,0,0.0,0.0,0.0,0,0,0,0,0,0,0,0,0,2020-12-27 19:15:00
491,2209,Ben Alnwick,4272,"[2009, 2010]",Tottenham Hotspur,0,0,0,0,0,0,1,1,0,90,0,0,1,1,0,90,0,0,0.0,0.0,0.0,0,0,0,0,0,0,0,0,0,2020-12-27 19:15:002020-12-27 19:15:00
492,5540,Ben Amos,2260,"[2010, 2011, 2012, 2013, 2014]",Manchester United,1,1,0,90,0,0,0,0,0,0,0,0,1,1,0,90,0,0,0.0,0.0,0.0,0,0,0,0,0,0,0,0,0,2020-12-27 19:15:002020-12-27 19:15:002020-12-27 19:15:002020-12-27 19:15:002020-12-27 19:15:00
493,5565,Ben Chilwell,2436,"[2015, 2016, 2017, 2018, 2019]",Leicester City,52,47,5,4279,2,0,47,43,4,3906,2,0,99,90,9,8185,4,0,0.0,0.0,0.0,1,2,3,0,0,0,0,0,0,2020-12-27 19:15:002020-12-27 19:15:002020-12-27 19:15:002020-12-27 19:15:002020-12-27 19:15:00
494,1116,Ben Chilwell,2436,[2020],Chelsea FC,6,6,0,460,2,0,6,6,0,532,0,0,12,12,0,992,2,0,0.0,0.0,0.0,2,0,2,0,0,0,0,0,0,2020-12-27 19:15:00
495,1117,Ben Clark,4168,[2002],Sunderland AFC,1,0,1,26,0,0,0,0,0,0,0,0,1,0,1,26,0,0,0.0,0.0,0.0,0,0,0,0,0,0,0,0,0,2020-12-27 19:15:00
496,2237,Ben Davies,1164,"[2012, 2013]",Swansea City,37,35,2,3178,2,0,34,30,4,2748,1,0,71,65,6,5926,3,0,0.0,0.0,0.0,1,1,2,0,0,0,0,0,0,2020-12-27 19:15:002020-12-27 19:15:00
497,7861,Ben Davies,1164,"[2014, 2015, 2016, 2017, 2018, 2019, 2020]",Tottenham Hotspur,66,49,17,4564,0,0,73,60,13,5533,3,0,139,109,30,10097,3,0,0.0,0.0,0.0,0,0,0,0,0,0,0,0,0,2020-12-27 19:15:002020-12-27 19:15:002020-12-27 19:15:002020-12-27 19:15:002020-12-27 19:15:002020-12-27 19:15:002020-12-27 19:15:00
498,3406,Ben Foster,1653,"[2006, 2018, 2019]",Watford FC,50,50,0,4499,0,0,54,54,0,4816,0,0,104,104,0,9315,0,0,0.0,0.0,0.0,0,0,0,0,0,0,0,0,0,2020-12-27 19:15:002020-12-27 19:15:002020-12-27 19:15:00
499,3387,Ben Foster,1653,"[2007, 2008, 2009]",Manchester United,4,4,0,360,0,0,7,7,0,630,0,0,11,11,0,990,0,0,0.0,0.0,0.0,0,0,0,0,0,0,0,0,0,2020-12-27 19:15:002020-12-27 19:15:002020-12-27 19:15:00
500,1131,Ben Foster,1653,[2010],Birmingham City,19,19,0,1710,0,0,19,19,0,1660,0,0,38,38,0,3370,0,0,0.0,0.0,0.0,0,0,0,0,0,0,0,0,0,2020-12-27 19:15:00
501,7945,Ben Foster,1653,"[2011, 2012, 2013, 2014, 2015, 2016, 2017]",West Bromwich Albion,106,106,0,9506,0,0,103,103,0,9258,0,0,209,209,0,18764,0,0,0.0,0.0,0.0,0,0,0,0,0,0,0,0,0,2020-12-27 19:15:002020-12-27 19:15:002020-12-27 19:15:002020-12-27 19:15:002020-12-27 19:15:002020-12-27 19:15:002020-12-27 19:15:00
502,1141,Ben Gibson,3004,[2016],Middlesbrough FC,19,19,0,1710,1,0,19,19,0,1710,0,0,38,38,0,3420,1,0,0.0,0.0,0.0,0,0,0,0,0,0,0,0,0,2020-12-27 19:15:00
503,2285,Ben Gibson,3004,"[2018, 2019]",Burnley FC,1,1,0,63,1,0,0,0,0,0,0,0,1,1,0,63,1,0,0.0,0.0,0.0,0,0,0,0,0,0,0,0,0,2020-12-27 19:15:002020-12-27 19:15:00
504,1144,Ben Godfrey,1824,[2019],Norwich City,15,15,0,1350,0,0,15,15,0,1310,0,0,30,30,0,2660,0,0,0.0,0.0,0.0,0,0,0,0,0,0,0,0,0,2020-12-27 19:15:00
505,1145,Ben Godfrey,1824,[2020],Everton FC,4,3,1,329,0,0,5,5,0,450,0,0,9,8,1,779,0,0,0.0,0.0,0.0,0,0,0,0,0,0,0,0,0,2020-12-27 19:15:00
506,3441,Ben Hamer,2520,"[2014, 2016, 2017]",Leicester City,6,6,0,540,0,0,6,5,1,454,0,0,12,11,1,994,0,0,0.0,0.0,0.0,0,0,0,0,0,0,0,0,0,2020-12-27 19:15:002020-12-27 19:15:002020-12-27 19:15:00
507,1149,Ben Hamer,2520,[2018],Huddersfield Town,4,4,0,283,0,0,3,3,0,270,0,0,7,7,0,553,0,0,0.0,0.0,0.0,0,0,0,0,0,0,0,0,0,2020-12-27 19:15:00
508,1150,Ben Hinchcliffe,4128,[2016],Hull City,0,0,0,0,0,0,0,0,0,0,0,0,0,0,0,0,0,0,0.0,0.0,0.0,0,0,0,0,0,0,0,0,0,2020-12-27 19:15:00
509,1151,Ben Hutchinson,4087,[2007],Middlesbrough FC,4,0,4,83,0,0,4,0,4,104,1,0,8,0,8,187,1,0,0.0,0.0,0.0,0,0,0,0,0,0,0,0,0,2020-12-27 19:15:00
510,4614,Ben Johnson,4056,"[2017, 2018, 2019, 2020]",West Ham United,5,3,2,316,1,0,3,2,1,158,0,0,8,5,3,474,1,0,0.0,0.0,0.0,1,0,1,0,0,0,0,0,0,2020-12-27 19:15:002020-12-27 19:15:002020-12-27 19:15:002020-12-27 19:15:00
511,6951,Ben Mee,1251,"[2014, 2016, 2017, 2018, 2019, 2020]",Burnley FC,84,83,1,7434,1,0,90,90,0,8100,3,0,174,173,1,15534,4,0,0.0,4.0,4.0,1,2,3,0,0,0,0,0,0,2020-12-27 19:15:002020-12-27 19:15:002020-12-27 19:15:002020-12-27 19:15:002020-12-27 19:15:002020-12-27 19:15:00
512,2325,Ben Osborn,3475,"[2019, 2020]",Sheffield United,11,7,4,683,0,0,11,4,7,415,0,0,22,11,11,1098,0,0,0.0,0.0,0.0,0,0,0,0,0,0,0,0,0,2020-12-27 19:15:002020-12-27 19:15:00
513,1164,Ben Reeves,3540,[2012],Southampton FC,2,0,2,16,0,0,1,0,1,9,0,0,3,0,3,25,0,0,0.0,0.0,0.0,0,0,0,0,0,0,0,0,0,2020-12-27 19:15:00
514,1165,Ben Roberts,4578,[2002],Charlton Athletic,1,0,1,58,0,0,0,0,0,0,0,0,1,0,1,58,0,0,0.0,0.0,0.0,0,0,0,0,0,0,0,0,0,2020-12-27 19:15:00
515,1166,Ben Sahar,4308,[2006],Chelsea FC,3,0,3,65,0,0,0,0,0,0,0,0,3,0,3,65,0,0,0.0,0.0,0.0,0,0,0,0,0,0,0,0,0,2020-12-27 19:15:00
516,3504,Ben Thatcher,1807,"[2000, 2001, 2002]",Tottenham Hotspur,17,12,5,1158,0,0,18,16,2,1418,0,0,35,28,7,2576,0,0,0.0,0.0,0.0,0,0,0,0,0,0,0,0,0,2020-12-27 19:15:002020-12-27 19:15:002020-12-27 19:15:00
517,1170,Ben Thatcher,1807,[2003],Leicester City,15,14,1,1221,0,0,14,14,0,1260,1,0,29,28,1,2481,1,0,0.0,0.0,0.0,0,1,1,0,0,0,0,0,0,2020-12-27 19:15:00
518,3516,Ben Thatcher,1807,"[2004, 2005, 2006]",Manchester City,24,23,1,2050,0,0,22,22,0,1936,0,0,46,45,1,3986,0,0,0.0,0.0,0.0,0,0,0,0,0,0,0,0,0,2020-12-27 19:15:002020-12-27 19:15:002020-12-27 19:15:00
519,1174,Ben Turner,3456,[2013],Cardiff City,15,15,0,1350,0,0,16,15,1,1371,0,0,31,30,1,2721,0,0,0.0,0.0,0.0,0,0,0,0,0,0,0,0,0,2020-12-27 19:15:00
520,1175,Ben Watson,2025,[2004],Crystal Palace,11,8,3,709,0,0,9,7,2,600,0,0,20,15,5,1309,0,0,0.0,0.0,0.0,0,0,0,0,0,0,0,0,0,2020-12-27 19:15:00
521,5890,Ben Watson,2025,"[2008, 2009, 2010, 2011, 2012]",Wigan Athletic,37,25,12,2370,5,0,40,29,11,2627,5,0,77,54,23,4997,10,0,3.0,4.0,7.0,3,5,8,3,1,4,0,0,0,2020-12-27 19:15:002020-12-27 19:15:002020-12-27 19:15:002020-12-27 19:15:002020-12-27 19:15:00
522,3546,Ben Watson,2025,"[2015, 2016, 2017]",Watford FC,21,18,3,1602,0,0,26,19,7,1737,1,0,47,37,10,3339,1,0,0.0,3.0,3.0,0,1,1,0,0,0,0,0,0,2020-12-27 19:15:002020-12-27 19:15:002020-12-27 19:15:00
523,2369,Ben White,4178,"[2018, 2020]",Brighton & Hove Albion,7,7,0,592,0,0,8,8,0,720,0,0,15,15,0,1312,0,0,0.0,0.0,0.0,0,0,0,0,0,0,0,0,0,2020-12-27 19:15:002020-12-27 19:15:00
524,1186,Ben Wilmot,2332,[2018],Watford FC,0,0,0,0,0,0,2,0,2,26,0,0,2,0,2,26,0,0,0.0,0.0,0.0,0,0,0,0,0,0,0,0,0,2020-12-27 19:15:00
525,2375,Ben Woodburn,3287,"[2016, 2017]",Liverpool FC,3,0,3,37,0,0,3,1,2,53,0,0,6,1,5,90,0,0,0.0,0.0,0.0,0,0,0,0,0,0,0,0,0,2020-12-27 19:15:002020-12-27 19:15:00
526,1189,Ben Wynter,4125,[2016],Crystal Palace,0,0,0,0,0,0,0,0,0,0,0,0,0,0,0,0,0,0,0.0,0.0,0.0,0,0,0,0,0,0,0,0,0,2020-12-27 19:15:00
527,2381,Beni Baningime,4016,"[2017, 2019]",Everton FC,5,1,4,125,0,0,3,0,3,67,0,0,8,1,7,192,0,0,0.0,0.0,0.0,0,0,0,0,0,0,0,0,0,2020-12-27 19:15:002020-12-27 19:15:00
528,3579,Benik Afobe,1043,"[2015, 2016, 2017]",AFC Bournemouth,32,15,17,1465,5,0,31,16,15,1459,5,0,63,31,32,2924,10,0,1.0,3.0,4.0,1,4,5,0,0,0,0,0,0,2020-12-27 19:15:002020-12-27 19:15:002020-12-27 19:15:00
529,1195,Benito Carbone,2920,[2000],Bradford City,15,15,0,1297,3,0,10,8,2,719,2,0,25,23,2,2016,5,0,1.0,0.0,1.0,1,1,2,0,0,0,0,0,0,2020-12-27 19:15:00
530,1196,Benito Carbone,2920,[2001],Middlesbrough FC,8,8,0,655,1,0,4,4,0,360,0,0,12,12,0,1015,1,0,0.0,0.0,0.0,1,0,1,0,0,0,0,0,0,2020-12-27 19:15:00
531,4794,Benjamin Mendy,2674,"[2017, 2018, 2019, 2020]",Manchester City,24,21,3,1802,1,0,18,17,1,1462,0,0,42,38,4,3264,1,0,0.0,0.0,0.0,0,0,0,0,0,0,0,0,0,2020-12-27 19:15:002020-12-27 19:15:002020-12-27 19:15:002020-12-27 19:15:00
532,1201,Benjamin Stambouli,1177,[2014],Tottenham Hotspur,5,2,3,237,0,0,7,2,5,217,0,0,12,4,8,454,0,0,0.0,0.0,0.0,0,0,0,0,0,0,0,0,0,2020-12-27 19:15:00
533,3609,Benjani,1391,"[2005, 2006, 2007]",Portsmouth FC,35,32,3,2626,11,0,34,29,5,2453,8,0,69,61,8,5079,19,0,4.0,0.0,4.0,8,4,12,0,0,0,0,0,0,2020-12-27 19:15:002020-12-27 19:15:002020-12-27 19:15:00
534,1205,Benjani,1391,[2008],Manchester City,4,4,0,314,0,0,3,2,1,161,1,0,7,6,1,475,1,0,0.0,0.0,0.0,0,1,1,0,0,0,0,0,0,2020-12-27 19:15:00
535,1206,Benjani,1391,[2009],Sunderland AFC,5,1,4,91,0,0,3,0,3,31,0,0,8,1,7,122,0,0,0.0,0.0,0.0,0,0,0,0,0,0,0,0,0,2020-12-27 19:15:00
536,1207,Benjani,1391,[2010],Blackburn Rovers,11,5,6,468,3,0,7,1,6,194,0,0,18,6,12,662,3,0,0.0,0.0,0.0,1,0,1,0,0,0,0,0,0,2020-12-27 19:15:00
537,1208,Benny Ashley-Seal,3932,[2019],Wolverhampton Wanderers,0,0,0,0,0,0,0,0,0,0,0,0,0,0,0,0,0,0,0.0,0.0,0.0,0,0,0,0,0,0,0,0,0,2020-12-27 19:15:00
538,1209,Benny Feilhaber,3599,[2007],Derby County,6,0,6,180,0,0,4,1,3,113,0,0,10,1,9,293,0,0,0.0,0.0,0.0,0,0,0,0,0,0,0,0,0,2020-12-27 19:15:00
539,3633,Benny McCarthy,2112,"[2006, 2007, 2008]",Blackburn Rovers,47,38,9,3347,25,0,44,34,10,2714,11,0,91,72,19,6061,36,0,17.0,1.0,18.0,19,9,28,9,4,13,0,0,0,2020-12-27 19:15:002020-12-27 19:15:002020-12-27 19:15:00
540,1213,Benny McCarthy,2112,[2009],Wigan Athletic,1,1,0,90,0,0,0,0,0,0,0,0,1,1,0,90,0,0,0.0,0.0,0.0,0,0,0,0,0,0,0,0,0,2020-12-27 19:15:00
541,1214,Benny McCarthy,2112,[2010],West Ham United,4,0,4,47,0,0,2,0,2,29,0,0,6,0,6,76,0,0,0.0,0.0,0.0,0,0,0,0,0,0,0,0,0,2020-12-27 19:15:00
542,1215,Benoît Assou-Ekotto,1269,[2006],Watford FC,1,1,0,90,0,0,0,0,0,0,0,0,1,1,0,90,0,0,0.0,0.0,0.0,0,0,0,0,0,0,0,0,0,2020-12-27 19:15:00
543,7311,Benoît Assou-Ekotto,1269,"[2007, 2008, 2009, 2010, 2011, 2012]",Tottenham Hotspur,74,71,3,6196,4,0,64,63,1,5504,0,0,138,134,4,11700,4,0,0.0,0.0,0.0,3,0,3,0,0,0,0,0,0,2020-12-27 19:15:002020-12-27 19:15:002020-12-27 19:15:002020-12-27 19:15:002020-12-27 19:15:002020-12-27 19:15:00
544,2445,Beram Kayal,2486,"[2017, 2018]",Brighton & Hove Albion,18,7,11,729,0,0,19,10,9,947,1,0,37,17,20,1676,1,0,0.0,3.0,3.0,0,1,1,0,0,0,0,0,0,2020-12-27 19:15:002020-12-27 19:15:00
545,3675,Bernard,1468,"[2018, 2019, 2020]",Everton FC,33,20,13,1746,4,0,33,21,12,1869,1,0,66,41,25,3615,5,0,3.0,0.0,3.0,4,0,4,0,0,0,0,0,0,2020-12-27 19:15:002020-12-27 19:15:002020-12-27 19:15:00
546,1227,Bernard Diomède,4247,[2000],Liverpool FC,1,1,0,72,0,0,1,0,1,36,0,0,2,1,1,108,0,0,0.0,0.0,0.0,0,0,0,0,0,0,0,0,0,2020-12-27 19:15:00
547,1228,Bernard Lambourde,4151,[2000],Chelsea FC,1,0,1,3,0,0,0,0,0,0,0,0,1,0,1,3,0,0,0.0,0.0,0.0,0,0,0,0,0,0,0,0,0,2020-12-27 19:15:00
548,1229,Bernard Mendy,2612,[2002],Bolton Wanderers,10,10,0,818,0,0,11,10,1,811,0,0,21,20,1,1629,0,0,0.0,0.0,0.0,0,0,0,0,0,0,0,0,0,2020-12-27 19:15:00
549,2461,Bernard Mendy,2612,"[2008, 2009]",Hull City,26,18,8,1767,1,0,23,12,11,1251,1,0,49,30,19,3018,2,0,0.0,0.0,0.0,1,0,1,0,0,0,0,0,0,2020-12-27 19:15:002020-12-27 19:15:00
550,3699,Bernardo,2419,"[2018, 2019, 2020]",Brighton & Hove Albion,15,13,2,1247,0,0,22,13,9,1206,0,0,37,26,11,2453,0,0,0.0,0.0,0.0,0,0,0,0,0,0,0,0,0,2020-12-27 19:15:002020-12-27 19:15:002020-12-27 19:15:00
551,1235,Bernardo Corradi,1880,[2006],Manchester City,11,8,3,635,2,0,14,11,3,979,1,0,25,19,6,1614,3,0,0.0,0.0,0.0,1,1,2,0,0,0,0,0,0,2020-12-27 19:15:00
552,1236,Bernardo Espinosa,3038,[2016],Middlesbrough FC,5,5,0,443,0,0,6,5,1,532,0,0,11,10,1,975,0,0,0.0,0.0,0.0,0,0,0,0,0,0,0,0,0,2020-12-27 19:15:00
553,1237,Bernardo Rosa,4225,[2019],West Ham United,0,0,0,0,0,0,0,0,0,0,0,0,0,0,0,0,0,0,0.0,0.0,0.0,0,0,0,0,0,0,0,0,0,2020-12-27 19:15:00
554,4958,Bernardo Silva,1207,"[2017, 2018, 2019, 2020]",Manchester City,56,36,20,3414,10,0,56,39,17,3538,9,0,112,75,37,6952,19,0,3.0,0.0,3.0,3,4,7,0,0,0,0,0,0,2020-12-27 19:15:002020-12-27 19:15:002020-12-27 19:15:002020-12-27 19:15:00
555,3729,Bernd Leno,1469,"[2018, 2019, 2020]",Arsenal FC,39,38,1,3465,0,0,38,38,0,3370,0,0,77,76,1,6835,0,0,0.0,0.0,0.0,0,0,0,0,0,0,0,0,0,2020-12-27 19:15:002020-12-27 19:15:002020-12-27 19:15:00
556,1245,Bernt Haas,1339,[2001],Sunderland AFC,12,12,0,1056,0,0,14,14,0,1231,0,0,26,26,0,2287,0,0,0.0,0.0,0.0,0,0,0,0,0,0,0,0,0,2020-12-27 19:15:00
557,1246,Bernt Haas,1339,[2004],West Bromwich Albion,4,4,0,333,0,0,6,5,1,423,0,0,10,9,1,756,0,0,0.0,0.0,0.0,0,0,0,0,0,0,0,0,0,2020-12-27 19:15:00
558,1247,Bersant Celina,4053,[2015],Manchester City,1,0,1,13,0,0,0,0,0,0,0,0,1,0,1,13,0,0,0.0,0.0,0.0,0,0,0,0,0,0,0,0,0,2020-12-27 19:15:00
559,1248,Bertrand Traoré,3505,[2015],Chelsea FC,6,2,4,206,2,0,4,2,2,167,0,0,10,4,6,373,2,0,0.0,0.0,0.0,1,0,1,0,0,0,0,0,0,2020-12-27 19:15:00
560,1249,Bertrand Traoré,3505,[2020],Aston Villa,6,3,3,266,1,0,5,2,3,196,1,0,11,5,6,462,2,0,0.0,0.0,0.0,1,0,1,0,0,0,0,0,0,2020-12-27 19:15:00
561,2501,Billy Gilmour,2958,"[2019, 2020]",Chelsea FC,5,1,4,112,0,0,2,1,1,88,0,0,7,2,5,200,0,0,0.0,0.0,0.0,0,0,0,0,0,0,0,0,0,2020-12-27 19:15:002020-12-27 19:15:00
562,3759,Billy Jones,1733,"[2011, 2012, 2013]",West Bromwich Albion,33,32,1,2763,1,0,33,30,3,2793,0,0,66,62,4,5556,1,0,1.0,0.0,1.0,1,0,1,0,0,0,0,0,0,2020-12-27 19:15:002020-12-27 19:15:002020-12-27 19:15:00
563,3768,Billy Jones,1733,"[2014, 2015, 2016]",Sunderland AFC,29,29,0,2573,1,0,36,33,3,2987,1,0,65,62,3,5560,2,0,0.0,0.0,0.0,0,1,1,0,0,0,0,0,0,2020-12-27 19:15:002020-12-27 19:15:002020-12-27 19:15:00
564,2517,Billy Knott,3865,"[2010, 2012]",Sunderland AFC,0,0,0,0,0,0,1,0,1,15,0,0,1,0,1,15,0,0,0.0,0.0,0.0,0,0,0,0,0,0,0,0,0,2020-12-27 19:15:002020-12-27 19:15:00
565,1260,Billy McKinlay,2837,[2000],Bradford City,5,4,1,362,0,0,6,6,0,540,0,0,11,10,1,902,0,0,0.0,0.0,0.0,0,0,0,0,0,0,0,0,0,2020-12-27 19:15:00
566,1261,Billy McKinlay,2837,[2003],Leicester City,7,7,0,564,0,0,9,8,1,702,0,0,16,15,1,1266,0,0,0.0,0.0,0.0,0,0,0,0,0,0,0,0,0,2020-12-27 19:15:00
567,1262,Billy McKinlay,2837,[2004],Fulham FC,1,0,1,5,0,0,1,1,0,90,0,0,2,1,1,95,0,0,0.0,0.0,0.0,0,0,0,0,0,0,0,0,0,2020-12-27 19:15:00
568,1263,Billy Sharp,3470,[2012],Southampton FC,1,0,1,14,0,0,1,0,1,4,0,0,2,0,2,18,0,0,0.0,0.0,0.0,0,0,0,0,0,0,0,0,0,2020-12-27 19:15:00
569,2529,Billy Sharp,3470,"[2019, 2020]",Sheffield United,16,7,9,695,3,0,14,5,9,546,1,0,30,12,18,1241,4,0,4.0,1.0,5.0,3,1,4,1,0,1,0,0,0,2020-12-27 19:15:002020-12-27 19:15:00
570,2533,Bjarne Goldbæk,3062,"[2001, 2002]",Fulham FC,11,8,3,659,1,0,9,6,3,510,0,0,20,14,6,1169,1,0,0.0,0.0,0.0,1,0,1,0,0,0,0,0,0,2020-12-27 19:15:002020-12-27 19:15:00
571,2537,Björn Engels,3715,"[2019, 2020]",Aston Villa,9,8,1,787,1,0,8,7,1,659,0,0,17,15,2,1446,1,0,0.0,0.0,0.0,1,0,1,0,0,0,0,0,0,2020-12-27 19:15:002020-12-27 19:15:00
572,1270,Björn Runström,3690,[2006],Fulham FC,0,0,0,0,0,0,1,0,1,8,0,0,1,0,1,8,0,0,0.0,0.0,0.0,0,0,0,0,0,0,0,0,0,2020-12-27 19:15:00
573,3816,Bjørn Helge Riise,3294,"[2009, 2010, 2011]",Fulham FC,6,1,5,144,0,0,9,4,5,290,0,0,15,5,10,434,0,0,0.0,0.0,0.0,0,0,0,0,0,0,0,0,0,2020-12-27 19:15:002020-12-27 19:15:002020-12-27 19:15:00
574,1274,Bjørn Otto Bragstad,3452,[2000],Derby County,5,5,0,433,0,0,6,4,2,457,0,0,11,9,2,890,0,0,0.0,0.0,0.0,0,0,0,0,0,0,0,0,0,2020-12-27 19:15:00
575,1275,Blair Adams,1692,[2010],Sunderland AFC,0,0,0,0,0,0,0,0,0,0,0,0,0,0,0,0,0,0,0.0,0.0,0.0,0,0,0,0,0,0,0,0,0,2020-12-27 19:15:00
576,1276,Blessing Kaku,4537,[2004],Bolton Wanderers,0,0,0,0,0,0,1,0,1,25,0,0,1,0,1,25,0,0,0.0,0.0,0.0,0,0,0,0,0,0,0,0,0,2020-12-27 19:15:00
577,1277,Bo Hansen,3921,[2001],Bolton Wanderers,7,5,2,429,0,0,10,5,5,444,1,0,17,10,7,873,1,0,0.0,1.0,1.0,0,1,1,0,0,0,0,0,0,2020-12-27 19:15:00
578,1278,Bo-kyung Kim,3459,[2013],Cardiff City,14,10,4,792,1,0,14,11,3,885,0,0,28,21,7,1677,1,0,1.0,0.0,1.0,1,0,1,0,0,0,0,0,0,2020-12-27 19:15:00
579,7689,Boa Morte,1085,"[2001, 2002, 2003, 2004, 2005, 2006]",Fulham FC,77,67,10,6138,17,0,78,71,7,6184,9,0,155,138,17,12322,26,0,8.0,2.0,10.0,10,5,15,0,0,0,0,0,0,2020-12-27 19:15:002020-12-27 19:15:002020-12-27 19:15:002020-12-27 19:15:002020-12-27 19:15:002020-12-27 19:15:00
580,5146,Boa Morte,1085,"[2007, 2008, 2009, 2010]",West Ham United,34,22,12,1851,1,0,40,28,12,2389,0,0,74,50,24,4240,1,0,0.0,0.0,0.0,1,0,1,0,0,0,0,0,0,2020-12-27 19:15:002020-12-27 19:15:002020-12-27 19:15:002020-12-27 19:15:00
581,2579,Boaz Myhill,1663,"[2008, 2009]",Hull City,27,27,0,2430,0,0,28,28,0,2520,0,0,55,55,0,4950,0,0,0.0,0.0,0.0,0,0,0,0,0,0,0,0,0,2020-12-27 19:15:002020-12-27 19:15:00
582,9058,Boaz Myhill,1663,"[2010, 2012, 2013, 2014, 2015, 2016, 2017]",West Bromwich Albion,31,30,1,2734,0,0,32,32,0,2880,0,0,63,62,1,5614,0,0,0.0,0.0,0.0,0,0,0,0,0,0,0,0,0,2020-12-27 19:15:002020-12-27 19:15:002020-12-27 19:15:002020-12-27 19:15:002020-12-27 19:15:002020-12-27 19:15:002020-12-27 19:15:00
583,1298,Bob Malcolm,4522,[2007],Derby County,0,0,0,0,0,0,1,1,0,59,0,0,1,1,0,59,0,0,0.0,0.0,0.0,0,0,0,0,0,0,0,0,0,2020-12-27 19:15:00
584,1299,Bob Taylor,3697,[2002],West Bromwich Albion,3,2,1,107,0,0,1,0,1,7,0,0,4,2,2,114,0,0,0.0,0.0,0.0,0,0,0,0,0,0,0,0,0,2020-12-27 19:15:00
585,2601,Bobby Convey,2592,"[2006, 2007]",Reading FC,13,9,4,729,0,0,15,10,5,866,0,0,28,19,9,1595,0,0,0.0,0.0,0.0,0,0,0,0,0,0,0,0,0,2020-12-27 19:15:002020-12-27 19:15:00
586,1302,Bobby Petta,4147,[2003],Fulham FC,6,2,4,174,0,0,3,1,2,144,0,0,9,3,6,318,0,0,0.0,0.0,0.0,0,0,0,0,0,0,0,0,0,2020-12-27 19:15:00
587,1303,Bobby Reid,3149,[2018],Cardiff City,11,8,3,725,4,0,16,8,8,697,1,0,27,16,11,1422,5,0,0.0,0.0,0.0,2,0,2,1,0,1,0,0,0,2020-12-27 19:15:00
588,1304,Bobby Reid,3149,[2020],Fulham FC,8,6,2,487,3,0,6,5,1,446,1,0,14,11,3,933,4,0,0.0,0.0,0.0,3,0,3,0,0,0,0,0,0,2020-12-27 19:15:00
589,2611,Bobby Thomas,2680,"[2019, 2020]",Burnley FC,0,0,0,0,0,0,0,0,0,0,0,0,0,0,0,0,0,0,0.0,0.0,0.0,0,0,0,0,0,0,0,0,0,2020-12-27 19:15:002020-12-27 19:15:00
590,1307,Bobby Zamora,1943,[2003],Tottenham Hotspur,8,4,4,352,0,0,8,2,6,263,0,0,16,6,10,615,0,0,0.0,0.0,0.0,0,0,0,0,0,0,0,0,0,2020-12-27 19:15:00
591,3927,Bobby Zamora,1943,"[2005, 2006, 2007]",West Ham United,42,28,14,2430,8,0,34,24,10,2076,10,0,76,52,24,4506,18,0,4.0,10.0,14.0,8,8,16,0,0,0,0,0,0,2020-12-27 19:15:002020-12-27 19:15:002020-12-27 19:15:00
592,3936,Bobby Zamora,1943,"[2008, 2009, 2010]",Fulham FC,36,30,6,2496,12,0,34,32,2,2680,3,0,70,62,8,5176,15,0,9.0,3.0,12.0,8,3,11,1,0,1,0,0,0,2020-12-27 19:15:002020-12-27 19:15:002020-12-27 19:15:00
593,3945,Bobby Zamora,1943,"[2011, 2012, 2014]",Queens Park Rangers,35,29,6,2463,2,0,31,20,11,1881,7,0,66,49,17,4344,9,0,1.0,1.0,2.0,2,3,5,0,0,0,0,0,0,2020-12-27 19:15:002020-12-27 19:15:002020-12-27 19:15:00
594,5274,Bojan,1585,"[2014, 2015, 2016, 2017]",Stoke City,25,22,3,1857,7,0,28,20,8,1608,7,0,53,42,11,3465,14,0,0.0,13.0,13.0,4,7,11,3,2,5,0,0,0,2020-12-27 19:15:002020-12-27 19:15:002020-12-27 19:15:002020-12-27 19:15:00
595,1321,Bojan Djordjic,4523,[2000],Manchester United,0,0,0,0,0,0,1,0,1,13,0,0,1,0,1,13,0,0,0.0,0.0,0.0,0,0,0,0,0,0,0,0,0,2020-12-27 19:15:00
596,2645,Bongani Khumalo,4052,"[2010, 2011]",Tottenham Hotspur,0,0,0,0,0,0,0,0,0,0,0,0,0,0,0,0,0,0,0.0,0.0,0.0,0,0,0,0,0,0,0,0,0,2020-12-27 19:15:002020-12-27 19:15:00
597,1324,Boris Živković,3515,[2003],Portsmouth FC,8,8,0,720,0,0,9,8,1,724,0,0,17,16,1,1444,0,0,0.0,0.0,0.0,0,0,0,0,0,0,0,0,0,2020-12-27 19:15:00
598,1325,Borja Bastón,3195,[2016],Swansea City,8,4,4,355,0,0,10,0,10,193,1,0,18,4,14,548,1,0,0.0,0.0,0.0,0,0,0,0,0,0,0,0,0,2020-12-27 19:15:00
599,1326,Borja Bastón,3195,[2019],Aston Villa,1,0,1,7,0,0,1,0,1,9,0,0,2,0,2,16,0,0,0.0,0.0,0.0,0,0,0,0,0,0,0,0,0,2020-12-27 19:15:00
600,1327,Borja Valero,2003,[2008],West Bromwich Albion,15,13,2,1122,0,0,15,14,1,1179,0,0,30,27,3,2301,0,0,0.0,0.0,0.0,0,0,0,0,0,0,0,0,0,2020-12-27 19:15:00
601,5318,Bosingwa,2268,"[2008, 2009, 2010, 2011]",Chelsea FC,41,37,4,3204,1,0,47,41,6,3707,2,0,88,78,10,6911,3,0,0.0,0.0,0.0,1,2,3,0,0,0,0,0,0,2020-12-27 19:15:002020-12-27 19:15:002020-12-27 19:15:002020-12-27 19:15:00
602,1332,Bosingwa,2268,[2012],Queens Park Rangers,10,10,0,840,0,0,13,12,1,987,0,0,23,22,1,1827,0,0,0.0,0.0,0.0,0,0,0,0,0,0,0,0,0,2020-12-27 19:15:00
603,2667,Boudewijn Zenden,1336,"[2001, 2002]",Chelsea FC,24,16,8,1288,3,0,18,8,10,867,1,0,42,24,18,2155,4,0,0.0,0.0,0.0,2,0,2,0,0,0,0,0,0,2020-12-27 19:15:002020-12-27 19:15:00
604,2671,Boudewijn Zenden,1336,"[2003, 2004]",Middlesbrough FC,32,32,0,2760,3,0,34,34,0,2954,6,0,66,66,0,5714,9,0,1.0,6.0,7.0,2,5,7,0,0,0,0,0,0,2020-12-27 19:15:002020-12-27 19:15:00
605,2675,Boudewijn Zenden,1336,"[2005, 2006]",Liverpool FC,12,8,4,675,2,0,11,6,5,585,0,0,23,14,9,1260,2,0,0.0,0.0,0.0,1,0,1,0,0,0,0,0,0,2020-12-27 19:15:002020-12-27 19:15:00
606,2679,Boudewijn Zenden,1336,"[2009, 2010]",Sunderland AFC,23,3,20,579,1,0,24,8,16,1039,3,0,47,11,36,1618,4,0,0.0,0.0,0.0,0,2,2,0,0,0,0,0,0,2020-12-27 19:15:002020-12-27 19:15:00
607,1341,Boško Balaban,4344,[2001],Aston Villa,4,0,4,76,0,0,4,0,4,54,0,0,8,0,8,130,0,0,0.0,0.0,0.0,0,0,0,0,0,0,0,0,0,2020-12-27 19:15:00
608,9415,Brad Friedel,1343,"[2001, 2002, 2003, 2004, 2005, 2006, 2007]",Blackburn Rovers,129,129,0,11566,0,0,123,123,0,11070,1,0,252,252,0,22636,1,0,0.0,0.0,0.0,0,0,0,0,0,0,0,0,0,2020-12-27 19:15:002020-12-27 19:15:002020-12-27 19:15:002020-12-27 19:15:002020-12-27 19:15:002020-12-27 19:15:002020-12-27 19:15:00
609,4050,Brad Friedel,1343,"[2008, 2009, 2010]",Aston Villa,54,54,0,4860,0,0,52,52,0,4680,0,0,106,106,0,9540,0,0,0.0,0.0,0.0,0,0,0,0,0,0,0,0,0,2020-12-27 19:15:002020-12-27 19:15:002020-12-27 19:15:00
610,5414,Brad Friedel,1343,"[2011, 2012, 2013, 2014]",Tottenham Hotspur,25,25,0,2250,0,0,25,25,0,2250,0,0,50,50,0,4500,0,0,0.0,0.0,0.0,0,0,0,0,0,0,0,0,0,2020-12-27 19:15:002020-12-27 19:15:002020-12-27 19:15:002020-12-27 19:15:00
611,9513,Brad Guzan,1435,"[2008, 2010, 2011, 2012, 2013, 2014, 2015]",Aston Villa,71,70,1,6352,0,0,72,71,1,6415,0,0,143,141,2,12767,0,0,0.0,0.0,0.0,0,0,0,0,0,0,0,0,0,2020-12-27 19:15:002020-12-27 19:15:002020-12-27 19:15:002020-12-27 19:15:002020-12-27 19:15:002020-12-27 19:15:002020-12-27 19:15:00
612,1363,Brad Guzan,1435,[2016],Middlesbrough FC,5,5,0,450,0,0,5,5,0,450,0,0,10,10,0,900,0,0,0.0,0.0,0.0,0,0,0,0,0,0,0,0,0,2020-12-27 19:15:00
613,6830,Brad Jones,1431,"[2004, 2005, 2006, 2007, 2008]",Middlesbrough FC,17,17,0,1530,0,0,16,16,0,1440,0,0,33,33,0,2970,0,0,0.0,0.0,0.0,0,0,0,0,0,0,0,0,0,2020-12-27 19:15:002020-12-27 19:15:002020-12-27 19:15:002020-12-27 19:15:002020-12-27 19:15:00
614,6855,Brad Jones,1431,"[2010, 2011, 2012, 2013, 2014]",Liverpool FC,5,5,0,450,0,0,6,5,1,440,0,0,11,10,1,890,0,0,0.0,0.0,0.0,0,0,0,0,0,0,0,0,0,2020-12-27 19:15:002020-12-27 19:15:002020-12-27 19:15:002020-12-27 19:15:002020-12-27 19:15:00
615,2749,Brad Smith,2369,"[2013, 2015]",Liverpool FC,0,0,0,0,0,0,5,3,2,329,0,0,5,3,2,329,0,0,0.0,0.0,0.0,0,0,0,0,0,0,0,0,0,2020-12-27 19:15:002020-12-27 19:15:00
616,2753,Brad Smith,2369,"[2016, 2017]",AFC Bournemouth,2,1,1,69,0,0,3,2,1,202,0,0,5,3,2,271,0,0,0.0,0.0,0.0,0,0,0,0,0,0,0,0,0,2020-12-27 19:15:002020-12-27 19:15:00
617,5518,Bradley Johnson,1373,"[2011, 2012, 2013, 2015]",Norwich City,50,45,5,4015,3,0,51,46,5,3940,3,0,101,91,10,7955,6,0,3.0,0.0,3.0,2,1,3,0,0,0,0,0,0,2020-12-27 19:15:002020-12-27 19:15:002020-12-27 19:15:002020-12-27 19:15:00
618,1382,Bradley Orr,2169,[2011],Queens Park Rangers,1,0,1,83,0,0,5,2,3,245,0,0,6,2,4,328,0,0,0.0,0.0,0.0,0,0,0,0,0,0,0,0,0,2020-12-27 19:15:00
619,2767,Bradley Wright-Phillips,1811,"[2004, 2005]",Manchester City,17,2,15,402,1,0,14,0,14,176,1,0,31,2,29,578,2,0,0.0,0.0,0.0,0,0,0,0,0,0,0,0,0,2020-12-27 19:15:002020-12-27 19:15:00
620,1385,Brahim Díaz,1212,[2017],Manchester City,3,0,3,22,0,0,2,0,2,28,0,0,5,0,5,50,0,0,0.0,0.0,0.0,0,0,0,0,0,0,0,0,0,2020-12-27 19:15:00
621,1386,Brandon Austin,4149,[2019],Tottenham Hotspur,0,0,0,0,0,0,0,0,0,0,0,0,0,0,0,0,0,0,0.0,0.0,0.0,0,0,0,0,0,0,0,0,0,2020-12-27 19:15:00
622,1387,Brandon Barker,4439,[2015],Manchester City,0,0,0,0,0,0,0,0,0,0,0,0,0,0,0,0,0,0,0.0,0.0,0.0,0,0,0,0,0,0,0,0,0,2020-12-27 19:15:00
623,1388,Brandon Comley,2926,[2014],Queens Park Rangers,0,0,0,0,0,0,1,0,1,10,0,0,1,0,1,10,0,0,0.0,0.0,0.0,0,0,0,0,0,0,0,0,0,2020-12-27 19:15:00
624,1389,Brandon Mason,3928,[2016],Watford FC,2,1,1,112,0,0,0,0,0,0,0,0,2,1,1,112,0,0,0.0,0.0,0.0,0,0,0,0,0,0,0,0,0,2020-12-27 19:15:00
625,1390,Brandon Pierrick,2313,[2019],Crystal Palace,0,0,0,0,0,0,2,0,2,13,0,0,2,0,2,13,0,0,0.0,0.0,0.0,0,0,0,0,0,0,0,0,0,2020-12-27 19:15:00
626,2783,Brandon Williams,2991,"[2019, 2020]",Manchester United,8,6,2,512,0,0,10,5,5,500,1,0,18,11,7,1012,1,0,0.0,0.0,0.0,0,0,0,0,0,0,0,0,0,2020-12-27 19:15:002020-12-27 19:15:00
627,12573,Branislav Ivanović,1532,"[2008, 2009, 2010, 2011, 2012, 2013, 2014, 2015, 2016]",Chelsea FC,126,119,7,10644,10,0,133,119,14,10692,11,0,259,238,21,21336,21,0,6.0,12.0,18.0,7,7,14,0,0,0,0,0,0,2020-12-27 19:15:002020-12-27 19:15:002020-12-27 19:15:002020-12-27 19:15:002020-12-27 19:15:002020-12-27 19:15:002020-12-27 19:15:002020-12-27 19:15:002020-12-27 19:15:00
628,1402,Branislav Ivanović,1532,[2020],West Bromwich Albion,4,3,1,282,0,0,5,4,1,350,0,0,9,7,2,632,0,0,0.0,0.0,0.0,0,0,0,0,0,0,0,0,0,2020-12-27 19:15:00
629,2807,Branko Strupar,3451,"[2000, 2001]",Derby County,10,7,3,610,6,0,10,7,3,620,4,0,20,14,6,1230,10,0,0.0,1.0,1.0,1,3,4,1,0,1,0,0,0,2020-12-27 19:15:002020-12-27 19:15:00
630,9856,Brede Hangeland,1033,"[2007, 2008, 2009, 2010, 2011, 2012, 2013]",Fulham FC,106,106,0,9377,6,0,105,105,0,9335,2,0,211,211,0,18712,8,0,8.0,0.0,8.0,4,1,5,0,0,0,0,0,0,2020-12-27 19:15:002020-12-27 19:15:002020-12-27 19:15:002020-12-27 19:15:002020-12-27 19:15:002020-12-27 19:15:002020-12-27 19:15:00
631,2825,Brede Hangeland,1033,"[2014, 2015]",Crystal Palace,12,11,1,1038,0,0,9,8,1,764,2,0,21,19,2,1802,2,0,0.0,0.0,0.0,0,2,2,0,0,0,0,0,0,2020-12-27 19:15:002020-12-27 19:15:00
632,2829,Brek Shea,3641,"[2012, 2013]",Stoke City,1,0,1,23,0,0,2,0,2,97,0,0,3,0,3,120,0,0,0.0,0.0,0.0,0,0,0,0,0,0,0,0,0,2020-12-27 19:15:002020-12-27 19:15:00
633,2833,Brendan Galloway,3717,"[2014, 2015]",Everton FC,10,9,1,769,0,0,7,7,0,628,0,0,17,16,1,1397,0,0,0.0,0.0,0.0,0,0,0,0,0,0,0,0,0,2020-12-27 19:15:002020-12-27 19:15:00
634,1418,Brendan Galloway,3717,[2016],West Bromwich Albion,2,2,0,158,0,0,1,1,0,90,0,0,3,3,0,248,0,0,0.0,0.0,0.0,0,0,0,0,0,0,0,0,0,2020-12-27 19:15:00
635,12807,Brett Emerton,1141,"[2003, 2004, 2005, 2006, 2007, 2008, 2009, 2010, 2011]",Blackburn Rovers,123,99,24,9357,7,0,119,102,17,8900,6,0,242,201,41,18257,13,0,3.0,4.0,7.0,5,3,8,0,0,0,0,0,0,2020-12-27 19:15:002020-12-27 19:15:002020-12-27 19:15:002020-12-27 19:15:002020-12-27 19:15:002020-12-27 19:15:002020-12-27 19:15:002020-12-27 19:15:002020-12-27 19:15:00
636,1428,Brett Holman,1974,[2012],Aston Villa,13,8,5,704,0,0,13,7,6,641,1,0,26,15,11,1345,1,0,0.0,0.0,0.0,0,1,1,0,0,0,0,0,0,2020-12-27 19:15:00
637,5722,Brett Ormerod,2607,"[2001, 2002, 2003, 2004]",Southampton FC,43,25,18,2247,7,0,34,22,12,1840,4,0,77,47,30,4087,11,0,3.0,0.0,3.0,4,3,7,0,0,0,0,0,0,2020-12-27 19:15:002020-12-27 19:15:002020-12-27 19:15:002020-12-27 19:15:00
638,1433,Brett Ormerod,2607,[2010],Blackpool FC,7,2,5,269,1,0,12,4,8,438,0,0,19,6,13,707,1,0,0.0,0.0,0.0,0,0,0,0,0,0,0,0,0,2020-12-27 19:15:00
639,1434,Brian Deane,2072,[2000],Middlesbrough FC,13,5,8,642,1,0,10,7,3,707,1,0,23,12,11,1349,2,0,0.0,0.0,0.0,0,0,0,0,0,0,0,0,0,2020-12-27 19:15:00
640,2871,Brian Deane,2072,"[2001, 2003]",Leicester City,10,5,5,577,0,0,10,8,2,721,6,0,20,13,7,1298,6,0,0.0,0.0,0.0,0,2,2,0,0,0,0,0,0,2020-12-27 19:15:002020-12-27 19:15:00
641,1437,Brian Jensen,2545,[2009],Burnley FC,19,19,0,1635,0,0,19,19,0,1710,0,0,38,38,0,3345,0,0,0.0,0.0,0.0,0,0,0,0,0,0,0,0,0,2020-12-27 19:15:00
642,2877,Brian Kerr,3983,"[2000, 2002]",Newcastle United,4,1,3,89,0,0,5,3,2,221,0,0,9,4,5,310,0,0,0.0,0.0,0.0,0,0,0,0,0,0,0,0,0,2020-12-27 19:15:002020-12-27 19:15:00
643,1440,Brian McBride,1088,[2002],Everton FC,4,4,0,262,2,0,4,3,1,295,2,0,8,7,1,557,4,0,3.0,0.0,3.0,2,2,4,0,0,0,0,0,0,2020-12-27 19:15:00
644,7215,Brian McBride,1088,"[2003, 2004, 2005, 2006, 2007]",Fulham FC,69,52,17,4707,18,0,65,44,21,3913,14,0,134,96,38,8620,32,0,9.0,1.0,10.0,13,10,23,0,0,0,0,0,0,2020-12-27 19:15:002020-12-27 19:15:002020-12-27 19:15:002020-12-27 19:15:002020-12-27 19:15:00
645,4341,Brian Murphy,2168,"[2011, 2012, 2014]",Queens Park Rangers,0,0,0,0,0,0,0,0,0,0,0,0,0,0,0,0,0,0,0.0,0.0,0.0,0,0,0,0,0,0,0,0,0,2020-12-27 19:15:002020-12-27 19:15:002020-12-27 19:15:00
646,1449,Brian Murphy,2168,[2018],Cardiff City,0,0,0,0,0,0,0,0,0,0,0,0,0,0,0,0,0,0,0.0,0.0,0.0,0,0,0,0,0,0,0,0,0,2020-12-27 19:15:00
647,2901,Brian O'Neil,3450,"[2000, 2001]",Derby County,7,5,2,445,0,0,6,5,1,406,0,0,13,10,3,851,0,0,0.0,0.0,0.0,0,0,0,0,0,0,0,0,0,2020-12-27 19:15:002020-12-27 19:15:00
648,1452,Brian Priske,2964,[2005],Portsmouth FC,15,13,2,1241,0,0,15,13,2,1188,0,0,30,26,4,2429,0,0,0.0,0.0,0.0,0,0,0,0,0,0,0,0,0,2020-12-27 19:15:00
649,1453,Bright Enobakhare,4437,[2018],Wolverhampton Wanderers,0,0,0,0,0,0,0,0,0,0,0,0,0,0,0,0,0,0,0.0,0.0,0.0,0,0,0,0,0,0,0,0,0,2020-12-27 19:15:00
650,2909,Brown Ideye,2999,"[2014, 2015]",West Bromwich Albion,13,8,5,737,3,0,11,5,6,560,1,0,24,13,11,1297,4,0,3.0,1.0,4.0,2,1,3,0,0,0,0,0,0,2020-12-27 19:15:002020-12-27 19:15:00
651,2913,Bruno,2481,"[2017, 2018]",Brighton & Hove Albion,20,18,2,1607,0,0,19,19,0,1547,0,0,39,37,2,3154,0,0,0.0,0.0,0.0,0,0,0,0,0,0,0,0,0,2020-12-27 19:15:002020-12-27 19:15:00
652,1458,Bruno Andrade,3670,[2011],Queens Park Rangers,0,0,0,0,0,0,1,0,1,10,0,0,1,0,1,10,0,0,0.0,0.0,0.0,0,0,0,0,0,0,0,0,0,2020-12-27 19:15:00
653,1459,Bruno Berner,4085,[2006],Blackburn Rovers,0,0,0,0,0,0,1,1,0,90,0,0,1,1,0,90,0,0,0.0,0.0,0.0,0,0,0,0,0,0,0,0,0,2020-12-27 19:15:00
654,1460,Bruno Berner,4085,[2007],Arsenal FC,1,1,0,90,0,0,0,0,0,0,0,0,1,1,0,90,0,0,0.0,0.0,0.0,0,0,0,0,0,0,0,0,0,2020-12-27 19:15:00
655,2923,Bruno Cheyrou,2363,"[2002, 2003]",Liverpool FC,15,6,9,543,0,0,15,10,5,826,2,0,30,16,14,1369,2,0,0.0,3.0,3.0,0,2,2,0,0,0,0,0,0,2020-12-27 19:15:002020-12-27 19:15:00
656,2927,Bruno Fernandes,2988,"[2019, 2020]",Manchester United,14,14,0,1164,6,0,14,13,1,1155,12,0,28,27,1,2319,18,0,3.0,5.0,8.0,3,9,12,4,4,8,0,0,0,2020-12-27 19:15:002020-12-27 19:15:00
657,1465,Bruno Jordão,3348,[2019],Wolverhampton Wanderers,0,0,0,0,0,0,1,0,1,6,0,0,1,0,1,6,0,0,0.0,0.0,0.0,0,0,0,0,0,0,0,0,0,2020-12-27 19:15:00
658,2933,Bruno Martins Indi,3322,"[2016, 2017]",Stoke City,25,23,2,2061,0,0,26,25,1,2240,1,0,51,48,3,4301,1,0,0.0,0.0,0.0,0,1,1,0,0,0,0,0,0,2020-12-27 19:15:002020-12-27 19:15:00
659,7350,Bruno N'Gotty,3076,"[2001, 2002, 2003, 2004, 2005]",Bolton Wanderers,74,71,3,6353,3,0,72,70,2,6244,2,0,146,141,5,12597,5,0,0.0,0.0,0.0,2,1,3,0,0,0,0,0,0,2020-12-27 19:15:002020-12-27 19:15:002020-12-27 19:15:002020-12-27 19:15:002020-12-27 19:15:00
660,1473,Bruno Perone,3667,[2011],Queens Park Rangers,0,0,0,0,0,0,1,1,0,90,0,0,1,1,0,90,0,0,0.0,0.0,0.0,0,0,0,0,0,0,0,0,0,2020-12-27 19:15:00
661,1474,Bruno Ribeiro,4145,[2011],Blackburn Rovers,0,0,0,0,0,0,0,0,0,0,0,0,0,0,0,0,0,0,0.0,0.0,0.0,0,0,0,0,0,0,0,0,0,2020-12-27 19:15:00
662,1475,Bruno Écuélé,3144,[2018],Cardiff City,19,19,0,1710,0,0,19,18,1,1665,0,0,38,37,1,3375,0,0,0.0,0.0,0.0,0,0,0,0,0,0,0,0,0,2020-12-27 19:15:00
663,2953,Bryan Hughes,1957,"[2002, 2003]",Birmingham City,25,12,13,1246,5,0,23,15,8,1375,0,0,48,27,21,2621,5,0,0.0,0.0,0.0,4,0,4,0,0,0,0,0,0,2020-12-27 19:15:002020-12-27 19:15:00
664,4437,Bryan Hughes,1957,"[2004, 2005, 2006]",Charlton Athletic,36,21,15,2031,4,0,37,25,12,2253,1,0,73,46,27,4284,5,0,3.0,0.0,3.0,4,0,4,0,0,0,0,0,0,2020-12-27 19:15:002020-12-27 19:15:002020-12-27 19:15:00
665,1481,Bryan Hughes,1957,[2008],Hull City,2,0,2,23,0,0,4,1,3,105,0,0,6,1,5,128,0,0,0.0,0.0,0.0,0,0,0,0,0,0,0,0,0,2020-12-27 19:15:00
666,5934,Bryan Oviedo,2240,"[2012, 2013, 2014, 2015]",Everton FC,21,12,9,1117,1,0,23,11,12,1143,1,0,44,23,21,2260,2,0,0.0,3.0,3.0,0,1,1,0,0,0,0,0,0,2020-12-27 19:15:002020-12-27 19:15:002020-12-27 19:15:002020-12-27 19:15:00
667,1486,Bryan Oviedo,2240,[2016],Sunderland AFC,4,4,0,309,0,0,6,6,0,540,0,0,10,10,0,849,0,0,0.0,0.0,0.0,0,0,0,0,0,0,0,0,0,2020-12-27 19:15:00
668,4464,Bryan Ruiz,3265,"[2011, 2012, 2013]",Fulham FC,35,28,7,2453,6,0,33,23,10,2245,1,0,68,51,17,4698,7,0,0.0,0.0,0.0,2,1,3,0,0,0,0,0,0,2020-12-27 19:15:002020-12-27 19:15:002020-12-27 19:15:00
669,4473,Brynjar Gunnarsson,1988,"[2006, 2007, 2012]",Reading FC,22,13,9,1260,2,0,19,13,6,1290,1,0,41,26,15,2550,3,0,0.0,1.0,1.0,2,1,3,0,0,0,0,0,0,2020-12-27 19:15:002020-12-27 19:15:002020-12-27 19:15:00
670,4482,Bukayo Saka,1479,"[2018, 2019, 2020]",Arsenal FC,22,16,6,1532,2,0,18,15,3,1314,1,0,40,31,9,2846,3,0,0.0,0.0,0.0,1,1,2,0,0,0,0,1,1,2020-12-27 19:15:002020-12-27 19:15:002020-12-27 19:15:00
671,1496,Bülent Akin,4162,[2002],Bolton Wanderers,0,0,0,0,0,0,1,0,1,5,0,0,1,0,1,5,0,0,0.0,0.0,0.0,0,0,0,0,0,0,0,0,0,2020-12-27 19:15:00
672,2995,Cabral,3861,"[2013, 2014]",Sunderland AFC,1,1,0,90,0,0,0,0,0,0,0,0,1,1,0,90,0,0,0.0,0.0,0.0,0,0,0,0,0,0,0,0,0,2020-12-27 19:15:002020-12-27 19:15:00
673,1499,Cala,3661,[2013],Cardiff City,3,3,0,270,0,0,4,4,0,360,2,0,7,7,0,630,2,0,0.0,3.0,3.0,0,2,2,0,0,0,0,0,0,2020-12-27 19:15:00
674,3001,Caleb Folan,2613,"[2006, 2007]",Wigan Athletic,7,4,3,332,0,0,8,5,3,436,2,0,15,9,6,768,2,0,0.0,4.0,4.0,0,2,2,0,0,0,0,0,0,2020-12-27 19:15:002020-12-27 19:15:00
675,3005,Caleb Folan,2613,"[2008, 2009]",Hull City,11,5,6,527,1,0,12,4,8,461,2,0,23,9,14,988,3,0,3.0,0.0,3.0,1,2,3,0,0,0,0,0,0,2020-12-27 19:15:002020-12-27 19:15:00
676,1504,Callum Connolly,4076,[2015],Everton FC,1,0,1,36,0,0,0,0,0,0,0,0,1,0,1,36,0,0,0.0,0.0,0.0,0,0,0,0,0,0,0,0,0,2020-12-27 19:15:00
677,4518,Callum Davidson,1306,"[2000, 2001, 2003]",Leicester City,35,31,4,2631,0,0,35,30,5,2592,1,0,70,61,9,5223,1,0,0.0,0.0,0.0,0,1,1,0,0,0,0,0,0,2020-12-27 19:15:002020-12-27 19:15:002020-12-27 19:15:00
678,6038,Callum Hudson-Odoi,1855,"[2017, 2018, 2019, 2020]",Chelsea FC,21,8,13,834,1,0,19,4,15,652,1,0,40,12,28,1486,2,0,0.0,0.0,0.0,0,0,0,0,0,0,0,0,0,2020-12-27 19:15:002020-12-27 19:15:002020-12-27 19:15:002020-12-27 19:15:00
679,6054,Callum McManaman,3001,"[2008, 2010, 2011, 2012]",Wigan Athletic,16,4,12,376,1,0,10,4,6,305,1,0,26,8,18,681,2,0,0.0,3.0,3.0,1,1,2,0,0,0,0,0,0,2020-12-27 19:15:002020-12-27 19:15:002020-12-27 19:15:002020-12-27 19:15:00
680,3033,Callum McManaman,3001,"[2014, 2015]",West Bromwich Albion,11,5,6,393,0,0,9,2,7,229,0,0,20,7,13,622,0,0,0.0,0.0,0.0,0,0,0,0,0,0,0,0,0,2020-12-27 19:15:002020-12-27 19:15:00
681,1518,Callum Paterson,3148,[2018],Cardiff City,14,11,3,1024,3,0,13,10,3,972,1,0,27,21,6,1996,4,0,3.0,0.0,3.0,3,0,3,0,0,0,0,0,0,2020-12-27 19:15:00
682,1519,Callum Roberts,4211,[2018],Newcastle United,0,0,0,0,0,0,0,0,0,0,0,0,0,0,0,0,0,0,0.0,0.0,0.0,0,0,0,0,0,0,0,0,0,2020-12-27 19:15:00
683,3041,Callum Robinson,3472,"[2013, 2014]",Aston Villa,1,0,1,5,0,0,3,0,3,41,0,0,4,0,4,46,0,0,0.0,0.0,0.0,0,0,0,0,0,0,0,0,0,2020-12-27 19:15:002020-12-27 19:15:00
684,1522,Callum Robinson,3472,[2019],Sheffield United,6,3,3,195,0,0,10,6,4,481,1,0,16,9,7,676,1,0,0.0,0.0,0.0,0,0,0,0,0,0,0,0,0,2020-12-27 19:15:00
685,1523,Callum Robinson,3472,[2020],West Bromwich Albion,7,4,3,310,2,0,7,4,3,358,0,0,14,8,6,668,2,0,0.0,0.0,0.0,1,0,1,0,0,0,0,0,0,2020-12-27 19:15:00
686,1524,Callum Slattery,4156,[2018],Southampton FC,1,0,1,6,0,0,2,1,1,104,0,0,3,1,2,110,0,0,0.0,0.0,0.0,0,0,0,0,0,0,0,0,0,2020-12-27 19:15:00
687,1525,Callum Williams,4200,[2015],Newcastle United,0,0,0,0,0,0,0,0,0,0,0,0,0,0,0,0,0,0,0.0,0.0,0.0,0,0,0,0,0,0,0,0,0,2020-12-27 19:15:00
688,3053,Callum Willock,4490,"[2001, 2002]",Fulham FC,1,0,1,38,0,0,2,0,2,21,0,0,3,0,3,59,0,0,0.0,0.0,0.0,0,0,0,0,0,0,0,0,0,2020-12-27 19:15:002020-12-27 19:15:00
689,7650,Callum Wilson,1039,"[2015, 2016, 2017, 2018, 2019]",AFC Bournemouth,64,56,8,5027,20,0,62,53,9,4546,21,0,126,109,17,9573,41,0,4.0,5.0,9.0,12,15,27,2,3,5,0,0,0,2020-12-27 19:15:002020-12-27 19:15:002020-12-27 19:15:002020-12-27 19:15:002020-12-27 19:15:00
690,1533,Callum Wilson,1039,[2020],Newcastle United,6,6,0,537,5,0,6,6,0,523,3,0,12,12,0,1060,8,0,1.0,1.0,2.0,3,3,6,3,1,4,0,0,0,2020-12-27 19:15:00
691,3069,Calum Chambers,1470,"[2012, 2013]",Southampton FC,11,8,3,731,0,0,11,10,1,912,0,0,22,18,4,1643,0,0,0.0,0.0,0.0,0,0,0,0,0,0,0,0,0,2020-12-27 19:15:002020-12-27 19:15:00
692,6153,Calum Chambers,1470,"[2014, 2015, 2017, 2019]",Arsenal FC,28,18,10,1631,2,0,33,24,9,2237,0,0,61,42,19,3868,2,0,0.0,0.0,0.0,1,0,1,0,0,0,0,0,0,2020-12-27 19:15:002020-12-27 19:15:002020-12-27 19:15:002020-12-27 19:15:00
693,1538,Calum Chambers,1470,[2016],Middlesbrough FC,13,13,0,1170,1,0,11,11,0,990,0,0,24,24,0,2160,1,0,0.0,0.0,0.0,1,0,1,0,0,0,0,0,0,2020-12-27 19:15:00
694,1540,Calum Chambers,1470,[2018],Fulham FC,17,16,1,1458,2,0,14,13,1,1129,0,0,31,29,2,2587,2,0,0.0,0.0,0.0,1,0,1,0,0,0,0,0,0,2020-12-27 19:15:00
695,1542,Calum Davenport,1394,[2000],Coventry City,1,0,1,45,0,0,0,0,0,0,0,0,1,0,1,45,0,0,0.0,0.0,0.0,0,0,0,0,0,0,0,0,0,2020-12-27 19:15:00
696,4632,Calum Davenport,1394,"[2004, 2005, 2006]",Tottenham Hotspur,8,5,3,461,0,0,7,4,3,378,1,0,15,9,6,839,1,0,0.0,0.0,0.0,0,1,1,0,0,0,0,0,0,2020-12-27 19:15:002020-12-27 19:15:002020-12-27 19:15:00
697,1546,Calum Davenport,1394,[2008],Sunderland AFC,4,4,0,343,0,0,4,3,1,344,0,0,8,7,1,687,0,0,0.0,0.0,0.0,0,0,0,0,0,0,0,0,0,2020-12-27 19:15:00
698,1547,Cameron Borthwick-Jackson,2188,[2015],Manchester United,5,3,2,300,0,0,5,3,2,392,0,0,10,6,4,692,0,0,0.0,0.0,0.0,0,0,0,0,0,0,0,0,0,2020-12-27 19:15:00
699,3097,Cameron Brannagan,3250,"[2014, 2015]",Liverpool FC,1,0,1,12,0,0,2,1,1,100,0,0,3,1,2,112,0,0,0.0,0.0,0.0,0,0,0,0,0,0,0,0,0,2020-12-27 19:15:002020-12-27 19:15:00
700,3101,Cameron Carter-Vickers,3747,"[2016, 2017]",Tottenham Hotspur,0,0,0,0,0,0,0,0,0,0,0,0,0,0,0,0,0,0,0.0,0.0,0.0,0,0,0,0,0,0,0,0,0,2020-12-27 19:15:002020-12-27 19:15:00
701,1552,Cameron Dummigan,4298,[2014],Burnley FC,0,0,0,0,0,0,0,0,0,0,0,0,0,0,0,0,0,0,0.0,0.0,0.0,0,0,0,0,0,0,0,0,0,2020-12-27 19:15:00
702,1553,Cameron Humphreys,2758,[2015],Manchester City,0,0,0,0,0,0,0,0,0,0,0,0,0,0,0,0,0,0,0.0,0.0,0.0,0,0,0,0,0,0,0,0,0,2020-12-27 19:15:00
703,4665,Cameron Jerome,1783,"[2007, 2009, 2010]",Birmingham City,46,38,8,3442,7,0,53,45,8,3883,13,0,99,83,16,7325,20,0,0.0,6.0,6.0,3,9,12,0,0,0,0,0,0,2020-12-27 19:15:002020-12-27 19:15:002020-12-27 19:15:00
704,3115,Cameron Jerome,1783,"[2011, 2012]",Stoke City,24,5,19,747,6,0,25,10,15,1197,1,0,49,15,34,1944,7,0,5.0,0.0,5.0,5,1,6,0,0,0,0,0,0,2020-12-27 19:15:002020-12-27 19:15:00
705,1559,Cameron Jerome,1783,[2013],Crystal Palace,12,9,3,784,1,0,16,11,5,973,1,0,28,20,8,1757,2,0,0.0,0.0,0.0,1,0,1,0,0,0,0,0,0,2020-12-27 19:15:00
706,1560,Cameron Jerome,1783,[2015],Norwich City,18,8,10,795,1,0,16,11,5,980,2,0,34,19,15,1775,3,0,0.0,0.0,0.0,1,2,3,0,0,0,0,0,0,2020-12-27 19:15:00
707,1561,Cameron John,4581,[2018],Wolverhampton Wanderers,0,0,0,0,0,0,0,0,0,0,0,0,0,0,0,0,0,0,0.0,0.0,0.0,0,0,0,0,0,0,0,0,0,2020-12-27 19:15:00
708,1562,Cameron Lancaster,4300,[2011],Tottenham Hotspur,1,0,1,12,0,0,0,0,0,0,0,0,1,0,1,12,0,0,0.0,0.0,0.0,0,0,0,0,0,0,0,0,0,2020-12-27 19:15:00
709,1563,Campabadal,4276,[2012],Wigan Athletic,1,0,1,2,0,0,0,0,0,0,0,0,1,0,1,2,0,0,0.0,0.0,0.0,0,0,0,0,0,0,0,0,0,2020-12-27 19:15:00
710,1564,Campaña,3131,[2013],Crystal Palace,3,2,1,144,0,0,3,2,1,166,0,0,6,4,2,310,0,0,0.0,0.0,0.0,0,0,0,0,0,0,0,0,0,2020-12-27 19:15:00
711,3131,Caoimhin Kelleher,4310,"[2019, 2020]",Liverpool FC,1,1,0,90,0,0,0,0,0,0,0,0,1,1,0,90,0,0,0.0,0.0,0.0,0,0,0,0,0,0,0,0,0,2020-12-27 19:15:002020-12-27 19:15:00
712,4704,Carl Cort,2162,"[2000, 2001, 2002]",Newcastle United,13,11,2,895,6,0,8,7,1,568,1,0,21,18,3,1463,7,0,3.0,0.0,3.0,4,0,4,0,0,0,0,0,0,2020-12-27 19:15:002020-12-27 19:15:002020-12-27 19:15:00
713,1570,Carl Cort,2162,[2003],Wolverhampton Wanderers,8,7,1,635,3,0,8,6,2,519,2,0,16,13,3,1154,5,0,3.0,1.0,4.0,2,1,3,0,0,0,0,0,0,2020-12-27 19:15:00
714,1571,Carl Dickinson,4009,[2008],Stoke City,1,1,0,90,0,0,4,2,2,175,0,0,5,3,2,265,0,0,0.0,0.0,0.0,0,0,0,0,0,0,0,0,0,2020-12-27 19:15:00
715,1572,Carl Fletcher,1940,[2005],West Ham United,7,4,3,372,1,0,4,1,3,206,0,0,11,5,6,578,1,0,0.0,0.0,0.0,1,0,1,0,0,0,0,0,0,2020-12-27 19:15:00
716,1573,Carl Hoefkens,3325,[2008],West Bromwich Albion,6,4,2,422,0,0,4,2,2,237,0,0,10,6,4,659,0,0,0.0,0.0,0.0,0,0,0,0,0,0,0,0,0,2020-12-27 19:15:00
717,1574,Carl Ikeme,4199,[2011],Wolverhampton Wanderers,0,0,0,0,0,0,1,0,1,39,0,0,1,0,1,39,0,0,0.0,0.0,0.0,0,0,0,0,0,0,0,0,0,2020-12-27 19:15:00
718,7889,Carl Jenkinson,2752,"[2011, 2012, 2013, 2016, 2018]",Arsenal FC,19,13,6,1271,0,0,21,15,6,1410,1,0,40,28,12,2681,1,0,0.0,0.0,0.0,0,0,0,0,0,0,0,0,0,2020-12-27 19:15:002020-12-27 19:15:002020-12-27 19:15:002020-12-27 19:15:002020-12-27 19:15:00
719,3157,Carl Jenkinson,2752,"[2014, 2015]",West Ham United,26,23,3,2063,0,0,26,19,7,1840,2,0,52,42,10,3903,2,0,0.0,0.0,0.0,0,1,1,0,0,0,0,0,0,2020-12-27 19:15:002020-12-27 19:15:00
720,1582,Carl Robinson,3220,[2003],Chelsea FC,1,0,1,5,0,0,0,0,0,0,0,0,1,0,1,5,0,0,0.0,0.0,0.0,0,0,0,0,0,0,0,0,0,2020-12-27 19:15:00
721,1583,Carl Robinson,3220,[2005],Sunderland AFC,3,1,2,105,0,0,2,2,0,171,0,0,5,3,2,276,0,0,0.0,0.0,0.0,0,0,0,0,0,0,0,0,0,2020-12-27 19:15:00
722,3169,Carl Stewart,4314,"[2016, 2017]",Watford FC,0,0,0,0,0,0,0,0,0,0,0,0,0,0,0,0,0,0,0.0,0.0,0.0,0,0,0,0,0,0,0,0,0,2020-12-27 19:15:002020-12-27 19:15:00
723,1586,Carl Tiler,3548,[2000],Charlton Athletic,2,2,0,180,0,0,5,5,0,443,0,0,7,7,0,623,0,0,0.0,0.0,0.0,0,0,0,0,0,0,0,0,0,2020-12-27 19:15:00
724,3175,Carles Gil,1872,"[2014, 2015]",Aston Villa,17,11,6,999,0,0,11,10,1,800,2,0,28,21,7,1799,2,0,0.0,0.0,0.0,0,1,1,0,0,0,0,0,0,2020-12-27 19:15:002020-12-27 19:15:00
725,14337,Carlo Cudicini,2370,"[2000, 2001, 2002, 2003, 2004, 2005, 2006, 2007, 2008]",Chelsea FC,71,69,2,6291,0,0,68,66,2,6035,0,0,139,135,4,12326,0,0,0.0,0.0,0.0,0,0,0,0,0,0,0,0,0,2020-12-27 19:15:002020-12-27 19:15:002020-12-27 19:15:002020-12-27 19:15:002020-12-27 19:15:002020-12-27 19:15:002020-12-27 19:15:002020-12-27 19:15:002020-12-27 19:15:00
726,6398,Carlo Cudicini,2370,"[2009, 2010, 2011, 2012]",Tottenham Hotspur,6,6,0,540,0,0,9,8,1,794,0,0,15,14,1,1334,0,0,0.0,0.0,0.0,0,0,0,0,0,0,0,0,0,2020-12-27 19:15:002020-12-27 19:15:002020-12-27 19:15:002020-12-27 19:15:00
727,3205,Carlo Nash,3303,"[2000, 2002]",Manchester City,6,6,0,540,0,0,9,9,0,810,0,0,15,15,0,1350,0,0,0.0,0.0,0.0,0,0,0,0,0,0,0,0,0,2020-12-27 19:15:002020-12-27 19:15:00
728,3209,Carlo Nash,3303,"[2003, 2004]",Middlesbrough FC,1,1,0,90,0,0,2,2,0,180,0,0,3,3,0,270,0,0,0.0,0.0,0.0,0,0,0,0,0,0,0,0,0,2020-12-27 19:15:002020-12-27 19:15:00
729,1606,Carlo Nash,3303,[2010],Stoke City,0,0,0,0,0,0,0,0,0,0,0,0,0,0,0,0,0,0,0.0,0.0,0.0,0,0,0,0,0,0,0,0,0,2020-12-27 19:15:00
730,1607,Carlo Nash,3303,[2013],Norwich City,0,0,0,0,0,0,0,0,0,0,0,0,0,0,0,0,0,0,0.0,0.0,0.0,0,0,0,0,0,0,0,0,0,2020-12-27 19:15:00
731,8050,Carlos Bocanegra,1081,"[2003, 2004, 2005, 2006, 2007]",Fulham FC,55,49,6,4537,3,0,56,51,5,4503,5,0,111,100,11,9040,8,0,4.0,4.0,8.0,2,4,6,0,0,0,0,0,0,2020-12-27 19:15:002020-12-27 19:15:002020-12-27 19:15:002020-12-27 19:15:002020-12-27 19:15:00
732,6458,Carlos Cuéllar,1401,"[2008, 2009, 2010, 2011]",Aston Villa,47,42,5,3853,2,0,42,40,2,3454,0,0,89,82,7,7307,2,0,0.0,0.0,0.0,1,0,1,0,0,0,0,0,0,2020-12-27 19:15:002020-12-27 19:15:002020-12-27 19:15:002020-12-27 19:15:00
733,3235,Carlos Cuéllar,1401,"[2012, 2013]",Sunderland AFC,15,15,0,1287,0,0,15,15,0,1314,1,0,30,30,0,2601,1,0,0.0,0.0,0.0,0,1,1,0,0,0,0,0,0,2020-12-27 19:15:002020-12-27 19:15:00
734,3239,Carlos Edwards,1217,"[2007, 2008]",Sunderland AFC,19,9,10,907,0,0,16,8,8,723,0,0,35,17,18,1630,0,0,0.0,0.0,0.0,0,0,0,0,0,0,0,0,0,2020-12-27 19:15:002020-12-27 19:15:00
735,6490,Carlos Marinelli,2698,"[2000, 2001, 2002, 2003]",Middlesbrough FC,20,10,10,991,2,0,21,8,13,874,1,0,41,18,23,1865,3,0,0.0,0.0,0.0,0,1,1,0,0,0,0,0,0,2020-12-27 19:15:002020-12-27 19:15:002020-12-27 19:15:002020-12-27 19:15:00
736,1625,Carlos Salcido,2650,[2010],Fulham FC,13,13,0,1065,0,0,10,9,1,838,0,0,23,22,1,1903,0,0,0.0,0.0,0.0,0,0,0,0,0,0,0,0,0,2020-12-27 19:15:00
737,3253,Carlos Sánchez,1867,"[2014, 2015]",Aston Villa,25,19,6,1732,0,0,23,17,6,1624,1,0,48,36,12,3356,1,0,0.0,0.0,0.0,0,1,1,0,0,0,0,0,0,2020-12-27 19:15:002020-12-27 19:15:00
738,3257,Carlos Sánchez,1867,"[2018, 2019]",West Ham United,7,2,5,213,0,0,6,1,5,140,0,0,13,3,10,353,0,0,0.0,0.0,0.0,0,0,0,0,0,0,0,0,0,2020-12-27 19:15:002020-12-27 19:15:00
739,1630,Carlos Tévez,1417,[2006],West Ham United,14,10,4,871,5,0,12,9,3,827,2,0,26,19,7,1698,7,0,0.0,3.0,3.0,2,2,4,0,1,1,0,0,0,2020-12-27 19:15:00
740,3263,Carlos Tévez,1417,"[2007, 2008]",Manchester United,32,24,8,2329,12,0,31,25,6,2212,7,0,63,49,14,4541,19,0,3.0,8.0,11.0,3,6,9,0,0,0,0,0,0,2020-12-27 19:15:002020-12-27 19:15:00
741,6538,Carlos Tévez,1417,"[2009, 2010, 2011, 2012]",Manchester City,58,51,7,4437,38,0,54,45,9,3880,21,0,112,96,16,8317,59,0,16.0,5.0,21.0,18,12,30,11,1,12,0,0,0,2020-12-27 19:15:002020-12-27 19:15:002020-12-27 19:15:002020-12-27 19:15:00
742,4914,Carlos Vela,3285,"[2008, 2009, 2010]",Arsenal FC,20,1,19,472,2,0,9,2,7,234,1,0,29,3,26,706,3,0,0.0,0.0,0.0,0,0,0,0,0,0,0,0,0,2020-12-27 19:15:002020-12-27 19:15:002020-12-27 19:15:00
743,1640,Carlos Villanueva,3545,[2008],Blackburn Rovers,5,2,3,242,0,0,7,3,4,313,0,0,12,5,7,555,0,0,0.0,0.0,0.0,0,0,0,0,0,0,0,0,0,2020-12-27 19:15:00
744,1641,Carlos Vinícius,1036,[2020],Tottenham Hotspur,0,0,0,0,0,0,1,0,1,11,0,0,1,0,1,11,0,0,0.0,0.0,0.0,0,0,0,0,0,0,0,0,0,2020-12-27 19:15:00
745,4931,Carlton Cole,2326,"[2001, 2002, 2005]",Chelsea FC,13,2,11,348,1,0,12,2,10,441,3,0,25,4,21,789,4,0,3.0,3.0,6.0,1,3,4,0,0,0,0,0,0,2020-12-27 19:15:002020-12-27 19:15:002020-12-27 19:15:00
746,1644,Carlton Cole,2326,[2003],Charlton Athletic,12,4,8,526,3,0,9,4,5,452,1,0,21,8,13,978,4,0,0.0,3.0,3.0,2,1,3,0,0,0,0,0,0,2020-12-27 19:15:00
747,1645,Carlton Cole,2326,[2004],Aston Villa,12,8,4,643,2,0,14,9,5,780,1,0,26,17,9,1423,3,0,0.0,0.0,0.0,1,0,1,0,0,0,0,0,0,2020-12-27 19:15:00
748,13204,Carlton Cole,2326,"[2006, 2007, 2008, 2009, 2010, 2012, 2013, 2014]",West Ham United,103,65,38,6000,24,0,111,64,47,6139,16,0,214,129,85,12139,40,0,3.0,3.0,6.0,13,9,22,1,0,1,0,0,0,2020-12-27 19:15:002020-12-27 19:15:002020-12-27 19:15:002020-12-27 19:15:002020-12-27 19:15:002020-12-27 19:15:002020-12-27 19:15:002020-12-27 19:15:00
749,1655,Carlton Palmer,3781,[2000],Coventry City,8,5,3,542,0,0,7,7,0,630,0,0,15,12,3,1172,0,0,0.0,0.0,0.0,0,0,0,0,0,0,0,0,0,2020-12-27 19:15:00
750,1656,Cauley Woodrow,3353,[2013],Fulham FC,3,2,1,206,1,0,3,3,0,205,0,0,6,5,1,411,1,0,0.0,0.0,0.0,1,0,1,0,0,0,0,0,0,2020-12-27 19:15:00
751,3315,Caçapa,3543,"[2007, 2008]",Newcastle United,13,10,3,827,1,0,12,10,2,966,0,0,25,20,5,1793,1,0,0.0,0.0,0.0,0,0,0,0,0,0,0,0,0,2020-12-27 19:15:002020-12-27 19:15:00
752,1659,Cañas,2938,[2013],Swansea City,10,7,3,680,0,0,13,12,1,988,0,0,23,19,4,1668,0,0,0.0,0.0,0.0,0,0,0,0,0,0,0,0,0,2020-12-27 19:15:00
753,1660,Cedric Avinel,3701,[2006],Watford FC,0,0,0,0,0,0,1,1,0,46,0,0,1,1,0,46,0,0,0.0,0.0,0.0,0,0,0,0,0,0,0,0,0,2020-12-27 19:15:00
754,6650,Celestine Babayaro,2015,"[2000, 2001, 2002, 2003]",Chelsea FC,34,30,4,2666,1,0,31,26,5,2295,1,0,65,56,9,4961,2,0,3.0,0.0,3.0,1,0,1,0,0,0,0,0,0,2020-12-27 19:15:002020-12-27 19:15:002020-12-27 19:15:002020-12-27 19:15:00
755,4998,Celestine Babayaro,2015,"[2004, 2005, 2006]",Newcastle United,24,23,1,2110,0,0,22,21,1,1851,0,0,46,44,2,3961,0,0,0.0,0.0,0.0,0,0,0,0,0,0,0,0,0,2020-12-27 19:15:002020-12-27 19:15:002020-12-27 19:15:00
756,1668,Cengiz Ünder,1038,[2020],Leicester City,3,1,2,141,0,0,3,0,3,62,0,0,6,1,5,203,0,0,0.0,0.0,0.0,0,0,0,0,0,0,0,0,0,2020-12-27 19:15:00
757,6682,Cenk Tosun,1463,"[2017, 2018, 2019, 2020]",Everton FC,25,12,13,1276,4,0,23,12,11,1098,5,0,48,24,24,2374,9,0,1.0,3.0,4.0,1,5,6,0,0,0,0,0,0,2020-12-27 19:15:002020-12-27 19:15:002020-12-27 19:15:002020-12-27 19:15:00
758,11732,Cesc Fàbregas,1526,"[2004, 2005, 2006, 2007, 2008, 2009, 2010]",Arsenal FC,108,97,11,8474,22,0,99,88,11,7875,13,0,207,185,22,16349,35,0,6.0,2.0,8.0,9,7,16,2,1,3,0,0,0,2020-12-27 19:15:002020-12-27 19:15:002020-12-27 19:15:002020-12-27 19:15:002020-12-27 19:15:002020-12-27 19:15:002020-12-27 19:15:00
759,8410,Cesc Fàbregas,1526,"[2014, 2015, 2016, 2017, 2018]",Chelsea FC,70,56,14,5063,9,0,68,49,19,4608,6,0,138,105,33,9671,15,0,4.0,9.0,13.0,8,4,12,2,0,2,0,0,0,2020-12-27 19:15:002020-12-27 19:15:002020-12-27 19:15:002020-12-27 19:15:002020-12-27 19:15:00
760,3371,Chancel Mbemba,2279,"[2015, 2017]",Newcastle United,21,20,1,1843,0,0,21,20,1,1753,0,0,42,40,2,3596,0,0,0.0,0.0,0.0,0,0,0,0,0,0,0,0,0,2020-12-27 19:15:002020-12-27 19:15:00
761,3375,Charis Mavrias,4112,"[2013, 2014]",Sunderland AFC,2,1,1,76,0,0,2,0,2,73,0,0,4,1,3,149,0,0,0.0,0.0,0.0,0,0,0,0,0,0,0,0,0,2020-12-27 19:15:002020-12-27 19:15:00
762,1689,Charles Banya,4209,[2012],Fulham FC,0,0,0,0,0,0,0,0,0,0,0,0,0,0,0,0,0,0,0.0,0.0,0.0,0,0,0,0,0,0,0,0,0,2020-12-27 19:15:00
763,6766,Charles N'Zogbia,2016,"[2004, 2005, 2006, 2007]",Newcastle United,48,37,11,3382,3,0,50,34,16,3170,5,0,98,71,27,6552,8,0,1.0,3.0,4.0,2,3,5,0,0,0,0,0,0,2020-12-27 19:15:002020-12-27 19:15:002020-12-27 19:15:002020-12-27 19:15:00
764,5085,Charles N'Zogbia,2016,"[2008, 2009, 2010]",Wigan Athletic,39,38,1,3294,6,0,43,41,2,3550,9,0,82,79,3,6844,15,0,6.0,3.0,9.0,5,4,9,0,0,0,0,0,0,2020-12-27 19:15:002020-12-27 19:15:002020-12-27 19:15:00
765,6794,Charles N'Zogbia,2016,"[2011, 2012, 2014, 2015]",Aston Villa,42,31,11,2612,3,0,38,23,15,1937,1,0,80,54,26,4549,4,0,1.0,0.0,1.0,2,1,3,0,0,0,0,0,0,2020-12-27 19:15:002020-12-27 19:15:002020-12-27 19:15:002020-12-27 19:15:00
766,1701,Charlie Adam,1554,[2010],Blackpool FC,18,18,0,1618,5,0,17,16,1,1434,7,0,35,34,1,3052,12,0,3.0,0.0,3.0,3,6,9,3,4,7,0,0,0,2020-12-27 19:15:00
767,3405,Charlie Adam,1554,"[2011, 2012]",Liverpool FC,13,13,0,1118,1,0,15,14,1,1120,1,0,28,27,1,2238,2,0,0.0,0.0,0.0,0,1,1,0,1,1,0,0,0,2020-12-27 19:15:002020-12-27 19:15:00
768,8530,Charlie Adam,1554,"[2013, 2014, 2015, 2016, 2017]",Stoke City,66,38,28,3508,11,0,51,31,20,2827,6,0,117,69,48,6335,17,0,7.0,4.0,11.0,10,6,16,1,2,3,0,0,0,2020-12-27 19:15:002020-12-27 19:15:002020-12-27 19:15:002020-12-27 19:15:002020-12-27 19:15:00
769,1709,Charlie Austin,1245,[2014],Queens Park Rangers,19,19,0,1689,10,0,16,16,0,1394,8,0,35,35,0,3083,18,0,9.0,0.0,9.0,6,5,11,1,2,3,0,0,0,2020-12-27 19:15:00
770,6846,Charlie Austin,1245,"[2015, 2016, 2017, 2018]",Southampton FC,38,18,20,1645,10,0,33,16,17,1511,6,0,71,34,37,3156,16,0,12.0,4.0,16.0,8,5,13,2,1,3,0,0,0,2020-12-27 19:15:002020-12-27 19:15:002020-12-27 19:15:002020-12-27 19:15:00
771,1714,Charlie Austin,1245,[2020],West Bromwich Albion,1,0,1,13,0,0,3,0,3,76,0,0,4,0,4,89,0,0,0.0,0.0,0.0,0,0,0,0,0,0,0,0,0,2020-12-27 19:15:00
772,1715,Charlie Colkett,4454,[2015],Chelsea FC,0,0,0,0,0,0,0,0,0,0,0,0,0,0,0,0,0,0,0.0,0.0,0.0,0,0,0,0,0,0,0,0,0,2020-12-27 19:15:00
773,8590,Charlie Daniels,1003,"[2015, 2016, 2017, 2018, 2019]",AFC Bournemouth,65,62,3,5423,6,0,64,62,2,5640,3,0,129,124,5,11063,9,0,0.0,3.0,3.0,3,1,4,1,1,2,0,0,0,2020-12-27 19:15:002020-12-27 19:15:002020-12-27 19:15:002020-12-27 19:15:002020-12-27 19:15:00
774,3443,Charlie MacDonald,3549,"[2000, 2001]",Charlton Athletic,2,1,1,76,1,0,3,0,3,29,0,0,5,1,4,105,1,0,1.0,0.0,1.0,1,0,1,0,0,0,0,0,0,2020-12-27 19:15:002020-12-27 19:15:00
775,1723,Charlie Rowan,4313,[2016],Watford FC,0,0,0,0,0,0,0,0,0,0,0,0,0,0,0,0,0,0,0.0,0.0,0.0,0,0,0,0,0,0,0,0,0,2020-12-27 19:15:00
776,6902,Charlie Taylor,2347,"[2017, 2018, 2019, 2020]",Burnley FC,42,39,3,3496,0,0,45,42,3,3898,0,0,87,81,6,7394,0,0,0.0,0.0,0.0,0,0,0,0,0,0,0,0,0,2020-12-27 19:15:002020-12-27 19:15:002020-12-27 19:15:002020-12-27 19:15:00
777,1728,Charlie Ward,4487,[2013],Stoke City,0,0,0,0,0,0,0,0,0,0,0,0,0,0,0,0,0,0,0.0,0.0,0.0,0,0,0,0,0,0,0,0,0,2020-12-27 19:15:00
778,1729,Charly Musonda,3382,[2017],Chelsea FC,1,0,1,1,0,0,2,0,2,34,0,0,3,0,3,35,0,0,0.0,0.0,0.0,0,0,0,0,0,0,0,0,0,2020-12-27 19:15:00
779,3461,Che Adams,2480,"[2019, 2020]",Southampton FC,22,13,9,1155,6,0,23,14,9,1247,2,0,45,27,18,2402,8,0,3.0,0.0,3.0,5,1,6,0,0,0,0,0,0,2020-12-27 19:15:002020-12-27 19:15:00
780,1732,Ched Evans,3749,[2008],Manchester City,6,1,5,136,1,0,8,1,7,174,0,0,14,2,12,310,1,0,0.0,0.0,0.0,0,0,0,0,0,0,0,0,0,2020-12-27 19:15:00
781,10413,Cheick Tioté,2289,"[2010, 2011, 2012, 2013, 2014, 2015]",Newcastle United,70,67,3,5643,1,0,68,62,6,5433,0,0,138,129,9,11076,1,0,1.0,0.0,1.0,1,0,1,0,0,0,0,0,0,2020-12-27 19:15:002020-12-27 19:15:002020-12-27 19:15:002020-12-27 19:15:002020-12-27 19:15:002020-12-27 19:15:00
782,6962,Cheikhou Kouyaté,2311,"[2014, 2015, 2016, 2017]",West Ham United,69,68,1,6000,8,0,61,60,1,5316,4,0,130,128,2,11316,12,0,5.0,0.0,5.0,5,4,9,0,0,0,0,0,0,2020-12-27 19:15:002020-12-27 19:15:002020-12-27 19:15:002020-12-27 19:15:00
783,5232,Cheikhou Kouyaté,2311,"[2018, 2019, 2020]",Crystal Palace,38,32,6,2761,2,0,43,33,10,2995,0,0,81,65,16,5756,2,0,0.0,0.0,0.0,2,0,2,0,0,0,0,0,0,2020-12-27 19:15:002020-12-27 19:15:002020-12-27 19:15:00
784,3493,Chico,2935,"[2012, 2013]",Swansea City,30,30,0,2621,2,0,27,26,1,2413,1,0,57,56,1,5034,3,0,1.0,1.0,2.0,1,1,2,0,0,0,0,0,0,2020-12-27 19:15:002020-12-27 19:15:00
785,1748,Chris Armstrong,2584,[2000],Tottenham Hotspur,5,0,5,87,1,0,4,3,1,276,1,0,9,3,6,363,2,0,3.0,0.0,3.0,1,0,1,0,0,0,0,0,0,2020-12-27 19:15:00
786,1749,Chris Armstrong,2584,[2006],Sheffield United,12,11,1,1054,0,0,13,11,2,979,0,0,25,22,3,2033,0,0,0.0,0.0,0.0,0,0,0,0,0,0,0,0,0,2020-12-27 19:15:00
787,3501,Chris Baird,1562,"[2002, 2003]",Southampton FC,3,1,2,64,0,0,4,1,3,294,0,0,7,2,5,358,0,0,0.0,0.0,0.0,0,0,0,0,0,0,0,0,0,2020-12-27 19:15:002020-12-27 19:15:00
788,10527,Chris Baird,1562,"[2007, 2008, 2009, 2010, 2011, 2012]",Fulham FC,63,46,17,4339,1,0,62,53,9,4856,3,0,125,99,26,9195,4,0,3.0,0.0,3.0,1,2,3,0,0,0,0,0,0,2020-12-27 19:15:002020-12-27 19:15:002020-12-27 19:15:002020-12-27 19:15:002020-12-27 19:15:002020-12-27 19:15:00
789,1758,Chris Baird,1562,[2014],West Bromwich Albion,8,3,5,264,0,0,11,6,5,539,0,0,19,9,10,803,0,0,0.0,0.0,0.0,0,0,0,0,0,0,0,0,0,2020-12-27 19:15:00
790,3519,Chris Bart-Williams,2685,"[2001, 2002]",Charlton Athletic,12,6,6,488,1,0,15,10,5,928,1,0,27,16,11,1416,2,0,3.0,0.0,3.0,1,1,2,0,1,1,0,0,0,2020-12-27 19:15:002020-12-27 19:15:00
791,3523,Chris Basham,2601,"[2008, 2009]",Bolton Wanderers,9,2,7,222,0,0,10,4,6,479,1,0,19,6,13,701,1,0,0.0,0.0,0.0,0,0,0,0,0,0,0,0,0,2020-12-27 19:15:002020-12-27 19:15:00
792,1763,Chris Basham,2601,[2010],Blackpool FC,0,0,0,0,0,0,2,1,1,118,0,0,2,1,1,118,0,0,0.0,0.0,0.0,0,0,0,0,0,0,0,0,0,2020-12-27 19:15:00
793,3529,Chris Basham,2601,"[2019, 2020]",Sheffield United,27,27,0,2307,0,0,26,26,0,2200,0,0,53,53,0,4507,0,0,0.0,0.0,0.0,0,0,0,0,0,0,0,0,0,2020-12-27 19:15:002020-12-27 19:15:00
794,1766,Chris Brown,3760,[2005],Sunderland AFC,6,5,1,480,1,0,7,5,2,429,0,0,13,10,3,909,1,0,0.0,0.0,0.0,0,0,0,0,0,0,0,0,0,2020-12-27 19:15:00
795,15939,Chris Brunt,1658,"[2008, 2010, 2011, 2012, 2013, 2014, 2015, 2016, 2017]",West Bromwich Albion,140,124,16,11010,15,0,129,113,16,10207,10,0,269,237,32,21217,25,0,7.0,1.0,8.0,9,6,15,2,1,3,0,0,0,2020-12-27 19:15:002020-12-27 19:15:002020-12-27 19:15:002020-12-27 19:15:002020-12-27 19:15:002020-12-27 19:15:002020-12-27 19:15:002020-12-27 19:15:002020-12-27 19:15:00
796,1776,Chris David,4555,[2013],Fulham FC,1,0,1,67,1,0,0,0,0,0,0,0,1,0,1,67,1,0,1.0,0.0,1.0,1,0,1,0,0,0,0,0,0,2020-12-27 19:15:00
797,3555,Chris Eagles,2491,"[2006, 2007]",Manchester United,2,1,1,99,0,0,4,1,3,127,1,0,6,2,4,226,1,0,0.0,0.0,0.0,0,0,0,0,0,0,0,0,0,2020-12-27 19:15:002020-12-27 19:15:00
798,1779,Chris Eagles,2491,[2009],Burnley FC,18,10,8,966,0,0,16,10,6,1005,2,0,34,20,14,1971,2,0,0.0,0.0,0.0,0,0,0,0,0,0,0,0,0,2020-12-27 19:15:00
799,1780,Chris Eagles,2491,[2011],Bolton Wanderers,17,12,5,1146,3,0,17,14,3,1153,1,0,34,26,8,2299,4,0,1.0,0.0,1.0,1,0,1,0,0,0,0,0,0,2020-12-27 19:15:00
800,3563,Chris Gunter,2506,"[2007, 2008]",Tottenham Hotspur,1,1,0,55,0,0,4,2,2,153,0,0,5,3,2,208,0,0,0.0,0.0,0.0,0,0,0,0,0,0,0,0,0,2020-12-27 19:15:002020-12-27 19:15:00
801,1783,Chris Gunter,2506,[2012],Reading FC,11,11,0,990,0,0,9,9,0,800,0,0,20,20,0,1790,0,0,0.0,0.0,0.0,0,0,0,0,0,0,0,0,0,2020-12-27 19:15:00
802,8930,Chris Herd,3040,"[2010, 2011, 2012, 2013, 2014]",Aston Villa,19,16,3,1352,0,0,16,14,2,1121,1,0,35,30,5,2473,1,0,0.0,0.0,0.0,0,1,1,0,0,0,0,0,0,2020-12-27 19:15:002020-12-27 19:15:002020-12-27 19:15:002020-12-27 19:15:002020-12-27 19:15:00
803,1789,Chris Iwelumo,2891,[2009],Wolverhampton Wanderers,8,1,7,215,0,0,6,1,5,188,0,0,14,2,12,403,0,0,0.0,0.0,0.0,0,0,0,0,0,0,0,0,0,2020-12-27 19:15:00
804,1790,Chris Kettings,4480,[2010],Blackpool FC,0,0,0,0,0,0,0,0,0,0,0,0,0,0,0,0,0,0,0.0,0.0,0.0,0,0,0,0,0,0,0,0,0,2020-12-27 19:15:00
805,1791,Chris Kirkland,2056,[2000],Coventry City,11,11,0,990,0,0,10,10,0,900,0,0,21,21,0,1890,0,0,0.0,0.0,0.0,0,0,0,0,0,0,0,0,0,2020-12-27 19:15:00
806,7174,Chris Kirkland,2056,"[2001, 2002, 2003, 2004]",Liverpool FC,11,11,0,990,0,0,13,13,0,1170,0,0,24,24,0,2160,0,0,0.0,0.0,0.0,0,0,0,0,0,0,0,0,0,2020-12-27 19:15:002020-12-27 19:15:002020-12-27 19:15:002020-12-27 19:15:00
807,1796,Chris Kirkland,2056,[2005],West Bromwich Albion,5,5,0,450,0,0,5,5,0,450,0,0,10,10,0,900,0,0,0.0,0.0,0.0,0,0,0,0,0,0,0,0,0,2020-12-27 19:15:00
808,8999,Chris Kirkland,2056,"[2006, 2008, 2009, 2010, 2011]",Wigan Athletic,46,46,0,4073,0,0,46,46,0,3944,0,0,92,92,0,8017,0,0,0.0,0.0,0.0,0,0,0,0,0,0,0,0,0,2020-12-27 19:15:002020-12-27 19:15:002020-12-27 19:15:002020-12-27 19:15:002020-12-27 19:15:00
809,1798,Chris Kirkland,2056,[2007],Blackburn Rovers,0,0,0,0,0,0,1,1,0,90,0,0,1,1,0,90,0,0,0.0,0.0,0.0,0,0,0,0,0,0,0,0,0,2020-12-27 19:15:00
810,1803,Chris Lucketti,4130,[2006],Sheffield United,3,3,0,270,0,0,3,3,0,212,0,0,6,6,0,482,0,0,0.0,0.0,0.0,0,0,0,0,0,0,0,0,0,2020-12-27 19:15:00
811,3609,Chris Löwe,3104,"[2017, 2018]",Huddersfield Town,28,21,7,1833,0,0,24,21,3,1817,0,0,52,42,10,3650,0,0,0.0,0.0,0.0,0,0,0,0,0,0,0,0,0,2020-12-27 19:15:002020-12-27 19:15:00
812,1806,Chris Makin,1101,[2000],Sunderland AFC,9,7,2,671,0,0,8,8,0,697,0,0,17,15,2,1368,0,0,0.0,0.0,0.0,0,0,0,0,0,0,0,0,0,2020-12-27 19:15:00
813,1807,Chris Makin,1101,[2001],Ipswich Town,16,16,0,1241,0,0,14,14,0,1183,0,0,30,30,0,2424,0,0,0.0,0.0,0.0,0,0,0,0,0,0,0,0,0,2020-12-27 19:15:00
814,7238,Chris Marsden,2048,"[2000, 2001, 2002, 2003]",Southampton FC,46,43,3,3601,2,0,42,36,6,3285,2,0,88,79,9,6886,4,0,1.0,0.0,1.0,1,1,2,0,0,0,0,0,0,2020-12-27 19:15:002020-12-27 19:15:002020-12-27 19:15:002020-12-27 19:15:00
815,3625,Chris Martin,3823,"[2011, 2012]",Norwich City,3,2,1,156,0,0,2,1,1,86,0,0,5,3,2,242,0,0,0.0,0.0,0.0,0,0,0,0,0,0,0,0,0,2020-12-27 19:15:002020-12-27 19:15:00
816,1814,Chris McCann,3997,[2009],Burnley FC,3,3,0,208,0,0,4,4,0,282,0,0,7,7,0,490,0,0,0.0,0.0,0.0,0,0,0,0,0,0,0,0,0,2020-12-27 19:15:00
817,3631,Chris Mepham,3156,"[2018, 2019]",AFC Bournemouth,13,10,3,898,1,0,12,10,2,863,0,0,25,20,5,1761,1,0,0.0,0.0,0.0,1,0,1,0,0,0,0,0,0,2020-12-27 19:15:002020-12-27 19:15:00
818,1817,Chris Morgan,2583,[2006],Sheffield United,12,11,1,1017,1,0,12,10,2,1015,0,0,24,21,3,2032,1,0,0.0,0.0,0.0,1,0,1,0,0,0,0,0,0,2020-12-27 19:15:00
819,5457,Chris Perry,1954,"[2000, 2001, 2002]",Tottenham Hotspur,39,36,3,3109,0,0,41,36,5,3297,2,0,80,72,8,6406,2,0,0.0,0.0,0.0,0,1,1,0,0,0,0,0,0,2020-12-27 19:15:002020-12-27 19:15:002020-12-27 19:15:00
820,5466,Chris Perry,1954,"[2003, 2004, 2005]",Charlton Athletic,37,35,2,3175,2,0,38,33,5,2989,1,0,75,68,7,6164,3,0,1.0,0.0,1.0,1,0,1,0,0,0,0,0,0,2020-12-27 19:15:002020-12-27 19:15:002020-12-27 19:15:00
821,9130,Chris Powell,1669,"[2000, 2001, 2002, 2003, 2005]",Charlton Athletic,75,68,7,6156,0,0,70,65,5,5698,1,0,145,133,12,11854,1,0,0.0,3.0,3.0,0,1,1,0,0,0,0,0,0,2020-12-27 19:15:002020-12-27 19:15:002020-12-27 19:15:002020-12-27 19:15:002020-12-27 19:15:00
822,1829,Chris Powell,1669,[2006],Watford FC,6,4,2,371,0,0,9,5,4,491,0,0,15,9,6,862,0,0,0.0,0.0,0.0,0,0,0,0,0,0,0,0,0,2020-12-27 19:15:00
823,3661,Chris Riggott,1330,"[2000, 2001]",Derby County,33,32,1,2804,0,0,29,29,0,2581,3,0,62,61,1,5385,3,0,0.0,0.0,0.0,0,1,1,0,0,0,0,0,0,2020-12-27 19:15:002020-12-27 19:15:00
824,12845,Chris Riggott,1330,"[2002, 2003, 2004, 2005, 2006, 2007, 2008]",Middlesbrough FC,46,42,4,3751,3,0,51,48,3,4206,2,0,97,90,7,7957,5,0,0.0,0.0,0.0,3,1,4,0,0,0,0,0,0,2020-12-27 19:15:002020-12-27 19:15:002020-12-27 19:15:002020-12-27 19:15:002020-12-27 19:15:002020-12-27 19:15:002020-12-27 19:15:00
825,1839,Chris Shuker,4371,[2002],Manchester City,2,1,1,81,0,0,1,0,1,27,0,0,3,1,2,108,0,0,0.0,0.0,0.0,0,0,0,0,0,0,0,0,0,2020-12-27 19:15:00
826,3681,Chris Smalling,1640,"[2008, 2009]",Fulham FC,5,3,2,284,0,0,7,5,2,508,0,0,12,8,4,792,0,0,0.0,0.0,0.0,0,0,0,0,0,0,0,0,0,2020-12-27 19:15:002020-12-27 19:15:00
827,16614,Chris Smalling,1640,"[2010, 2011, 2012, 2013, 2014, 2015, 2016, 2017, 2018]",Manchester United,95,84,11,7635,7,0,111,93,18,8649,5,0,206,177,29,16284,12,0,0.0,3.0,3.0,6,2,8,0,0,0,0,0,0,2020-12-27 19:15:002020-12-27 19:15:002020-12-27 19:15:002020-12-27 19:15:002020-12-27 19:15:002020-12-27 19:15:002020-12-27 19:15:002020-12-27 19:15:002020-12-27 19:15:00
828,1851,Chris Sutton,3114,[2005],Birmingham City,4,4,0,315,0,0,6,6,0,515,1,0,10,10,0,830,1,0,0.0,0.0,0.0,0,1,1,0,0,0,0,0,0,2020-12-27 19:15:00
829,1852,Chris Sutton,3114,[2006],Aston Villa,4,3,1,285,0,0,4,3,1,307,1,0,8,6,2,592,1,0,0.0,3.0,3.0,0,1,1,0,0,0,0,0,0,2020-12-27 19:15:00
830,3707,Chris Wood,2348,"[2008, 2010]",West Bromwich Albion,0,0,0,0,0,0,3,0,3,23,0,0,3,0,3,23,0,0,0.0,0.0,0.0,0,0,0,0,0,0,0,0,0,2020-12-27 19:15:002020-12-27 19:15:00
831,1855,Chris Wood,2348,[2014],Leicester City,3,0,3,23,1,0,4,0,4,85,0,0,7,0,7,108,1,0,1.0,0.0,1.0,1,0,1,0,0,0,0,0,0,2020-12-27 19:15:00
832,7430,Chris Wood,2348,"[2017, 2018, 2019, 2020]",Burnley FC,53,46,7,4012,20,0,55,46,9,3864,17,0,108,92,16,7876,37,0,14.0,2.0,16.0,15,12,27,1,0,1,0,0,0,2020-12-27 19:15:002020-12-27 19:15:002020-12-27 19:15:002020-12-27 19:15:00
833,1860,Christian Atsu,2244,[2014],Everton FC,5,1,4,112,0,0,0,0,0,0,0,0,5,1,4,112,0,0,0.0,0.0,0.0,0,0,0,0,0,0,0,0,0,2020-12-27 19:15:00
834,5586,Christian Atsu,2244,"[2017, 2018, 2019]",Newcastle United,35,19,16,1870,2,0,40,21,19,2141,1,0,75,40,35,4011,3,0,0.0,0.0,0.0,2,0,2,0,0,0,0,0,0,2020-12-27 19:15:002020-12-27 19:15:002020-12-27 19:15:00
835,3729,Christian Bassedas,3776,"[2000, 2001]",Newcastle United,12,10,2,817,0,0,10,6,4,589,1,0,22,16,6,1406,1,0,0.0,0.0,0.0,0,1,1,0,0,0,0,0,0,2020-12-27 19:15:002020-12-27 19:15:00
836,1866,Christian Bassila,3283,[2000],West Ham United,3,0,3,78,0,0,0,0,0,0,0,0,3,0,3,78,0,0,0.0,0.0,0.0,0,0,0,0,0,0,0,0,0,2020-12-27 19:15:00
837,1867,Christian Bassila,3283,[2005],Sunderland AFC,7,7,0,518,0,0,6,5,1,464,0,0,13,12,1,982,0,0,0.0,0.0,0.0,0,0,0,0,0,0,0,0,0,2020-12-27 19:15:00
838,5607,Christian Benteke,1443,"[2012, 2013, 2014]",Aston Villa,46,42,4,3788,24,0,42,39,3,3508,18,0,88,81,7,7296,42,0,13.0,6.0,19.0,17,11,28,4,2,6,0,0,0,2020-12-27 19:15:002020-12-27 19:15:002020-12-27 19:15:00
839,1871,Christian Benteke,1443,[2015],Liverpool FC,13,7,6,732,4,0,16,7,9,785,5,0,29,14,15,1517,9,0,7.0,6.0,13.0,4,2,6,0,1,1,0,0,0,2020-12-27 19:15:00
840,9370,Christian Benteke,1443,"[2016, 2017, 2018, 2019, 2020]",Crystal Palace,61,43,18,3962,6,0,56,43,13,3901,18,0,117,86,31,7863,24,0,1.0,10.0,11.0,2,15,17,1,2,3,0,0,0,2020-12-27 19:15:002020-12-27 19:15:002020-12-27 19:15:002020-12-27 19:15:002020-12-27 19:15:00
841,1877,Christian Benítez,1784,[2009],Birmingham City,16,12,4,1087,1,0,14,9,5,848,2,0,30,21,9,1935,3,0,0.0,0.0,0.0,0,2,2,0,0,0,0,0,0,2020-12-27 19:15:00
842,9400,Christian Dailly,1626,"[2000, 2001, 2002, 2005, 2006]",West Ham United,48,38,10,3543,0,0,55,41,14,4009,0,0,103,79,24,7552,0,0,0.0,0.0,0.0,0,0,0,0,0,0,0,0,0,2020-12-27 19:15:002020-12-27 19:15:002020-12-27 19:15:002020-12-27 19:15:002020-12-27 19:15:00
843,13202,Christian Eriksen,1165,"[2013, 2014, 2015, 2016, 2017, 2018, 2019]",Tottenham Hotspur,115,105,10,9321,27,0,111,101,10,9000,24,0,226,206,20,18321,51,0,16.0,17.0,33.0,15,17,32,0,0,0,0,0,0,2020-12-27 19:15:002020-12-27 19:15:002020-12-27 19:15:002020-12-27 19:15:002020-12-27 19:15:002020-12-27 19:15:002020-12-27 19:15:00
844,11355,Christian Fuchs,2564,"[2015, 2016, 2017, 2018, 2019, 2020]",Leicester City,54,50,4,4530,2,0,62,54,8,4880,0,0,116,104,12,9410,2,0,0.0,0.0,0.0,1,0,1,0,0,0,0,0,0,2020-12-27 19:15:002020-12-27 19:15:002020-12-27 19:15:002020-12-27 19:15:002020-12-27 19:15:002020-12-27 19:15:00
845,7590,Christian Kabasele,1921,"[2016, 2017, 2018, 2019]",Watford FC,49,41,8,3742,1,0,43,38,5,3299,3,0,92,79,13,7041,4,0,0.0,0.0,0.0,1,1,2,0,0,0,0,0,0,2020-12-27 19:15:002020-12-27 19:15:002020-12-27 19:15:002020-12-27 19:15:00
846,1900,Christian Kalvenes,4141,[2009],Burnley FC,2,1,1,36,0,0,4,2,2,242,0,0,6,3,3,278,0,0,0.0,0.0,0.0,0,0,0,0,0,0,0,0,0,2020-12-27 19:15:00
847,1901,Christian Karembeu,2069,[2000],Middlesbrough FC,15,15,0,1237,2,0,17,16,1,1267,2,0,32,31,1,2504,4,0,6.0,1.0,7.0,2,2,4,0,0,0,0,0,0,2020-12-27 19:15:00
848,1902,Christian Nadé,2587,[2006],Sheffield United,15,5,10,557,2,0,10,2,8,356,1,0,25,7,18,913,3,0,3.0,0.0,3.0,2,0,2,0,0,0,0,0,0,2020-12-27 19:15:00
849,1903,Christian Negouai,4440,[2004],Manchester City,0,0,0,0,0,0,1,0,1,10,0,0,1,0,1,10,0,0,0.0,0.0,0.0,0,0,0,0,0,0,0,0,0,2020-12-27 19:15:00
850,1904,Christian Panucci,3789,[2000],Chelsea FC,3,3,0,270,0,0,4,3,1,297,0,0,7,6,1,567,0,0,0.0,0.0,0.0,0,0,0,0,0,0,0,0,0,2020-12-27 19:15:00
851,1905,Christian Poulsen,3168,[2010],Liverpool FC,5,5,0,381,0,0,7,4,3,360,0,0,12,9,3,741,0,0,0.0,0.0,0.0,0,0,0,0,0,0,0,0,0,2020-12-27 19:15:00
852,3813,Christian Pulišić,2957,"[2019, 2020]",Chelsea FC,17,12,5,1124,3,0,16,12,4,1118,7,0,33,24,9,2242,10,0,0.0,0.0,0.0,1,2,3,0,0,0,0,0,0,2020-12-27 19:15:002020-12-27 19:15:00
853,1908,Christian Saydee,4453,[2019],AFC Bournemouth,0,0,0,0,0,0,0,0,0,0,0,0,0,0,0,0,0,0,0.0,0.0,0.0,0,0,0,0,0,0,0,0,0,2020-12-27 19:15:00
854,1909,Christian Wilhelmsson,3752,[2007],Bolton Wanderers,6,0,6,158,0,0,2,0,2,75,0,0,8,0,8,233,0,0,0.0,0.0,0.0,0,0,0,0,0,0,0,0,0,2020-12-27 19:15:00
855,1910,Christian Ziege,1129,[2000],Liverpool FC,8,5,3,461,0,0,7,6,1,503,1,0,15,11,4,964,1,0,0.0,0.0,0.0,0,0,0,0,0,0,0,0,0,2020-12-27 19:15:00
856,5736,Christian Ziege,1129,"[2001, 2002, 2003]",Tottenham Hotspur,24,22,2,1903,5,0,23,22,1,1843,2,0,47,44,3,3746,7,0,0.0,0.0,0.0,4,1,5,0,0,0,0,0,0,2020-12-27 19:15:002020-12-27 19:15:002020-12-27 19:15:00
857,1914,Christoph Zimmermann,2177,[2019],Norwich City,8,7,1,674,0,0,9,9,0,756,0,0,17,16,1,1430,0,0,0.0,0.0,0.0,0,0,0,0,0,0,0,0,0,2020-12-27 19:15:00
858,5748,Christophe Berra,2885,"[2009, 2010, 2011]",Wolverhampton Wanderers,48,44,4,4005,0,0,47,47,0,4230,0,0,95,91,4,8235,0,0,0.0,0.0,0.0,0,0,0,0,0,0,0,0,0,2020-12-27 19:15:002020-12-27 19:15:002020-12-27 19:15:00
859,3837,Christophe Dugarry,2791,"[2002, 2003]",Birmingham City,16,15,1,1233,5,0,14,13,1,1066,1,0,30,28,2,2299,6,0,3.0,0.0,3.0,3,1,4,0,0,0,0,0,0,2020-12-27 19:15:002020-12-27 19:15:00
860,1920,Christopher Black,3792,[2002],Sunderland AFC,1,1,0,45,0,0,1,1,0,85,0,0,2,2,0,130,0,0,0.0,0.0,0.0,0,0,0,0,0,0,0,0,0,2020-12-27 19:15:00
861,9617,Christopher Samba,2109,"[2006, 2007, 2008, 2010, 2011]",Blackburn Rovers,68,68,0,5909,5,0,60,59,1,5248,7,0,128,127,1,11157,12,0,0.0,4.0,4.0,4,4,8,0,0,0,0,0,0,2020-12-27 19:15:002020-12-27 19:15:002020-12-27 19:15:002020-12-27 19:15:002020-12-27 19:15:00
862,1924,Christopher Samba,2109,[2009],Wigan Athletic,1,1,0,90,0,0,0,0,0,0,0,0,1,1,0,90,0,0,0.0,0.0,0.0,0,0,0,0,0,0,0,0,0,2020-12-27 19:15:00
863,1927,Christopher Samba,2109,[2012],Queens Park Rangers,5,5,0,450,0,0,5,5,0,450,0,0,10,10,0,900,0,0,0.0,0.0,0.0,0,0,0,0,0,0,0,0,0,2020-12-27 19:15:00
864,3857,Christopher Schindler,3098,"[2017, 2018]",Huddersfield Town,38,38,0,3401,0,0,36,36,0,3209,1,0,74,74,0,6610,1,0,0.0,1.0,1.0,0,1,1,0,0,0,0,0,0,2020-12-27 19:15:002020-12-27 19:15:00
865,3861,Chu-young Park,3274,"[2011, 2013]",Arsenal FC,1,0,1,6,0,0,0,0,0,0,0,0,1,0,1,6,0,0,0.0,0.0,0.0,0,0,0,0,0,0,0,0,0,2020-12-27 19:15:002020-12-27 19:15:00
866,3865,Chuba Akpom,3801,"[2013, 2014]",Arsenal FC,1,0,1,20,0,0,3,0,3,8,0,0,4,0,4,28,0,0,0.0,0.0,0.0,0,0,0,0,0,0,0,0,0,2020-12-27 19:15:002020-12-27 19:15:00
867,1934,Chuba Akpom,3801,[2016],Liverpool FC,0,0,0,0,0,0,0,0,0,0,0,0,0,0,0,0,0,0,0.0,0.0,0.0,0,0,0,0,0,0,0,0,0,2020-12-27 19:15:00
868,5808,Chung-yong Lee,2126,"[2009, 2010, 2011]",Bolton Wanderers,35,28,7,2439,6,0,32,24,8,2183,1,0,67,52,15,4622,7,0,3.0,3.0,6.0,4,1,5,0,0,0,0,0,0,2020-12-27 19:15:002020-12-27 19:15:002020-12-27 19:15:00
869,7758,Chung-yong Lee,2126,"[2014, 2015, 2016, 2017]",Crystal Palace,21,5,16,615,0,0,17,5,12,458,1,0,38,10,28,1073,1,0,0.0,3.0,3.0,0,1,1,0,0,0,0,0,0,2020-12-27 19:15:002020-12-27 19:15:002020-12-27 19:15:002020-12-27 19:15:00
870,13615,Ciaran Clark,1437,"[2009, 2010, 2011, 2012, 2013, 2014, 2015]",Aston Villa,63,55,8,5200,4,0,69,62,7,5592,3,0,132,117,15,10792,7,0,0.0,1.0,1.0,2,3,5,0,0,0,0,0,0,2020-12-27 19:15:002020-12-27 19:15:002020-12-27 19:15:002020-12-27 19:15:002020-12-27 19:15:002020-12-27 19:15:002020-12-27 19:15:00
871,7802,Ciaran Clark,1437,"[2017, 2018, 2019, 2020]",Newcastle United,26,23,3,2117,3,0,25,25,0,2214,5,0,51,48,3,4331,8,0,3.0,0.0,3.0,1,3,4,0,0,0,0,0,0,2020-12-27 19:15:002020-12-27 19:15:002020-12-27 19:15:002020-12-27 19:15:00
872,5862,Clarence Acuña,3573,"[2000, 2001, 2002]",Newcastle United,21,14,7,1244,1,0,23,19,4,1693,5,0,44,33,11,2937,6,0,3.0,2.0,5.0,1,4,5,0,0,0,0,0,0,2020-12-27 19:15:002020-12-27 19:15:002020-12-27 19:15:00
873,1956,Clarke Carlisle,2547,[2006],Watford FC,2,2,0,180,0,0,2,2,0,180,0,0,4,4,0,360,0,0,0.0,0.0,0.0,0,0,0,0,0,0,0,0,0,2020-12-27 19:15:00
874,1957,Clarke Carlisle,2547,[2009],Burnley FC,14,14,0,1260,0,0,13,13,0,1114,0,0,27,27,0,2374,0,0,0.0,0.0,0.0,0,0,0,0,0,0,0,0,0,2020-12-27 19:15:00
875,1958,Claude Davis,1571,[2006],Sheffield United,10,7,3,650,0,0,11,11,0,904,0,0,21,18,3,1554,0,0,0.0,0.0,0.0,0,0,0,0,0,0,0,0,0,2020-12-27 19:15:00
876,1959,Claude Davis,1571,[2007],Derby County,10,10,0,849,0,0,9,9,0,675,0,0,19,19,0,1524,0,0,0.0,0.0,0.0,0,0,0,0,0,0,0,0,0,2020-12-27 19:15:00
877,9810,Claude Makélélé,1762,"[2003, 2004, 2005, 2006, 2007]",Chelsea FC,69,60,9,5312,1,0,74,71,3,6286,1,0,143,131,12,11598,2,0,3.0,0.0,3.0,1,1,2,0,0,0,0,0,0,2020-12-27 19:15:002020-12-27 19:15:002020-12-27 19:15:002020-12-27 19:15:002020-12-27 19:15:00
878,7866,Claudio Bravo,1208,"[2016, 2017, 2018, 2019]",Manchester City,15,14,1,1294,0,0,14,13,1,1246,0,0,29,27,2,2540,0,0,0.0,0.0,0.0,0,0,0,0,0,0,0,0,0,2020-12-27 19:15:002020-12-27 19:15:002020-12-27 19:15:002020-12-27 19:15:00
879,1969,Claudio Pizarro,3437,[2007],Chelsea FC,10,4,6,381,1,0,11,0,11,299,1,0,21,4,17,680,2,0,0.0,3.0,3.0,1,1,2,0,0,0,0,0,0,2020-12-27 19:15:00
880,3941,Claudio Reyna,1634,"[2001, 2002]",Sunderland AFC,13,13,0,1087,3,0,15,15,0,1262,0,0,28,28,0,2349,3,0,6.0,0.0,6.0,3,0,3,0,0,0,0,0,0,2020-12-27 19:15:002020-12-27 19:15:00
881,7894,Claudio Reyna,1634,"[2003, 2004, 2005, 2006]",Manchester City,39,32,7,2717,2,0,35,34,1,2826,2,0,74,66,8,5543,4,0,0.0,0.0,0.0,1,2,3,0,0,0,0,0,0,2020-12-27 19:15:002020-12-27 19:15:002020-12-27 19:15:002020-12-27 19:15:00
882,11871,Claudio Yacob,1661,"[2012, 2013, 2014, 2015, 2016, 2017]",West Bromwich Albion,80,66,14,5892,1,0,80,70,10,6055,0,0,160,136,24,11947,1,0,0.0,0.0,0.0,1,0,1,0,0,0,0,0,0,2020-12-27 19:15:002020-12-27 19:15:002020-12-27 19:15:002020-12-27 19:15:002020-12-27 19:15:002020-12-27 19:15:00
883,7934,Claus Jensen,1674,"[2000, 2001, 2002, 2003]",Charlton Athletic,60,54,6,4790,5,0,59,55,4,4798,11,0,119,109,10,9588,16,0,0.0,0.0,0.0,2,3,5,1,0,1,0,0,0,2020-12-27 19:15:002020-12-27 19:15:002020-12-27 19:15:002020-12-27 19:15:00
884,5961,Claus Jensen,1674,"[2004, 2005, 2006]",Fulham FC,15,12,3,1087,3,0,19,18,1,1567,1,0,34,30,4,2654,4,0,3.0,0.0,3.0,2,1,3,0,0,0,0,0,0,2020-12-27 19:15:002020-12-27 19:15:002020-12-27 19:15:00
885,9955,Claus Lundekvam,2047,"[2000, 2001, 2002, 2003, 2004]",Southampton FC,83,82,1,7090,0,0,77,77,0,6686,1,0,160,159,1,13776,1,0,0.0,0.0,0.0,0,0,0,0,0,0,0,0,0,2020-12-27 19:15:002020-12-27 19:15:002020-12-27 19:15:002020-12-27 19:15:002020-12-27 19:15:00
886,13980,Clint Dempsey,1565,"[2006, 2007, 2008, 2009, 2010, 2011, 2013]",Fulham FC,94,78,16,7215,32,0,90,79,11,7106,18,0,184,157,27,14321,50,0,10.0,6.0,16.0,18,12,30,1,1,2,0,0,0,2020-12-27 19:15:002020-12-27 19:15:002020-12-27 19:15:002020-12-27 19:15:002020-12-27 19:15:002020-12-27 19:15:002020-12-27 19:15:00
887,2000,Clint Dempsey,1565,[2012],Tottenham Hotspur,15,13,2,1121,3,0,14,9,5,877,4,0,29,22,7,1998,7,0,1.0,0.0,1.0,2,2,4,0,0,0,0,0,0,2020-12-27 19:15:00
888,6009,Clint Hill,2540,"[2011, 2012, 2014]",Queens Park Rangers,37,33,4,3040,0,0,35,32,3,2706,1,0,72,65,7,5746,1,0,0.0,0.0,0.0,0,1,1,0,0,0,0,0,0,2020-12-27 19:15:002020-12-27 19:15:002020-12-27 19:15:00
889,8026,Clinton Morrison,1521,"[2002, 2003, 2004, 2005]",Birmingham City,41,27,14,2454,6,0,43,28,15,2573,8,0,84,55,29,5027,14,0,0.0,4.0,4.0,4,6,10,0,0,0,0,0,0,2020-12-27 19:15:002020-12-27 19:15:002020-12-27 19:15:002020-12-27 19:15:00
890,2009,Clinton N'Jie,3735,[2015],Tottenham Hotspur,5,0,5,143,0,0,3,0,3,41,0,0,8,0,8,184,0,0,0.0,0.0,0.0,0,0,0,0,0,0,0,0,0,2020-12-27 19:15:00
891,2010,Clive Clarke,4054,[2005],West Ham United,1,1,0,45,0,0,1,1,0,76,0,0,2,2,0,121,0,0,0.0,0.0,0.0,0,0,0,0,0,0,0,0,0,2020-12-27 19:15:00
892,2011,Cody Cropper,4391,[2013],Southampton FC,0,0,0,0,0,0,0,0,0,0,0,0,0,0,0,0,0,0,0.0,0.0,0.0,0,0,0,0,0,0,0,0,0,2020-12-27 19:15:00
893,2012,Cole Kpekawa,4401,[2014],Queens Park Rangers,0,0,0,0,0,0,1,0,1,5,0,0,1,0,1,5,0,0,0.0,0.0,0.0,0,0,0,0,0,0,0,0,0,2020-12-27 19:15:00
894,4027,Cole Palmer,2963,"[2019, 2020]",Manchester City,0,0,0,0,0,0,0,0,0,0,0,0,0,0,0,0,0,0,0.0,0.0,0.0,0,0,0,0,0,0,0,0,0,2020-12-27 19:15:002020-12-27 19:15:00
895,2015,Colin Cameron,2906,[2003],Wolverhampton Wanderers,15,11,4,1038,3,0,15,14,1,1184,1,0,30,25,5,2222,4,0,3.0,0.0,3.0,1,1,2,1,0,1,0,0,0,2020-12-27 19:15:00
896,12111,Colin Cooper,2138,"[2000, 2001, 2002, 2003, 2004, 2005]",Middlesbrough FC,44,38,6,3421,2,0,54,42,12,3877,2,0,98,80,18,7298,4,0,1.0,0.0,1.0,2,2,4,0,0,0,0,0,0,2020-12-27 19:15:002020-12-27 19:15:002020-12-27 19:15:002020-12-27 19:15:002020-12-27 19:15:002020-12-27 19:15:00
897,4045,Colin Doyle,1962,"[2007, 2010]",Birmingham City,2,2,0,180,0,0,2,1,1,140,0,0,4,3,1,320,0,0,0.0,0.0,0.0,0,0,0,0,0,0,0,0,0,2020-12-27 19:15:002020-12-27 19:15:00
898,2024,Colin Hendry,4190,[2000],Coventry City,2,1,1,98,0,0,0,0,0,0,0,0,2,1,1,98,0,0,0.0,0.0,0.0,0,0,0,0,0,0,0,0,0,2020-12-27 19:15:00
899,2025,Colin Hendry,4190,[2001],Bolton Wanderers,1,1,0,83,0,0,2,2,0,122,0,0,3,3,0,205,0,0,0.0,0.0,0.0,0,0,0,0,0,0,0,0,0,2020-12-27 19:15:00
900,2026,Colin Kâzım-Richards,3665,[2006],Sheffield United,12,7,5,705,1,0,14,7,7,707,0,0,26,14,12,1412,1,0,1.0,0.0,1.0,1,0,1,0,0,0,0,0,0,2020-12-27 19:15:00
901,4055,Collin Quaner,3107,"[2017, 2018]",Huddersfield Town,14,6,8,606,0,0,14,7,7,704,0,0,28,13,15,1310,0,0,0.0,0.0,0.0,0,0,0,0,0,0,0,0,0,2020-12-27 19:15:002020-12-27 19:15:00
902,10155,Collins John,1089,"[2003, 2004, 2005, 2006, 2007]",Fulham FC,43,21,22,1911,9,0,51,19,32,2097,11,0,94,40,54,4008,20,0,3.0,1.0,4.0,7,8,15,0,1,1,0,0,0,2020-12-27 19:15:002020-12-27 19:15:002020-12-27 19:15:002020-12-27 19:15:002020-12-27 19:15:00
903,2034,Collins Mbesuma,4319,[2005],Portsmouth FC,2,0,2,18,0,0,2,0,2,33,0,0,4,0,4,51,0,0,0.0,0.0,0.0,0,0,0,0,0,0,0,0,0,2020-12-27 19:15:00
904,2035,Con Blatsis,4205,[2000],Derby County,1,1,0,90,0,0,1,1,0,85,0,0,2,2,0,175,0,0,0.0,0.0,0.0,0,0,0,0,0,0,0,0,0,2020-12-27 19:15:00
905,2036,Connor Goldson,2660,[2017],Brighton & Hove Albion,2,2,0,180,0,0,1,0,1,19,0,0,3,2,1,199,0,0,0.0,0.0,0.0,0,0,0,0,0,0,0,0,0,2020-12-27 19:15:00
906,2037,Connor Mahoney,4345,[2017],AFC Bournemouth,0,0,0,0,0,0,0,0,0,0,0,0,0,0,0,0,0,0,0.0,0.0,0.0,0,0,0,0,0,0,0,0,0,2020-12-27 19:15:00
907,4077,Connor Randall,2129,"[2015, 2016]",Liverpool FC,2,1,1,73,0,0,1,1,0,90,0,0,3,2,1,163,0,0,0.0,0.0,0.0,0,0,0,0,0,0,0,0,0,2020-12-27 19:15:002020-12-27 19:15:00
908,4081,Connor Roberts,3806,"[2016, 2017]",Swansea City,2,2,0,153,0,0,2,1,1,115,0,0,4,3,1,268,0,0,0.0,0.0,0.0,0,0,0,0,0,0,0,0,0,2020-12-27 19:15:002020-12-27 19:15:00
909,8174,Connor Wickham,1035,"[2011, 2012, 2013, 2014]",Sunderland AFC,42,23,19,2340,7,0,37,26,11,2254,4,0,79,49,30,4594,11,0,0.0,0.0,0.0,5,4,9,0,0,0,0,0,0,2020-12-27 19:15:002020-12-27 19:15:002020-12-27 19:15:002020-12-27 19:15:00
910,8190,Connor Wickham,1035,"[2015, 2016, 2018, 2019]",Crystal Palace,19,9,10,935,1,0,22,10,12,950,7,0,41,19,22,1885,8,0,0.0,1.0,1.0,1,4,5,0,1,1,0,0,0,2020-12-27 19:15:002020-12-27 19:15:002020-12-27 19:15:002020-12-27 19:15:00
911,4101,Conor Coady,2144,"[2010, 2012]",Liverpool FC,0,0,0,0,0,0,1,0,1,1,0,0,1,0,1,1,0,0,0.0,0.0,0.0,0,0,0,0,0,0,0,0,0,2020-12-27 19:15:002020-12-27 19:15:00
912,6159,Conor Coady,2144,"[2018, 2019, 2020]",Wolverhampton Wanderers,45,45,0,4050,0,0,45,45,0,4050,0,0,90,90,0,8100,0,0,0.0,0.0,0.0,0,0,0,0,0,0,0,0,0,2020-12-27 19:15:002020-12-27 19:15:002020-12-27 19:15:00
913,4111,Conor Coventry,3840,"[2018, 2019]",West Ham United,0,0,0,0,0,0,0,0,0,0,0,0,0,0,0,0,0,0,0.0,0.0,0.0,0,0,0,0,0,0,0,0,0,2020-12-27 19:15:002020-12-27 19:15:00
914,2057,Conor Gallagher,1028,[2020],West Bromwich Albion,5,5,0,450,2,0,6,6,0,530,0,0,11,11,0,980,2,0,3.0,0.0,3.0,2,0,2,0,0,0,0,0,0,2020-12-27 19:15:00
915,2058,Conor Henderson,4218,[2010],Arsenal FC,0,0,0,0,0,0,0,0,0,0,0,0,0,0,0,0,0,0,0.0,0.0,0.0,0,0,0,0,0,0,0,0,0,2020-12-27 19:15:00
916,4119,Conor Hourihane,2847,"[2019, 2020]",Aston Villa,15,11,4,903,2,0,16,10,6,864,2,0,31,21,10,1767,4,0,3.0,0.0,3.0,2,0,2,0,0,0,0,0,0,2020-12-27 19:15:002020-12-27 19:15:00
917,2061,Conor Masterson,4277,[2017],Liverpool FC,0,0,0,0,0,0,0,0,0,0,0,0,0,0,0,0,0,0,0.0,0.0,0.0,0,0,0,0,0,0,0,0,0,2020-12-27 19:15:00
918,10320,Conor McAleny,4217,"[2010, 2011, 2013, 2014, 2015]",Everton FC,1,0,1,2,0,0,1,0,1,13,0,0,2,0,2,15,0,0,0.0,0.0,0.0,0,0,0,0,0,0,0,0,0,2020-12-27 19:15:002020-12-27 19:15:002020-12-27 19:15:002020-12-27 19:15:002020-12-27 19:15:00
919,4135,Conor Sammon,2879,"[2010, 2011]",Wigan Athletic,15,5,10,547,1,0,17,4,13,546,0,0,32,9,23,1093,1,0,0.0,0.0,0.0,1,0,1,0,0,0,0,0,0,2020-12-27 19:15:002020-12-27 19:15:00
920,2069,Conor Townsend,1027,[2020],West Bromwich Albion,4,4,0,345,0,0,4,4,0,360,0,0,8,8,0,705,0,0,0.0,0.0,0.0,0,0,0,0,0,0,0,0,0,2020-12-27 19:15:00
921,2070,Corey Jordan,3209,[2015],AFC Bournemouth,0,0,0,0,0,0,0,0,0,0,0,0,0,0,0,0,0,0,0.0,0.0,0.0,0,0,0,0,0,0,0,0,0,2020-12-27 19:15:00
922,6216,Corrado Grabbi,1457,"[2001, 2002, 2003]",Blackburn Rovers,18,7,11,567,2,0,12,4,8,386,0,0,30,11,19,953,2,0,4.0,0.0,4.0,2,0,2,0,0,0,0,0,0,2020-12-27 19:15:002020-12-27 19:15:002020-12-27 19:15:00
923,2074,Cosmin Contra,1319,[2004],West Bromwich Albion,4,4,0,273,0,0,1,1,0,75,0,0,5,5,0,348,0,0,0.0,0.0,0.0,0,0,0,0,0,0,0,0,0,2020-12-27 19:15:00
924,6228,Costel Pantilimon,1354,"[2011, 2012, 2013]",Manchester City,4,4,0,360,0,0,3,3,0,270,0,0,7,7,0,630,0,0,0.0,0.0,0.0,0,0,0,0,0,0,0,0,0,2020-12-27 19:15:002020-12-27 19:15:002020-12-27 19:15:00
925,4157,Costel Pantilimon,1354,"[2014, 2015]",Sunderland AFC,22,22,0,1980,0,0,23,23,0,2070,0,0,45,45,0,4050,0,0,0.0,0.0,0.0,0,0,0,0,0,0,0,0,0,2020-12-27 19:15:002020-12-27 19:15:00
926,4161,Costel Pantilimon,1354,"[2016, 2017]",Watford FC,1,0,1,24,0,0,1,0,1,57,0,0,2,0,2,81,0,0,0.0,0.0,0.0,0,0,0,0,0,0,0,0,0,2020-12-27 19:15:002020-12-27 19:15:00
927,12507,Coutinho,1425,"[2012, 2013, 2014, 2015, 2016, 2017]",Liverpool FC,79,72,7,6012,19,0,72,64,8,5389,22,0,151,136,15,11401,41,0,9.0,3.0,12.0,11,14,25,0,0,0,0,0,0,2020-12-27 19:15:002020-12-27 19:15:002020-12-27 19:15:002020-12-27 19:15:002020-12-27 19:15:002020-12-27 19:15:00
928,2088,Couñago,4063,[2001],Ipswich Town,8,1,7,250,0,0,4,0,4,99,0,0,12,1,11,349,0,0,0.0,0.0,0.0,0,0,0,0,0,0,0,0,0,2020-12-27 19:15:00
929,2089,Craig Beattie,4002,[2008],West Bromwich Albion,4,0,4,58,1,0,3,1,2,92,0,0,7,1,6,150,1,0,0.0,0.0,0.0,0,0,0,0,0,0,0,0,0,2020-12-27 19:15:00
930,2090,Craig Bellamy,2012,[2000],Leeds United,1,1,0,90,0,0,0,0,0,0,0,0,1,1,0,90,0,0,0.0,0.0,0.0,0,0,0,0,0,0,0,0,0,2020-12-27 19:15:00
931,8370,Craig Bellamy,2012,"[2001, 2002, 2003, 2004]",Newcastle United,44,42,2,3723,16,0,43,40,3,3562,12,0,87,82,5,7285,28,0,10.0,0.0,10.0,10,8,18,0,0,0,0,0,0,2020-12-27 19:15:002020-12-27 19:15:002020-12-27 19:15:002020-12-27 19:15:00
932,2095,Craig Bellamy,2012,[2005],Blackburn Rovers,14,11,3,986,7,0,13,11,2,1027,6,0,27,22,5,2013,13,0,3.0,0.0,3.0,3,4,7,0,1,1,0,0,0,2020-12-27 19:15:00
933,4196,Craig Bellamy,2012,"[2006, 2011]",Liverpool FC,21,11,10,1001,5,0,33,24,9,2158,8,0,54,35,19,3159,13,0,1.0,0.0,1.0,5,3,8,0,0,0,0,0,0,2020-12-27 19:15:002020-12-27 19:15:00
934,4195,Craig Bellamy,2012,"[2007, 2008]",West Ham United,11,9,2,789,2,0,12,11,1,956,5,0,23,20,3,1745,7,0,0.0,0.0,0.0,0,3,3,0,0,0,0,0,0,2020-12-27 19:15:002020-12-27 19:15:00
935,2099,Craig Bellamy,2012,[2009],Manchester City,17,11,6,1085,4,0,14,14,0,1230,6,0,31,25,6,2315,10,0,0.0,1.0,1.0,3,4,7,0,0,0,0,0,0,2020-12-27 19:15:00
936,2101,Craig Bellamy,2012,[2013],Cardiff City,10,7,3,650,2,0,12,6,6,603,0,0,22,13,9,1253,2,0,0.0,0.0,0.0,2,0,2,0,0,0,0,0,0,2020-12-27 19:15:00
937,4205,Craig Burley,3412,"[2000, 2001]",Derby County,17,17,0,1457,1,0,17,17,0,1514,1,0,34,34,0,2971,2,0,3.0,0.0,3.0,1,1,2,0,0,0,0,0,0,2020-12-27 19:15:002020-12-27 19:15:00
938,2104,Craig Cathcart,1918,[2010],Blackpool FC,16,15,1,1275,1,0,14,13,1,1113,0,0,30,28,2,2388,1,0,0.0,0.0,0.0,1,0,1,0,0,0,0,0,0,2020-12-27 19:15:00
939,10535,Craig Cathcart,1918,"[2015, 2016, 2017, 2018, 2019]",Watford FC,61,58,3,5168,2,0,61,57,4,5154,2,0,122,115,7,10322,4,0,3.0,0.0,3.0,1,2,3,0,0,0,0,0,0,2020-12-27 19:15:002020-12-27 19:15:002020-12-27 19:15:002020-12-27 19:15:002020-12-27 19:15:00
940,14791,Craig Dawson,1655,"[2011, 2012, 2013, 2014, 2015, 2016, 2017]",West Bromwich Albion,74,73,1,6479,9,0,79,76,3,6867,3,0,153,149,4,13346,12,0,0.0,1.0,1.0,4,3,7,0,0,0,0,0,0,2020-12-27 19:15:002020-12-27 19:15:002020-12-27 19:15:002020-12-27 19:15:002020-12-27 19:15:002020-12-27 19:15:002020-12-27 19:15:00
941,2117,Craig Dawson,1655,[2019],Watford FC,15,13,2,1188,2,0,14,13,1,1171,0,0,29,26,3,2359,2,0,1.0,0.0,1.0,2,0,2,0,0,0,0,0,0,2020-12-27 19:15:00
942,2118,Craig Dawson,1655,[2020],West Ham United,0,0,0,0,0,0,0,0,0,0,0,0,0,0,0,0,0,0,0.0,0.0,0.0,0,0,0,0,0,0,0,0,0,2020-12-27 19:15:00
943,2119,Craig Eastmond,3490,[2009],Arsenal FC,1,0,1,13,0,0,3,2,1,158,0,0,4,2,2,171,0,0,0.0,0.0,0.0,0,0,0,0,0,0,0,0,0,2020-12-27 19:15:00
944,2120,Craig Fagan,1576,[2002],Birmingham City,0,0,0,0,0,0,1,0,1,9,0,0,1,0,1,9,0,0,0.0,0.0,0.0,0,0,0,0,0,0,0,0,0,2020-12-27 19:15:00
945,2121,Craig Fagan,1576,[2007],Derby County,10,7,3,666,0,0,12,10,2,816,0,0,22,17,5,1482,0,0,0.0,0.0,0.0,0,0,0,0,0,0,0,0,0,2020-12-27 19:15:00
946,4245,Craig Fagan,1576,"[2008, 2009]",Hull City,24,17,7,1521,3,0,23,18,5,1766,2,0,47,35,12,3287,5,0,0.0,1.0,1.0,2,1,3,1,0,1,0,0,0,2020-12-27 19:15:002020-12-27 19:15:00
947,2124,Craig Fleming,2385,[2004],Norwich City,18,18,0,1620,1,0,19,19,0,1710,0,0,37,37,0,3330,1,0,0.0,0.0,0.0,1,0,1,0,0,0,0,0,0,2020-12-27 19:15:00
948,2125,Craig Forrest,2338,[2000],West Ham United,1,0,1,45,0,0,2,2,0,180,0,0,3,2,1,225,0,0,0.0,0.0,0.0,0,0,0,0,0,0,0,0,0,2020-12-27 19:15:00
949,8510,Craig Gardner,1403,"[2005, 2006, 2007, 2008]",Aston Villa,28,17,11,1579,2,0,30,15,15,1332,3,0,58,32,26,2911,5,0,3.0,0.0,3.0,2,2,4,0,0,0,0,0,0,2020-12-27 19:15:002020-12-27 19:15:002020-12-27 19:15:002020-12-27 19:15:00
950,4261,Craig Gardner,1403,"[2009, 2010]",Birmingham City,20,17,3,1547,7,0,22,18,4,1627,2,0,42,35,7,3174,9,0,6.0,0.0,6.0,5,1,6,1,0,1,0,0,0,2020-12-27 19:15:002020-12-27 19:15:00
951,6399,Craig Gardner,1403,"[2011, 2012, 2013]",Sunderland AFC,43,30,13,2940,7,0,38,31,7,2825,4,0,81,61,20,5765,11,0,1.0,0.0,1.0,3,3,6,3,2,5,0,0,0,2020-12-27 19:15:002020-12-27 19:15:002020-12-27 19:15:00
952,6408,Craig Gardner,1403,"[2014, 2015, 2016]",West Bromwich Albion,41,25,16,2429,3,0,37,27,10,2502,3,0,78,52,26,4931,6,0,3.0,1.0,4.0,3,2,5,0,0,0,0,0,0,2020-12-27 19:15:002020-12-27 19:15:002020-12-27 19:15:00
953,10700,Craig Gordon,1691,"[2007, 2008, 2009, 2010, 2011]",Sunderland AFC,45,45,0,4050,0,0,42,42,0,3757,0,0,87,87,0,7807,0,0,0.0,0.0,0.0,0,0,0,0,0,0,0,0,0,2020-12-27 19:15:002020-12-27 19:15:002020-12-27 19:15:002020-12-27 19:15:002020-12-27 19:15:00
954,4287,Craig Hignett,1455,"[2001, 2002]",Blackburn Rovers,11,1,10,222,2,0,9,3,6,423,3,0,20,4,16,645,5,0,0.0,3.0,3.0,0,2,2,0,0,0,0,0,0,2020-12-27 19:15:002020-12-27 19:15:00
955,2145,Craig Hignett,1455,[2003],Leicester City,6,1,5,154,1,0,7,2,5,137,0,0,13,3,10,291,1,0,1.0,0.0,1.0,1,0,1,0,0,0,0,0,0,2020-12-27 19:15:00
956,4293,Craig Lynch,1693,"[2010, 2011]",Sunderland AFC,2,0,2,28,0,0,0,0,0,0,0,0,2,0,2,28,0,0,0.0,0.0,0.0,0,0,0,0,0,0,0,0,0,2020-12-27 19:15:002020-12-27 19:15:00
957,4297,Craig Moore,2972,"[2005, 2006]",Newcastle United,11,11,0,928,0,0,13,13,0,1109,0,0,24,24,0,2037,0,0,0.0,0.0,0.0,0,0,0,0,0,0,0,0,0,2020-12-27 19:15:002020-12-27 19:15:00
958,2150,Craig Noone,3462,[2013],Cardiff City,11,8,3,769,0,0,6,5,1,454,1,0,17,13,4,1223,1,0,0.0,0.0,0.0,0,1,1,0,0,0,0,0,0,2020-12-27 19:15:00
959,8610,Craig Short,1133,"[2001, 2002, 2003, 2004]",Blackburn Rovers,39,37,2,3154,2,0,40,39,1,3401,1,0,79,76,3,6555,3,0,1.0,1.0,2.0,1,1,2,0,0,0,0,0,0,2020-12-27 19:15:002020-12-27 19:15:002020-12-27 19:15:002020-12-27 19:15:00
960,2155,Craig Strachan,3973,[2000],Coventry City,1,1,0,88,0,0,1,1,0,84,0,0,2,2,0,172,0,0,0.0,0.0,0.0,0,0,0,0,0,0,0,0,0,2020-12-27 19:15:00
961,2156,Cristhian Stuani,3009,[2016],Middlesbrough FC,10,9,1,686,1,0,13,7,6,675,3,0,23,16,7,1361,4,0,0.0,0.0,0.0,1,2,3,0,0,0,0,0,0,2020-12-27 19:15:00
962,4315,Cristian Ceballos,4466,"[2012, 2014]",Tottenham Hotspur,0,0,0,0,0,0,0,0,0,0,0,0,0,0,0,0,0,0,0.0,0.0,0.0,0,0,0,0,0,0,0,0,0,2020-12-27 19:15:002020-12-27 19:15:00
963,4319,Cristian Gamboa,3568,"[2014, 2015]",West Bromwich Albion,5,0,5,101,0,0,6,1,5,159,0,0,11,1,10,260,0,0,0.0,0.0,0.0,0,0,0,0,0,0,0,0,0,2020-12-27 19:15:002020-12-27 19:15:00
964,2161,Cristian Riveros,3239,[2010],Sunderland AFC,3,2,1,181,0,0,9,3,6,320,1,0,12,5,7,501,1,0,0.0,0.0,0.0,0,0,0,0,0,0,0,0,0,2020-12-27 19:15:00
965,12987,Cristiano Ronaldo,1726,"[2003, 2004, 2005, 2006, 2007, 2008]",Manchester United,101,84,17,7676,57,0,94,72,22,6834,27,0,195,156,39,14510,84,0,12.0,13.0,25.0,27,16,43,8,3,11,0,0,0,2020-12-27 19:15:002020-12-27 19:15:002020-12-27 19:15:002020-12-27 19:15:002020-12-27 19:15:002020-12-27 19:15:00
966,4337,Crusat,2882,"[2011, 2012]",Wigan Athletic,9,3,6,280,1,0,6,1,5,206,0,0,15,4,11,486,1,0,0.0,0.0,0.0,1,0,1,0,0,0,0,0,0,2020-12-27 19:15:002020-12-27 19:15:00
967,2170,Csaba Somogyi,4506,[2012],Fulham FC,0,0,0,0,0,0,0,0,0,0,0,0,0,0,0,0,0,0,0.0,0.0,0.0,0,0,0,0,0,0,0,0,0,2020-12-27 19:15:00
968,4343,Cuco Martina,1049,"[2015, 2016]",Southampton FC,14,10,4,962,1,0,10,7,3,711,0,0,24,17,7,1673,1,0,0.0,0.0,0.0,1,0,1,0,0,0,0,0,0,2020-12-27 19:15:002020-12-27 19:15:00
969,4347,Cuco Martina,1049,"[2017, 2019]",Everton FC,12,11,1,1020,0,0,9,9,0,810,0,0,21,20,1,1830,0,0,0.0,0.0,0.0,0,0,0,0,0,0,0,0,0,2020-12-27 19:15:002020-12-27 19:15:00
970,2175,Curtis Davies,2224,[2005],West Bromwich Albion,15,15,0,1350,1,0,16,16,0,1440,1,0,31,31,0,2790,2,0,0.0,0.0,0.0,0,1,1,0,0,0,0,0,0,2020-12-27 19:15:00
971,6531,Curtis Davies,2224,"[2007, 2008, 2009]",Aston Villa,20,19,1,1692,1,0,24,21,3,1815,2,0,44,40,4,3507,3,0,0.0,0.0,0.0,1,1,2,0,0,0,0,0,0,2020-12-27 19:15:002020-12-27 19:15:002020-12-27 19:15:00
972,2179,Curtis Davies,2224,[2010],Birmingham City,2,1,1,113,0,0,4,1,3,221,0,0,6,2,4,334,0,0,0.0,0.0,0.0,0,0,0,0,0,0,0,0,0,2020-12-27 19:15:00
973,6543,Curtis Davies,2224,"[2013, 2014, 2016]",Hull City,42,42,0,3676,2,0,42,41,1,3605,0,0,84,83,1,7281,2,0,0.0,0.0,0.0,1,0,1,0,0,0,0,0,0,2020-12-27 19:15:002020-12-27 19:15:002020-12-27 19:15:00
974,4367,Curtis Fleming,2065,"[2000, 2001]",Middlesbrough FC,19,19,0,1602,0,0,18,17,1,1516,0,0,37,36,1,3118,0,0,0.0,0.0,0.0,0,0,0,0,0,0,0,0,0,2020-12-27 19:15:002020-12-27 19:15:00
975,2185,Curtis Good,4536,[2012],Newcastle United,0,0,0,0,0,0,0,0,0,0,0,0,0,0,0,0,0,0,0.0,0.0,0.0,0,0,0,0,0,0,0,0,0,2020-12-27 19:15:00
976,8750,Curtis Jones,2310,"[2017, 2018, 2019, 2020]",Liverpool FC,9,6,3,545,1,0,7,1,6,180,0,0,16,7,9,725,1,0,0.0,0.0,0.0,0,0,0,0,0,0,0,0,0,2020-12-27 19:15:002020-12-27 19:15:002020-12-27 19:15:002020-12-27 19:15:00
977,2190,Curtis Woodhouse,3454,[2002],Birmingham City,0,0,0,0,0,0,3,0,3,43,0,0,3,0,3,43,0,0,0.0,0.0,0.0,0,0,0,0,0,0,0,0,0,2020-12-27 19:15:00
978,2191,Cyril Chapuis,4281,[2003],Leeds United,1,0,1,44,0,0,0,0,0,0,0,0,1,0,1,44,0,0,0.0,0.0,0.0,0,0,0,0,0,0,0,0,0,2020-12-27 19:15:00
979,4385,Cyrus Christie,3911,"[2018, 2020]",Fulham FC,15,10,5,1053,0,0,13,9,4,890,0,0,28,19,9,1943,0,0,0.0,0.0,0.0,0,0,0,0,0,0,0,0,0,2020-12-27 19:15:002020-12-27 19:15:00
980,2194,Cédric Kipré,1081,[2020],West Bromwich Albion,0,0,0,0,0,0,0,0,0,0,0,0,0,0,0,0,0,0,0.0,0.0,0.0,0,0,0,0,0,0,0,0,0,2020-12-27 19:15:00
981,2195,Cédric Roussel,3782,[2000],Coventry City,7,6,1,464,0,0,8,3,5,389,2,0,15,9,6,853,2,0,0.0,3.0,3.0,0,1,1,0,0,0,0,0,0,2020-12-27 19:15:00
982,10990,Cédric Soares,1910,"[2015, 2016, 2017, 2018, 2019]",Southampton FC,60,59,1,5164,1,0,60,58,2,4928,0,0,120,117,3,10092,1,0,0.0,0.0,0.0,0,0,0,0,0,0,0,0,0,2020-12-27 19:15:002020-12-27 19:15:002020-12-27 19:15:002020-12-27 19:15:002020-12-27 19:15:00
983,2201,Cédric Soares,1910,[2020],Arsenal FC,1,0,1,5,0,0,0,0,0,0,0,0,1,0,1,5,0,0,0.0,0.0,0.0,0,0,0,0,0,0,0,0,0,2020-12-27 19:15:00
984,2202,César Martín,4305,[2006],Bolton Wanderers,0,0,0,0,0,0,1,0,1,1,0,0,1,0,1,1,0,0,0.0,0.0,0.0,0,0,0,0,0,0,0,0,0,2020-12-27 19:15:00
985,2203,DJ Campbell,2167,[2005],Birmingham City,6,2,4,243,0,0,5,2,3,259,0,0,11,4,7,502,0,0,0.0,0.0,0.0,0,0,0,0,0,0,0,0,0,2020-12-27 19:15:00
986,2204,DJ Campbell,2167,[2010],Blackpool FC,16,16,0,1440,8,0,15,14,1,1234,5,0,31,30,1,2674,13,0,4.0,3.0,7.0,5,3,8,0,0,0,0,0,0,2020-12-27 19:15:00
987,4411,DJ Campbell,2167,"[2011, 2012]",Queens Park Rangers,6,2,4,201,0,0,5,0,5,121,1,0,11,2,9,322,1,0,0.0,0.0,0.0,0,0,0,0,0,0,0,0,0,2020-12-27 19:15:002020-12-27 19:15:00
988,2207,DaMarcus Beasley,1877,[2006],Manchester City,7,6,1,536,0,0,11,5,6,490,3,0,18,11,7,1026,3,0,0.0,3.0,3.0,0,2,2,0,0,0,0,0,0,2020-12-27 19:15:00
989,2208,Dael Fry,4331,[2016],Middlesbrough FC,0,0,0,0,0,0,0,0,0,0,0,0,0,0,0,0,0,0,0.0,0.0,0.0,0,0,0,0,0,0,0,0,0,2020-12-27 19:15:00
990,8842,Dale Stephens,2421,"[2017, 2018, 2019, 2020]",Brighton & Hove Albion,48,45,3,3996,0,0,51,48,3,4316,1,0,99,93,6,8312,1,0,0.0,0.0,0.0,0,1,1,0,0,0,0,0,0,2020-12-27 19:15:002020-12-27 19:15:002020-12-27 19:15:002020-12-27 19:15:00
991,2213,Dale Stephens,2421,[2020],Burnley FC,2,2,0,136,0,0,2,1,1,84,0,0,4,3,1,220,0,0,0.0,0.0,0.0,0,0,0,0,0,0,0,0,0,2020-12-27 19:15:00
992,8862,Daley Blind,2186,"[2014, 2015, 2016, 2017]",Manchester United,47,46,1,3971,2,0,43,38,5,3507,2,0,90,84,6,7478,4,0,0.0,2.0,2.0,2,2,4,0,0,0,0,0,0,2020-12-27 19:15:002020-12-27 19:15:002020-12-27 19:15:002020-12-27 19:15:00
993,2218,Dame N'Doye,3176,[2014],Hull City,8,8,0,698,3,0,7,5,2,498,2,0,15,13,2,1196,5,0,3.0,0.0,3.0,2,1,3,0,0,0,0,0,0,2020-12-27 19:15:00
994,2219,Dame N'Doye,3176,[2015],Sunderland AFC,5,2,3,218,1,0,6,3,3,349,0,0,11,5,6,567,1,0,0.0,0.0,0.0,1,0,1,0,0,0,0,0,0,2020-12-27 19:15:00
995,4441,Damien Delaney,1022,"[2000, 2001]",Leicester City,3,2,1,189,0,0,5,3,2,342,0,0,8,5,3,531,0,0,0.0,0.0,0.0,0,0,0,0,0,0,0,0,0,2020-12-27 19:15:002020-12-27 19:15:00
996,11120,Damien Delaney,1022,"[2013, 2014, 2015, 2016, 2017]",Crystal Palace,65,59,6,5259,1,0,65,60,5,5490,2,0,130,119,11,10749,3,0,0.0,0.0,0.0,0,1,1,0,0,0,0,0,0,2020-12-27 19:15:002020-12-27 19:15:002020-12-27 19:15:002020-12-27 19:15:002020-12-27 19:15:00
997,4455,Damien Duff,1348,"[2001, 2002]",Blackburn Rovers,28,28,0,2390,10,0,27,26,1,2333,6,0,55,54,1,4723,16,0,3.0,0.0,3.0,7,3,10,0,0,0,0,0,0,2020-12-27 19:15:002020-12-27 19:15:00
998,6690,Damien Duff,1348,"[2003, 2004, 2005]",Chelsea FC,41,29,12,2703,7,0,40,34,6,2772,7,0,81,63,18,5475,14,0,6.0,1.0,7.0,4,3,7,0,0,0,0,0,0,2020-12-27 19:15:002020-12-27 19:15:002020-12-27 19:15:00
999,6699,Damien Duff,1348,"[2006, 2007, 2008]",Newcastle United,35,27,8,2446,1,0,31,31,0,2637,3,0,66,58,8,5083,4,0,3.0,1.0,4.0,1,3,4,0,0,0,0,0,0,2020-12-27 19:15:002020-12-27 19:15:002020-12-27 19:15:00
1000,11185,Damien Duff,1348,"[2009, 2010, 2011, 2012, 2013]",Fulham FC,62,55,7,4632,8,0,66,54,12,4765,6,0,128,109,19,9397,14,0,7.0,1.0,8.0,6,2,8,0,0,0,0,0,0,2020-12-27 19:15:002020-12-27 19:15:002020-12-27 19:15:002020-12-27 19:15:002020-12-27 19:15:00
1001,2240,Damien Francis,2117,[2004],Norwich City,15,15,0,1338,5,0,16,16,0,1438,2,0,31,31,0,2776,7,0,6.0,1.0,7.0,5,2,7,0,0,0,0,0,0,2020-12-27 19:15:00
1002,2241,Damien Francis,2117,[2005],Wigan Athletic,11,9,2,816,0,0,9,7,2,633,1,0,20,16,4,1449,1,0,0.0,3.0,3.0,0,1,1,0,0,0,0,0,0,2020-12-27 19:15:00
1003,2242,Damien Francis,2117,[2006],Watford FC,15,14,1,1174,2,0,14,11,3,1011,2,0,29,25,4,2185,4,0,0.0,0.0,0.0,1,1,2,0,0,0,0,0,0,2020-12-27 19:15:00
1004,2243,Damien Johnson,2503,[2001],Blackburn Rovers,4,4,0,306,1,0,2,2,0,125,0,0,6,6,0,431,1,0,0.0,0.0,0.0,0,0,0,0,0,0,0,0,0,2020-12-27 19:15:00
1005,13479,Damien Johnson,2503,"[2002, 2003, 2004, 2005, 2007, 2009]",Birmingham City,77,75,2,6513,2,0,72,71,1,6255,0,0,149,146,3,12768,2,0,3.0,0.0,3.0,2,0,2,0,0,0,0,0,0,2020-12-27 19:15:002020-12-27 19:15:002020-12-27 19:15:002020-12-27 19:15:002020-12-27 19:15:002020-12-27 19:15:00
1006,4501,Damien Plessis,3160,"[2007, 2008]",Liverpool FC,0,0,0,0,0,0,3,3,0,226,0,0,3,3,0,226,0,0,0.0,0.0,0.0,0,0,0,0,0,0,0,0,0,2020-12-27 19:15:002020-12-27 19:15:00
1007,2252,Dan Adshead,3726,[2019],Norwich City,0,0,0,0,0,0,0,0,0,0,0,0,0,0,0,0,0,0,0.0,0.0,0.0,0,0,0,0,0,0,0,0,0,2020-12-27 19:15:00
1008,2253,Dan Burn,2420,[2013],Fulham FC,4,2,2,258,0,0,5,4,1,348,0,0,9,6,3,606,0,0,0.0,0.0,0.0,0,0,0,0,0,0,0,0,0,2020-12-27 19:15:00
1009,6765,Dan Burn,2420,"[2018, 2019, 2020]",Brighton & Hove Albion,20,19,1,1621,0,0,22,20,2,1834,0,0,42,39,3,3455,0,0,0.0,0.0,0.0,0,0,0,0,0,0,0,0,0,2020-12-27 19:15:002020-12-27 19:15:002020-12-27 19:15:00
1010,4515,Dan Gosling,1005,"[2008, 2009]",Everton FC,11,3,8,387,3,0,10,5,5,452,1,0,21,8,13,839,4,0,0.0,0.0,0.0,1,0,1,0,0,0,0,0,0,2020-12-27 19:15:002020-12-27 19:15:00
1011,9042,Dan Gosling,1005,"[2010, 2011, 2012, 2013]",Newcastle United,9,2,7,301,0,0,15,3,12,363,1,0,24,5,19,664,1,0,0.0,0.0,0.0,0,0,0,0,0,0,0,0,0,2020-12-27 19:15:002020-12-27 19:15:002020-12-27 19:15:002020-12-27 19:15:00
1012,11325,Dan Gosling,1005,"[2015, 2016, 2017, 2018, 2019]",AFC Bournemouth,67,47,20,4118,7,0,71,49,22,4581,5,0,138,96,42,8699,12,0,1.0,3.0,4.0,5,4,9,0,0,0,0,0,0,2020-12-27 19:15:002020-12-27 19:15:002020-12-27 19:15:002020-12-27 19:15:002020-12-27 19:15:00
1013,4537,Dan N'Lundulu,4562,"[2019, 2020]",Southampton FC,4,0,4,16,0,0,1,0,1,1,0,0,5,0,5,17,0,0,0.0,0.0,0.0,0,0,0,0,0,0,0,0,0,2020-12-27 19:15:002020-12-27 19:15:00
1014,2270,Dan Petrescu,2898,[2000],Bradford City,8,7,1,592,0,0,7,7,0,520,1,0,15,14,1,1112,1,0,0.0,1.0,1.0,0,1,1,0,0,0,0,0,0,2020-12-27 19:15:00
1015,2271,Dan Petrescu,2898,[2001],Southampton FC,1,0,1,20,0,0,1,0,1,35,0,0,2,0,2,55,0,0,0.0,0.0,0.0,0,0,0,0,0,0,0,0,0,2020-12-27 19:15:00
1016,4545,Dan Potts,4163,"[2012, 2013]",West Ham United,0,0,0,0,0,0,2,1,1,117,0,0,2,1,1,117,0,0,0.0,0.0,0.0,0,0,0,0,0,0,0,0,0,2020-12-27 19:15:002020-12-27 19:15:00
1017,2274,Dan Smith,3761,[2005],Sunderland AFC,1,0,1,28,0,0,2,1,1,63,0,0,3,1,2,91,0,0,0.0,0.0,0.0,0,0,0,0,0,0,0,0,0,2020-12-27 19:15:00
1018,4551,Dani Ceballos,2511,"[2019, 2020]",Arsenal FC,20,16,4,1452,0,0,17,10,7,1094,0,0,37,26,11,2546,0,0,0.0,0.0,0.0,0,0,0,0,0,0,0,0,0,2020-12-27 19:15:002020-12-27 19:15:00
1019,4555,Dani Pacheco,3171,"[2009, 2010]",Liverpool FC,2,0,2,17,0,0,3,0,3,29,0,0,5,0,5,46,0,0,0.0,0.0,0.0,0,0,0,0,0,0,0,0,0,2020-12-27 19:15:002020-12-27 19:15:00
1020,20547,Daniel Agger,1776,"[2005, 2006, 2007, 2008, 2009, 2010, 2011, 2012, 2013]",Liverpool FC,90,82,8,7328,7,0,85,74,11,6759,2,0,175,156,19,14087,9,0,3.0,0.0,3.0,4,1,5,0,0,0,0,0,0,2020-12-27 19:15:002020-12-27 19:15:002020-12-27 19:15:002020-12-27 19:15:002020-12-27 19:15:002020-12-27 19:15:002020-12-27 19:15:002020-12-27 19:15:002020-12-27 19:15:00
1021,2288,Daniel Agyei,3721,[2016],Burnley FC,1,0,1,15,0,0,2,0,2,8,0,0,3,0,3,23,0,0,0.0,0.0,0.0,0,0,0,0,0,0,0,0,0,2020-12-27 19:15:00
1022,2289,Daniel Alfei,2941,[2013],Swansea City,0,0,0,0,0,0,0,0,0,0,0,0,0,0,0,0,0,0,0.0,0.0,0.0,0,0,0,0,0,0,0,0,0,2020-12-27 19:15:00
1023,11460,Daniel Amartey,2666,"[2015, 2016, 2017, 2018, 2020]",Leicester City,24,16,8,1477,0,0,25,17,8,1611,1,0,49,33,16,3088,1,0,0.0,1.0,1.0,0,1,1,0,0,0,0,0,0,2020-12-27 19:15:002020-12-27 19:15:002020-12-27 19:15:002020-12-27 19:15:002020-12-27 19:15:00
1024,2295,Daniel Ayala,3003,[2009],Liverpool FC,2,1,1,123,0,0,3,1,2,111,0,0,5,2,3,234,0,0,0.0,0.0,0.0,0,0,0,0,0,0,0,0,0,2020-12-27 19:15:00
1025,2296,Daniel Ayala,3003,[2011],Norwich City,4,3,1,227,0,0,3,3,0,270,0,0,7,6,1,497,0,0,0.0,0.0,0.0,0,0,0,0,0,0,0,0,0,2020-12-27 19:15:00
1026,2297,Daniel Ayala,3003,[2016],Middlesbrough FC,5,4,1,345,1,0,9,7,2,572,0,0,14,11,3,917,1,0,0.0,0.0,0.0,1,0,1,0,0,0,0,0,0,2020-12-27 19:15:00
1027,2298,Daniel Bachmann,3485,[2015],Stoke City,0,0,0,0,0,0,0,0,0,0,0,0,0,0,0,0,0,0,0.0,0.0,0.0,0,0,0,0,0,0,0,0,0,2020-12-27 19:15:00
1028,2299,Daniel Bachmann,3485,[2017],Watford FC,0,0,0,0,0,0,0,0,0,0,0,0,0,0,0,0,0,0,0.0,0.0,0.0,0,0,0,0,0,0,0,0,0,2020-12-27 19:15:00
1029,2300,Daniel Barlaser,4202,[2015],Newcastle United,0,0,0,0,0,0,0,0,0,0,0,0,0,0,0,0,0,0,0.0,0.0,0.0,0,0,0,0,0,0,0,0,0,2020-12-27 19:15:00
1030,2301,Daniel Batty,4549,[2016],Hull City,0,0,0,0,0,0,0,0,0,0,0,0,0,0,0,0,0,0,0.0,0.0,0.0,0,0,0,0,0,0,0,0,0,2020-12-27 19:15:00
1031,2302,Daniel Braaten,4289,[2007],Bolton Wanderers,1,0,1,15,1,0,5,0,5,129,0,0,6,0,6,144,1,0,0.0,0.0,0.0,0,0,0,0,0,0,0,0,0,2020-12-27 19:15:00
1032,2303,Daniel Carriço,3745,[2012],Reading FC,2,1,1,79,0,0,1,0,1,9,0,0,3,1,2,88,0,0,0.0,0.0,0.0,0,0,0,0,0,0,0,0,0,2020-12-27 19:15:00
1033,2304,Daniel Cordone,3397,[2000],Newcastle United,8,6,2,465,2,0,12,6,6,567,0,0,20,12,8,1032,2,0,0.0,0.0,0.0,1,0,1,0,0,0,0,0,0,2020-12-27 19:15:00
1034,4611,Daniel Cousin,2324,"[2008, 2009]",Hull City,16,11,5,870,2,0,14,8,6,790,2,0,30,19,11,1660,4,0,0.0,3.0,3.0,2,2,4,0,0,0,0,0,0,2020-12-27 19:15:002020-12-27 19:15:00
1035,11545,Daniel Gabbidon,2464,"[2005, 2006, 2007, 2009, 2010]",West Ham United,45,41,4,3759,0,0,50,47,3,4143,0,0,95,88,7,7902,0,0,0.0,0.0,0.0,0,0,0,0,0,0,0,0,0,2020-12-27 19:15:002020-12-27 19:15:002020-12-27 19:15:002020-12-27 19:15:002020-12-27 19:15:00
1036,2312,Daniel Gabbidon,2464,[2011],Queens Park Rangers,7,7,0,630,0,0,10,8,2,794,0,0,17,15,2,1424,0,0,0.0,0.0,0.0,0,0,0,0,0,0,0,0,0,2020-12-27 19:15:00
1037,2313,Daniel Gabbidon,2464,[2013],Crystal Palace,11,11,0,981,1,0,12,11,1,993,0,0,23,22,1,1974,1,0,0.0,0.0,0.0,1,0,1,0,0,0,0,0,0,2020-12-27 19:15:00
1038,2314,Daniel James,2989,[2016],Swansea City,0,0,0,0,0,0,0,0,0,0,0,0,0,0,0,0,0,0,0.0,0.0,0.0,0,0,0,0,0,0,0,0,0,2020-12-27 19:15:00
1039,4631,Daniel James,2989,"[2019, 2020]",Manchester United,20,15,5,1325,3,0,18,16,2,1290,1,0,38,31,7,2615,4,0,0.0,0.0,0.0,1,1,2,0,0,0,0,0,0,2020-12-27 19:15:002020-12-27 19:15:00
1040,6954,Daniel Johnson,2599,"[2010, 2011, 2013]",Aston Villa,0,0,0,0,0,0,0,0,0,0,0,0,0,0,0,0,0,0,0.0,0.0,0.0,0,0,0,0,0,0,0,0,0,2020-12-27 19:15:002020-12-27 19:15:002020-12-27 19:15:00
1041,2320,Daniel Kemp,4558,[2016],West Ham United,0,0,0,0,0,0,0,0,0,0,0,0,0,0,0,0,0,0,0.0,0.0,0.0,0,0,0,0,0,0,0,0,0,2020-12-27 19:15:00
1042,2321,Daniel Langley,1085,[2020],Newcastle United,0,0,0,0,0,0,0,0,0,0,0,0,0,0,0,0,0,0,0.0,0.0,0.0,0,0,0,0,0,0,0,0,0,2020-12-27 19:15:00
1043,2322,Daniel Osvaldo,3711,[2013],Southampton FC,7,4,3,424,3,0,6,5,1,431,0,0,13,9,4,855,3,0,1.0,0.0,1.0,3,0,3,0,0,0,0,0,0,2020-12-27 19:15:00
1044,4647,Daniel Podence,3346,"[2019, 2020]",Wolverhampton Wanderers,13,10,3,832,3,0,10,7,3,548,1,0,23,17,6,1380,4,0,0.0,3.0,3.0,2,1,3,0,0,0,0,0,0,2020-12-27 19:15:002020-12-27 19:15:00
1045,2325,Daniel Pudil,4407,[2015],Watford FC,0,0,0,0,0,0,0,0,0,0,0,0,0,0,0,0,0,0,0.0,0.0,0.0,0,0,0,0,0,0,0,0,0,2020-12-27 19:15:00
1046,2326,Daniel Redmond,4294,[2012],Wigan Athletic,0,0,0,0,0,0,0,0,0,0,0,0,0,0,0,0,0,0,0.0,0.0,0.0,0,0,0,0,0,0,0,0,0,2020-12-27 19:15:00
1047,6984,Daniel Sturridge,1428,"[2006, 2007, 2008]",Manchester City,12,3,9,361,3,0,8,2,6,248,2,0,20,5,15,609,5,0,0.0,1.0,1.0,1,1,2,1,0,1,0,0,0,2020-12-27 19:15:002020-12-27 19:15:002020-12-27 19:15:00
1048,6995,Daniel Sturridge,1428,"[2009, 2011, 2012]",Chelsea FC,23,13,10,1193,5,0,27,18,9,1526,8,0,50,31,19,2719,13,0,0.0,1.0,1.0,3,4,7,0,0,0,0,0,0,2020-12-27 19:15:002020-12-27 19:15:002020-12-27 19:15:00
1049,2331,Daniel Sturridge,1428,[2010],Bolton Wanderers,7,6,1,557,5,0,5,5,0,420,3,0,12,11,1,977,8,0,3.0,1.0,4.0,3,3,6,0,0,0,0,0,0,2020-12-27 19:15:00
1050,11681,Daniel Sturridge,1428,"[2013, 2014, 2015, 2016, 2018]",Liverpool FC,46,28,18,2584,23,0,47,27,20,2690,16,0,93,55,38,5274,39,0,12.0,6.0,18.0,8,11,19,0,0,0,0,0,0,2020-12-27 19:15:002020-12-27 19:15:002020-12-27 19:15:002020-12-27 19:15:002020-12-27 19:15:00
1051,2338,Daniel Sturridge,1428,[2017],West Bromwich Albion,2,1,1,78,0,0,4,1,3,38,0,0,6,2,4,116,0,0,0.0,0.0,0.0,0,0,0,0,0,0,0,0,0,2020-12-27 19:15:00
1052,2340,Daniel Van Buyten,4124,[2003],Manchester City,3,3,0,270,0,0,1,1,0,90,0,0,4,4,0,360,0,0,0.0,0.0,0.0,0,0,0,0,0,0,0,0,0,2020-12-27 19:15:00
1053,4683,Daniel Williams,3105,"[2017, 2018]",Huddersfield Town,10,4,6,460,0,0,15,8,7,752,0,0,25,12,13,1212,0,0,0.0,0.0,0.0,0,0,0,0,0,0,0,0,0,2020-12-27 19:15:002020-12-27 19:15:00
1054,2343,Daniele Daino,4450,[2001],Derby County,1,1,0,90,0,0,1,1,0,77,0,0,2,2,0,167,0,0,0.0,0.0,0.0,0,0,0,0,0,0,0,0,0,2020-12-27 19:15:00
1055,2344,Daniele Padelli,4326,[2006],Liverpool FC,1,1,0,90,0,0,0,0,0,0,0,0,1,1,0,90,0,0,0.0,0.0,0.0,0,0,0,0,0,0,0,0,0,2020-12-27 19:15:00
1056,4691,Danilo,1206,"[2017, 2018]",Manchester City,16,10,6,1002,2,0,18,12,6,1146,2,0,34,22,12,2148,4,0,0.0,0.0,0.0,1,2,3,0,0,0,0,0,0,2020-12-27 19:15:002020-12-27 19:15:00
1057,2347,Daniël de Ridder,3242,[2007],Birmingham City,4,3,1,287,0,0,6,3,3,291,0,0,10,6,4,578,0,0,0.0,0.0,0.0,0,0,0,0,0,0,0,0,0,2020-12-27 19:15:00
1058,4697,Daniël de Ridder,3242,"[2008, 2010]",Wigan Athletic,8,3,5,342,0,0,10,2,8,233,0,0,18,5,13,575,0,0,0.0,0.0,0.0,0,0,0,0,0,0,0,0,0,2020-12-27 19:15:002020-12-27 19:15:00
1059,2350,Danny Allsopp,4330,[2000],West Ham United,1,0,1,15,0,0,0,0,0,0,0,0,1,0,1,15,0,0,0.0,0.0,0.0,0,0,0,0,0,0,0,0,0,2020-12-27 19:15:00
1060,2351,Danny Batth,4095,[2010],Wolverhampton Wanderers,0,0,0,0,0,0,0,0,0,0,0,0,0,0,0,0,0,0,0.0,0.0,0.0,0,0,0,0,0,0,0,0,0,2020-12-27 19:15:00
1061,2352,Danny Butterfield,4059,[2004],Crystal Palace,3,3,0,237,0,0,4,4,0,312,0,0,7,7,0,549,0,0,0.0,0.0,0.0,0,0,0,0,0,0,0,0,0,2020-12-27 19:15:00
1062,4707,Danny Cadamarteri,3773,"[2000, 2001]",Everton FC,9,4,5,428,3,0,10,5,5,409,1,0,19,9,10,837,4,0,0.0,0.0,0.0,3,0,3,0,0,0,0,0,0,2020-12-27 19:15:002020-12-27 19:15:00
1063,7068,Danny Collins,1215,"[2005, 2007, 2008]",Sunderland AFC,47,45,2,4048,1,0,46,43,3,4026,2,0,93,88,5,8074,3,0,0.0,0.0,0.0,1,1,2,0,0,0,0,0,0,2020-12-27 19:15:002020-12-27 19:15:002020-12-27 19:15:00
1064,7077,Danny Collins,1215,"[2009, 2010, 2011]",Stoke City,24,21,3,1932,0,0,26,24,2,2177,0,0,50,45,5,4109,0,0,0.0,0.0,0.0,0,0,0,0,0,0,0,0,0,2020-12-27 19:15:002020-12-27 19:15:002020-12-27 19:15:00
1065,2361,Danny Coyne,3164,[2003],Leicester City,2,0,2,54,0,0,2,1,1,102,0,0,4,1,3,156,0,0,0.0,0.0,0.0,0,0,0,0,0,0,0,0,0,2020-12-27 19:15:00
1066,2362,Danny Crow,4098,[2004],Norwich City,1,0,1,23,0,0,2,0,2,17,0,0,3,0,3,40,0,0,0.0,0.0,0.0,0,0,0,0,0,0,0,0,0,2020-12-27 19:15:00
1067,2363,Danny Dichio,3082,[2000],Sunderland AFC,7,1,6,206,1,0,8,1,7,184,0,0,15,2,13,390,1,0,0.0,0.0,0.0,0,0,0,0,0,0,0,0,0,2020-12-27 19:15:00
1068,2364,Danny Dichio,3082,[2002],West Bromwich Albion,15,10,5,1019,5,0,12,9,3,841,0,0,27,19,8,1860,5,0,3.0,0.0,3.0,5,0,5,0,0,0,0,0,0,2020-12-27 19:15:00
1069,7098,Danny Drinkwater,2522,"[2014, 2015, 2016]",Leicester City,45,40,5,3554,3,0,42,38,4,3442,1,0,87,78,9,6996,4,0,0.0,1.0,1.0,2,1,3,0,0,0,0,0,0,2020-12-27 19:15:002020-12-27 19:15:002020-12-27 19:15:00
1070,4737,Danny Drinkwater,2522,"[2017, 2018]",Chelsea FC,5,2,3,205,1,0,7,3,4,317,0,0,12,5,7,522,1,0,0.0,0.0,0.0,0,0,0,0,0,0,0,0,0,2020-12-27 19:15:002020-12-27 19:15:00
1071,2370,Danny Drinkwater,2522,[2019],Burnley FC,1,1,0,59,0,0,0,0,0,0,0,0,1,1,0,59,0,0,0.0,0.0,0.0,0,0,0,0,0,0,0,0,0,2020-12-27 19:15:00
1072,2371,Danny Fox,2870,[2009],Burnley FC,8,7,1,608,1,0,6,6,0,540,0,0,14,13,1,1148,1,0,0.0,0.0,0.0,0,0,0,0,0,0,0,0,0,2020-12-27 19:15:00
1073,4745,Danny Fox,2870,"[2012, 2013]",Southampton FC,13,11,2,892,0,0,10,6,4,590,1,0,23,17,6,1482,1,0,0.0,0.0,0.0,0,0,0,0,0,0,0,0,0,2020-12-27 19:15:002020-12-27 19:15:00
1074,4749,Danny Graham,2317,"[2004, 2005]",Middlesbrough FC,7,0,7,77,1,0,7,1,6,152,0,0,14,1,13,229,1,0,1.0,0.0,1.0,1,0,1,0,0,0,0,0,0,2020-12-27 19:15:002020-12-27 19:15:00
1075,2376,Danny Graham,2317,[2006],Watford FC,1,0,1,10,0,0,0,0,0,0,0,0,1,0,1,10,0,0,0.0,0.0,0.0,0,0,0,0,0,0,0,0,0,2020-12-27 19:15:00
1076,4755,Danny Graham,2317,"[2011, 2012]",Swansea City,27,21,6,1825,11,0,27,21,6,1919,4,0,54,42,12,3744,15,0,7.0,3.0,10.0,5,3,8,1,0,1,0,0,0,2020-12-27 19:15:002020-12-27 19:15:00
1077,2379,Danny Graham,2317,[2013],Hull City,9,5,4,501,0,0,9,7,2,499,1,0,18,12,6,1000,1,0,0.0,0.0,0.0,0,1,1,0,0,0,0,0,0,2020-12-27 19:15:00
1078,4761,Danny Graham,2317,"[2014, 2015]",Sunderland AFC,9,4,5,417,0,0,15,7,8,567,1,0,24,11,13,984,1,0,0.0,0.0,0.0,0,1,1,0,0,0,0,0,0,2020-12-27 19:15:002020-12-27 19:15:00
1079,2382,Danny Granville,2021,[2000],Manchester City,9,8,1,632,0,0,9,7,2,606,0,0,18,15,3,1238,0,0,0.0,0.0,0.0,0,0,0,0,0,0,0,0,0,2020-12-27 19:15:00
1080,2383,Danny Granville,2021,[2004],Crystal Palace,19,19,0,1674,1,0,15,15,0,1350,2,0,34,34,0,3024,3,0,0.0,0.0,0.0,0,2,2,0,0,0,0,0,0,2020-12-27 19:15:00
1081,2384,Danny Guthrie,2397,[2006],Liverpool FC,1,0,1,6,0,0,2,0,2,26,0,0,3,0,3,32,0,0,0.0,0.0,0.0,0,0,0,0,0,0,0,0,0,2020-12-27 19:15:00
1082,2385,Danny Guthrie,2397,[2007],Bolton Wanderers,12,12,0,1019,0,0,12,9,3,848,0,0,24,21,3,1867,0,0,0.0,0.0,0.0,0,0,0,0,0,0,0,0,0,2020-12-27 19:15:00
1083,7161,Danny Guthrie,2397,"[2008, 2010, 2011]",Newcastle United,28,23,5,2070,0,0,25,21,4,1873,3,0,53,44,9,3943,3,0,0.0,0.0,0.0,0,1,1,0,1,1,0,0,0,2020-12-27 19:15:002020-12-27 19:15:002020-12-27 19:15:00
1084,2389,Danny Guthrie,2397,[2012],Reading FC,11,10,1,818,0,0,10,9,1,800,1,0,21,19,2,1618,1,0,0.0,0.0,0.0,0,1,1,0,0,0,0,0,0,2020-12-27 19:15:00
1085,2390,Danny Hay,4252,[2000],Leeds United,2,0,2,119,0,0,2,2,0,180,0,0,4,2,2,299,0,0,0.0,0.0,0.0,0,0,0,0,0,0,0,0,0,2020-12-27 19:15:00
1086,4783,Danny Higginbotham,1990,"[2000, 2001]",Derby County,27,27,0,2427,0,0,30,27,3,2442,1,0,57,54,3,4869,1,0,0.0,0.0,0.0,0,0,0,0,1,1,0,0,0,2020-12-27 19:15:002020-12-27 19:15:00
1087,7182,Danny Higginbotham,1990,"[2002, 2003, 2004]",Southampton FC,22,18,4,1726,0,0,32,26,6,2474,1,0,54,44,10,4200,1,0,0.0,1.0,1.0,0,1,1,0,0,0,0,0,0,2020-12-27 19:15:002020-12-27 19:15:002020-12-27 19:15:00
1088,2396,Danny Higginbotham,1990,[2007],Sunderland AFC,9,9,0,810,3,0,11,11,0,990,0,0,20,20,0,1800,3,0,0.0,0.0,0.0,3,0,3,0,0,0,0,0,0,2020-12-27 19:15:00
1089,9594,Danny Higginbotham,1990,"[2008, 2009, 2010, 2011]",Stoke City,35,34,1,3049,4,0,29,27,2,2372,0,0,64,61,3,5421,4,0,0.0,0.0,0.0,3,0,3,1,0,1,0,0,0,2020-12-27 19:15:002020-12-27 19:15:002020-12-27 19:15:002020-12-27 19:15:00
1090,2401,Danny Hoesen,4498,[2010],Fulham FC,0,0,0,0,0,0,0,0,0,0,0,0,0,0,0,0,0,0,0.0,0.0,0.0,0,0,0,0,0,0,0,0,0,2020-12-27 19:15:00
1091,2402,Danny Ings,1193,[2014],Burnley FC,18,18,0,1593,5,0,17,17,0,1442,6,0,35,35,0,3035,11,0,4.0,6.0,10.0,3,5,8,1,0,1,0,0,0,2020-12-27 19:15:00
1092,4807,Danny Ings,1193,"[2015, 2017]",Liverpool FC,7,2,5,253,1,0,7,4,3,351,2,0,14,6,8,604,3,0,0.0,0.0,0.0,1,2,3,0,0,0,0,0,0,2020-12-27 19:15:002020-12-27 19:15:00
1093,7218,Danny Ings,1193,"[2018, 2019, 2020]",Southampton FC,37,34,3,2782,15,0,36,31,5,2591,20,0,73,65,8,5373,35,0,5.0,9.0,14.0,10,13,23,3,3,6,0,0,0,2020-12-27 19:15:002020-12-27 19:15:002020-12-27 19:15:00
1094,2408,Danny Lafferty,4093,[2014],Burnley FC,1,0,1,16,0,0,0,0,0,0,0,0,1,0,1,16,0,0,0.0,0.0,0.0,0,0,0,0,0,0,0,0,0,2020-12-27 19:15:00
1095,2409,Danny Livesey,4445,[2002],Bolton Wanderers,1,0,1,60,0,0,1,0,1,15,0,0,2,0,2,75,0,0,0.0,0.0,0.0,0,0,0,0,0,0,0,0,0,2020-12-27 19:15:00
1096,7233,Danny Mills,1292,"[2000, 2001, 2002]",Leeds United,35,34,1,3024,0,0,38,37,1,3300,2,0,73,71,2,6324,2,0,0.0,0.0,0.0,0,1,1,0,0,0,0,0,0,2020-12-27 19:15:002020-12-27 19:15:002020-12-27 19:15:00
1097,2413,Danny Mills,1292,[2003],Middlesbrough FC,15,15,0,1343,0,0,12,12,0,1070,0,0,27,27,0,2413,0,0,0.0,0.0,0.0,0,0,0,0,0,0,0,0,0,2020-12-27 19:15:00
1098,7245,Danny Mills,1292,"[2004, 2005, 2006]",Manchester City,28,25,3,2221,1,0,17,16,1,1360,0,0,45,41,4,3581,1,0,0.0,0.0,0.0,1,0,1,0,0,0,0,0,0,2020-12-27 19:15:002020-12-27 19:15:002020-12-27 19:15:00
1099,2417,Danny Mills,1292,[2007],Derby County,1,1,0,90,0,0,1,1,0,32,0,0,2,2,0,122,0,0,0.0,0.0,0.0,0,0,0,0,0,0,0,0,0,2020-12-27 19:15:00
1100,7259,Danny Murphy,1398,"[2000, 2002, 2003]",Liverpool FC,44,30,14,2938,6,0,44,33,11,3111,10,0,88,63,25,6049,16,0,0.0,12.0,12.0,4,8,12,2,3,5,0,0,0,2020-12-27 19:15:002020-12-27 19:15:002020-12-27 19:15:00
1101,2419,Danny Murphy,1398,[2001],West Ham United,1,1,0,59,0,0,0,0,0,0,0,0,1,1,0,59,0,0,0.0,0.0,0.0,0,0,0,0,0,0,0,0,0,2020-12-27 19:15:00
1102,4845,Danny Murphy,1398,"[2004, 2005]",Charlton Athletic,28,27,1,2377,3,0,26,25,1,2189,4,0,54,52,2,4566,7,0,1.0,0.0,1.0,1,3,4,0,1,1,0,0,0,2020-12-27 19:15:002020-12-27 19:15:00
1103,2424,Danny Murphy,1398,[2006],Tottenham Hotspur,6,2,4,246,1,0,5,3,2,312,1,0,11,5,6,558,2,0,0.0,0.0,0.0,1,0,1,0,0,0,0,0,0,2020-12-27 19:15:00
1104,12135,Danny Murphy,1398,"[2007, 2008, 2009, 2010, 2011]",Fulham FC,83,80,3,6808,14,0,79,74,5,6388,4,0,162,154,8,13196,18,0,5.0,3.0,8.0,10,3,13,10,2,12,0,0,0,2020-12-27 19:15:002020-12-27 19:15:002020-12-27 19:15:002020-12-27 19:15:002020-12-27 19:15:00
1105,2430,Danny Pugh,2756,[2002],Manchester United,1,0,1,5,0,0,0,0,0,0,0,0,1,0,1,5,0,0,0.0,0.0,0.0,0,0,0,0,0,0,0,0,0,2020-12-27 19:15:00
1106,9730,Danny Pugh,2756,"[2008, 2009, 2010, 2011]",Stoke City,17,7,10,740,1,0,20,8,12,995,0,0,37,15,22,1735,1,0,0.0,0.0,0.0,1,0,1,0,0,0,0,0,0,2020-12-27 19:15:002020-12-27 19:15:002020-12-27 19:15:002020-12-27 19:15:00
1107,24402,Danny Rose,1399,"[2009, 2010, 2011, 2013, 2014, 2015, 2016, 2017, 2018, 2019]",Tottenham Hotspur,83,74,9,6520,7,0,73,64,9,5705,1,0,156,138,18,12225,8,0,7.0,3.0,10.0,5,1,6,0,0,0,0,0,0,2020-12-27 19:15:002020-12-27 19:15:002020-12-27 19:15:002020-12-27 19:15:002020-12-27 19:15:002020-12-27 19:15:002020-12-27 19:15:002020-12-27 19:15:002020-12-27 19:15:002020-12-27 19:15:00
1108,2438,Danny Rose,1399,[2012],Sunderland AFC,14,14,0,1207,0,0,13,11,2,1043,1,0,27,25,2,2250,1,0,0.0,0.0,0.0,0,1,1,0,0,0,0,0,0,2020-12-27 19:15:00
1109,2446,Danny Seaborne,2874,[2012],Southampton FC,0,0,0,0,0,0,0,0,0,0,0,0,0,0,0,0,0,0,0.0,0.0,0.0,0,0,0,0,0,0,0,0,0,2020-12-27 19:15:00
1110,2447,Danny Shittu,2116,[2006],Watford FC,12,10,2,869,0,0,15,14,1,1205,1,0,27,24,3,2074,1,0,0.0,0.0,0.0,0,1,1,0,0,0,0,0,0,2020-12-27 19:15:00
1111,2448,Danny Shittu,2116,[2008],Bolton Wanderers,5,5,0,450,0,0,5,4,1,340,0,0,10,9,1,790,0,0,0.0,0.0,0.0,0,0,0,0,0,0,0,0,0,2020-12-27 19:15:00
1112,2449,Danny Simpson,2395,[2007],Manchester United,3,1,2,129,0,0,0,0,0,0,0,0,3,1,2,129,0,0,0.0,0.0,0.0,0,0,0,0,0,0,0,0,0,2020-12-27 19:15:00
1113,2450,Danny Simpson,2395,[2008],Blackburn Rovers,6,5,1,439,0,0,6,5,1,450,0,0,12,10,2,889,0,0,0.0,0.0,0.0,0,0,0,0,0,0,0,0,0,2020-12-27 19:15:00
1114,7356,Danny Simpson,2395,"[2010, 2011, 2012]",Newcastle United,42,42,0,3635,0,0,42,41,1,3696,0,0,84,83,1,7331,0,0,0.0,0.0,0.0,0,0,0,0,0,0,0,0,0,2020-12-27 19:15:002020-12-27 19:15:002020-12-27 19:15:00
1115,12280,Danny Simpson,2395,"[2014, 2015, 2016, 2017, 2018]",Leicester City,54,51,3,4464,0,0,59,56,3,4963,0,0,113,107,6,9427,0,0,0.0,0.0,0.0,0,0,0,0,0,0,0,0,0,2020-12-27 19:15:002020-12-27 19:15:002020-12-27 19:15:002020-12-27 19:15:002020-12-27 19:15:00
1116,7380,Danny Tiatto,3199,"[2000, 2002, 2003]",Manchester City,27,20,7,1954,1,0,21,19,2,1628,1,0,48,39,9,3582,2,0,1.0,0.0,1.0,1,0,1,0,0,0,0,0,0,2020-12-27 19:15:002020-12-27 19:15:002020-12-27 19:15:00
1117,2462,Danny Ward,2444,[2009],Bolton Wanderers,1,0,1,7,0,0,1,0,1,9,0,0,2,0,2,16,0,0,0.0,0.0,0.0,0,0,0,0,0,0,0,0,0,2020-12-27 19:15:00
1118,9858,Danny Ward,2444,"[2013, 2014, 2015, 2017]",Liverpool FC,0,0,0,0,0,0,2,2,0,180,0,0,2,2,0,180,0,0,0.0,0.0,0.0,0,0,0,0,0,0,0,0,0,2020-12-27 19:15:002020-12-27 19:15:002020-12-27 19:15:002020-12-27 19:15:00
1119,7404,Danny Ward,2444,"[2018, 2019, 2020]",Leicester City,0,0,0,0,0,0,0,0,0,0,0,0,0,0,0,0,0,0,0.0,0.0,0.0,0,0,0,0,0,0,0,0,0,2020-12-27 19:15:002020-12-27 19:15:002020-12-27 19:15:00
1120,2470,Danny Webber,3335,[2006],Sheffield United,11,6,5,517,1,0,11,7,4,638,2,0,22,13,9,1155,3,0,0.0,6.0,6.0,1,2,3,0,0,0,0,0,0,2020-12-27 19:15:00
1121,2471,Danny Webber,3335,[2009],Portsmouth FC,7,1,6,84,1,0,10,3,7,380,0,0,17,4,13,464,1,0,1.0,0.0,1.0,1,0,1,0,0,0,0,0,0,2020-12-27 19:15:00
1122,12373,Danny Welbeck,1506,"[2008, 2009, 2011, 2012, 2013]",Manchester United,43,29,14,2575,11,0,46,23,23,2410,9,0,89,52,37,4985,20,0,0.0,6.0,6.0,4,4,8,0,0,0,0,0,0,2020-12-27 19:15:002020-12-27 19:15:002020-12-27 19:15:002020-12-27 19:15:002020-12-27 19:15:00
1123,2474,Danny Welbeck,1506,[2010],Sunderland AFC,13,11,2,902,4,0,13,10,3,864,2,0,26,21,5,1766,6,0,3.0,0.0,3.0,4,1,5,0,0,0,0,0,0,2020-12-27 19:15:00
1124,12400,Danny Welbeck,1506,"[2014, 2015, 2016, 2017, 2018]",Arsenal FC,42,20,22,1990,10,0,46,26,20,2330,6,0,88,46,42,4320,16,0,10.0,3.0,13.0,7,2,9,0,0,0,0,0,0,2020-12-27 19:15:002020-12-27 19:15:002020-12-27 19:15:002020-12-27 19:15:002020-12-27 19:15:00
1125,2483,Danny Welbeck,1506,[2019],Watford FC,8,3,5,367,1,0,10,5,5,449,1,0,18,8,10,816,2,0,3.0,0.0,3.0,1,0,1,0,0,0,0,0,0,2020-12-27 19:15:00
1126,2484,Danny Welbeck,1506,[2020],Brighton & Hove Albion,4,3,1,282,1,0,5,4,1,341,1,0,9,7,2,623,2,0,1.0,0.0,1.0,1,1,2,0,0,0,0,0,0,2020-12-27 19:15:00
1127,2485,Danny Wilson,3738,[2010],Liverpool FC,0,0,0,0,0,0,2,1,1,155,0,0,2,1,1,155,0,0,0.0,0.0,0.0,0,0,0,0,0,0,0,0,0,2020-12-27 19:15:00
1128,2486,Dara O'Shea,1032,[2020],West Bromwich Albion,5,4,1,370,0,0,5,5,0,450,0,0,10,9,1,820,0,0,0.0,0.0,0.0,0,0,0,0,0,0,0,0,0,2020-12-27 19:15:00
1129,2487,Darius Henderson,2120,[2006],Watford FC,15,10,5,860,1,0,17,11,6,1066,2,0,32,21,11,1926,3,0,0.0,3.0,3.0,1,1,2,0,1,1,0,0,0,2020-12-27 19:15:00
1130,12450,Darius Vassell,1798,"[2000, 2001, 2002, 2003, 2004]",Aston Villa,72,54,18,4971,20,0,69,49,20,4392,15,0,141,103,38,9363,35,0,9.0,3.0,12.0,13,9,22,1,1,2,0,0,0,2020-12-27 19:15:002020-12-27 19:15:002020-12-27 19:15:002020-12-27 19:15:002020-12-27 19:15:00
1131,9978,Darius Vassell,1798,"[2005, 2006, 2007, 2008]",Manchester City,51,45,6,3779,9,0,50,44,6,3871,8,0,101,89,12,7650,17,0,1.0,6.0,7.0,5,6,11,0,0,0,0,0,0,2020-12-27 19:15:002020-12-27 19:15:002020-12-27 19:15:002020-12-27 19:15:00
1132,2497,Darnell Furlong,2924,[2014],Queens Park Rangers,1,1,0,90,0,0,2,2,0,136,0,0,3,3,0,226,0,0,0.0,0.0,0.0,0,0,0,0,0,0,0,0,0,2020-12-27 19:15:00
1133,2498,Darnell Furlong,2924,[2020],West Bromwich Albion,7,7,0,609,0,0,7,7,0,630,1,0,14,14,0,1239,1,0,0.0,0.0,0.0,0,1,1,0,0,0,0,1,1,2020-12-27 19:15:00
1134,2499,Darnell Johnson,4462,[2019],Leicester City,0,0,0,0,0,0,0,0,0,0,0,0,0,0,0,0,0,0,0.0,0.0,0.0,0,0,0,0,0,0,0,0,0,2020-12-27 19:15:00
1135,2500,Darren Ambrose,1956,[2001],Ipswich Town,0,0,0,0,0,0,1,0,1,5,0,0,1,0,1,5,0,0,0.0,0.0,0.0,0,0,0,0,0,0,0,0,0,2020-12-27 19:15:00
1136,7506,Darren Ambrose,1956,"[2002, 2003, 2004]",Newcastle United,17,9,8,836,0,0,18,7,11,711,5,0,35,16,19,1547,5,0,0.0,2.0,2.0,0,5,5,0,0,0,0,0,0,2020-12-27 19:15:002020-12-27 19:15:002020-12-27 19:15:00
1137,5009,Darren Ambrose,1956,"[2005, 2006]",Charlton Athletic,28,19,9,1763,4,0,26,21,5,1709,2,0,54,40,14,3472,6,0,0.0,1.0,1.0,3,2,5,0,0,0,0,0,0,2020-12-27 19:15:002020-12-27 19:15:00
1138,10030,Darren Anderton,2082,"[2000, 2001, 2002, 2003]",Tottenham Hotspur,49,45,4,3904,4,0,47,42,5,3797,3,0,96,87,9,7701,7,0,0.0,0.0,0.0,3,3,6,2,0,2,0,0,0,2020-12-27 19:15:002020-12-27 19:15:002020-12-27 19:15:002020-12-27 19:15:00
1139,2510,Darren Anderton,2082,[2004],Birmingham City,8,3,5,304,1,0,11,6,5,555,2,0,19,9,10,859,3,0,0.0,3.0,3.0,0,2,2,0,0,0,0,0,0,2020-12-27 19:15:00
1140,2511,Darren Bent,1958,[2001],Ipswich Town,4,1,3,160,1,0,1,1,0,69,0,0,5,2,3,229,1,0,3.0,0.0,3.0,1,0,1,0,0,0,0,0,0,2020-12-27 19:15:00
1141,5025,Darren Bent,1958,"[2005, 2006]",Charlton Athletic,34,34,0,3012,20,0,34,34,0,3016,12,0,68,68,0,6028,32,0,15.0,3.0,18.0,15,7,22,4,2,6,0,0,0,2020-12-27 19:15:002020-12-27 19:15:00
1142,5029,Darren Bent,1958,"[2007, 2008]",Tottenham Hotspur,31,15,16,1602,8,0,28,17,11,1670,10,0,59,32,27,3272,18,0,3.0,4.0,7.0,3,7,10,1,0,1,0,0,0,2020-12-27 19:15:002020-12-27 19:15:00
1143,2516,Darren Bent,1958,[2009],Sunderland AFC,19,19,0,1681,16,0,18,18,0,1619,8,0,37,37,0,3300,24,0,6.0,6.0,12.0,9,7,16,4,1,5,0,0,0,2020-12-27 19:15:00
1144,10075,Darren Bent,1958,"[2010, 2011, 2012, 2014]",Aston Villa,32,22,10,2061,10,0,29,23,6,2086,11,0,61,45,16,4147,21,0,5.0,0.0,5.0,6,8,14,1,1,2,0,0,0,2020-12-27 19:15:002020-12-27 19:15:002020-12-27 19:15:002020-12-27 19:15:00
1145,2520,Darren Bent,1958,[2013],Fulham FC,12,5,7,584,2,0,12,6,6,656,1,0,24,11,13,1240,3,0,3.0,1.0,4.0,1,1,2,0,0,0,0,0,0,2020-12-27 19:15:00
1146,7569,Darren Carter,1515,"[2002, 2003, 2004]",Birmingham City,15,8,7,742,1,0,16,7,9,664,1,0,31,15,16,1406,2,0,1.0,0.0,1.0,1,1,2,0,0,0,0,0,0,2020-12-27 19:15:002020-12-27 19:15:002020-12-27 19:15:00
1147,2525,Darren Carter,1515,[2005],West Bromwich Albion,11,6,5,598,1,0,8,5,3,504,0,0,19,11,8,1102,1,0,3.0,0.0,3.0,1,0,1,0,0,0,0,0,0,2020-12-27 19:15:00
1148,2526,Darren Eadie,2830,[2000],Leicester City,12,7,5,654,0,0,12,9,3,802,2,0,24,16,8,1456,2,0,0.0,3.0,3.0,0,1,1,0,0,0,0,0,0,2020-12-27 19:15:00
1149,30390,Darren Fletcher,1730,"[2003, 2004, 2005, 2006, 2007, 2008, 2009, 2010, 2011, 2012, 2013, 2014]",Manchester United,107,82,25,7258,10,0,117,98,19,8403,8,0,224,180,44,15661,18,0,4.0,6.0,10.0,7,7,14,0,0,0,0,0,0,2020-12-27 19:15:002020-12-27 19:15:002020-12-27 19:15:002020-12-27 19:15:002020-12-27 19:15:002020-12-27 19:15:002020-12-27 19:15:002020-12-27 19:15:002020-12-27 19:15:002020-12-27 19:15:002020-12-27 19:15:002020-12-27 19:15:00
1150,5079,Darren Fletcher,1730,"[2015, 2016]",West Bromwich Albion,38,37,1,3279,3,0,38,38,0,3332,0,0,76,75,1,6611,3,0,3.0,0.0,3.0,2,0,2,0,0,0,0,0,0,2020-12-27 19:15:002020-12-27 19:15:00
1151,2541,Darren Fletcher,1730,[2017],Stoke City,13,13,0,1050,0,0,14,12,2,1173,1,0,27,25,2,2223,1,0,0.0,3.0,3.0,0,1,1,0,0,0,0,0,0,2020-12-27 19:15:00
1152,2542,Darren Holloway,4173,[2000],Sunderland AFC,1,1,0,90,0,0,2,2,0,135,0,0,3,3,0,225,0,0,0.0,0.0,0.0,0,0,0,0,0,0,0,0,0,2020-12-27 19:15:00
1153,2543,Darren Huckerby,2389,[2000],Leeds United,3,0,3,59,0,0,3,1,2,99,0,0,6,1,5,158,0,0,0.0,0.0,0.0,0,0,0,0,0,0,0,0,0,2020-12-27 19:15:00
1154,2544,Darren Huckerby,2389,[2002],Manchester City,7,3,4,290,1,0,9,3,6,287,0,0,16,6,10,577,1,0,3.0,0.0,3.0,1,0,1,0,0,0,0,0,0,2020-12-27 19:15:00
1155,2545,Darren Huckerby,2389,[2004],Norwich City,17,16,1,1419,4,0,19,19,0,1681,2,0,36,35,1,3100,6,0,0.0,1.0,1.0,3,1,4,2,0,2,0,0,0,2020-12-27 19:15:00
1156,5093,Darren Kenton,3531,"[2003, 2004]",Southampton FC,7,4,3,455,0,0,8,7,1,612,0,0,15,11,4,1067,0,0,0.0,0.0,0.0,0,0,0,0,0,0,0,0,0,2020-12-27 19:15:002020-12-27 19:15:00
1157,7647,Darren Moore,1317,"[2002, 2004, 2005]",West Bromwich Albion,26,22,4,1800,1,0,23,19,4,1849,1,0,49,41,8,3649,2,0,3.0,3.0,6.0,1,1,2,0,0,0,0,0,0,2020-12-27 19:15:002020-12-27 19:15:002020-12-27 19:15:00
1158,2551,Darren Moore,1317,[2007],Derby County,15,14,1,1130,0,0,16,15,1,1337,0,0,31,29,2,2467,0,0,0.0,0.0,0.0,0,0,0,0,0,0,0,0,0,2020-12-27 19:15:00
1159,2552,Darren Potter,3936,[2004],Liverpool FC,0,0,0,0,0,0,2,0,2,54,0,0,2,0,2,54,0,0,0.0,0.0,0.0,0,0,0,0,0,0,0,0,0,2020-12-27 19:15:00
1160,2553,Darren Powell,3826,[2004],Crystal Palace,2,2,0,180,0,0,4,2,2,261,1,0,6,4,2,441,1,0,0.0,0.0,0.0,0,0,0,0,0,0,0,0,0,2020-12-27 19:15:00
1161,2554,Darren Pratley,3818,[2003],Fulham FC,0,0,0,0,0,0,1,0,1,16,0,0,1,0,1,16,0,0,0.0,0.0,0.0,0,0,0,0,0,0,0,0,0,2020-12-27 19:15:00
1162,2555,Darren Pratley,3818,[2011],Bolton Wanderers,12,7,5,632,1,0,13,7,6,641,0,0,25,14,11,1273,1,0,0.0,0.0,0.0,1,0,1,0,0,0,0,0,0,2020-12-27 19:15:00
1163,5113,Darren Purse,1318,"[2002, 2003]",Birmingham City,14,14,0,1249,1,0,15,14,1,1261,0,0,29,28,1,2510,1,0,0.0,0.0,0.0,1,0,1,0,0,0,0,0,0,2020-12-27 19:15:002020-12-27 19:15:00
1164,2558,Darren Purse,1318,[2004],West Bromwich Albion,11,11,0,990,0,0,12,12,0,1080,0,0,23,23,0,2070,0,0,0.0,0.0,0.0,0,0,0,0,0,0,0,0,0,2020-12-27 19:15:00
1165,2559,Darren Randolph,2637,[2006],Charlton Athletic,0,0,0,0,0,0,1,1,0,90,0,0,1,1,0,90,0,0,0.0,0.0,0.0,0,0,0,0,0,0,0,0,0,2020-12-27 19:15:00
1166,10246,Darren Randolph,2637,"[2015, 2016, 2019, 2020]",West Ham United,15,15,0,1350,0,0,15,15,0,1350,0,0,30,30,0,2700,0,0,0.0,0.0,0.0,0,0,0,0,0,0,0,0,0,2020-12-27 19:15:002020-12-27 19:15:002020-12-27 19:15:002020-12-27 19:15:00
1167,2564,Darren Ward,4220,[2004],Norwich City,0,0,0,0,0,0,1,0,1,27,0,0,1,0,1,27,0,0,0.0,0.0,0.0,0,0,0,0,0,0,0,0,0,2020-12-27 19:15:00
1168,2565,Darren Ward,4220,[2007],Sunderland AFC,2,2,0,180,0,0,1,1,0,90,0,0,3,3,0,270,0,0,0.0,0.0,0.0,0,0,0,0,0,0,0,0,0,2020-12-27 19:15:00
1169,7701,Darren Williams,1094,"[2000, 2001, 2002]",Sunderland AFC,33,25,8,2401,0,0,32,24,8,2356,0,0,65,49,16,4757,0,0,0.0,0.0,0.0,0,0,0,0,0,0,0,0,0,2020-12-27 19:15:002020-12-27 19:15:002020-12-27 19:15:00
1170,10282,Darron Gibson,2538,"[2008, 2009, 2010, 2011]",Manchester United,18,6,12,804,0,0,13,8,5,665,3,0,31,14,17,1469,3,0,0.0,3.0,3.0,0,1,1,0,0,0,0,0,0,2020-12-27 19:15:002020-12-27 19:15:002020-12-27 19:15:002020-12-27 19:15:00
1171,10298,Darron Gibson,2538,"[2012, 2013, 2014, 2015]",Everton FC,18,13,5,1174,1,0,22,14,8,1312,0,0,40,27,13,2486,1,0,0.0,0.0,0.0,1,0,1,0,0,0,0,0,0,2020-12-27 19:15:002020-12-27 19:15:002020-12-27 19:15:002020-12-27 19:15:00
1172,2577,Darron Gibson,2538,[2016],Sunderland AFC,5,4,1,384,0,0,7,3,4,257,0,0,12,7,5,641,0,0,0.0,0.0,0.0,0,0,0,0,0,0,0,0,0,2020-12-27 19:15:00
1173,5157,Darryl Powell,2621,"[2000, 2001]",Derby County,25,25,0,2053,1,0,23,23,0,1959,1,0,48,48,0,4012,2,0,0.0,0.0,0.0,1,1,2,0,0,0,0,0,0,2020-12-27 19:15:002020-12-27 19:15:00
1174,2580,Darryl Powell,2621,[2002],Birmingham City,4,1,3,122,0,0,7,2,5,233,0,0,11,3,8,355,0,0,0.0,0.0,0.0,0,0,0,0,0,0,0,0,0,2020-12-27 19:15:00
1175,5163,Daryl Janmaat,1929,"[2014, 2015]",Newcastle United,34,34,0,2994,3,0,35,35,0,3065,0,0,69,69,0,6059,3,0,0.0,0.0,0.0,1,0,1,0,0,0,0,0,0,2020-12-27 19:15:002020-12-27 19:15:00
1176,10338,Daryl Janmaat,1929,"[2016, 2017, 2018, 2019]",Watford FC,40,32,8,2784,1,0,36,31,5,2781,4,0,76,63,13,5565,5,0,0.0,0.0,0.0,1,1,2,0,0,0,0,0,0,2020-12-27 19:15:002020-12-27 19:15:002020-12-27 19:15:002020-12-27 19:15:00
1177,10354,Daryl Murphy,1900,"[2005, 2007, 2008, 2009]",Sunderland AFC,38,13,25,1347,4,0,32,19,13,1679,0,0,70,32,38,3026,4,0,1.0,0.0,1.0,2,0,2,0,0,0,0,0,0,2020-12-27 19:15:002020-12-27 19:15:002020-12-27 19:15:002020-12-27 19:15:00
1178,2591,Darío Silva,3966,[2005],Portsmouth FC,7,7,0,595,1,0,6,6,0,382,1,0,13,13,0,977,2,0,0.0,0.0,0.0,1,0,1,0,0,0,0,0,0,2020-12-27 19:15:00
1179,7779,Dave Edwards,2889,"[2009, 2010, 2011]",Wolverhampton Wanderers,30,28,2,2122,4,0,30,23,7,2024,1,0,60,51,9,4146,5,0,3.0,0.0,3.0,3,0,3,0,0,0,0,0,0,2020-12-27 19:15:002020-12-27 19:15:002020-12-27 19:15:00
1180,5191,Dave Kitson,1995,"[2006, 2007]",Reading FC,25,20,5,1793,6,0,20,15,5,1385,6,0,45,35,10,3178,12,0,3.0,1.0,4.0,4,4,8,0,0,0,0,0,0,2020-12-27 19:15:002020-12-27 19:15:00
1181,5195,Dave Kitson,1995,"[2008, 2009]",Stoke City,17,12,5,913,2,0,17,8,9,798,1,0,34,20,14,1711,3,0,3.0,0.0,3.0,2,1,3,0,0,0,0,0,0,2020-12-27 19:15:002020-12-27 19:15:00
1182,2599,Dave McEwen,3871,[2000],West Ham United,1,0,1,6,0,0,0,0,0,0,0,0,1,0,1,6,0,0,0.0,0.0,0.0,0,0,0,0,0,0,0,0,0,2020-12-27 19:15:00
1183,2600,Dave Raven,4557,[2004],Liverpool FC,0,0,0,0,0,0,1,0,1,23,0,0,1,0,1,23,0,0,0.0,0.0,0.0,0,0,0,0,0,0,0,0,0,2020-12-27 19:15:00
1184,7806,David Batty,2694,"[2000, 2001, 2003]",Leeds United,26,21,5,1883,0,0,26,21,5,1887,0,0,52,42,10,3770,0,0,0.0,0.0,0.0,0,0,0,0,0,0,0,0,0,2020-12-27 19:15:002020-12-27 19:15:002020-12-27 19:15:00
1185,7815,David Beckham,1109,"[2000, 2001, 2002]",Manchester United,46,38,8,3598,11,0,40,37,3,3333,15,0,86,75,11,6931,26,0,0.0,8.0,8.0,5,10,15,0,2,2,0,0,0,2020-12-27 19:15:002020-12-27 19:15:002020-12-27 19:15:00
1186,5215,David Bellion,1944,"[2001, 2002]",Sunderland AFC,8,3,5,370,1,0,12,2,10,409,0,0,20,5,15,779,1,0,3.0,0.0,3.0,1,0,1,0,0,0,0,0,0,2020-12-27 19:15:002020-12-27 19:15:00
1187,5219,David Bellion,1944,"[2003, 2004]",Manchester United,15,5,10,577,3,0,9,0,9,90,1,0,24,5,19,667,4,0,0.0,0.0,0.0,1,1,2,0,0,0,0,0,0,2020-12-27 19:15:002020-12-27 19:15:00
1188,2611,David Bellion,1944,[2005],West Ham United,3,1,2,85,0,0,5,1,4,130,0,0,8,2,6,215,0,0,0.0,0.0,0.0,0,0,0,0,0,0,0,0,0,2020-12-27 19:15:00
1189,2612,David Bentley,2011,[2003],Arsenal FC,0,0,0,0,0,0,1,1,0,61,0,0,1,1,0,61,0,0,0.0,0.0,0.0,0,0,0,0,0,0,0,0,0,2020-12-27 19:15:00
1190,2613,David Bentley,2011,[2004],Norwich City,12,10,2,911,0,0,13,11,2,1000,2,0,25,21,4,1911,2,0,0.0,0.0,0.0,0,1,1,0,0,0,0,0,0,2020-12-27 19:15:00
1191,7845,David Bentley,2011,"[2005, 2006, 2007]",Blackburn Rovers,52,49,3,4218,9,0,47,44,3,3928,4,0,99,93,6,8146,13,0,0.0,6.0,6.0,7,3,10,0,0,0,0,0,0,2020-12-27 19:15:002020-12-27 19:15:002020-12-27 19:15:00
1192,5235,David Bentley,2011,"[2008, 2009]",Tottenham Hotspur,18,13,5,1247,1,0,21,17,4,1475,1,0,39,30,9,2722,2,0,0.0,0.0,0.0,0,1,1,0,0,0,0,0,0,2020-12-27 19:15:002020-12-27 19:15:00
1193,2619,David Bentley,2011,[2010],Birmingham City,7,6,1,560,0,0,6,3,3,258,0,0,13,9,4,818,0,0,0.0,0.0,0.0,0,0,0,0,0,0,0,0,0,2020-12-27 19:15:00
1194,5241,David Brooks,2740,"[2018, 2019]",AFC Bournemouth,22,22,0,1605,4,0,17,15,2,1187,4,0,39,37,2,2792,8,0,0.0,0.0,0.0,2,1,3,0,0,0,0,0,0,2020-12-27 19:15:002020-12-27 19:15:00
1195,5245,David Button,2428,"[2018, 2019]",Brighton & Hove Albion,2,2,0,180,0,0,2,2,0,180,0,0,4,4,0,360,0,0,0.0,0.0,0.0,0,0,0,0,0,0,0,0,0,2020-12-27 19:15:002020-12-27 19:15:00
1196,2624,David Button,2428,[2020],West Bromwich Albion,0,0,0,0,0,0,0,0,0,0,0,0,0,0,0,0,0,0,0.0,0.0,0.0,0,0,0,0,0,0,0,0,0,2020-12-27 19:15:00
1197,2625,David Carney,2606,[2010],Blackpool FC,5,3,2,287,0,0,6,2,4,203,0,0,11,5,6,490,0,0,0.0,0.0,0.0,0,0,0,0,0,0,0,0,0,2020-12-27 19:15:00
1198,5253,David Connolly,1970,"[2005, 2006]",Wigan Athletic,9,1,8,224,0,0,10,3,7,339,1,0,19,4,15,563,1,0,0.0,0.0,0.0,0,1,1,0,0,0,0,0,0,2020-12-27 19:15:002020-12-27 19:15:00
1199,2628,David Connolly,1970,[2007],Sunderland AFC,2,0,2,37,0,0,1,1,0,58,0,0,3,1,2,95,0,0,0.0,0.0,0.0,0,0,0,0,0,0,0,0,0,2020-12-27 19:15:00
1200,7890,David Cornell,3839,"[2012, 2013, 2014]",Swansea City,0,0,0,0,0,0,0,0,0,0,0,0,0,0,0,0,0,0,0.0,0.0,0.0,0,0,0,0,0,0,0,0,0,2020-12-27 19:15:002020-12-27 19:15:002020-12-27 19:15:00
1201,5265,David Cotterill,3529,"[2006, 2007]",Wigan Athletic,10,3,7,381,0,0,8,4,4,361,1,0,18,7,11,742,1,0,0.0,0.0,0.0,0,1,1,0,0,0,0,0,0,2020-12-27 19:15:002020-12-27 19:15:00
1202,5269,David Davis,3886,"[2010, 2011]",Wolverhampton Wanderers,5,5,0,304,0,0,2,1,1,94,0,0,7,6,1,398,0,0,0.0,0.0,0.0,0,0,0,0,0,0,0,0,0,2020-12-27 19:15:002020-12-27 19:15:00
1203,2636,David Di Michele,2327,[2008],West Ham United,15,12,3,1002,4,0,14,9,5,827,0,0,29,21,8,1829,4,0,0.0,0.0,0.0,3,0,3,0,0,0,0,0,0,2020-12-27 19:15:00
1204,21142,David Dunn,1456,"[2001, 2002, 2006, 2007, 2008, 2009, 2010, 2011]",Blackburn Rovers,95,77,18,6269,17,0,89,67,22,5795,13,0,184,144,40,12064,30,0,11.0,7.0,18.0,13,10,23,3,5,8,0,0,0,2020-12-27 19:15:002020-12-27 19:15:002020-12-27 19:15:002020-12-27 19:15:002020-12-27 19:15:002020-12-27 19:15:002020-12-27 19:15:002020-12-27 19:15:00
1205,7920,David Dunn,1456,"[2003, 2004, 2005]",Birmingham City,23,18,5,1595,2,0,23,18,5,1423,4,0,46,36,10,3018,6,0,3.0,4.0,7.0,1,2,3,1,0,1,0,0,0,2020-12-27 19:15:002020-12-27 19:15:002020-12-27 19:15:00
1206,7947,David Edgar,3825,"[2006, 2007, 2008]",Newcastle United,9,4,5,413,2,0,10,7,3,614,0,0,19,11,8,1027,2,0,1.0,0.0,1.0,1,0,1,0,0,0,0,0,0,2020-12-27 19:15:002020-12-27 19:15:002020-12-27 19:15:00
1207,2651,David Edgar,3825,[2009],Burnley FC,2,0,2,59,0,0,2,2,0,180,0,0,4,2,2,239,0,0,0.0,0.0,0.0,0,0,0,0,0,0,0,0,0,2020-12-27 19:15:00
1208,5305,David Elm,3402,"[2009, 2010]",Fulham FC,5,2,3,179,1,0,5,1,4,149,0,0,10,3,7,328,1,0,0.0,0.0,0.0,0,0,0,0,0,0,0,0,0,2020-12-27 19:15:002020-12-27 19:15:00
1209,2654,David Ferguson,4042,[2012],Sunderland AFC,0,0,0,0,0,0,0,0,0,0,0,0,0,0,0,0,0,0,0.0,0.0,0.0,0,0,0,0,0,0,0,0,0,2020-12-27 19:15:00
1210,7968,David Fox,3046,"[2011, 2012, 2013]",Norwich City,14,14,0,1077,0,0,16,9,7,893,0,0,30,23,7,1970,0,0,0.0,0.0,0.0,0,0,0,0,0,0,0,0,0,2020-12-27 19:15:002020-12-27 19:15:002020-12-27 19:15:00
1211,2658,David Ginola,3869,[2000],Aston Villa,15,9,6,834,2,0,11,4,7,405,1,0,26,13,13,1239,3,0,1.0,0.0,1.0,2,0,2,0,0,0,0,0,0,2020-12-27 19:15:00
1212,2659,David Ginola,3869,[2001],Everton FC,2,1,1,100,0,0,3,1,2,84,0,0,5,2,3,184,0,0,0.0,0.0,0.0,0,0,0,0,0,0,0,0,0,2020-12-27 19:15:00
1213,2660,David Goodwillie,3424,[2011],Blackburn Rovers,10,1,9,243,1,0,10,3,7,355,1,0,20,4,16,598,2,0,0.0,1.0,1.0,0,1,1,0,0,0,0,0,0,2020-12-27 19:15:00
1214,2661,David Healy,1567,[2000],Manchester United,1,0,1,31,0,0,0,0,0,0,0,0,1,0,1,31,0,0,0.0,0.0,0.0,0,0,0,0,0,0,0,0,0,2020-12-27 19:15:00
1215,2662,David Healy,1567,[2007],Fulham FC,15,6,9,623,3,0,15,9,6,737,1,0,30,15,15,1360,4,0,0.0,0.0,0.0,1,1,2,0,0,0,0,0,0,2020-12-27 19:15:00
1216,5327,David Healy,1567,"[2008, 2009]",Sunderland AFC,6,0,6,94,1,0,7,0,7,82,0,0,13,0,13,176,1,0,0.0,0.0,0.0,0,0,0,0,0,0,0,0,0,2020-12-27 19:15:002020-12-27 19:15:00
1217,2665,David Hopkin,3256,[2000],Bradford City,5,4,1,366,0,0,6,4,2,388,0,0,11,8,3,754,0,0,0.0,0.0,0.0,0,0,0,0,0,0,0,0,0,2020-12-27 19:15:00
1218,2666,David James,1385,[2000],Aston Villa,19,19,0,1710,0,0,17,17,0,1530,0,0,36,36,0,3240,0,0,0.0,0.0,0.0,0,0,0,0,0,0,0,0,0,2020-12-27 19:15:00
1219,5335,David James,1385,"[2001, 2002]",West Ham United,29,29,0,2610,0,0,29,29,0,2610,0,0,58,58,0,5220,0,0,0.0,0.0,0.0,0,0,0,0,0,0,0,0,0,2020-12-27 19:15:002020-12-27 19:15:00
1220,8010,David James,1385,"[2003, 2004, 2005]",Manchester City,46,46,0,4140,0,0,39,39,0,3510,0,0,85,85,0,7650,0,0,0.0,0.0,0.0,0,0,0,0,0,0,0,0,0,2020-12-27 19:15:002020-12-27 19:15:002020-12-27 19:15:00
1221,10694,David James,1385,"[2006, 2007, 2008, 2009]",Portsmouth FC,65,65,0,5850,0,0,68,68,0,6104,0,0,133,133,0,11954,0,0,0.0,0.0,0.0,0,0,0,0,0,0,0,0,0,2020-12-27 19:15:002020-12-27 19:15:002020-12-27 19:15:002020-12-27 19:15:00
1222,2676,David Johnson,3878,[2000],Ipswich Town,7,4,3,335,0,0,6,2,4,272,0,0,13,6,7,607,0,0,0.0,0.0,0.0,0,0,0,0,0,0,0,0,0,2020-12-27 19:15:00
1223,2677,David Jones,1490,[2007],Derby County,9,8,1,633,0,0,5,4,1,349,1,0,14,12,2,982,1,0,0.0,0.0,0.0,0,0,0,0,0,0,0,0,0,2020-12-27 19:15:00
1224,5357,David Jones,1490,"[2009, 2010]",Wolverhampton Wanderers,14,12,2,1041,2,0,17,14,3,1253,0,0,31,26,5,2294,2,0,3.0,0.0,3.0,2,0,2,0,0,0,0,0,0,2020-12-27 19:15:002020-12-27 19:15:00
1225,5361,David Jones,1490,"[2011, 2012]",Wigan Athletic,13,11,2,1004,0,0,16,10,6,967,0,0,29,21,8,1971,0,0,0.0,0.0,0.0,0,0,0,0,0,0,0,0,0,2020-12-27 19:15:002020-12-27 19:15:00
1226,5365,David Jones,1490,"[2014, 2016]",Burnley FC,20,20,0,1777,0,0,17,17,0,1520,0,0,37,37,0,3297,0,0,0.0,0.0,0.0,0,0,0,0,0,0,0,0,0,2020-12-27 19:15:002020-12-27 19:15:00
1227,18809,David Luiz,1471,"[2010, 2011, 2012, 2013, 2016, 2017, 2018]",Chelsea FC,80,75,5,6859,9,0,79,75,4,6681,2,0,159,150,9,13540,11,0,0.0,0.0,0.0,3,2,5,0,0,0,0,0,0,2020-12-27 19:15:002020-12-27 19:15:002020-12-27 19:15:002020-12-27 19:15:002020-12-27 19:15:002020-12-27 19:15:002020-12-27 19:15:00
1228,5383,David Luiz,1471,"[2019, 2020]",Arsenal FC,23,21,2,1831,2,0,18,17,1,1566,0,0,41,38,3,3397,2,0,3.0,0.0,3.0,1,0,1,0,0,0,0,0,0,2020-12-27 19:15:002020-12-27 19:15:00
1229,2693,David Marshall,2737,[2013],Cardiff City,19,19,0,1710,0,0,18,18,0,1620,0,0,37,37,0,3330,0,0,0.0,0.0,0.0,0,0,0,0,0,0,0,0,0,2020-12-27 19:15:00
1230,2694,David Marshall,2737,[2016],Hull City,8,8,0,720,0,0,8,8,0,720,0,0,16,16,0,1440,0,0,0.0,0.0,0.0,0,0,0,0,0,0,0,0,0,2020-12-27 19:15:00
1231,14698,David Martin,2198,"[2019, 2020]",West Ham United,1,1,0,90,0,0,4,3,1,345,0,0,5,4,1,435,0,0,0.0,0.0,0.0,0,0,0,0,0,0,0,0,0,2020-12-27 19:15:002020-12-27 19:15:00
1232,8091,David May,3319,"[2000, 2001, 2002]",Manchester United,2,2,0,168,0,0,3,1,2,101,0,0,5,3,2,269,0,0,0.0,0.0,0.0,0,0,0,0,0,0,0,0,0,2020-12-27 19:15:002020-12-27 19:15:002020-12-27 19:15:00
1233,5399,David McGoldrick,3582,"[2019, 2020]",Sheffield United,22,17,5,1409,4,0,19,14,5,1162,2,0,41,31,10,2571,6,0,0.0,0.0,0.0,2,1,3,0,0,0,0,0,0,2020-12-27 19:15:002020-12-27 19:15:00
1234,10810,David Meyler,2225,"[2009, 2010, 2011, 2012]",Sunderland AFC,11,7,4,580,0,0,13,6,7,547,0,0,24,13,11,1127,0,0,0.0,0.0,0.0,0,0,0,0,0,0,0,0,0,2020-12-27 19:15:002020-12-27 19:15:002020-12-27 19:15:002020-12-27 19:15:00
1235,8118,David Meyler,2225,"[2013, 2014, 2016]",Hull City,38,28,10,2389,2,0,40,27,13,2466,2,0,78,55,23,4855,4,0,0.0,0.0,0.0,1,1,2,0,0,0,0,0,0,2020-12-27 19:15:002020-12-27 19:15:002020-12-27 19:15:00
1236,2708,David Moberg-Karlsson,4113,[2013],Sunderland AFC,0,0,0,0,0,0,0,0,0,0,0,0,0,0,0,0,0,0,0.0,0.0,0.0,0,0,0,0,0,0,0,0,0,2020-12-27 19:15:00
1237,5419,David Murphy,2135,"[2001, 2002]",Middlesbrough FC,7,1,6,176,0,0,6,3,3,224,0,0,13,4,9,400,0,0,0.0,0.0,0.0,0,0,0,0,0,0,0,0,0,2020-12-27 19:15:002020-12-27 19:15:00
1238,5423,David Murphy,2135,"[2007, 2010]",Birmingham City,13,9,4,863,1,0,11,8,3,818,0,0,24,17,7,1681,1,0,0.0,0.0,0.0,1,0,1,0,0,0,0,0,0,2020-12-27 19:15:002020-12-27 19:15:00
1239,8142,David N'Gog,1895,"[2008, 2009, 2010]",Liverpool FC,37,13,24,1332,9,0,26,8,18,1050,0,0,63,21,42,2382,9,0,0.0,0.0,0.0,5,0,5,0,0,0,0,0,0,2020-12-27 19:15:002020-12-27 19:15:002020-12-27 19:15:00
1240,2716,David N'Gog,1895,[2011],Bolton Wanderers,16,12,4,1050,0,0,17,12,5,995,3,0,33,24,9,2045,3,0,0.0,3.0,3.0,0,3,3,0,0,0,0,0,0,2020-12-27 19:15:00
1241,2717,David N'Gog,1895,[2013],Swansea City,1,0,1,17,0,0,2,0,2,26,0,0,3,0,3,43,0,0,0.0,0.0,0.0,0,0,0,0,0,0,0,0,0,2020-12-27 19:15:00
1242,5437,David Nugent,2519,"[2007, 2008]",Portsmouth FC,15,8,7,828,1,0,15,10,5,847,2,0,30,18,12,1675,3,0,0.0,0.0,0.0,1,1,2,0,0,0,0,0,0,2020-12-27 19:15:002020-12-27 19:15:00
1243,2720,David Nugent,2519,[2009],Burnley FC,15,9,6,904,5,0,15,11,4,970,1,0,30,20,10,1874,6,0,2.0,0.0,2.0,4,1,5,0,0,0,0,0,0,2020-12-27 19:15:00
1244,2721,David Nugent,2519,[2014],Leicester City,13,9,4,791,1,0,16,7,9,913,4,0,29,16,13,1704,5,0,0.0,0.0,0.0,0,2,2,1,0,1,0,0,0,2020-12-27 19:15:00
1245,2722,David Nugent,2519,[2016],Middlesbrough FC,1,0,1,2,0,0,3,0,3,38,0,0,4,0,4,40,0,0,0.0,0.0,0.0,0,0,0,0,0,0,0,0,0,2020-12-27 19:15:00
1246,10898,David Ospina,1495,"[2014, 2015, 2016, 2017]",Arsenal FC,15,14,1,1280,0,0,14,13,1,1222,0,0,29,27,2,2502,0,0,0.0,0.0,0.0,0,0,0,0,0,0,0,0,0,2020-12-27 19:15:002020-12-27 19:15:002020-12-27 19:15:002020-12-27 19:15:00
1247,2727,David Pizarro,3633,[2011],Manchester City,4,1,3,91,0,0,1,0,1,73,0,0,5,1,4,164,0,0,0.0,0.0,0.0,0,0,0,0,0,0,0,0,0,2020-12-27 19:15:00
1248,8187,David Prutton,2915,"[2002, 2003, 2004]",Southampton FC,25,19,6,1830,1,0,31,26,5,2404,1,0,56,45,11,4234,2,0,0.0,0.0,0.0,1,0,1,0,0,0,0,0,0,2020-12-27 19:15:002020-12-27 19:15:002020-12-27 19:15:00
1249,2731,David Rozehnal,3542,[2007],Newcastle United,11,8,3,774,0,0,10,8,2,715,0,0,21,16,5,1489,0,0,0.0,0.0,0.0,0,0,0,0,0,0,0,0,0,2020-12-27 19:15:00
1250,8199,David Seaman,2354,"[2000, 2001, 2002]",Arsenal FC,35,35,0,3150,0,0,33,33,0,2970,0,0,68,68,0,6120,0,0,0.0,0.0,0.0,0,0,0,0,0,0,0,0,0,2020-12-27 19:15:002020-12-27 19:15:002020-12-27 19:15:00
1251,2735,David Seaman,2354,[2003],Manchester City,8,8,0,720,0,0,10,10,0,785,0,0,18,18,0,1505,0,0,0.0,0.0,0.0,0,0,0,0,0,0,0,0,0,2020-12-27 19:15:00
1252,27405,David Silva,1211,"[2010, 2011, 2012, 2013, 2014, 2015, 2016, 2017, 2018, 2019]",Manchester City,160,145,15,12109,36,0,148,135,13,11785,22,0,308,280,28,23894,58,0,9.0,1.0,10.0,15,12,27,0,0,0,0,0,0,2020-12-27 19:15:002020-12-27 19:15:002020-12-27 19:15:002020-12-27 19:15:002020-12-27 19:15:002020-12-27 19:15:002020-12-27 19:15:002020-12-27 19:15:002020-12-27 19:15:002020-12-27 19:15:00
1253,8241,David Sommeil,1806,"[2002, 2003, 2005]",Manchester City,25,24,1,2151,3,0,20,19,1,1655,1,0,45,43,2,3806,4,0,1.0,0.0,1.0,3,1,4,0,0,0,0,0,0,2020-12-27 19:15:002020-12-27 19:15:002020-12-27 19:15:00
1254,2749,David Sommeil,1806,[2006],Sheffield United,2,2,0,180,0,0,3,2,1,148,0,0,5,4,1,328,0,0,0.0,0.0,0.0,0,0,0,0,0,0,0,0,0,2020-12-27 19:15:00
1255,13760,David Stockdale,2558,"[2009, 2010, 2011, 2012, 2013]",Fulham FC,22,21,1,1904,0,0,17,16,1,1454,0,0,39,37,2,3358,0,0,0.0,0.0,0.0,0,0,0,0,0,0,0,0,0,2020-12-27 19:15:002020-12-27 19:15:002020-12-27 19:15:002020-12-27 19:15:002020-12-27 19:15:00
1256,2755,David Thompson,2102,[2000],Leeds United,1,1,0,76,0,0,0,0,0,0,0,0,1,1,0,76,0,0,0.0,0.0,0.0,0,0,0,0,0,0,0,0,0,2020-12-27 19:15:00
1257,8271,David Thompson,2102,"[2002, 2003, 2004]",Blackburn Rovers,29,21,8,1962,3,0,29,23,6,2084,2,0,58,44,14,4046,5,0,3.0,0.0,3.0,2,2,4,0,0,0,0,0,0,2020-12-27 19:15:002020-12-27 19:15:002020-12-27 19:15:00
1258,2759,David Thompson,2102,[2005],Wigan Athletic,4,3,1,228,0,0,6,4,2,400,2,0,10,7,3,628,2,0,0.0,0.0,0.0,0,1,1,0,0,0,0,0,0,2020-12-27 19:15:00
1259,2760,David Thompson,2102,[2006],Bolton Wanderers,2,0,2,81,0,0,5,3,2,204,0,0,7,3,4,285,0,0,0.0,0.0,0.0,0,0,0,0,0,0,0,0,0,2020-12-27 19:15:00
1260,11050,David Unsworth,2582,"[2000, 2001, 2002, 2003]",Everton FC,62,49,13,4632,11,0,54,45,9,4065,5,0,116,94,22,8697,16,0,5.0,1.0,6.0,9,4,13,6,1,7,0,0,0,2020-12-27 19:15:002020-12-27 19:15:002020-12-27 19:15:002020-12-27 19:15:00
1261,2765,David Unsworth,2582,[2004],Portsmouth FC,8,8,0,656,2,0,7,7,0,539,0,0,15,15,0,1195,2,0,1.0,0.0,1.0,2,0,2,2,0,2,0,0,0,2020-12-27 19:15:00
1262,2766,David Unsworth,2582,[2006],Sheffield United,3,3,0,226,0,0,2,2,0,151,0,0,5,5,0,377,0,0,0.0,0.0,0.0,0,0,0,0,0,0,0,0,0,2020-12-27 19:15:00
1263,2767,David Vaughan,1412,[2010],Blackpool FC,17,17,0,1530,1,0,18,18,0,1620,1,0,35,35,0,3150,2,0,0.0,0.0,0.0,1,1,2,0,0,0,0,0,0,2020-12-27 19:15:00
1264,8307,David Vaughan,1412,"[2011, 2012, 2013]",Sunderland AFC,22,12,10,1114,1,0,26,13,13,1253,2,0,48,25,23,2367,3,0,0.0,0.0,0.0,1,0,1,0,0,0,0,0,0,2020-12-27 19:15:002020-12-27 19:15:002020-12-27 19:15:00
1265,19418,David Weir,1800,"[2000, 2001, 2002, 2003, 2004, 2005, 2006]",Everton FC,92,88,4,7812,4,0,90,85,5,7714,4,0,182,173,9,15526,8,0,3.0,4.0,7.0,2,3,5,0,0,0,0,0,0,2020-12-27 19:15:002020-12-27 19:15:002020-12-27 19:15:002020-12-27 19:15:002020-12-27 19:15:002020-12-27 19:15:002020-12-27 19:15:00
1266,2778,David Wetherall,3255,[2000],Bradford City,9,9,0,810,1,0,6,6,0,489,0,0,15,15,0,1299,1,0,0.0,0.0,0.0,1,0,1,0,0,0,0,0,0,2020-12-27 19:15:00
1267,11122,David Wheater,2218,"[2005, 2006, 2007, 2008]",Middlesbrough FC,37,37,0,3286,4,0,37,33,4,3001,1,0,74,70,4,6287,5,0,0.0,0.0,0.0,4,1,5,0,0,0,0,0,0,2020-12-27 19:15:002020-12-27 19:15:002020-12-27 19:15:002020-12-27 19:15:00
1268,5567,David Wheater,2218,"[2010, 2011]",Bolton Wanderers,14,13,1,1188,2,0,17,16,1,1464,0,0,31,29,2,2652,2,0,0.0,0.0,0.0,1,0,1,0,0,0,0,0,0,2020-12-27 19:15:002020-12-27 19:15:00
1269,5571,David Wright,3642,"[2005, 2006]",Wigan Athletic,8,2,6,353,0,0,6,5,1,435,0,0,14,7,7,788,0,0,0.0,0.0,0.0,0,0,0,0,0,0,0,0,0,2020-12-27 19:15:002020-12-27 19:15:00
1270,11154,Davide Santon,2451,"[2011, 2012, 2013, 2014]",Newcastle United,43,40,3,3313,0,0,39,36,3,3218,1,0,82,76,6,6531,1,0,0.0,0.0,0.0,0,1,1,0,0,0,0,0,0,2020-12-27 19:15:002020-12-27 19:15:002020-12-27 19:15:002020-12-27 19:15:00
1271,5583,Davide Zappacosta,3381,"[2017, 2018]",Chelsea FC,13,6,7,521,1,0,13,7,6,698,0,0,26,13,13,1219,1,0,0.0,0.0,0.0,0,0,0,0,0,0,0,0,0,2020-12-27 19:15:002020-12-27 19:15:00
1272,11178,Davinson Sánchez,1856,"[2017, 2018, 2019, 2020]",Tottenham Hotspur,43,41,2,3632,1,0,45,42,3,3765,0,0,88,83,5,7397,1,0,0.0,0.0,0.0,1,0,1,0,0,0,0,1,1,2020-12-27 19:15:002020-12-27 19:15:002020-12-27 19:15:002020-12-27 19:15:00
1273,2797,Davor Šuker,3883,[2000],West Ham United,5,3,2,244,1,0,5,3,2,276,1,0,10,6,4,520,2,0,1.0,1.0,2.0,1,1,2,0,0,0,0,0,0,2020-12-27 19:15:00
1274,2798,Davy Klaassen,3903,[2017],Everton FC,5,3,2,177,0,0,2,0,2,73,0,0,7,3,4,250,0,0,0.0,0.0,0.0,0,0,0,0,0,0,0,0,0,2020-12-27 19:15:00
1275,11202,Davy Pröpper,2423,"[2017, 2018, 2019, 2020]",Brighton & Hove Albion,52,51,1,4444,1,0,48,46,2,4073,1,0,100,97,3,8517,2,0,0.0,0.0,0.0,1,0,1,0,0,0,0,0,0,2020-12-27 19:15:002020-12-27 19:15:002020-12-27 19:15:002020-12-27 19:15:00
1276,28075,De Gea,1638,"[2011, 2012, 2013, 2014, 2015, 2016, 2017, 2018, 2019, 2020]",Manchester United,163,163,0,14653,0,0,162,162,0,14536,0,0,325,325,0,29189,0,0,0.0,0.0,0.0,0,0,0,0,0,0,0,0,0,2020-12-27 19:15:002020-12-27 19:15:002020-12-27 19:15:002020-12-27 19:15:002020-12-27 19:15:002020-12-27 19:15:002020-12-27 19:15:002020-12-27 19:15:002020-12-27 19:15:002020-12-27 19:15:00
1277,2813,De Lucas,3433,[2002],Chelsea FC,10,8,2,703,0,0,15,9,6,847,0,0,25,17,8,1550,0,0,0.0,0.0,0.0,0,0,0,0,0,0,0,0,0,2020-12-27 19:15:00
1278,2814,De Pedro,4495,[2004],Blackburn Rovers,1,1,0,46,0,0,1,0,1,13,0,0,2,1,1,59,0,0,0.0,0.0,0.0,0,0,0,0,0,0,0,0,0,2020-12-27 19:15:00
1279,2815,DeAndre Yedlin,1175,[2014],Tottenham Hotspur,1,0,1,11,0,0,0,0,0,0,0,0,1,0,1,11,0,0,0.0,0.0,0.0,0,0,0,0,0,0,0,0,0,2020-12-27 19:15:00
1280,2816,DeAndre Yedlin,1175,[2015],Sunderland AFC,13,12,1,1027,0,0,10,9,1,785,0,0,23,21,2,1812,0,0,0.0,0.0,0.0,0,0,0,0,0,0,0,0,0,2020-12-27 19:15:00
1281,11274,DeAndre Yedlin,1175,"[2017, 2018, 2019, 2020]",Newcastle United,44,39,5,3486,1,0,38,32,6,2984,1,0,82,71,11,6470,2,0,0.0,0.0,0.0,1,1,2,0,0,0,0,0,0,2020-12-27 19:15:002020-12-27 19:15:002020-12-27 19:15:002020-12-27 19:15:00
1282,2821,Dean Ashton,2245,[2004],Norwich City,8,8,0,714,5,0,8,8,0,707,2,0,16,16,0,1421,7,0,6.0,0.0,6.0,4,2,6,1,0,1,0,0,0,2020-12-27 19:15:00
1283,8469,Dean Ashton,2245,"[2005, 2007, 2008]",West Ham United,23,17,6,1574,10,0,21,14,7,1238,5,0,44,31,13,2812,15,0,1.0,4.0,5.0,6,4,10,0,0,0,0,0,0,2020-12-27 19:15:002020-12-27 19:15:002020-12-27 19:15:00
1284,5651,Dean Gordon,3550,"[2000, 2001]",Middlesbrough FC,10,5,5,609,1,0,10,7,3,695,1,0,20,12,8,1304,2,0,3.0,0.0,3.0,1,0,1,0,0,0,0,0,0,2020-12-27 19:15:002020-12-27 19:15:00
1285,5655,Dean Hammond,3575,"[2014, 2015]",Leicester City,7,4,3,412,0,0,5,5,0,368,0,0,12,9,3,780,0,0,0.0,0.0,0.0,0,0,0,0,0,0,0,0,0,2020-12-27 19:15:002020-12-27 19:15:00
1286,2829,Dean Henderson,3464,[2019],Sheffield United,18,18,0,1620,0,0,18,18,0,1620,0,0,36,36,0,3240,0,0,0.0,0.0,0.0,0,0,0,0,0,0,0,0,0,2020-12-27 19:15:00
1287,2830,Dean Henderson,3464,[2020],Manchester United,0,0,0,0,0,0,3,2,1,224,0,0,3,2,1,224,0,0,0.0,0.0,0.0,0,0,0,0,0,0,0,0,0,2020-12-27 19:15:00
1288,5663,Dean Holdsworth,3072,"[2001, 2002]",Bolton Wanderers,20,8,12,852,2,0,20,6,14,646,0,0,40,14,26,1498,2,0,4.0,0.0,4.0,2,0,2,0,0,0,0,0,0,2020-12-27 19:15:002020-12-27 19:15:00
1289,14175,Dean Kiely,2334,"[2000, 2001, 2002, 2003, 2004]",Charlton Athletic,85,85,0,7605,0,0,82,82,0,7380,0,0,167,167,0,14985,0,0,0.0,0.0,0.0,0,0,0,0,0,0,0,0,0,2020-12-27 19:15:002020-12-27 19:15:002020-12-27 19:15:002020-12-27 19:15:002020-12-27 19:15:00
1290,2838,Dean Kiely,2334,[2005],Portsmouth FC,8,8,0,720,0,0,7,7,0,630,0,0,15,15,0,1350,0,0,0.0,0.0,0.0,0,0,0,0,0,0,0,0,0,2020-12-27 19:15:00
1291,5679,Dean Kiely,2334,"[2008, 2010]",West Bromwich Albion,2,2,0,180,0,0,1,1,0,90,0,0,3,3,0,270,0,0,0.0,0.0,0.0,0,0,0,0,0,0,0,0,0,2020-12-27 19:15:002020-12-27 19:15:00
1292,5683,Dean Leacock,1570,"[2003, 2005]",Fulham FC,6,6,0,497,0,0,3,2,1,224,0,0,9,8,1,721,0,0,0.0,0.0,0.0,0,0,0,0,0,0,0,0,0,2020-12-27 19:15:002020-12-27 19:15:00
1293,2843,Dean Leacock,1570,[2007],Derby County,12,10,2,896,0,0,14,12,2,1104,0,0,26,22,4,2000,0,0,0.0,0.0,0.0,0,0,0,0,0,0,0,0,0,2020-12-27 19:15:00
1294,5689,Dean Marney,1253,"[2003, 2004]",Tottenham Hotspur,4,1,3,133,2,0,4,3,1,258,0,0,8,4,4,391,2,0,0.0,0.0,0.0,1,0,1,0,0,0,0,0,0,2020-12-27 19:15:002020-12-27 19:15:00
1295,5693,Dean Marney,1253,"[2008, 2009]",Hull City,21,20,1,1734,1,0,26,21,5,1907,0,0,47,41,6,3641,1,0,0.0,0.0,0.0,0,0,0,0,0,0,0,0,0,2020-12-27 19:15:002020-12-27 19:15:00
1296,8547,Dean Marney,1253,"[2014, 2016, 2017]",Burnley FC,23,23,0,1944,1,0,18,18,0,1514,0,0,41,41,0,3458,1,0,0.0,0.0,0.0,1,0,1,0,0,0,0,0,0,2020-12-27 19:15:002020-12-27 19:15:002020-12-27 19:15:00
1297,2851,Dean Moxey,3129,[2013],Crystal Palace,12,11,1,885,0,0,8,7,1,633,0,0,20,18,2,1518,0,0,0.0,0.0,0.0,0,0,0,0,0,0,0,0,0,2020-12-27 19:15:00
1298,2852,Dean Richards,2799,[2000],Southampton FC,15,15,0,1324,0,0,12,12,0,1080,1,0,27,27,0,2404,1,0,0.0,1.0,1.0,0,1,1,0,0,0,0,0,0,2020-12-27 19:15:00
1299,8562,Dean Richards,2799,"[2001, 2002, 2003]",Tottenham Hotspur,37,37,0,3270,2,0,36,36,0,3189,2,0,73,73,0,6459,4,0,3.0,0.0,3.0,2,2,4,0,0,0,0,0,0,2020-12-27 19:15:002020-12-27 19:15:002020-12-27 19:15:00
1300,2856,Dean Saunders,2839,[2000],Bradford City,4,0,4,68,0,0,6,4,2,331,0,0,10,4,6,399,0,0,0.0,0.0,0.0,0,0,0,0,0,0,0,0,0,2020-12-27 19:15:00
1301,5715,Dean Sturridge,1312,"[2000, 2001]",Leicester City,11,10,1,755,3,0,11,10,1,703,3,0,22,20,2,1458,6,0,1.0,0.0,1.0,3,2,5,0,0,0,0,0,0,2020-12-27 19:15:002020-12-27 19:15:00
1302,2859,Dean Sturridge,1312,[2003],Wolverhampton Wanderers,1,0,1,30,0,0,4,2,2,169,0,0,5,2,3,199,0,0,0.0,0.0,0.0,0,0,0,0,0,0,0,0,0,2020-12-27 19:15:00
1303,8583,Dean Whitehead,1218,"[2005, 2007, 2008]",Sunderland AFC,47,44,3,4030,3,0,50,48,2,4328,1,0,97,92,5,8358,4,0,0.0,0.0,0.0,2,1,3,2,0,2,0,0,0,2020-12-27 19:15:002020-12-27 19:15:002020-12-27 19:15:00
1304,11458,Dean Whitehead,1218,"[2009, 2010, 2011, 2012]",Stoke City,64,46,18,4434,1,0,68,54,14,5158,2,0,132,100,32,9592,3,0,3.0,3.0,6.0,1,2,3,0,0,0,0,0,0,2020-12-27 19:15:002020-12-27 19:15:002020-12-27 19:15:002020-12-27 19:15:00
1305,2867,Dean Whitehead,1218,[2017],Huddersfield Town,3,0,3,55,0,0,1,0,1,12,0,0,4,0,4,67,0,0,0.0,0.0,0.0,0,0,0,0,0,0,0,0,0,2020-12-27 19:15:00
1306,2868,Dean Windass,2814,[2000],Bradford City,10,9,1,812,2,0,12,11,1,998,1,0,22,20,2,1810,3,0,0.0,0.0,0.0,1,1,2,0,0,0,0,0,0,2020-12-27 19:15:00
1307,5739,Dean Windass,2814,"[2001, 2002]",Middlesbrough FC,15,6,9,571,1,0,13,2,11,239,0,0,28,8,20,810,1,0,1.0,0.0,1.0,1,0,1,0,0,0,0,0,0,2020-12-27 19:15:002020-12-27 19:15:00
1308,2871,Dean Windass,2814,[2008],Hull City,2,0,2,40,0,0,3,1,2,77,0,0,5,1,4,117,0,0,0.0,0.0,0.0,0,0,0,0,0,0,0,0,0,2020-12-27 19:15:00
1309,2872,Declan John,3658,[2013],Cardiff City,10,7,3,655,0,0,10,9,1,832,0,0,20,16,4,1487,0,0,0.0,0.0,0.0,0,0,0,0,0,0,0,0,0,2020-12-27 19:15:00
1310,14375,Declan Rice,2206,"[2016, 2017, 2018, 2019, 2020]",West Ham United,54,50,4,4522,3,0,61,53,8,4768,0,0,115,103,12,9290,3,0,3.0,0.0,3.0,2,0,2,0,0,0,0,0,0,2020-12-27 19:15:002020-12-27 19:15:002020-12-27 19:15:002020-12-27 19:15:002020-12-27 19:15:00
1311,8637,Declan Rudd,2629,"[2011, 2012, 2015]",Norwich City,6,6,0,540,0,0,7,6,1,549,0,0,13,12,1,1089,0,0,0.0,0.0,0.0,0,0,0,0,0,0,0,0,0,2020-12-27 19:15:002020-12-27 19:15:002020-12-27 19:15:00
1312,5763,Deco,2892,"[2008, 2009]",Chelsea FC,19,14,5,1193,1,0,23,16,7,1503,4,0,42,30,12,2696,5,0,0.0,3.0,3.0,0,1,1,0,0,0,0,0,0,2020-12-27 19:15:002020-12-27 19:15:00
1313,11540,Dedryck Boyata,1679,"[2009, 2010, 2013, 2014]",Manchester City,7,4,3,341,0,0,6,4,2,362,0,0,13,8,5,703,0,0,0.0,0.0,0.0,0,0,0,0,0,0,0,0,0,2020-12-27 19:15:002020-12-27 19:15:002020-12-27 19:15:002020-12-27 19:15:00
1314,2885,Dedryck Boyata,1679,[2011],Bolton Wanderers,8,8,0,683,1,0,6,5,1,440,0,0,14,13,1,1123,1,0,0.0,0.0,0.0,0,0,0,0,0,0,0,0,0,2020-12-27 19:15:00
1315,2888,Dejan Lovren,1179,[2013],Southampton FC,17,17,0,1530,0,0,14,14,0,1258,2,0,31,31,0,2788,2,0,0.0,3.0,3.0,0,1,1,0,0,0,0,0,0,2020-12-27 19:15:00
1316,17349,Dejan Lovren,1179,"[2014, 2015, 2016, 2017, 2018, 2019]",Liverpool FC,63,58,5,5145,2,0,68,59,9,5231,3,0,131,117,14,10376,5,0,0.0,0.0,0.0,1,2,3,0,0,0,0,0,0,2020-12-27 19:15:002020-12-27 19:15:002020-12-27 19:15:002020-12-27 19:15:002020-12-27 19:15:002020-12-27 19:15:00
1317,11586,Dejan Stefanović,1066,"[2003, 2004, 2005, 2006]",Portsmouth FC,59,59,0,5156,3,0,52,51,1,4537,0,0,111,110,1,9693,3,0,0.0,0.0,0.0,3,0,3,0,0,0,0,0,0,2020-12-27 19:15:002020-12-27 19:15:002020-12-27 19:15:002020-12-27 19:15:00
1318,2899,Dejan Stefanović,1066,[2007],Fulham FC,7,7,0,630,0,0,6,6,0,540,0,0,13,13,0,1170,0,0,0.0,0.0,0.0,0,0,0,0,0,0,0,0,0,2020-12-27 19:15:00
1319,2900,Dekel Keinan,2603,[2010],Blackpool FC,1,0,1,18,0,0,5,3,2,378,0,0,6,3,3,396,0,0,0.0,0.0,0.0,0,0,0,0,0,0,0,0,0,2020-12-27 19:15:00
1320,2901,Del Horno,3731,[2005],Chelsea FC,14,14,0,1145,0,0,11,11,0,900,1,0,25,25,0,2045,1,0,0.0,0.0,0.0,0,1,1,0,0,0,0,0,0,2020-12-27 19:15:00
1321,17427,Dele Alli,1915,"[2015, 2016, 2017, 2018, 2019, 2020]",Tottenham Hotspur,76,68,8,5924,21,0,84,73,11,6335,29,0,160,141,19,12259,50,0,4.0,6.0,10.0,12,17,29,1,1,2,0,0,0,2020-12-27 19:15:002020-12-27 19:15:002020-12-27 19:15:002020-12-27 19:15:002020-12-27 19:15:002020-12-27 19:15:00
1322,5817,Delroy Facey,3991,"[2002, 2003]",Bolton Wanderers,5,1,4,129,2,0,5,0,5,72,0,0,10,1,9,201,2,0,0.0,0.0,0.0,0,0,0,0,0,0,0,0,0,2020-12-27 19:15:002020-12-27 19:15:00
1323,14560,Demarai Gray,2568,"[2015, 2016, 2017, 2018, 2019]",Leicester City,67,23,44,2707,4,0,65,30,35,2798,6,0,132,53,79,5505,10,0,3.0,6.0,9.0,2,4,6,0,0,0,0,0,0,2020-12-27 19:15:002020-12-27 19:15:002020-12-27 19:15:002020-12-27 19:15:002020-12-27 19:15:00
1324,2915,Demba Ba,1544,[2010],West Ham United,6,4,2,393,2,0,6,6,0,540,5,0,12,10,2,933,7,0,0.0,1.0,1.0,1,2,3,0,0,0,0,0,0,2020-12-27 19:15:00
1325,2916,Demba Ba,1544,[2011],Newcastle United,18,17,1,1430,8,0,16,15,1,1300,8,0,34,32,2,2730,16,0,0.0,1.0,1.0,6,4,10,0,2,2,0,0,0,2020-12-27 19:15:00
1326,5835,Demba Ba,1544,"[2012, 2013]",Chelsea FC,16,8,8,784,5,0,17,8,9,746,2,0,33,16,17,1530,7,0,3.0,3.0,6.0,2,2,4,0,0,0,0,0,0,2020-12-27 19:15:002020-12-27 19:15:00
1327,2919,Demeaco Duhaney,4257,[2018],Huddersfield Town,1,1,0,46,0,0,0,0,0,0,0,0,1,1,0,46,0,0,0.0,0.0,0.0,0,0,0,0,0,0,0,0,0,2020-12-27 19:15:00
1328,2920,Demetri Mitchell,3276,[2016],Manchester United,1,1,0,90,0,0,0,0,0,0,0,0,1,1,0,90,0,0,0.0,0.0,0.0,0,0,0,0,0,0,0,0,0,2020-12-27 19:15:00
1329,14615,Denilson,1232,"[2006, 2007, 2008, 2009, 2010]",Arsenal FC,50,36,14,3323,4,0,45,32,13,2841,3,0,95,68,27,6164,7,0,0.0,0.0,0.0,3,2,5,0,0,0,0,0,0,2020-12-27 19:15:002020-12-27 19:15:002020-12-27 19:15:002020-12-27 19:15:002020-12-27 19:15:00
1330,5853,Denis Irwin,1454,"[2000, 2001]",Manchester United,14,12,2,1079,0,0,19,18,1,1514,0,0,33,30,3,2593,0,0,0.0,0.0,0.0,0,0,0,0,0,0,0,0,0,2020-12-27 19:15:002020-12-27 19:15:00
1331,2928,Denis Irwin,1454,[2003],Wolverhampton Wanderers,17,16,1,1411,0,0,15,14,1,1251,0,0,32,30,2,2662,0,0,0.0,0.0,0.0,0,0,0,0,0,0,0,0,0,2020-12-27 19:15:00
1332,5859,Denis Odoi,3941,"[2018, 2020]",Fulham FC,17,15,2,1333,0,0,17,17,0,1530,0,0,34,32,2,2863,0,0,0.0,0.0,0.0,0,0,0,0,0,0,0,0,0,2020-12-27 19:15:002020-12-27 19:15:00
1333,2931,Denis Stracqualursi,1749,[2011],Everton FC,13,4,9,449,1,0,8,3,5,288,0,0,21,7,14,737,1,0,0.0,0.0,0.0,0,0,0,0,0,0,0,0,0,2020-12-27 19:15:00
1334,2932,Denis Suárez,2909,[2012],Manchester City,0,0,0,0,0,0,0,0,0,0,0,0,0,0,0,0,0,0,0.0,0.0,0.0,0,0,0,0,0,0,0,0,0,2020-12-27 19:15:00
1335,2933,Denis Suárez,2909,[2018],Arsenal FC,2,0,2,29,0,0,2,0,2,38,0,0,4,0,4,67,0,0,0.0,0.0,0.0,0,0,0,0,0,0,0,0,0,2020-12-27 19:15:00
1336,17619,Dennis Bergkamp,1527,"[2000, 2001, 2002, 2003, 2004, 2005]",Arsenal FC,90,60,30,5533,14,0,75,51,24,4436,16,0,165,111,54,9969,30,0,6.0,7.0,13.0,8,11,19,0,0,0,0,0,0,2020-12-27 19:15:002020-12-27 19:15:002020-12-27 19:15:002020-12-27 19:15:002020-12-27 19:15:002020-12-27 19:15:00
1337,2940,Dennis Cirkin,4519,[2019],Tottenham Hotspur,0,0,0,0,0,0,0,0,0,0,0,0,0,0,0,0,0,0,0.0,0.0,0.0,0,0,0,0,0,0,0,0,0,2020-12-27 19:15:00
1338,5883,Dennis Praet,2448,"[2019, 2020]",Leicester City,18,10,8,880,2,0,21,10,11,846,0,0,39,20,19,1726,2,0,0.0,0.0,0.0,1,0,1,0,0,0,0,0,0,2020-12-27 19:15:002020-12-27 19:15:00
1339,8832,Dennis Rommedahl,2747,"[2004, 2005, 2006]",Charlton Athletic,37,29,8,2435,0,0,37,27,10,2300,4,0,74,56,18,4735,4,0,0.0,7.0,7.0,0,4,4,0,0,0,0,0,0,2020-12-27 19:15:002020-12-27 19:15:002020-12-27 19:15:00
1340,2946,Dennis Srbeny,1833,[2019],Norwich City,5,0,5,33,0,0,3,0,3,8,1,0,8,0,8,41,1,0,0.0,0.0,0.0,0,0,0,0,0,0,0,0,0,2020-12-27 19:15:00
1341,2947,Dennis Wise,3054,[2000],Chelsea FC,18,17,1,1531,1,0,17,17,0,1530,2,0,35,34,1,3061,3,0,0.0,0.0,0.0,1,1,2,0,0,0,0,0,0,2020-12-27 19:15:00
1342,2948,Dennis Wise,3054,[2001],Leicester City,8,7,1,637,1,0,9,8,1,730,0,0,17,15,2,1367,1,0,0.0,0.0,0.0,0,0,0,0,0,0,0,0,0,2020-12-27 19:15:00
1343,2949,Denny Landzaat,2342,[2006],Wigan Athletic,17,15,2,1292,0,0,16,14,2,1235,2,0,33,29,4,2527,2,0,0.0,0.0,0.0,0,1,1,0,0,0,0,0,0,2020-12-27 19:15:00
1344,2950,Denny Landzaat,2342,[2007],Blackburn Rovers,0,0,0,0,0,0,1,1,0,90,0,0,1,1,0,90,0,0,0.0,0.0,0.0,0,0,0,0,0,0,0,0,0,2020-12-27 19:15:00
1345,5903,Deon Burton,3374,"[2000, 2001]",Derby County,25,14,11,1452,5,0,20,16,4,1498,1,0,45,30,15,2950,6,0,7.0,0.0,7.0,4,1,5,1,0,1,0,0,0,2020-12-27 19:15:002020-12-27 19:15:00
1346,2953,Deon Burton,3374,[2003],Portsmouth FC,0,0,0,0,0,0,1,0,1,18,0,0,1,0,1,18,0,0,0.0,0.0,0.0,0,0,0,0,0,0,0,0,0,2020-12-27 19:15:00
1347,2954,Derek Boateng,3434,[2013],Fulham FC,2,1,1,90,0,0,1,1,0,65,0,0,3,2,1,155,0,0,0.0,0.0,0.0,0,0,0,0,0,0,0,0,0,2020-12-27 19:15:00
1348,2955,Derek Geary,3663,[2006],Sheffield United,12,12,0,1016,0,0,12,12,0,1024,0,0,24,24,0,2040,0,0,0.0,0.0,0.0,0,0,0,0,0,0,0,0,0,2020-12-27 19:15:00
1349,2956,Derek McInnes,3080,[2002],West Bromwich Albion,13,12,1,985,0,0,15,15,0,1279,2,0,28,27,1,2264,2,0,0.0,0.0,0.0,0,1,1,0,0,0,0,0,0,2020-12-27 19:15:00
1350,5915,Derrick Williams,3086,"[2011, 2012]",Aston Villa,0,0,0,0,0,0,1,0,1,25,0,0,1,0,1,25,0,0,0.0,0.0,0.0,0,0,0,0,0,0,0,0,0,2020-12-27 19:15:002020-12-27 19:15:00
1351,2959,Des Lyttle,4405,[2002],West Bromwich Albion,2,1,1,107,0,0,2,1,1,95,0,0,4,2,2,202,0,0,0.0,0.0,0.0,0,0,0,0,0,0,0,0,0,2020-12-27 19:15:00
1352,2960,Dexter Blackstock,4127,[2004],Norwich City,1,1,0,60,0,0,0,0,0,0,0,0,1,1,0,60,0,0,0.0,0.0,0.0,0,0,0,0,0,0,0,0,0,2020-12-27 19:15:00
1353,11850,Diafra Sakho,3418,"[2014, 2015, 2016, 2017]",West Ham United,30,21,9,1899,9,0,32,19,13,1862,9,0,62,40,22,3761,18,0,6.0,1.0,7.0,5,4,9,0,0,0,0,0,0,2020-12-27 19:15:002020-12-27 19:15:002020-12-27 19:15:002020-12-27 19:15:00
1354,2965,Dickson Etuhu,1969,[2007],Sunderland AFC,9,9,0,746,1,0,11,9,2,762,0,0,20,18,2,1508,1,0,0.0,0.0,0.0,1,0,1,0,0,0,0,0,0,2020-12-27 19:15:00
1355,11870,Dickson Etuhu,1969,"[2008, 2009, 2010, 2011]",Fulham FC,43,33,10,2957,1,0,47,31,16,2853,2,0,90,64,26,5810,3,0,0.0,1.0,1.0,0,2,2,0,0,0,0,0,0,2020-12-27 19:15:002020-12-27 19:15:002020-12-27 19:15:002020-12-27 19:15:00
1356,2970,Didier Agathe,3937,[2006],Aston Villa,2,0,2,69,0,0,3,0,3,97,0,0,5,0,5,166,0,0,0.0,0.0,0.0,0,0,0,0,0,0,0,0,0,2020-12-27 19:15:00
1357,2971,Didier Digard,3952,[2008],Middlesbrough FC,12,7,5,626,0,0,11,8,3,697,0,0,23,15,8,1323,0,0,0.0,0.0,0.0,0,0,0,0,0,0,0,0,0,2020-12-27 19:15:00
1358,2972,Didier Domi,3755,[2000],Newcastle United,7,6,1,565,0,0,7,5,2,453,0,0,14,11,3,1018,0,0,0.0,0.0,0.0,0,0,0,0,0,0,0,0,0,2020-12-27 19:15:00
1359,2973,Didier Domi,3755,[2003],Leeds United,5,3,2,282,0,0,6,5,1,441,0,0,11,8,3,723,0,0,0.0,0.0,0.0,0,0,0,0,0,0,0,0,0,2020-12-27 19:15:00
1360,26802,Didier Drogba,1766,"[2004, 2005, 2006, 2007, 2008, 2009, 2010, 2011, 2014]",Chelsea FC,131,93,38,8935,70,0,121,92,29,8485,35,0,252,185,67,17420,105,0,23.0,15.0,38.0,36,26,62,4,0,4,0,0,0,2020-12-27 19:15:002020-12-27 19:15:002020-12-27 19:15:002020-12-27 19:15:002020-12-27 19:15:002020-12-27 19:15:002020-12-27 19:15:002020-12-27 19:15:002020-12-27 19:15:00
1361,2983,Didier Ndong,2367,[2016],Sunderland AFC,16,14,2,1293,0,0,15,13,2,1226,1,0,31,27,4,2519,1,0,0.0,0.0,0.0,0,0,0,0,0,0,0,0,0,2020-12-27 19:15:00
1362,2984,Didier Ndong,2367,[2017],Watford FC,0,0,0,0,0,0,0,0,0,0,0,0,0,0,0,0,0,0,0.0,0.0,0.0,0,0,0,0,0,0,0,0,0,2020-12-27 19:15:00
1363,8958,Didier Zokora,2465,"[2006, 2007, 2008]",Tottenham Hotspur,44,37,7,3315,0,0,43,37,6,3214,0,0,87,74,13,6529,0,0,0.0,0.0,0.0,0,0,0,0,0,0,0,0,0,2020-12-27 19:15:002020-12-27 19:15:002020-12-27 19:15:00
1364,2988,Diego Arismendi,4090,[2011],Stoke City,0,0,0,0,0,0,0,0,0,0,0,0,0,0,0,0,0,0,0.0,0.0,0.0,0,0,0,0,0,0,0,0,0,2020-12-27 19:15:00
1365,2989,Diego Cavalieri,4120,[2010],Liverpool FC,0,0,0,0,0,0,0,0,0,0,0,0,0,0,0,0,0,0,0.0,0.0,0.0,0,0,0,0,0,0,0,0,0,2020-12-27 19:15:00
1366,2990,Diego Cavalieri,4120,[2017],Crystal Palace,0,0,0,0,0,0,0,0,0,0,0,0,0,0,0,0,0,0,0.0,0.0,0.0,0,0,0,0,0,0,0,0,0,2020-12-27 19:15:00
1367,8976,Diego Costa,2731,"[2014, 2015, 2016]",Chelsea FC,45,42,3,3745,30,0,44,44,0,3839,22,0,89,86,3,7584,52,0,11.0,16.0,27.0,17,12,29,1,0,1,0,0,0,2020-12-27 19:15:002020-12-27 19:15:002020-12-27 19:15:00
1368,11982,Diego Forlán,2783,"[2001, 2002, 2003, 2004]",Manchester United,31,14,17,1423,8,0,32,9,23,1067,2,0,63,23,40,2490,10,0,7.0,0.0,7.0,6,1,7,0,0,0,0,0,0,2020-12-27 19:15:002020-12-27 19:15:002020-12-27 19:15:002020-12-27 19:15:00
1369,2998,Diego Gavilán,4428,[2000],Newcastle United,1,0,1,5,0,0,0,0,0,0,0,0,1,0,1,5,0,0,0.0,0.0,0.0,0,0,0,0,0,0,0,0,0,2020-12-27 19:15:00
1370,2999,Diego Lugano,2305,[2013],West Bromwich Albion,3,2,1,229,1,0,6,5,1,429,0,0,9,7,2,658,1,0,1.0,0.0,1.0,1,0,1,0,0,0,0,0,0,2020-12-27 19:15:00
1371,3000,Diego Penny,4542,[2009],Burnley FC,1,0,1,75,0,0,0,0,0,0,0,0,1,0,1,75,0,0,0.0,0.0,0.0,0,0,0,0,0,0,0,0,0,2020-12-27 19:15:00
1372,6003,Diego Poyet,3417,"[2014, 2015]",West Ham United,0,0,0,0,0,0,3,1,2,91,0,0,3,1,2,91,0,0,0.0,0.0,0.0,0,0,0,0,0,0,0,0,0,2020-12-27 19:15:002020-12-27 19:15:00
1373,6007,Diego Rico,3155,"[2018, 2019]",AFC Bournemouth,17,14,3,1318,0,0,22,18,4,1625,0,0,39,32,7,2943,0,0,0.0,0.0,0.0,0,0,0,0,0,0,0,0,0,2020-12-27 19:15:002020-12-27 19:15:00
1374,3005,Diego Tristán,3819,[2008],West Ham United,8,3,5,326,1,0,6,5,1,403,2,0,14,8,6,729,3,0,3.0,4.0,7.0,1,2,3,0,0,0,0,0,0,2020-12-27 19:15:00
1375,18051,Dietmar Hamann,2690,"[2000, 2001, 2002, 2003, 2004, 2005]",Liverpool FC,82,72,10,6451,5,0,74,68,6,5983,2,0,156,140,16,12434,7,0,3.0,0.0,3.0,3,1,4,0,0,0,0,0,0,2020-12-27 19:15:002020-12-27 19:15:002020-12-27 19:15:002020-12-27 19:15:002020-12-27 19:15:002020-12-27 19:15:00
1376,9039,Dietmar Hamann,2690,"[2006, 2007, 2008]",Manchester City,25,20,5,1716,0,0,28,22,6,1866,0,0,53,42,11,3582,0,0,0.0,0.0,0.0,0,0,0,0,0,0,0,0,0,2020-12-27 19:15:002020-12-27 19:15:002020-12-27 19:15:00
1377,3015,Dieumerci Mbokani,2628,[2015],Norwich City,15,8,7,851,6,0,14,7,7,736,1,0,29,15,14,1587,7,0,0.0,0.0,0.0,3,1,4,0,0,0,0,0,0,2020-12-27 19:15:00
1378,3016,Dieumerci Mbokani,2628,[2016],Hull City,8,5,3,534,0,0,4,3,1,229,0,0,12,8,4,763,0,0,0.0,0.0,0.0,0,0,0,0,0,0,0,0,0,2020-12-27 19:15:00
1379,6035,Dimitar Berbatov,1397,"[2006, 2007]",Tottenham Hotspur,33,32,1,2835,16,0,34,29,5,2691,11,0,67,61,6,5526,27,0,0.0,3.0,3.0,11,8,19,0,1,1,0,0,0,2020-12-27 19:15:002020-12-27 19:15:00
1380,12082,Dimitar Berbatov,1397,"[2008, 2009, 2010, 2011]",Manchester United,52,42,10,3759,35,0,55,39,16,3527,14,0,107,81,26,7286,49,0,9.0,9.0,18.0,13,7,20,2,0,2,0,0,0,2020-12-27 19:15:002020-12-27 19:15:002020-12-27 19:15:002020-12-27 19:15:00
1381,6047,Dimitar Berbatov,1397,"[2012, 2013]",Fulham FC,26,26,0,2288,10,0,25,24,1,2128,9,0,51,50,1,4416,19,0,6.0,3.0,9.0,7,6,13,3,3,6,0,0,0,2020-12-27 19:15:002020-12-27 19:15:00
1382,3025,Dimitri Foulquier,3950,[2019],Watford FC,1,0,1,17,0,0,2,1,1,41,0,0,3,1,2,58,0,0,0.0,0.0,0.0,0,0,0,0,0,0,0,0,0,2020-12-27 19:15:00
1383,6053,Dimitri Payet,2640,"[2015, 2016]",West Ham United,25,24,1,2125,5,0,23,22,1,1963,6,0,48,46,2,4088,11,0,1.0,4.0,5.0,3,4,7,0,0,0,0,0,0,2020-12-27 19:15:002020-12-27 19:15:00
1384,3028,Dimitrios Konstantopoulos,3944,[2016],Middlesbrough FC,0,0,0,0,0,0,0,0,0,0,0,0,0,0,0,0,0,0,0.0,0.0,0.0,0,0,0,0,0,0,0,0,0,2020-12-27 19:15:00
1385,9090,Diniyar Bilyaletdinov,1753,"[2009, 2010, 2011]",Everton FC,32,21,11,1800,7,0,27,12,15,1104,1,0,59,33,26,2904,8,0,4.0,0.0,4.0,7,0,7,0,0,0,0,0,0,2020-12-27 19:15:002020-12-27 19:15:002020-12-27 19:15:00
1386,3032,Dino Baggio,3807,[2003],Blackburn Rovers,4,0,4,78,0,0,5,0,5,88,1,0,9,0,9,166,1,0,0.0,0.0,0.0,0,0,0,0,0,0,0,0,0,2020-12-27 19:15:00
1387,6067,Diogo Dalot,2910,"[2018, 2019]",Manchester United,8,6,2,527,0,0,12,7,5,554,0,0,20,13,7,1081,0,0,0.0,0.0,0.0,0,0,0,0,0,0,0,0,0,2020-12-27 19:15:002020-12-27 19:15:00
1388,9109,Diogo Jota,2150,"[2018, 2019, 2020]",Wolverhampton Wanderers,33,27,6,2296,10,0,34,29,5,2373,6,0,67,56,11,4669,16,0,6.0,5.0,11.0,7,6,13,0,0,0,0,0,0,2020-12-27 19:15:002020-12-27 19:15:002020-12-27 19:15:00
1389,3037,Diogo Jota,2150,[2020],Liverpool FC,5,2,3,219,4,0,4,3,1,282,1,0,9,5,4,501,5,0,6.0,0.0,6.0,2,1,3,0,0,0,0,0,0,2020-12-27 19:15:00
1390,3039,Diomansy Kamara,1564,[2004],Portsmouth FC,12,7,5,654,2,0,13,8,5,718,2,0,25,15,10,1372,4,0,0.0,0.0,0.0,2,2,4,0,0,0,0,0,0,2020-12-27 19:15:00
1391,3040,Diomansy Kamara,1564,[2005],West Bromwich Albion,12,11,1,895,1,0,14,10,4,895,0,0,26,21,5,1790,1,0,0.0,0.0,0.0,1,0,1,0,0,0,0,0,0,2020-12-27 19:15:00
1392,12170,Diomansy Kamara,1564,"[2007, 2008, 2009, 2010]",Fulham FC,33,17,16,1664,6,0,26,15,11,1368,6,0,59,32,27,3032,12,0,1.0,6.0,7.0,4,4,8,0,0,0,0,0,0,2020-12-27 19:15:002020-12-27 19:15:002020-12-27 19:15:002020-12-27 19:15:00
1393,12186,Dion Dublin,2768,"[2000, 2001, 2002, 2003]",Aston Villa,51,32,19,3050,13,0,47,36,11,3372,12,0,98,68,30,6422,25,0,9.0,2.0,11.0,9,8,17,1,1,2,0,0,0,2020-12-27 19:15:002020-12-27 19:15:002020-12-27 19:15:002020-12-27 19:15:00
1394,3049,Dion Henry,3379,[2017],Crystal Palace,0,0,0,0,0,0,0,0,0,0,0,0,0,0,0,0,0,0,0.0,0.0,0.0,0,0,0,0,0,0,0,0,0,2020-12-27 19:15:00
1395,3050,Dion Pereira,3931,[2016],Watford FC,1,0,1,16,0,0,1,0,1,7,0,0,2,0,2,23,0,0,0.0,0.0,0.0,0,0,0,0,0,0,0,0,0,2020-12-27 19:15:00
1396,6103,Dionatan Teixeira,3872,"[2014, 2015]",Stoke City,0,0,0,0,0,0,2,0,2,48,0,0,2,0,2,48,0,0,0.0,0.0,0.0,0,0,0,0,0,0,0,0,0,2020-12-27 19:15:002020-12-27 19:15:00
1397,18333,Dirk Kuyt,1894,"[2006, 2007, 2008, 2009, 2010, 2011]",Liverpool FC,109,92,17,8358,30,0,99,84,15,7410,21,0,208,176,32,15768,51,0,8.0,10.0,18.0,16,12,28,4,4,8,0,0,0,2020-12-27 19:15:002020-12-27 19:15:002020-12-27 19:15:002020-12-27 19:15:002020-12-27 19:15:002020-12-27 19:15:00
1398,18369,Divock Origi,2086,"[2015, 2016, 2017, 2018, 2019, 2020]",Liverpool FC,43,16,27,1409,13,0,50,16,34,1792,6,0,93,32,61,3201,19,0,5.0,3.0,8.0,7,2,9,0,0,0,0,0,0,2020-12-27 19:15:002020-12-27 19:15:002020-12-27 19:15:002020-12-27 19:15:002020-12-27 19:15:002020-12-27 19:15:00
1399,3065,Djair Parfitt-Williams,4350,[2015],West Ham United,0,0,0,0,0,0,0,0,0,0,0,0,0,0,0,0,0,0,0.0,0.0,0.0,0,0,0,0,0,0,0,0,0,2020-12-27 19:15:00
1400,3066,Djamel Belmadi,4172,[2002],Manchester City,6,2,4,268,0,0,2,0,2,63,0,0,8,2,6,331,0,0,0.0,0.0,0.0,0,0,0,0,0,0,0,0,0,2020-12-27 19:15:00
1401,6135,Djibril Cissé,1899,"[2004, 2005]",Liverpool FC,23,13,10,1176,5,0,26,16,10,1511,8,0,49,29,20,2687,13,0,3.0,4.0,7.0,2,4,6,1,2,3,0,0,0,2020-12-27 19:15:002020-12-27 19:15:00
1402,3069,Djibril Cissé,1899,[2008],Sunderland AFC,17,17,0,1420,5,0,18,12,6,1099,5,0,35,29,6,2519,10,0,3.0,6.0,9.0,4,4,8,1,0,1,0,0,0,2020-12-27 19:15:00
1403,6141,Djibril Cissé,1899,"[2011, 2012]",Queens Park Rangers,12,9,3,831,4,0,14,10,4,905,5,0,26,19,7,1736,9,0,4.0,0.0,4.0,3,4,7,0,0,0,0,0,0,2020-12-27 19:15:002020-12-27 19:15:00
1404,3072,Djibril Diawara,3067,[2001],Bolton Wanderers,6,2,4,282,0,0,3,2,1,191,0,0,9,4,5,473,0,0,0.0,0.0,0.0,0,0,0,0,0,0,0,0,0,2020-12-27 19:15:00
1405,3073,Djibril Sidibé,1460,[2019],Everton FC,12,8,4,898,0,0,13,10,3,922,0,0,25,18,7,1820,0,0,0.0,0.0,0.0,0,0,0,0,0,0,0,0,0,2020-12-27 19:15:00
1406,15380,Djimi Traoré,2364,"[2000, 2002, 2003, 2004, 2005]",Liverpool FC,41,33,8,2980,0,0,45,37,8,3364,0,0,86,70,16,6344,0,0,0.0,0.0,0.0,0,0,0,0,0,0,0,0,0,2020-12-27 19:15:002020-12-27 19:15:002020-12-27 19:15:002020-12-27 19:15:002020-12-27 19:15:00
1407,3079,Djimi Traoré,2364,[2006],Charlton Athletic,6,6,0,476,0,0,5,5,0,385,0,0,11,11,0,861,0,0,0.0,0.0,0.0,0,0,0,0,0,0,0,0,0,2020-12-27 19:15:00
1408,3080,Djimi Traoré,2364,[2007],Portsmouth FC,2,1,1,134,0,0,1,0,1,1,0,0,3,1,2,135,0,0,0.0,0.0,0.0,0,0,0,0,0,0,0,0,0,2020-12-27 19:15:00
1409,3081,Do-heon Kim,2001,[2008],West Bromwich Albion,6,3,3,320,0,0,10,6,4,443,0,0,16,9,7,763,0,0,0.0,0.0,0.0,0,0,0,0,0,0,0,0,0,2020-12-27 19:15:00
1410,3082,Dodi Lukebakio,2368,[2017],Watford FC,0,0,0,0,0,0,1,0,1,15,0,0,1,0,1,15,0,0,0.0,0.0,0.0,0,0,0,0,0,0,0,0,0,2020-12-27 19:15:00
1411,6167,Domingos Quina,2094,"[2016, 2017]",West Ham United,0,0,0,0,0,0,0,0,0,0,0,0,0,0,0,0,0,0,0.0,0.0,0.0,0,0,0,0,0,0,0,0,0,2020-12-27 19:15:002020-12-27 19:15:00
1412,6171,Domingos Quina,2094,"[2018, 2019]",Watford FC,6,2,4,221,1,0,6,1,5,132,0,0,12,3,9,353,1,0,0.0,0.0,0.0,0,0,0,0,0,0,0,0,0,2020-12-27 19:15:002020-12-27 19:15:00
1413,3087,Dominic Ball,4496,[2014],Tottenham Hotspur,0,0,0,0,0,0,0,0,0,0,0,0,0,0,0,0,0,0,0.0,0.0,0.0,0,0,0,0,0,0,0,0,0,2020-12-27 19:15:00
1414,15450,Dominic Calvert-Lewin,1056,"[2016, 2017, 2018, 2019, 2020]",Everton FC,64,43,21,3943,19,0,65,44,21,4011,16,0,129,87,42,7954,35,0,5.0,8.0,13.0,11,12,23,0,0,0,0,0,0,2020-12-27 19:15:002020-12-27 19:15:002020-12-27 19:15:002020-12-27 19:15:002020-12-27 19:15:00
1415,3093,Dominic Gape,4417,[2014],Southampton FC,1,0,1,2,0,0,0,0,0,0,0,0,1,0,1,2,0,0,0.0,0.0,0.0,0,0,0,0,0,0,0,0,0,2020-12-27 19:15:00
1416,12382,Dominic Matteo,1293,"[2000, 2001, 2002, 2003]",Leeds United,48,48,0,4154,2,0,53,53,0,4649,0,0,101,101,0,8803,2,0,3.0,0.0,3.0,2,0,2,0,0,0,0,0,0,2020-12-27 19:15:002020-12-27 19:15:002020-12-27 19:15:002020-12-27 19:15:00
1417,6197,Dominic Matteo,1293,"[2004, 2005]",Blackburn Rovers,18,17,1,1487,0,0,15,13,2,1166,0,0,33,30,3,2653,0,0,0.0,0.0,0.0,0,0,0,0,0,0,0,0,0,2020-12-27 19:15:002020-12-27 19:15:00
1418,3100,Dominic Samuel,4502,[2012],Reading FC,0,0,0,0,0,0,1,0,1,18,0,0,1,0,1,18,0,0,0.0,0.0,0.0,0,0,0,0,0,0,0,0,0,2020-12-27 19:15:00
1419,6203,Dominic Solanke,1194,"[2014, 2016]",Chelsea FC,0,0,0,0,0,0,0,0,0,0,0,0,0,0,0,0,0,0,0.0,0.0,0.0,0,0,0,0,0,0,0,0,0,2020-12-27 19:15:002020-12-27 19:15:00
1420,3103,Dominic Solanke,1194,[2017],Liverpool FC,10,2,8,255,1,0,11,3,8,328,0,0,21,5,16,583,1,0,0.0,0.0,0.0,0,0,0,0,0,0,0,0,0,2020-12-27 19:15:00
1421,6209,Dominic Solanke,1194,"[2018, 2019]",AFC Bournemouth,17,9,8,939,2,0,25,10,15,1045,1,0,42,19,23,1984,3,0,0.0,0.0,0.0,1,1,2,0,0,0,0,0,0,2020-12-27 19:15:002020-12-27 19:15:00
1422,3106,Don Cowie,3463,[2013],Cardiff City,10,4,6,445,0,0,8,6,2,519,0,0,18,10,8,964,0,0,0.0,0.0,0.0,0,0,0,0,0,0,0,0,0,2020-12-27 19:15:00
1423,3107,Don Hutchison,1095,[2000],Sunderland AFC,11,11,0,958,3,0,14,13,1,1194,5,0,25,24,1,2152,8,0,3.0,0.0,3.0,3,4,7,0,0,0,0,0,0,2020-12-27 19:15:00
1424,6217,Don Hutchison,1095,"[2001, 2002]",West Ham United,16,10,6,889,1,0,16,12,4,1079,0,0,32,22,10,1968,1,0,0.0,0.0,0.0,1,0,1,0,0,0,0,0,0,2020-12-27 19:15:002020-12-27 19:15:00
1425,3110,Donald Love,3316,[2015],Manchester United,0,0,0,0,0,0,1,0,1,53,0,0,1,0,1,53,0,0,0.0,0.0,0.0,0,0,0,0,0,0,0,0,0,2020-12-27 19:15:00
1426,3111,Donald Love,3316,[2016],Sunderland AFC,7,5,2,481,0,0,5,1,4,126,0,0,12,6,6,607,0,0,0.0,0.0,0.0,0,0,0,0,0,0,0,0,0,2020-12-27 19:15:00
1427,3112,Doneil Henry,4269,[2015],West Ham United,0,0,0,0,0,0,0,0,0,0,0,0,0,0,0,0,0,0,0.0,0.0,0.0,0,0,0,0,0,0,0,0,0,2020-12-27 19:15:00
1428,3113,Donervon Daniels,4103,[2013],West Bromwich Albion,0,0,0,0,0,0,0,0,0,0,0,0,0,0,0,0,0,0,0.0,0.0,0.0,0,0,0,0,0,0,0,0,0,2020-12-27 19:15:00
1429,6229,Dong-gook Lee,3400,"[2006, 2007]",Middlesbrough FC,12,4,8,369,0,0,11,4,7,458,0,0,23,8,15,827,0,0,0.0,0.0,0.0,0,0,0,0,0,0,0,0,0,2020-12-27 19:15:002020-12-27 19:15:00
1430,9351,Dong-won Ji,3576,"[2011, 2012, 2013]",Sunderland AFC,13,1,12,222,2,0,11,3,8,415,0,0,24,4,20,637,2,0,3.0,0.0,3.0,1,0,1,0,0,0,0,0,0,2020-12-27 19:15:002020-12-27 19:15:002020-12-27 19:15:00
1431,3119,Doni,2994,[2011],Liverpool FC,2,2,0,180,0,0,2,2,0,180,0,0,4,4,0,360,0,0,0.0,0.0,0.0,0,0,0,0,0,0,0,0,0,2020-12-27 19:15:00
1432,3120,Donny van de Beek,1017,[2020],Manchester United,5,0,5,90,1,0,5,2,3,161,0,0,10,2,8,251,1,0,0.0,0.0,0.0,0,0,0,0,0,0,0,0,0,2020-12-27 19:15:00
1433,12490,Doriva,1338,"[2002, 2003, 2004, 2005]",Middlesbrough FC,37,27,10,2457,0,0,42,29,13,2690,0,0,79,56,23,5147,0,0,0.0,0.0,0.0,0,0,0,0,0,0,0,0,0,2020-12-27 19:15:002020-12-27 19:15:002020-12-27 19:15:002020-12-27 19:15:00
1434,3125,Dorus de Vries,3707,[2011],Wolverhampton Wanderers,2,2,0,180,0,0,2,2,0,141,0,0,4,4,0,321,0,0,0.0,0.0,0.0,0,0,0,0,0,0,0,0,0,2020-12-27 19:15:00
1435,3126,Dougie Freedman,2030,[2004],Crystal Palace,11,6,5,587,0,0,9,4,5,301,1,0,20,10,10,888,1,0,0.0,0.0,0.0,0,1,1,0,0,0,0,0,0,2020-12-27 19:15:00
1436,3127,Douglas,3700,[2006],Watford FC,3,3,0,262,0,0,4,3,1,174,1,0,7,6,1,436,1,0,0.0,0.0,0.0,0,0,0,0,0,0,0,0,0,2020-12-27 19:15:00
1437,6257,Douglas Luiz,2845,"[2019, 2020]",Aston Villa,24,21,3,1874,2,0,24,19,5,1786,1,0,48,40,8,3660,3,0,0.0,0.0,0.0,1,0,1,0,0,0,0,0,0,2020-12-27 19:15:002020-12-27 19:15:00
1438,3130,Dujon Sterling,4373,[2017],Chelsea FC,0,0,0,0,0,0,0,0,0,0,0,0,0,0,0,0,0,0,0.0,0.0,0.0,0,0,0,0,0,0,0,0,0,2020-12-27 19:15:00
1439,18801,Duncan Ferguson,1805,"[2000, 2001, 2002, 2003, 2004, 2005]",Everton FC,63,30,33,3319,18,0,55,19,36,2413,6,0,118,49,69,5732,24,0,14.0,3.0,17.0,14,3,17,2,1,3,0,0,0,2020-12-27 19:15:002020-12-27 19:15:002020-12-27 19:15:002020-12-27 19:15:002020-12-27 19:15:002020-12-27 19:15:00
1440,9414,Duncan Watmore,2820,"[2014, 2015, 2016]",Sunderland AFC,19,9,10,1043,2,0,18,9,9,892,1,0,37,18,19,1935,3,0,0.0,0.0,0.0,0,0,0,0,0,0,0,0,0,2020-12-27 19:15:002020-12-27 19:15:002020-12-27 19:15:00
1441,3140,Dušan Kuciak,4027,[2016],Hull City,0,0,0,0,0,0,0,0,0,0,0,0,0,0,0,0,0,0,0.0,0.0,0.0,0,0,0,0,0,0,0,0,0,2020-12-27 19:15:00
1442,12570,Dušan Tadić,1159,"[2014, 2015, 2016, 2017]",Southampton FC,68,59,9,4903,13,0,66,56,10,4688,8,0,134,115,19,9591,21,0,3.0,7.0,10.0,4,4,8,2,2,4,0,0,0,2020-12-27 19:15:002020-12-27 19:15:002020-12-27 19:15:002020-12-27 19:15:00
1443,9438,Dwight Gayle,2477,"[2013, 2014, 2015]",Crystal Palace,35,15,20,1593,7,0,29,12,17,1190,8,0,64,27,37,2783,15,0,4.0,7.0,11.0,6,6,12,2,0,2,0,0,0,2020-12-27 19:15:002020-12-27 19:15:002020-12-27 19:15:00
1444,9447,Dwight Gayle,2477,"[2017, 2019, 2020]",Newcastle United,28,17,11,1455,5,0,31,16,15,1414,6,0,59,33,26,2869,11,0,3.0,0.0,3.0,5,5,10,0,0,0,0,0,0,2020-12-27 19:15:002020-12-27 19:15:002020-12-27 19:15:00
1445,12610,Dwight McNeil,2349,"[2017, 2018, 2019, 2020]",Burnley FC,38,36,2,3157,5,0,35,34,1,2955,0,0,73,70,3,6112,5,0,0.0,0.0,0.0,1,0,1,0,0,0,0,0,0,2020-12-27 19:15:002020-12-27 19:15:002020-12-27 19:15:002020-12-27 19:15:00
1446,9468,Dwight Tiendalli,2936,"[2012, 2013, 2014]",Swansea City,11,8,3,715,0,0,16,13,3,1175,1,0,27,21,6,1890,1,0,0.0,3.0,3.0,0,1,1,0,0,0,0,0,0,2020-12-27 19:15:002020-12-27 19:15:002020-12-27 19:15:00
1447,6317,Dwight Yorke,1223,"[2000, 2001]",Manchester United,17,12,5,1100,8,0,15,7,8,839,1,0,32,19,13,1939,9,0,0.0,0.0,0.0,5,0,5,0,0,0,0,0,0,2020-12-27 19:15:002020-12-27 19:15:00
1448,6321,Dwight Yorke,1223,"[2002, 2003]",Blackburn Rovers,27,19,8,1634,4,0,28,20,8,1959,8,0,55,39,16,3593,12,0,3.0,8.0,11.0,3,8,11,0,1,1,0,0,0,2020-12-27 19:15:002020-12-27 19:15:00
1449,3162,Dwight Yorke,1223,[2004],Birmingham City,8,2,6,335,2,0,5,2,3,184,0,0,13,4,9,519,2,0,1.0,0.0,1.0,2,0,2,0,0,0,0,0,0,2020-12-27 19:15:00
1450,6327,Dwight Yorke,1223,"[2007, 2008]",Sunderland AFC,13,11,2,801,0,0,14,10,4,752,1,0,27,21,6,1553,1,0,0.0,0.0,0.0,0,0,0,0,0,0,0,0,0,2020-12-27 19:15:002020-12-27 19:15:00
1451,3165,Dylan Tombides,4477,[2010],West Ham United,0,0,0,0,0,0,0,0,0,0,0,0,0,0,0,0,0,0,0.0,0.0,0.0,0,0,0,0,0,0,0,0,0,2020-12-27 19:15:00
1452,3166,Eberechi Eze,1019,[2020],Crystal Palace,6,5,1,422,1,0,8,5,3,490,0,0,14,10,4,912,1,0,0.0,0.0,0.0,0,0,0,0,0,0,0,0,0,2020-12-27 19:15:00
1453,3167,Ebi Smolarek,2728,[2008],Bolton Wanderers,5,1,4,113,0,0,7,0,7,106,0,0,12,1,11,219,0,0,0.0,0.0,0.0,0,0,0,0,0,0,0,0,0,2020-12-27 19:15:00
1454,9507,Ed de Goey,3051,"[2000, 2001, 2002]",Chelsea FC,12,12,0,1035,0,0,10,10,0,900,0,0,22,22,0,1935,0,0,0.0,0.0,0.0,0,0,0,0,0,0,0,0,0,2020-12-27 19:15:002020-12-27 19:15:002020-12-27 19:15:00
1455,9516,Eddie Johnson,3295,"[2007, 2009, 2010]",Fulham FC,10,2,8,317,0,0,9,3,6,305,0,0,19,5,14,622,0,0,0.0,0.0,0.0,0,0,0,0,0,0,0,0,0,2020-12-27 19:15:002020-12-27 19:15:002020-12-27 19:15:00
1456,3174,Eddie Lewis,1574,[2001],Fulham FC,0,0,0,0,0,0,1,1,0,90,0,0,1,1,0,90,0,0,0.0,0.0,0.0,0,0,0,0,0,0,0,0,0,2020-12-27 19:15:00
1457,3175,Eddie Lewis,1574,[2007],Derby County,13,13,0,1079,0,0,11,9,2,830,0,0,24,22,2,1909,0,0,0.0,0.0,0.0,0,0,0,0,0,0,0,0,0,2020-12-27 19:15:00
1458,12710,Eddie Nketiah,2512,"[2017, 2018, 2019, 2020]",Arsenal FC,14,5,9,498,2,0,19,5,14,540,2,0,33,10,23,1038,4,0,3.0,0.0,3.0,2,1,3,0,0,0,0,0,0,2020-12-27 19:15:002020-12-27 19:15:002020-12-27 19:15:002020-12-27 19:15:00
1459,22281,Eden Hazard,1541,"[2012, 2013, 2014, 2015, 2016, 2017, 2018]",Chelsea FC,122,110,12,9722,53,0,122,111,11,9658,32,0,244,221,23,19380,85,0,18.0,10.0,28.0,28,22,50,13,4,17,0,0,0,2020-12-27 19:15:002020-12-27 19:15:002020-12-27 19:15:002020-12-27 19:15:002020-12-27 19:15:002020-12-27 19:15:002020-12-27 19:15:00
1460,12754,Ederson,1195,"[2017, 2018, 2019, 2020]",Manchester City,61,61,0,5445,0,0,61,61,0,5490,0,0,122,122,0,10935,0,0,0.0,0.0,0.0,0,0,0,0,0,0,0,0,0,2020-12-27 19:15:002020-12-27 19:15:002020-12-27 19:15:002020-12-27 19:15:00
1461,6383,Edgar Davids,3344,"[2005, 2006]",Tottenham Hotspur,20,18,2,1545,0,0,19,15,4,1313,1,0,39,33,6,2858,1,0,0.0,0.0,0.0,0,0,0,0,0,0,0,0,0,2020-12-27 19:15:002020-12-27 19:15:00
1462,6387,Edimilson Fernandes,2643,"[2016, 2017]",West Ham United,21,7,14,847,0,0,21,10,11,985,0,0,42,17,25,1832,0,0,0.0,0.0,0.0,0,0,0,0,0,0,0,0,0,2020-12-27 19:15:002020-12-27 19:15:00
1463,15985,Edin Džeko,1362,"[2010, 2011, 2012, 2013, 2014]",Manchester City,62,34,28,3332,18,0,68,40,28,3778,32,0,130,74,56,7110,50,0,9.0,12.0,21.0,11,16,27,0,0,0,0,0,0,2020-12-27 19:15:002020-12-27 19:15:002020-12-27 19:15:002020-12-27 19:15:002020-12-27 19:15:00
1464,3200,Edinson Cavani,1016,[2020],Manchester United,4,0,4,93,0,0,4,1,3,113,3,0,8,1,7,206,3,0,0.0,3.0,3.0,0,2,2,0,0,0,0,0,0,2020-12-27 19:15:00
1465,3201,Edouard Mendy,1002,[2020],Chelsea FC,5,5,0,450,0,0,6,6,0,540,0,0,11,11,0,990,0,0,0.0,0.0,0.0,0,0,0,0,0,0,0,0,0,2020-12-27 19:15:00
1466,16020,Edu,1529,"[2000, 2001, 2002, 2003, 2004]",Arsenal FC,39,21,18,2032,3,0,40,20,20,1927,4,0,79,41,38,3959,7,0,0.0,3.0,3.0,2,2,4,1,0,1,0,0,0,2020-12-27 19:15:002020-12-27 19:15:002020-12-27 19:15:002020-12-27 19:15:002020-12-27 19:15:00
1467,6415,Eduardo,3544,"[2007, 2009]",Arsenal FC,20,13,7,1094,3,0,19,11,8,817,5,0,39,24,15,1911,8,0,0.0,0.0,0.0,1,3,4,0,0,0,0,0,0,2020-12-27 19:15:002020-12-27 19:15:00
1468,6419,Eduardo,3544,"[2016, 2017]",Chelsea FC,0,0,0,0,0,0,0,0,0,0,0,0,0,0,0,0,0,0,0.0,0.0,0.0,0,0,0,0,0,0,0,0,0,2020-12-27 19:15:002020-12-27 19:15:00
1469,3211,Eduardo Vargas,3851,[2014],Queens Park Rangers,12,8,4,722,2,0,9,8,1,664,1,0,21,16,5,1386,3,0,0.0,0.0,0.0,2,1,3,0,0,0,0,0,0,2020-12-27 19:15:00
1470,12854,Edwin van der Sar,1077,"[2001, 2002, 2003, 2004]",Fulham FC,62,61,1,5463,0,0,55,55,0,4922,0,0,117,116,1,10385,0,0,0.0,0.0,0.0,0,0,0,0,0,0,0,0,0,2020-12-27 19:15:002020-12-27 19:15:002020-12-27 19:15:002020-12-27 19:15:00
1471,19311,Edwin van der Sar,1077,"[2005, 2006, 2007, 2008, 2009, 2010]",Manchester United,92,92,0,8280,0,0,94,94,0,8313,0,0,186,186,0,16593,0,0,0.0,0.0,0.0,0,0,0,0,0,0,0,0,0,2020-12-27 19:15:002020-12-27 19:15:002020-12-27 19:15:002020-12-27 19:15:002020-12-27 19:15:002020-12-27 19:15:00
1472,3222,Eggert Jónsson,4179,[2011],Wolverhampton Wanderers,2,1,1,109,0,0,1,1,0,64,0,0,3,2,1,173,0,0,0.0,0.0,0.0,0,0,0,0,0,0,0,0,0,2020-12-27 19:15:00
1473,3223,Egil Østenstad,2300,[2000],Manchester City,3,1,2,143,0,0,0,0,0,0,0,0,3,1,2,143,0,0,0.0,0.0,0.0,0,0,0,0,0,0,0,0,0,2020-12-27 19:15:00
1474,6449,Egil Østenstad,2300,"[2001, 2002]",Blackburn Rovers,11,7,4,567,1,0,10,3,7,350,0,0,21,10,11,917,1,0,0.0,0.0,0.0,1,0,1,0,0,0,0,0,0,2020-12-27 19:15:002020-12-27 19:15:00
1475,12910,Eirik Bakke,1298,"[2000, 2001, 2002, 2003]",Leeds United,46,35,11,3234,4,0,42,36,6,3096,2,0,88,71,17,6330,6,0,0.0,0.0,0.0,3,2,5,0,0,0,0,0,0,2020-12-27 19:15:002020-12-27 19:15:002020-12-27 19:15:002020-12-27 19:15:00
1476,3230,Eirik Bakke,1298,[2005],Aston Villa,7,5,2,386,0,0,7,3,4,299,0,0,14,8,6,685,0,0,0.0,0.0,0.0,0,0,0,0,0,0,0,0,0,2020-12-27 19:15:00
1477,19401,Eiður Guðjohnsen,2373,"[2000, 2001, 2002, 2003, 2004, 2005]",Chelsea FC,93,65,28,5881,34,0,90,58,32,5327,20,0,183,123,60,11208,54,0,6.0,10.0,16.0,17,11,28,2,0,2,0,0,0,2020-12-27 19:15:002020-12-27 19:15:002020-12-27 19:15:002020-12-27 19:15:002020-12-27 19:15:002020-12-27 19:15:00
1478,3237,Eiður Guðjohnsen,2373,[2009],Tottenham Hotspur,6,1,5,136,0,0,5,2,3,247,1,0,11,3,8,383,1,0,0.0,0.0,0.0,0,1,1,0,0,0,0,0,0,2020-12-27 19:15:00
1479,3238,Eiður Guðjohnsen,2373,[2010],Fulham FC,3,2,1,158,0,0,7,2,5,251,0,0,10,4,6,409,0,0,0.0,0.0,0.0,0,0,0,0,0,0,0,0,0,2020-12-27 19:15:00
1480,3239,El-Hadji Ba,2266,[2013],Sunderland AFC,1,0,1,19,0,0,0,0,0,0,0,0,1,0,1,19,0,0,0.0,0.0,0.0,0,0,0,0,0,0,0,0,0,2020-12-27 19:15:00
1481,6481,El-Hadji Diouf,1719,"[2002, 2003]",Liverpool FC,29,20,9,1717,3,0,25,20,5,1780,0,0,54,40,14,3497,3,0,0.0,0.0,0.0,2,0,2,0,0,0,0,0,0,2020-12-27 19:15:002020-12-27 19:15:00
1482,12974,El-Hadji Diouf,1719,"[2004, 2005, 2006, 2007]",Bolton Wanderers,55,50,5,4351,10,0,55,48,7,4102,11,0,110,98,12,8453,21,0,1.0,12.0,13.0,9,10,19,1,1,2,0,0,0,2020-12-27 19:15:002020-12-27 19:15:002020-12-27 19:15:002020-12-27 19:15:00
1483,9741,El-Hadji Diouf,1719,"[2008, 2009, 2010]",Blackburn Rovers,31,27,4,2343,3,0,28,27,1,2274,1,0,59,54,5,4617,4,0,2.0,0.0,2.0,3,1,4,0,0,0,0,0,0,2020-12-27 19:15:002020-12-27 19:15:002020-12-27 19:15:00
1484,6499,Elano,3031,"[2007, 2008]",Manchester City,32,27,5,2317,9,0,29,22,7,1920,5,0,61,49,12,4237,14,0,3.0,0.0,3.0,3,3,6,3,3,6,0,0,0,2020-12-27 19:15:002020-12-27 19:15:00
1485,9756,Eldin Jakupović,2563,"[2013, 2014, 2016]",Hull City,12,12,0,1080,0,0,14,13,1,1217,0,0,26,25,1,2297,0,0,0.0,0.0,0.0,0,0,0,0,0,0,0,0,0,2020-12-27 19:15:002020-12-27 19:15:002020-12-27 19:15:00
1486,3254,Eldin Jakupović,2563,[2017],Leicester City,1,1,0,90,0,0,1,1,0,90,0,0,2,2,0,180,0,0,0.0,0.0,0.0,0,0,0,0,0,0,0,0,0,2020-12-27 19:15:00
1487,3255,Elia Caprile,1076,[2020],Leeds United,0,0,0,0,0,0,0,0,0,0,0,0,0,0,0,0,0,0,0.0,0.0,0.0,0,0,0,0,0,0,0,0,0,2020-12-27 19:15:00
1488,9771,Eliaquim Mangala,1209,"[2014, 2015, 2017]",Manchester City,27,26,1,2315,0,0,30,25,5,2383,0,0,57,51,6,4698,0,0,0.0,0.0,0.0,0,0,0,0,0,0,0,0,0,2020-12-27 19:15:002020-12-27 19:15:002020-12-27 19:15:00
1489,6519,Elias Kachunga,3101,"[2017, 2018]",Huddersfield Town,18,15,3,1233,0,0,21,15,6,1286,1,0,39,30,9,2519,1,0,0.0,0.0,0.0,0,1,1,0,0,0,0,0,0,2020-12-27 19:15:002020-12-27 19:15:00
1490,3261,Eljero Elia,1155,[2014],Southampton FC,7,4,3,333,0,0,9,5,4,455,2,0,16,9,7,788,2,0,0.0,3.0,3.0,0,2,2,0,0,0,0,0,0,2020-12-27 19:15:00
1491,3262,Elliot Anderson,1086,[2020],Newcastle United,0,0,0,0,0,0,0,0,0,0,0,0,0,0,0,0,0,0,0.0,0.0,0.0,0,0,0,0,0,0,0,0,0,2020-12-27 19:15:00
1492,3263,Elliot Embleton,3362,[2016],Sunderland AFC,0,0,0,0,0,0,0,0,0,0,0,0,0,0,0,0,0,0,0.0,0.0,0.0,0,0,0,0,0,0,0,0,0,2020-12-27 19:15:00
1493,3264,Elliot Grandin,2610,[2010],Blackpool FC,10,8,2,600,1,0,13,13,0,914,0,0,23,21,2,1514,1,0,1.0,0.0,1.0,1,0,1,0,0,0,0,0,0,2020-12-27 19:15:00
1494,13066,Elliot Lee,3524,"[2012, 2013, 2014, 2015]",West Ham United,1,0,1,2,0,0,1,0,1,13,0,0,2,0,2,15,0,0,0.0,0.0,0.0,0,0,0,0,0,0,0,0,0,2020-12-27 19:15:002020-12-27 19:15:002020-12-27 19:15:002020-12-27 19:15:00
1495,3269,Elliot Omozusi,3969,[2007],Fulham FC,4,4,0,329,0,0,4,4,0,360,0,0,8,8,0,689,0,0,0.0,0.0,0.0,0,0,0,0,0,0,0,0,0,2020-12-27 19:15:00
1496,9813,Elliott Bennett,3043,"[2011, 2012, 2013]",Norwich City,30,15,15,1476,1,0,30,18,12,1667,1,0,60,33,27,3143,2,0,0.0,3.0,3.0,0,1,1,0,0,0,0,0,0,2020-12-27 19:15:002020-12-27 19:15:002020-12-27 19:15:00
1497,3273,Elliott Moore,4081,[2016],Leicester City,0,0,0,0,0,0,0,0,0,0,0,0,0,0,0,0,0,0,0.0,0.0,0.0,0,0,0,0,0,0,0,0,0,2020-12-27 19:15:00
1498,3274,Elliott Ward,3578,[2005],West Bromwich Albion,1,1,0,90,0,0,0,0,0,0,0,0,1,1,0,90,0,0,0.0,0.0,0.0,0,0,0,0,0,0,0,0,0,2020-12-27 19:15:00
1499,3275,Elliott Ward,3578,[2011],Norwich City,6,6,0,540,0,0,6,6,0,540,0,0,12,12,0,1080,0,0,0.0,0.0,0.0,0,0,0,0,0,0,0,0,0,2020-12-27 19:15:00
1500,6553,Ellis Simms,4364,"[2019, 2020]",Everton FC,0,0,0,0,0,0,0,0,0,0,0,0,0,0,0,0,0,0,0.0,0.0,0.0,0,0,0,0,0,0,0,0,0,2020-12-27 19:15:002020-12-27 19:15:00
1501,3278,Elsad Zverotić,3455,[2013],Fulham FC,2,2,0,140,0,0,4,3,1,266,0,0,6,5,1,406,0,0,0.0,0.0,0.0,0,0,0,0,0,0,0,0,0,2020-12-27 19:15:00
1502,3279,Elvijs Putniņš,3210,[2011],Queens Park Rangers,0,0,0,0,0,0,0,0,0,0,0,0,0,0,0,0,0,0,0.0,0.0,0.0,0,0,0,0,0,0,0,0,0,2020-12-27 19:15:00
1503,6561,Elvis Hammond,4011,"[2002, 2004]",Fulham FC,6,1,5,233,0,0,4,1,3,114,0,0,10,2,8,347,0,0,0.0,0.0,0.0,0,0,0,0,0,0,0,0,0,2020-12-27 19:15:002020-12-27 19:15:00
1504,13134,Emanuel Pogatetz,1883,"[2005, 2006, 2007, 2008]",Middlesbrough FC,55,53,2,4621,3,0,54,52,2,4711,1,0,109,105,4,9332,4,0,0.0,0.0,0.0,1,1,2,0,0,0,0,0,0,2020-12-27 19:15:002020-12-27 19:15:002020-12-27 19:15:002020-12-27 19:15:00
1505,3286,Emanuel Pogatetz,1883,[2012],West Ham United,2,0,2,19,0,0,4,1,3,130,0,0,6,1,5,149,0,0,0.0,0.0,0.0,0,0,0,0,0,0,0,0,0,2020-12-27 19:15:00
1506,3287,Emanuel Villa,3598,[2007],Derby County,9,7,2,599,2,0,7,2,5,327,1,0,16,9,7,926,3,0,1.0,1.0,2.0,2,1,3,0,0,0,0,0,0,2020-12-27 19:15:00
1507,9867,Emanuele Giaccherini,2263,"[2013, 2014, 2015]",Sunderland AFC,13,8,5,722,2,0,19,10,9,936,2,0,32,18,14,1658,4,0,0.0,0.0,0.0,0,1,1,0,0,0,0,0,0,2020-12-27 19:15:002020-12-27 19:15:002020-12-27 19:15:00
1508,3291,Emerse Faé,4140,[2007],Reading FC,2,1,1,92,0,0,5,2,3,189,0,0,7,3,4,281,0,0,0.0,0.0,0.0,0,0,0,0,0,0,0,0,0,2020-12-27 19:15:00
1509,13174,Emerson,3166,"[2017, 2018, 2019, 2020]",Chelsea FC,14,12,2,1092,0,0,18,11,7,960,0,0,32,23,9,2052,0,0,0.0,0.0,0.0,0,0,0,0,0,0,0,0,0,2020-12-27 19:15:002020-12-27 19:15:002020-12-27 19:15:002020-12-27 19:15:00
1510,6593,Emerson Hyndman,3938,"[2017, 2018]",AFC Bournemouth,0,0,0,0,0,0,2,1,1,96,0,0,2,1,1,96,0,0,0.0,0.0,0.0,0,0,0,0,0,0,0,0,0,2020-12-27 19:15:002020-12-27 19:15:00
1511,6597,Emil Krafth,2476,"[2019, 2020]",Newcastle United,9,7,2,635,0,0,12,7,5,672,0,0,21,14,7,1307,0,0,0.0,0.0,0.0,0,0,0,0,0,0,0,0,0,2020-12-27 19:15:002020-12-27 19:15:00
1512,9905,Emile Heskey,1519,"[2000, 2002, 2003]",Liverpool FC,52,39,13,3412,14,0,46,36,10,3274,13,0,98,75,23,6686,27,0,7.0,6.0,13.0,6,8,14,0,0,0,0,0,0,2020-12-27 19:15:002020-12-27 19:15:002020-12-27 19:15:00
1513,3301,Emile Heskey,1519,[2001],West Ham United,1,1,0,90,0,0,0,0,0,0,0,0,1,1,0,90,0,0,0.0,0.0,0.0,0,0,0,0,0,0,0,0,0,2020-12-27 19:15:00
1514,6609,Emile Heskey,1519,"[2004, 2005]",Birmingham City,35,35,0,2848,8,0,32,32,0,2772,6,0,67,67,0,5620,14,0,12.0,0.0,12.0,6,4,10,0,0,0,0,0,0,2020-12-27 19:15:002020-12-27 19:15:00
1515,3306,Emile Heskey,1519,[2006],Wigan Athletic,16,16,0,1326,6,0,18,17,1,1379,3,0,34,33,1,2705,9,0,3.0,0.0,3.0,5,3,8,0,0,0,0,0,0,2020-12-27 19:15:00
1516,3307,Emile Heskey,1519,[2007],Blackburn Rovers,0,0,0,0,0,0,1,1,0,38,0,0,1,1,0,38,0,0,0.0,0.0,0.0,0,0,0,0,0,0,0,0,0,2020-12-27 19:15:00
1517,13238,Emile Heskey,1519,"[2008, 2009, 2010, 2011]",Aston Villa,42,26,16,2091,4,0,47,28,19,2368,5,0,89,54,35,4459,9,0,0.0,7.0,7.0,1,5,6,0,0,0,0,0,0,2020-12-27 19:15:002020-12-27 19:15:002020-12-27 19:15:002020-12-27 19:15:00
1518,9939,Emile Smith-Rowe,1474,"[2018, 2019, 2020]",Arsenal FC,2,1,1,96,0,0,1,1,0,66,0,0,3,2,1,162,0,0,0.0,0.0,0.0,0,0,0,0,0,0,0,0,0,2020-12-27 19:15:002020-12-27 19:15:002020-12-27 19:15:00
1519,3315,Emiliano Buendia,1831,[2019],Norwich City,19,16,3,1408,0,0,17,12,5,1112,1,0,36,28,8,2520,1,0,0.0,0.0,0.0,0,1,1,0,0,0,0,0,0,2020-12-27 19:15:00
1520,13270,Emiliano Insúa,1889,"[2006, 2007, 2008, 2009]",Liverpool FC,19,18,1,1672,0,0,27,25,2,2268,0,0,46,43,3,3940,0,0,0.0,0.0,0.0,0,0,0,0,0,0,0,0,0,2020-12-27 19:15:002020-12-27 19:15:002020-12-27 19:15:002020-12-27 19:15:00
1521,16610,Emiliano Martínez,1482,"[2012, 2014, 2016, 2018, 2019]",Arsenal FC,7,6,1,571,0,0,8,7,1,680,0,0,15,13,2,1251,0,0,0.0,0.0,0.0,0,0,0,0,0,0,0,0,0,2020-12-27 19:15:002020-12-27 19:15:002020-12-27 19:15:002020-12-27 19:15:002020-12-27 19:15:00
1522,3325,Emiliano Martínez,1482,[2020],Aston Villa,7,7,0,630,0,0,6,6,0,540,0,0,13,13,0,1170,0,0,0.0,0.0,0.0,0,0,0,0,0,0,0,0,0,2020-12-27 19:15:00
1523,3326,Emiliano Viviano,4365,[2013],Arsenal FC,0,0,0,0,0,0,0,0,0,0,0,0,0,0,0,0,0,0,0.0,0.0,0.0,0,0,0,0,0,0,0,0,0,2020-12-27 19:15:00
1524,3327,Emilio N'Sue,3012,[2016],Middlesbrough FC,1,1,0,90,0,0,3,3,0,232,0,0,4,4,0,322,0,0,0.0,0.0,0.0,0,0,0,0,0,0,0,0,0,2020-12-27 19:15:00
1525,13318,Emmanuel Adebayor,1235,"[2005, 2006, 2007, 2008]",Arsenal FC,53,44,9,4026,21,0,49,40,9,3624,25,0,102,84,18,7650,46,0,3.0,9.0,12.0,10,12,22,4,1,5,0,0,0,2020-12-27 19:15:002020-12-27 19:15:002020-12-27 19:15:002020-12-27 19:15:00
1526,6665,Emmanuel Adebayor,1235,"[2009, 2010]",Manchester City,18,14,4,1298,8,0,16,13,3,1154,7,0,34,27,7,2452,15,0,3.0,3.0,6.0,4,5,9,0,1,1,0,0,0,2020-12-27 19:15:002020-12-27 19:15:00
1527,13342,Emmanuel Adebayor,1235,"[2011, 2012, 2013, 2014]",Tottenham Hotspur,50,39,11,3687,17,0,42,40,2,3438,18,0,92,79,13,7125,35,0,3.0,7.0,10.0,9,11,20,1,3,4,0,0,0,2020-12-27 19:15:002020-12-27 19:15:002020-12-27 19:15:002020-12-27 19:15:00
1528,3338,Emmanuel Adebayor,1235,[2015],Crystal Palace,5,3,2,274,1,0,7,4,3,345,0,0,12,7,5,619,1,0,0.0,0.0,0.0,1,0,1,0,0,0,0,0,0,2020-12-27 19:15:00
1529,23394,Emmanuel Eboué,1231,"[2004, 2005, 2006, 2007, 2008, 2009, 2010]",Arsenal FC,70,51,19,4532,2,0,60,43,17,3894,2,0,130,94,36,8426,4,0,0.0,0.0,0.0,0,1,1,1,0,1,0,0,0,2020-12-27 19:15:002020-12-27 19:15:002020-12-27 19:15:002020-12-27 19:15:002020-12-27 19:15:002020-12-27 19:15:002020-12-27 19:15:00
1530,3346,Emmanuel Emenike,2714,[2015],West Ham United,6,3,3,252,0,0,7,2,5,256,0,0,13,5,8,508,0,0,0.0,0.0,0.0,0,0,0,0,0,0,0,0,0,2020-12-27 19:15:00
1531,10044,Emmanuel Frimpong,2753,"[2011, 2012, 2013]",Arsenal FC,4,2,2,166,0,0,2,1,1,71,0,0,6,3,3,237,0,0,0.0,0.0,0.0,0,0,0,0,0,0,0,0,0,2020-12-27 19:15:002020-12-27 19:15:002020-12-27 19:15:00
1532,10053,Emmanuel Mayuka,2872,"[2012, 2013, 2014]",Southampton FC,9,1,8,177,0,0,7,0,7,95,0,0,16,1,15,272,0,0,0.0,0.0,0.0,0,0,0,0,0,0,0,0,0,2020-12-27 19:15:002020-12-27 19:15:002020-12-27 19:15:00
1533,3353,Emmanuel Olisadebe,4255,[2005],Portsmouth FC,1,0,1,29,0,0,1,0,1,37,0,0,2,0,2,66,0,0,0.0,0.0,0.0,0,0,0,0,0,0,0,0,0,2020-12-27 19:15:00
1534,10065,Emmanuel Petit,2616,"[2001, 2002, 2003]",Chelsea FC,28,25,3,2198,1,0,25,25,0,2124,1,0,53,50,3,4322,2,0,3.0,0.0,3.0,1,0,1,0,0,0,0,0,0,2020-12-27 19:15:002020-12-27 19:15:002020-12-27 19:15:00
1535,6715,Emmanuel Rivière,2634,"[2014, 2015]",Newcastle United,12,10,2,749,0,0,14,6,8,529,1,0,26,16,10,1278,1,0,0.0,0.0,0.0,0,1,1,0,0,0,0,0,0,2020-12-27 19:15:002020-12-27 19:15:00
1536,3359,Emmerson Boyce,2023,[2004],Crystal Palace,14,13,1,1172,0,0,12,12,0,1080,0,0,26,25,1,2252,0,0,0.0,0.0,0.0,0,0,0,0,0,0,0,0,0,2020-12-27 19:15:00
1537,20180,Emmerson Boyce,2023,"[2006, 2008, 2009, 2010, 2011, 2012]",Wigan Athletic,82,80,2,7024,6,0,86,84,2,7389,5,0,168,164,4,14413,11,0,3.0,0.0,3.0,5,2,7,0,0,0,0,0,0,2020-12-27 19:15:002020-12-27 19:15:002020-12-27 19:15:002020-12-27 19:15:002020-12-27 19:15:002020-12-27 19:15:00
1538,3361,Emmerson Boyce,2023,[2007],Blackburn Rovers,0,0,0,0,0,0,1,1,0,90,0,0,1,1,0,90,0,0,0.0,0.0,0.0,0,0,0,0,0,0,0,0,0,2020-12-27 19:15:00
1539,10104,Emre Belözoğlu,2712,"[2005, 2006, 2007]",Newcastle United,30,24,6,2015,4,0,27,21,6,1947,1,0,57,45,12,3962,5,0,9.0,0.0,9.0,4,0,4,0,1,1,0,0,0,2020-12-27 19:15:002020-12-27 19:15:002020-12-27 19:15:00
1540,13486,Emre Can,1185,"[2014, 2015, 2016, 2017]",Liverpool FC,57,51,6,4503,4,0,57,50,7,4503,6,0,114,101,13,9006,10,0,3.0,3.0,6.0,3,4,7,0,0,0,0,0,0,2020-12-27 19:15:002020-12-27 19:15:002020-12-27 19:15:002020-12-27 19:15:00
1541,6749,Enda Stevens,1972,"[2011, 2012]",Aston Villa,4,4,0,294,0,0,3,2,1,177,0,0,7,6,1,471,0,0,0.0,0.0,0.0,0,0,0,0,0,0,0,0,0,2020-12-27 19:15:002020-12-27 19:15:00
1542,6753,Enda Stevens,1972,"[2019, 2020]",Sheffield United,25,25,0,2177,1,0,25,25,0,2250,1,0,50,50,0,4427,2,0,0.0,0.0,0.0,1,1,2,0,0,0,0,0,0,2020-12-27 19:15:002020-12-27 19:15:00
1543,6757,Enner Valencia,2715,"[2014, 2015]",West Ham United,26,16,10,1456,3,0,25,19,6,1679,5,0,51,35,16,3135,8,0,0.0,0.0,0.0,2,2,4,0,0,0,0,0,0,2020-12-27 19:15:002020-12-27 19:15:00
1544,3380,Enner Valencia,2715,[2016],Everton FC,11,3,8,427,2,0,10,2,8,279,1,0,21,5,16,706,3,0,0.0,0.0,0.0,1,0,1,0,0,0,0,0,0,2020-12-27 19:15:00
1545,3381,Enric Vallès,4242,[2010],Birmingham City,0,0,0,0,0,0,0,0,0,0,0,0,0,0,0,0,0,0,0.0,0.0,0.0,0,0,0,0,0,0,0,0,0,2020-12-27 19:15:00
1546,3382,Eoin Jess,2840,[2000],Bradford City,7,7,0,630,1,0,6,6,0,514,2,0,13,13,0,1144,3,0,0.0,0.0,0.0,1,2,3,0,0,0,0,0,0,2020-12-27 19:15:00
1547,3383,Erdal Rakip,4530,[2017],Crystal Palace,0,0,0,0,0,0,0,0,0,0,0,0,0,0,0,0,0,0,0.0,0.0,0.0,0,0,0,0,0,0,0,0,0,2020-12-27 19:15:00
1548,16930,Eric Bailly,2755,"[2016, 2017, 2018, 2019, 2020]",Manchester United,27,23,4,2021,0,0,31,23,8,2024,1,0,58,46,12,4045,1,0,0.0,0.0,0.0,0,1,1,0,0,0,0,0,0,2020-12-27 19:15:002020-12-27 19:15:002020-12-27 19:15:002020-12-27 19:15:002020-12-27 19:15:00
1549,23744,Eric Dier,1162,"[2014, 2015, 2016, 2017, 2018, 2019, 2020]",Tottenham Hotspur,97,88,9,7919,7,0,91,87,4,7623,3,0,188,175,13,15542,10,0,3.0,3.0,6.0,5,3,8,0,0,0,0,0,0,2020-12-27 19:15:002020-12-27 19:15:002020-12-27 19:15:002020-12-27 19:15:002020-12-27 19:15:002020-12-27 19:15:002020-12-27 19:15:00
1550,3396,Eric Djemba-Djemba,1793,[2003],Manchester United,7,4,3,383,0,0,8,6,2,499,0,0,15,10,5,882,0,0,0.0,0.0,0.0,0,0,0,0,0,0,0,0,0,2020-12-27 19:15:00
1551,10194,Eric Djemba-Djemba,1793,"[2004, 2005, 2006]",Aston Villa,3,2,1,166,0,0,8,2,6,300,0,0,11,4,7,466,0,0,0.0,0.0,0.0,0,0,0,0,0,0,0,0,0,2020-12-27 19:15:002020-12-27 19:15:002020-12-27 19:15:00
1552,6801,Eric García,3476,"[2019, 2020]",Manchester City,9,6,3,587,0,0,7,4,3,403,0,0,16,10,6,990,0,0,0.0,0.0,0.0,0,0,0,0,0,0,0,0,0,2020-12-27 19:15:002020-12-27 19:15:00
1553,10209,Eric Lichaj,1976,"[2010, 2011, 2012]",Aston Villa,17,11,6,1139,1,0,14,9,5,1055,0,0,31,20,11,2194,1,0,0.0,0.0,0.0,1,0,1,0,0,0,0,0,0,2020-12-27 19:15:002020-12-27 19:15:002020-12-27 19:15:00
1554,3405,Eric Maxim Choupo-Moting,1906,[2017],Stoke City,14,13,1,1124,4,0,15,12,3,1045,1,0,29,25,4,2169,5,0,1.0,0.0,1.0,3,1,4,0,0,0,0,0,0,2020-12-27 19:15:00
1555,3406,Erik Durm,3216,[2018],Huddersfield Town,13,8,5,875,0,0,15,13,2,1183,0,0,28,21,7,2058,0,0,0.0,0.0,0.0,0,0,0,0,0,0,0,0,0,2020-12-27 19:15:00
1556,6815,Erik Edman,2196,"[2004, 2005]",Tottenham Hotspur,14,14,0,1216,0,0,17,17,0,1438,1,0,31,31,0,2654,1,0,0.0,0.0,0.0,0,1,1,0,0,0,0,0,0,2020-12-27 19:15:002020-12-27 19:15:00
1557,10230,Erik Edman,2196,"[2007, 2008, 2009]",Wigan Athletic,5,4,1,385,0,0,5,3,2,249,0,0,10,7,3,634,0,0,0.0,0.0,0.0,0,0,0,0,0,0,0,0,0,2020-12-27 19:15:002020-12-27 19:15:002020-12-27 19:15:00
1558,3412,Erik Hagen,4337,[2007],Wigan Athletic,0,0,0,0,0,0,1,1,0,73,0,0,1,1,0,73,0,0,0.0,0.0,0.0,0,0,0,0,0,0,0,0,0,2020-12-27 19:15:00
1559,3413,Erik Meijer,3739,[2000],Liverpool FC,2,0,2,30,0,0,1,0,1,10,0,0,3,0,3,40,0,0,0.0,0.0,0.0,0,0,0,0,0,0,0,0,0,2020-12-27 19:15:00
1560,10245,Erik Nevland,2197,"[2007, 2008, 2009]",Fulham FC,27,8,19,937,6,0,25,10,15,906,3,0,52,18,34,1843,9,0,3.0,0.0,3.0,3,2,5,0,0,0,0,0,0,2020-12-27 19:15:002020-12-27 19:15:002020-12-27 19:15:00
1561,17095,Erik Pieters,1545,"[2013, 2014, 2015, 2016, 2017]",Stoke City,85,84,1,7378,1,0,84,79,5,7058,0,0,169,163,6,14436,1,0,3.0,0.0,3.0,1,0,1,0,0,0,0,0,0,2020-12-27 19:15:002020-12-27 19:15:002020-12-27 19:15:002020-12-27 19:15:002020-12-27 19:15:00
1562,6845,Erik Pieters,1545,"[2019, 2020]",Burnley FC,14,10,4,955,0,0,17,13,4,1189,0,0,31,23,8,2144,0,0,0.0,0.0,0.0,0,0,0,0,0,0,1,0,1,2020-12-27 19:15:002020-12-27 19:15:00
1563,3424,Erwin Mulder,4148,[2017],Swansea City,0,0,0,0,0,0,0,0,0,0,0,0,0,0,0,0,0,0,0.0,0.0,0.0,0,0,0,0,0,0,0,0,0,2020-12-27 19:15:00
1564,3425,Espen Baardsen,4544,[2002],Everton FC,0,0,0,0,0,0,1,1,0,90,0,0,1,1,0,90,0,0,0.0,0.0,0.0,0,0,0,0,0,0,0,0,0,2020-12-27 19:15:00
1565,3426,Esteban Cambiasso,2517,[2014],Leicester City,13,13,0,1121,3,0,18,14,4,1300,2,0,31,27,4,2421,5,0,0.0,0.0,0.0,2,2,4,0,0,0,0,0,0,2020-12-27 19:15:00
1566,6855,Ethan Ampadu,3167,"[2017, 2018]",Chelsea FC,0,0,0,0,0,0,1,0,1,10,0,0,1,0,1,10,0,0,0.0,0.0,0.0,0,0,0,0,0,0,0,0,0,2020-12-27 19:15:002020-12-27 19:15:00
1567,3429,Ethan Ampadu,3167,[2020],Sheffield United,5,5,0,397,0,0,4,3,1,329,0,0,9,8,1,726,0,0,0.0,0.0,0.0,0,0,0,0,0,0,0,0,0,2020-12-27 19:15:00
1568,3430,Ethan Ebanks-Landell,4435,[2010],Wolverhampton Wanderers,0,0,0,0,0,0,0,0,0,0,0,0,0,0,0,0,0,0,0.0,0.0,0.0,0,0,0,0,0,0,0,0,0,2020-12-27 19:15:00
1569,3431,Ethan Robson,3816,[2016],Sunderland AFC,0,0,0,0,0,0,0,0,0,0,0,0,0,0,0,0,0,0,0.0,0.0,0.0,0,0,0,0,0,0,0,0,0,2020-12-27 19:15:00
1570,3432,Eunan O'Kane,1011,[2015],AFC Bournemouth,10,2,8,362,0,0,6,4,2,387,0,0,16,6,10,749,0,0,0.0,0.0,0.0,0,0,0,0,0,0,0,0,0,2020-12-27 19:15:00
1571,3433,Evandro,2735,[2016],Hull City,5,2,3,165,0,0,6,5,1,412,0,0,11,7,4,577,0,0,0.0,0.0,0.0,0,0,0,0,0,0,0,0,0,2020-12-27 19:15:00
1572,3434,Eyal Berkovic,3123,[2002],Manchester City,13,13,0,1056,1,0,13,13,0,1016,0,0,26,26,0,2072,1,0,0.0,0.0,0.0,0,0,0,0,0,0,0,0,0,2020-12-27 19:15:00
1573,6871,Eyal Berkovic,3123,"[2003, 2004]",Portsmouth FC,15,11,4,861,1,0,7,5,2,403,1,0,22,16,6,1264,2,0,0.0,0.0,0.0,1,1,2,0,0,0,0,0,0,2020-12-27 19:15:002020-12-27 19:15:00
1574,3437,Eyong Enoh,4004,[2012],Fulham FC,4,4,0,360,0,0,5,4,1,333,0,0,9,8,1,693,0,0,0.0,0.0,0.0,0,0,0,0,0,0,0,0,0,2020-12-27 19:15:00
1575,3438,Ezekiel Fryers,2127,[2011],Manchester United,2,0,2,67,0,0,0,0,0,0,0,0,2,0,2,67,0,0,0.0,0.0,0.0,0,0,0,0,0,0,0,0,0,2020-12-27 19:15:00
1576,3439,Ezekiel Fryers,2127,[2013],Tottenham Hotspur,4,3,1,314,0,0,3,0,3,83,0,0,7,3,4,397,0,0,0.0,0.0,0.0,0,0,0,0,0,0,0,0,0,2020-12-27 19:15:00
1577,6881,Ezekiel Fryers,2127,"[2014, 2016]",Crystal Palace,3,0,3,60,0,0,6,0,6,124,0,0,9,0,9,184,0,0,0.0,0.0,0.0,0,0,0,0,0,0,0,0,0,2020-12-27 19:15:002020-12-27 19:15:00
1578,6885,Ezequiel Schelotto,2507,"[2017, 2019]",Brighton & Hove Albion,14,9,5,800,0,0,14,10,4,877,0,0,28,19,9,1677,0,0,0.0,0.0,0.0,0,0,0,0,0,0,0,0,0,2020-12-27 19:15:002020-12-27 19:15:00
1579,3444,Ezgjan Alioski,1066,[2020],Leeds United,7,5,2,391,1,0,6,5,1,430,0,0,13,10,3,821,1,0,0.0,0.0,0.0,0,0,0,0,0,0,0,0,0,2020-12-27 19:15:00
1580,6891,Ezri Konsa,2844,"[2019, 2020]",Aston Villa,18,17,1,1531,2,0,18,17,1,1457,1,0,36,34,2,2988,3,0,3.0,0.0,3.0,2,1,3,0,0,0,0,0,0,2020-12-27 19:15:002020-12-27 19:15:00
1581,20697,Fabian Delph,1198,"[2009, 2010, 2011, 2012, 2013, 2014]",Aston Villa,57,49,8,4418,2,0,55,48,7,4323,1,0,112,97,15,8741,3,0,3.0,3.0,6.0,2,1,3,0,0,0,0,0,0,2020-12-27 19:15:002020-12-27 19:15:002020-12-27 19:15:002020-12-27 19:15:002020-12-27 19:15:002020-12-27 19:15:00
1582,13818,Fabian Delph,1198,"[2015, 2016, 2017, 2018]",Manchester City,29,19,10,1772,4,0,28,20,8,1672,0,0,57,39,18,3444,4,0,0.0,0.0,0.0,1,0,1,0,0,0,0,0,0,2020-12-27 19:15:002020-12-27 19:15:002020-12-27 19:15:002020-12-27 19:15:00
1583,6915,Fabian Delph,1198,"[2019, 2020]",Everton FC,10,7,3,691,0,0,11,8,3,730,0,0,21,15,6,1421,0,0,0.0,0.0,0.0,0,0,0,0,0,0,0,0,0,2020-12-27 19:15:002020-12-27 19:15:00
1584,10380,Fabian Schär,2474,"[2018, 2019, 2020]",Newcastle United,28,23,5,2167,5,0,26,22,4,2007,1,0,54,45,9,4174,6,0,1.0,0.0,1.0,4,0,4,0,0,0,0,0,0,2020-12-27 19:15:002020-12-27 19:15:002020-12-27 19:15:00
1585,6925,Fabian Wilnis,3320,"[2000, 2001]",Ipswich Town,22,15,7,1331,1,0,19,16,3,1468,1,0,41,31,10,2799,2,0,0.0,3.0,3.0,1,1,2,0,0,0,0,0,0,2020-12-27 19:15:002020-12-27 19:15:00
1586,10395,Fabien Barthez,1104,"[2000, 2001, 2002]",Manchester United,49,49,0,4281,0,0,38,38,0,3345,0,0,87,87,0,7626,0,0,0.0,0.0,0.0,0,0,0,0,0,0,0,0,0,2020-12-27 19:15:002020-12-27 19:15:002020-12-27 19:15:00
1587,10404,Fabinho,2085,"[2018, 2019, 2020]",Liverpool FC,35,30,5,2760,3,0,34,25,9,2443,0,0,69,55,14,5203,3,0,0.0,0.0,0.0,1,0,1,0,0,0,0,0,0,2020-12-27 19:15:002020-12-27 19:15:002020-12-27 19:15:00
1588,6941,Fabio Borini,1777,"[2009, 2010]",Chelsea FC,4,0,4,33,0,0,0,0,0,0,0,0,4,0,4,33,0,0,0.0,0.0,0.0,0,0,0,0,0,0,0,0,0,2020-12-27 19:15:002020-12-27 19:15:00
1589,6946,Fabio Borini,1777,"[2012, 2014]",Liverpool FC,14,3,11,419,0,0,11,5,6,483,2,0,25,8,17,902,2,0,0.0,0.0,0.0,0,1,1,0,0,0,0,0,0,2020-12-27 19:15:002020-12-27 19:15:00
1590,10424,Fabio Borini,1777,"[2013, 2015, 2016]",Sunderland AFC,43,32,11,2897,8,0,39,34,5,2885,6,0,82,66,16,5782,14,0,5.0,3.0,8.0,4,3,7,1,3,4,0,0,0,2020-12-27 19:15:002020-12-27 19:15:002020-12-27 19:15:00
1591,3477,Fabio Daprelà,4251,[2009],West Ham United,4,2,2,182,0,0,3,2,1,189,0,0,7,4,3,371,0,0,0.0,0.0,0.0,0,0,0,0,0,0,0,0,0,2020-12-27 19:15:00
1592,10437,Fabián Balbuena,2200,"[2018, 2019, 2020]",West Ham United,25,23,2,2016,1,0,27,25,2,2254,2,0,52,48,4,4270,3,0,0.0,0.0,0.0,0,1,1,0,0,0,0,0,0,2020-12-27 19:15:002020-12-27 19:15:002020-12-27 19:15:00
1593,13930,Fabrice Fernandes,2695,"[2001, 2002, 2003, 2004]",Southampton FC,46,40,6,3465,3,0,39,31,8,2435,2,0,85,71,14,5900,5,0,1.0,1.0,2.0,2,2,4,0,0,0,0,0,0,2020-12-27 19:15:002020-12-27 19:15:002020-12-27 19:15:002020-12-27 19:15:00
1594,3485,Fabrice Fernandes,2695,[2005],Bolton Wanderers,0,0,0,0,0,0,1,0,1,15,0,0,1,0,1,15,0,0,0.0,0.0,0.0,0,0,0,0,0,0,0,0,0,2020-12-27 19:15:00
1595,3486,Fabrice Muamba,1964,[2007],Birmingham City,19,19,0,1646,1,0,18,18,0,1552,1,0,37,37,0,3198,2,0,0.0,0.0,0.0,0,0,0,0,0,0,0,0,0,2020-12-27 19:15:00
1596,13954,Fabrice Muamba,1964,"[2008, 2009, 2010, 2011]",Bolton Wanderers,63,55,8,4497,2,0,66,62,4,5129,1,0,129,117,12,9626,3,0,0.0,0.0,0.0,1,0,1,0,0,0,0,0,0,2020-12-27 19:15:002020-12-27 19:15:002020-12-27 19:15:002020-12-27 19:15:00
1597,3491,Fabricio,3905,[2018],Fulham FC,1,1,0,90,0,0,1,1,0,90,0,0,2,2,0,180,0,0,0.0,0.0,0.0,0,0,0,0,0,0,0,0,0,2020-12-27 19:15:00
1598,24465,Fabricio Coloccini,2278,"[2008, 2010, 2011, 2012, 2013, 2014, 2015]",Newcastle United,105,105,0,9342,3,0,104,104,0,9212,1,0,209,209,0,18554,4,0,1.0,0.0,1.0,3,0,3,0,0,0,0,0,0,2020-12-27 19:15:002020-12-27 19:15:002020-12-27 19:15:002020-12-27 19:15:002020-12-27 19:15:002020-12-27 19:15:002020-12-27 19:15:00
1599,3499,Fabrizio Ravanelli,3360,[2001],Derby County,17,16,1,1405,5,0,12,12,0,1045,4,0,29,28,1,2450,9,0,0.0,0.0,0.0,5,2,7,1,0,1,0,0,0,2020-12-27 19:15:00
1600,3500,Facundo Ferreyra,4438,[2014],Newcastle United,0,0,0,0,0,0,0,0,0,0,0,0,0,0,0,0,0,0,0.0,0.0,0.0,0,0,0,0,0,0,0,0,0,2020-12-27 19:15:00
1601,7003,Facundo Sava,3063,"[2002, 2003]",Fulham FC,13,9,4,816,4,0,12,5,7,433,2,0,25,14,11,1249,6,0,6.0,0.0,6.0,3,1,4,0,0,0,0,0,0,2020-12-27 19:15:002020-12-27 19:15:00
1602,3503,Fangzhuo Dong,4361,[2006],Manchester United,0,0,0,0,0,0,1,1,0,72,0,0,1,1,0,72,0,0,0.0,0.0,0.0,0,0,0,0,0,0,0,0,0,2020-12-27 19:15:00
1603,7009,Faustino Anjorin,4109,"[2019, 2020]",Chelsea FC,1,0,1,19,0,0,0,0,0,0,0,0,1,0,1,19,0,0,0.0,0.0,0.0,0,0,0,0,0,0,0,0,0,2020-12-27 19:15:002020-12-27 19:15:00
1604,3506,Federico Bessone,4271,[2011],Swansea City,1,0,1,4,0,0,0,0,0,0,0,0,1,0,1,4,0,0,0.0,0.0,0.0,0,0,0,0,0,0,0,0,0,2020-12-27 19:15:00
1605,7015,Federico Fazio,1163,"[2014, 2015]",Tottenham Hotspur,9,9,0,810,0,0,11,11,0,990,0,0,20,20,0,1800,0,0,0.0,0.0,0.0,0,0,0,0,0,0,0,0,0,2020-12-27 19:15:002020-12-27 19:15:00
1606,14042,Federico Fernández,1697,"[2014, 2015, 2016, 2017]",Swansea City,54,54,0,4860,1,0,63,62,1,5601,1,0,117,116,1,10461,2,0,3.0,1.0,4.0,1,1,2,0,0,0,0,0,0,2020-12-27 19:15:002020-12-27 19:15:002020-12-27 19:15:002020-12-27 19:15:00
1607,10542,Federico Fernández,1697,"[2018, 2019, 2020]",Newcastle United,30,28,2,2458,1,0,34,31,3,2770,1,0,64,59,5,5228,2,0,3.0,0.0,3.0,1,0,1,0,0,0,0,1,1,2020-12-27 19:15:002020-12-27 19:15:002020-12-27 19:15:00
1608,14070,Federico Macheda,2019,"[2008, 2009, 2010, 2011]",Manchester United,11,1,10,237,2,0,8,4,4,341,2,0,19,5,14,578,4,0,3.0,3.0,6.0,1,1,2,0,0,0,0,0,0,2020-12-27 19:15:002020-12-27 19:15:002020-12-27 19:15:002020-12-27 19:15:00
1609,10563,Felipe Anderson,2203,"[2018, 2019, 2020]",West Ham United,31,28,3,2255,5,0,32,28,4,2308,5,0,63,56,7,4563,10,0,0.0,4.0,4.0,3,4,7,0,0,0,0,0,0,2020-12-27 19:15:002020-12-27 19:15:002020-12-27 19:15:00
1610,7047,Felipe Caicedo,3089,"[2007, 2008]",Manchester City,13,5,8,441,4,0,14,5,9,598,0,0,27,10,17,1039,4,0,3.0,0.0,3.0,3,0,3,0,0,0,0,0,0,2020-12-27 19:15:002020-12-27 19:15:00
1611,3525,Felix Nmecha,1000,[2020],Manchester City,0,0,0,0,0,0,0,0,0,0,0,0,0,0,0,0,0,0,0.0,0.0,0.0,0,0,0,0,0,0,0,0,0,2020-12-27 19:15:00
1612,3526,Ferdinand Coly,4455,[2002],Birmingham City,1,1,0,68,0,0,0,0,0,0,0,0,1,1,0,68,0,0,0.0,0.0,0.0,0,0,0,0,0,0,0,0,0,2020-12-27 19:15:00
1613,28244,Fernandinho,1202,"[2013, 2014, 2015, 2016, 2017, 2018, 2019, 2020]",Manchester City,114,97,17,8912,13,0,116,107,9,9424,5,0,230,204,26,18336,18,0,3.0,0.0,3.0,3,3,6,0,0,0,0,0,0,2020-12-27 19:15:002020-12-27 19:15:002020-12-27 19:15:002020-12-27 19:15:002020-12-27 19:15:002020-12-27 19:15:002020-12-27 19:15:002020-12-27 19:15:00
1614,10608,Fernando,1592,"[2014, 2015, 2016]",Manchester City,35,22,13,2092,2,0,29,22,7,2062,2,0,64,44,20,4154,4,0,0.0,0.0,0.0,1,2,3,0,0,0,0,0,0,2020-12-27 19:15:002020-12-27 19:15:002020-12-27 19:15:00
1615,3538,Fernando Amorebieta,3349,[2013],Fulham FC,12,10,2,976,1,0,11,10,1,906,0,0,23,20,3,1882,1,0,0.0,0.0,0.0,0,0,0,0,0,0,0,0,0,2020-12-27 19:15:00
1616,3539,Fernando Forestieri,4444,[2015],Watford FC,0,0,0,0,0,0,0,0,0,0,0,0,0,0,0,0,0,0,0.0,0.0,0.0,0,0,0,0,0,0,0,0,0,2020-12-27 19:15:00
1617,3540,Fernando Guerrero,2553,[2009],Burnley FC,3,0,3,15,0,0,4,0,4,56,0,0,7,0,7,71,0,0,0.0,0.0,0.0,0,0,0,0,0,0,0,0,0,2020-12-27 19:15:00
1618,10626,Fernando Torres,1539,"[2007, 2008, 2009]",Liverpool FC,41,37,4,3226,40,0,38,32,6,2766,16,0,79,69,10,5992,56,0,13.0,13.0,26.0,22,13,35,0,0,0,0,0,0,2020-12-27 19:15:002020-12-27 19:15:002020-12-27 19:15:00
1619,17730,Fernando Torres,1539,"[2010, 2011, 2012, 2013, 2014]",Chelsea FC,53,32,21,3190,12,0,56,39,17,3638,8,0,109,71,38,6828,20,0,6.0,3.0,9.0,7,4,11,0,1,1,0,0,0,2020-12-27 19:15:002020-12-27 19:15:002020-12-27 19:15:002020-12-27 19:15:002020-12-27 19:15:00
1620,3549,Ferrán Torres,1042,[2020],Manchester City,4,3,1,231,2,0,6,4,2,341,0,0,10,7,3,572,2,0,0.0,0.0,0.0,0,0,0,0,0,0,0,0,0,2020-12-27 19:15:00
1621,14206,Fikayo Tomori,3506,"[2015, 2017, 2019, 2020]",Chelsea FC,9,7,2,704,0,0,8,8,0,663,1,0,17,15,2,1367,1,0,0.0,0.0,0.0,0,1,1,0,0,0,0,0,0,2020-12-27 19:15:002020-12-27 19:15:002020-12-27 19:15:002020-12-27 19:15:00
1622,3554,Filip Benković,4491,[2019],Leicester City,0,0,0,0,0,0,0,0,0,0,0,0,0,0,0,0,0,0,0.0,0.0,0.0,0,0,0,0,0,0,0,0,0,2020-12-27 19:15:00
1623,3555,Filip Krovinović,1031,[2020],West Bromwich Albion,4,2,2,228,0,0,6,3,3,297,0,0,10,5,5,525,0,0,0.0,0.0,0.0,0,0,0,0,0,0,0,0,0,2020-12-27 19:15:00
1624,3556,Filip Lesniak,4082,[2016],Tottenham Hotspur,0,0,0,0,0,0,1,0,1,4,0,0,1,0,1,4,0,0,0.0,0.0,0.0,0,0,0,0,0,0,0,0,0,2020-12-27 19:15:00
1625,3557,Filip Đuričić,2663,[2014],Southampton FC,4,2,2,173,0,0,5,1,4,154,0,0,9,3,6,327,0,0,0.0,0.0,0.0,0,0,0,0,0,0,0,0,0,2020-12-27 19:15:00
1626,3558,Filipe Luís,3421,[2014],Chelsea FC,6,4,2,410,0,0,9,5,4,530,0,0,15,9,6,940,0,0,0.0,0.0,0.0,0,0,0,0,0,0,0,0,0,2020-12-27 19:15:00
1627,10680,Filipe Oliveira,4075,"[2002, 2003, 2004]",Chelsea FC,1,0,1,11,0,0,4,0,4,10,0,0,5,0,5,21,0,0,0.0,0.0,0.0,0,0,0,0,0,0,0,0,0,2020-12-27 19:15:002020-12-27 19:15:002020-12-27 19:15:00
1628,3562,Filipe Teixeira,2004,[2008],West Bromwich Albion,4,0,4,124,0,0,6,1,5,135,0,0,10,1,9,259,0,0,0.0,0.0,0.0,0,0,0,0,0,0,0,0,0,2020-12-27 19:15:00
1629,3563,Finidi George,2723,[2001],Ipswich Town,13,11,2,900,4,0,12,10,2,694,2,0,25,21,4,1594,6,0,0.0,0.0,0.0,1,2,3,0,0,0,0,0,0,2020-12-27 19:15:00
1630,3564,Fitz Hall,2024,[2003],Southampton FC,4,3,1,340,0,0,6,3,3,320,0,0,10,6,4,660,0,0,0.0,0.0,0.0,0,0,0,0,0,0,0,0,0,2020-12-27 19:15:00
1631,3565,Fitz Hall,2024,[2004],Crystal Palace,18,18,0,1576,2,0,17,17,0,1506,1,0,35,35,0,3082,3,0,0.0,0.0,0.0,2,1,3,0,0,0,0,0,0,2020-12-27 19:15:00
1632,7133,Fitz Hall,2024,"[2006, 2007]",Wigan Athletic,12,11,1,950,0,0,13,11,2,984,0,0,25,22,3,1934,0,0,0.0,0.0,0.0,0,0,0,0,0,0,0,0,0,2020-12-27 19:15:002020-12-27 19:15:00
1633,3568,Fitz Hall,2024,[2011],Queens Park Rangers,7,5,2,485,0,0,7,6,1,438,0,0,14,11,3,923,0,0,0.0,0.0,0.0,0,0,0,0,0,0,0,0,0,2020-12-27 19:15:00
1634,3569,Florent Cuvelier,4504,[2012],Stoke City,0,0,0,0,0,0,0,0,0,0,0,0,0,0,0,0,0,0,0.0,0.0,0.0,0,0,0,0,0,0,0,0,0,2020-12-27 19:15:00
1635,7141,Florent Hadergjonaj,3099,"[2017, 2018]",Huddersfield Town,22,20,2,1800,0,0,25,18,7,1713,0,0,47,38,9,3513,0,0,0.0,0.0,0.0,0,0,0,0,0,0,0,0,0,2020-12-27 19:15:002020-12-27 19:15:00
1636,7145,Florent Laville,3787,"[2002, 2003]",Bolton Wanderers,8,8,0,657,0,0,7,7,0,630,0,0,15,15,0,1287,0,0,0.0,0.0,0.0,0,0,0,0,0,0,0,0,0,2020-12-27 19:15:002020-12-27 19:15:00
1637,17880,Florent Malouda,2270,"[2007, 2008, 2009, 2010, 2011]",Chelsea FC,72,50,22,4459,24,0,76,59,17,5137,11,0,148,109,39,9596,35,0,9.0,3.0,12.0,12,3,15,0,0,0,0,0,0,2020-12-27 19:15:002020-12-27 19:15:002020-12-27 19:15:002020-12-27 19:15:002020-12-27 19:15:00
1638,7159,Florent Sinama-Pongolle,3873,"[2003, 2004]",Liverpool FC,17,6,11,636,3,0,13,3,10,443,1,0,30,9,21,1079,4,0,3.0,0.0,3.0,1,0,1,0,0,0,0,0,0,2020-12-27 19:15:002020-12-27 19:15:00
1639,3581,Florent Sinama-Pongolle,3873,[2005],Blackburn Rovers,6,5,1,404,0,0,4,3,1,304,1,0,10,8,2,708,1,0,0.0,0.0,0.0,0,0,0,0,0,0,0,0,0,2020-12-27 19:15:00
1640,10749,Florian Lejeune,2577,"[2017, 2018, 2019]",Newcastle United,21,21,0,1793,0,0,21,19,2,1807,2,0,42,40,2,3600,2,0,0.0,1.0,1.0,0,1,1,0,0,0,0,0,0,2020-12-27 19:15:002020-12-27 19:15:002020-12-27 19:15:00
1641,3585,Florian Marange,3234,[2013],Crystal Palace,0,0,0,0,0,0,1,1,0,90,0,0,1,1,0,90,0,0,0.0,0.0,0.0,0,0,0,0,0,0,0,0,0,2020-12-27 19:15:00
1642,3586,Florian Thauvin,2821,[2015],Newcastle United,6,2,4,275,0,0,7,1,6,145,0,0,13,3,10,420,0,0,0.0,0.0,0.0,0,0,0,0,0,0,0,0,0,2020-12-27 19:15:00
1643,7175,Florin Andone,2706,"[2018, 2019]",Brighton & Hove Albion,14,4,10,521,2,0,12,5,7,485,2,0,26,9,17,1006,4,0,3.0,3.0,6.0,1,1,2,0,0,0,0,0,0,2020-12-27 19:15:002020-12-27 19:15:00
1644,7179,Florin Gardoş,1157,"[2014, 2016]",Southampton FC,5,2,3,191,0,0,6,3,3,382,0,0,11,5,6,573,0,0,0.0,0.0,0.0,0,0,0,0,0,0,0,0,0,2020-12-27 19:15:002020-12-27 19:15:00
1645,3591,Floyd Ayité,3942,[2018],Fulham FC,7,3,4,296,0,0,9,0,9,169,1,0,16,3,13,465,1,0,0.0,0.0,0.0,0,1,1,0,0,0,0,0,0,2020-12-27 19:15:00
1646,7185,Fousséni Diabaté,2566,"[2017, 2018]",Leicester City,7,4,3,353,0,0,8,2,6,284,0,0,15,6,9,637,0,0,0.0,0.0,0.0,0,0,0,0,0,0,0,0,0,2020-12-27 19:15:002020-12-27 19:15:00
1647,3594,Fraizer Campbell,1027,[2007],Manchester United,0,0,0,0,0,0,1,0,1,17,0,0,1,0,1,17,0,0,0.0,0.0,0.0,0,0,0,0,0,0,0,0,0,2020-12-27 19:15:00
1648,3595,Fraizer Campbell,1027,[2008],Tottenham Hotspur,7,1,6,227,0,0,3,0,3,48,1,0,10,1,9,275,1,0,0.0,0.0,0.0,0,0,0,0,0,0,0,0,0,2020-12-27 19:15:00
1649,14390,Fraizer Campbell,1027,"[2009, 2010, 2011, 2012]",Sunderland AFC,27,16,11,1575,4,0,30,12,18,1359,2,0,57,28,29,2934,6,0,0.0,0.0,0.0,3,1,4,0,0,0,0,0,0,2020-12-27 19:15:002020-12-27 19:15:002020-12-27 19:15:002020-12-27 19:15:00
1650,3600,Fraizer Campbell,1027,[2013],Cardiff City,18,17,1,1418,5,0,19,15,4,1355,1,0,37,32,5,2773,6,0,0.0,0.0,0.0,3,0,3,0,0,0,0,0,0,2020-12-27 19:15:00
1651,10806,Fraizer Campbell,1027,"[2014, 2015, 2016]",Crystal Palace,22,9,13,861,3,0,21,8,13,825,2,0,43,17,26,1686,5,0,1.0,1.0,2.0,2,2,4,0,0,0,0,0,0,2020-12-27 19:15:002020-12-27 19:15:002020-12-27 19:15:00
1652,7209,Fran Mérida,3491,"[2008, 2009]",Arsenal FC,2,0,2,25,0,0,4,0,4,56,1,0,6,0,6,81,1,0,0.0,0.0,0.0,0,0,0,0,0,0,0,0,0,2020-12-27 19:15:002020-12-27 19:15:00
1653,10821,Francis Benali,3384,"[2000, 2001, 2002]",Southampton FC,4,1,3,129,0,0,5,1,4,165,0,0,9,2,7,294,0,0,0.0,0.0,0.0,0,0,0,0,0,0,0,0,0,2020-12-27 19:15:002020-12-27 19:15:002020-12-27 19:15:00
1654,21669,Francis Coquelin,1503,"[2011, 2012, 2014, 2015, 2016, 2017]",Arsenal FC,51,33,18,2940,0,0,52,37,15,3057,0,0,103,70,33,5997,0,0,0.0,0.0,0.0,0,0,0,0,0,0,0,0,0,2020-12-27 19:15:002020-12-27 19:15:002020-12-27 19:15:002020-12-27 19:15:002020-12-27 19:15:002020-12-27 19:15:00
1655,7233,Francis Jeffers,2359,"[2000, 2003]",Everton FC,17,9,8,872,3,0,11,6,5,612,3,0,28,15,13,1484,6,0,0.0,3.0,3.0,3,3,6,0,0,0,0,0,0,2020-12-27 19:15:002020-12-27 19:15:00
1656,7233,Francis Jeffers,2359,"[2001, 2002]",Arsenal FC,11,1,10,249,3,0,11,3,8,296,1,0,22,4,18,545,4,0,0.0,0.0,0.0,2,1,3,0,0,0,0,0,0,2020-12-27 19:15:002020-12-27 19:15:00
1657,3619,Francis Jeffers,2359,[2004],Charlton Athletic,12,5,7,426,3,0,8,4,4,436,0,0,20,9,11,862,3,0,0.0,0.0,0.0,2,0,2,0,0,0,0,0,0,2020-12-27 19:15:00
1658,3620,Francis Jeffers,2359,[2006],Blackburn Rovers,5,2,3,134,0,0,5,1,4,217,0,0,10,3,7,351,0,0,0.0,0.0,0.0,0,0,0,0,0,0,0,0,0,2020-12-27 19:15:00
1659,3621,Francisco Santos,4377,[2012],Everton FC,0,0,0,0,0,0,0,0,0,0,0,0,0,0,0,0,0,0,0.0,0.0,0.0,0,0,0,0,0,0,0,0,0,2020-12-27 19:15:00
1660,7245,Francisco Xisco,2404,"[2008, 2010]",Newcastle United,3,2,1,192,1,0,3,1,2,100,0,0,6,3,3,292,1,0,0.0,0.0,0.0,0,0,0,0,0,0,0,0,0,2020-12-27 19:15:002020-12-27 19:15:00
1661,18130,Franck Queudrue,1329,"[2001, 2002, 2003, 2004, 2005]",Middlesbrough FC,76,75,1,6465,5,0,70,66,4,5832,6,0,146,141,5,12297,11,0,7.0,3.0,10.0,5,2,7,0,0,0,0,0,0,2020-12-27 19:15:002020-12-27 19:15:002020-12-27 19:15:002020-12-27 19:15:002020-12-27 19:15:00
1662,3629,Franck Queudrue,1329,[2006],Fulham FC,13,13,0,1125,0,0,14,13,1,1210,1,0,27,26,1,2335,1,0,0.0,1.0,1.0,0,1,1,0,0,0,0,0,0,2020-12-27 19:15:00
1663,7261,Franck Queudrue,1329,"[2007, 2009]",Birmingham City,11,10,1,914,0,0,11,10,1,832,0,0,22,20,2,1746,0,0,0.0,0.0,0.0,0,0,0,0,0,0,0,0,0,2020-12-27 19:15:002020-12-27 19:15:00
1664,7265,Franck Songo'o,4046,"[2005, 2007]",Portsmouth FC,1,0,1,14,0,0,2,0,2,43,0,0,3,0,3,57,0,0,0.0,0.0,0.0,0,0,0,0,0,0,0,0,0,2020-12-27 19:15:002020-12-27 19:15:00
1665,3634,Franck Tabanou,3709,[2015],Swansea City,0,0,0,0,0,0,0,0,0,0,0,0,0,0,0,0,0,0,0.0,0.0,0.0,0,0,0,0,0,0,0,0,0,2020-12-27 19:15:00
1666,3635,Franco Di Santo,2272,[2008],Chelsea FC,6,0,6,126,0,0,2,0,2,28,0,0,8,0,8,154,0,0,0.0,0.0,0.0,0,0,0,0,0,0,0,0,0,2020-12-27 19:15:00
1667,14550,Franco Di Santo,2272,"[2009, 2010, 2011, 2012]",Wigan Athletic,48,30,18,2677,6,0,45,28,17,2481,7,0,93,58,35,5158,13,0,0.0,5.0,5.0,4,6,10,0,0,0,0,0,0,2020-12-27 19:15:002020-12-27 19:15:002020-12-27 19:15:002020-12-27 19:15:00
1668,3640,Frank Fielding,4416,[2010],Blackburn Rovers,0,0,0,0,0,0,0,0,0,0,0,0,0,0,0,0,0,0,0.0,0.0,0.0,0,0,0,0,0,0,0,0,0,2020-12-27 19:15:00
1669,3641,Frank Lampard,1536,[2000],West Ham United,8,8,0,675,2,0,14,14,0,1250,5,0,22,22,0,1925,7,0,0.0,4.0,4.0,0,3,3,0,1,1,0,0,0,2020-12-27 19:15:00
1670,47424,Frank Lampard,1536,"[2001, 2002, 2003, 2004, 2005, 2006, 2007, 2008, 2009, 2010, 2011, 2012, 2013]",Chelsea FC,215,200,15,17827,79,0,208,198,10,17672,68,0,423,398,25,35499,147,0,33.0,27.0,60.0,36,47,83,23,18,41,0,0,0,2020-12-27 19:15:002020-12-27 19:15:002020-12-27 19:15:002020-12-27 19:15:002020-12-27 19:15:002020-12-27 19:15:002020-12-27 19:15:002020-12-27 19:15:002020-12-27 19:15:002020-12-27 19:15:002020-12-27 19:15:002020-12-27 19:15:002020-12-27 19:15:00
1671,3655,Frank Lampard,1536,[2014],Manchester City,15,6,9,536,3,0,17,4,13,456,3,0,32,10,22,992,6,0,4.0,3.0,7.0,3,1,4,0,0,0,0,0,0,2020-12-27 19:15:00
1672,3656,Frank Leboeuf,3052,[2000],Chelsea FC,11,11,0,967,0,0,13,11,2,941,0,0,24,22,2,1908,0,0,0.0,0.0,0.0,0,0,0,0,0,0,0,0,0,2020-12-27 19:15:00
1673,7315,Frank Nouble,3820,"[2009, 2010]",West Ham United,4,1,3,81,0,0,6,2,4,176,0,0,10,3,7,257,0,0,0.0,0.0,0.0,0,0,0,0,0,0,0,0,0,2020-12-27 19:15:002020-12-27 19:15:00
1674,10980,Frank Sinclair,1305,"[2000, 2001, 2003]",Leicester City,35,32,3,2692,1,0,30,25,5,2301,0,0,65,57,8,4993,1,0,0.0,0.0,0.0,0,0,0,0,0,0,0,0,0,2020-12-27 19:15:002020-12-27 19:15:002020-12-27 19:15:00
1675,3662,Frankie Sutherland,4580,[2014],Queens Park Rangers,0,0,0,0,0,0,0,0,0,0,0,0,0,0,0,0,0,0,0.0,0.0,0.0,0,0,0,0,0,0,0,0,0,2020-12-27 19:15:00
1676,3663,François Grenet,3866,[2001],Derby County,4,4,0,328,0,0,10,7,3,670,0,0,14,11,3,998,0,0,0.0,0.0,0.0,0,0,0,0,0,0,0,0,0,2020-12-27 19:15:00
1677,3664,Fraser Forster,1240,[2011],Newcastle United,0,0,0,0,0,0,0,0,0,0,0,0,0,0,0,0,0,0,0.0,0.0,0.0,0,0,0,0,0,0,0,0,0,2020-12-27 19:15:00
1678,25676,Fraser Forster,1240,"[2014, 2015, 2016, 2017, 2018, 2019, 2020]",Southampton FC,55,55,0,4874,0,0,52,52,0,4680,0,0,107,107,0,9554,0,0,0.0,0.0,0.0,0,0,0,0,0,0,0,0,0,2020-12-27 19:15:002020-12-27 19:15:002020-12-27 19:15:002020-12-27 19:15:002020-12-27 19:15:002020-12-27 19:15:002020-12-27 19:15:00
1679,3672,Fraser Fyvie,4118,[2012],Wigan Athletic,1,0,1,21,0,0,0,0,0,0,0,0,1,0,1,21,0,0,0.0,0.0,0.0,0,0,0,0,0,0,0,0,0,2020-12-27 19:15:00
1680,3673,Frazer Richardson,2873,[2003],Leeds United,2,1,1,90,0,0,2,1,1,94,0,0,4,2,2,184,0,0,0.0,0.0,0.0,0,0,0,0,0,0,0,0,0,2020-12-27 19:15:00
1681,3674,Frazer Richardson,2873,[2012],Southampton FC,3,1,2,71,0,0,2,1,1,95,0,0,5,2,3,166,0,0,0.0,0.0,0.0,0,0,0,0,0,0,0,0,0,2020-12-27 19:15:00
1682,11028,Fred,2911,"[2018, 2019, 2020]",Manchester United,30,23,7,2105,1,0,27,22,5,1923,0,0,57,45,12,4028,1,0,0.0,0.0,0.0,1,0,1,0,0,0,0,0,0,2020-12-27 19:15:002020-12-27 19:15:002020-12-27 19:15:00
1683,7357,Freddie Ladapo,4418,"[2016, 2017]",Crystal Palace,0,0,0,0,0,0,1,0,1,16,0,0,1,0,1,16,0,0,0.0,0.0,0.0,0,0,0,0,0,0,0,0,0,2020-12-27 19:15:002020-12-27 19:15:00
1684,25781,Freddie Ljungberg,1525,"[2000, 2001, 2002, 2003, 2004, 2005, 2006]",Arsenal FC,81,70,11,5776,16,0,90,83,7,6869,23,0,171,153,18,12645,39,0,4.0,3.0,7.0,11,15,26,0,0,0,0,0,0,2020-12-27 19:15:002020-12-27 19:15:002020-12-27 19:15:002020-12-27 19:15:002020-12-27 19:15:002020-12-27 19:15:002020-12-27 19:15:00
1685,3687,Freddie Ljungberg,1525,[2007],West Ham United,13,12,1,996,1,0,12,10,2,862,1,0,25,22,3,1858,2,0,0.0,0.0,0.0,1,1,2,0,0,0,0,0,0,2020-12-27 19:15:00
1686,14758,Freddie Sears,2246,"[2007, 2008, 2009, 2010]",West Ham United,20,9,11,852,2,0,15,5,10,598,0,0,35,14,21,1450,2,0,3.0,0.0,3.0,1,0,1,0,0,0,0,0,0,2020-12-27 19:15:002020-12-27 19:15:002020-12-27 19:15:002020-12-27 19:15:00
1687,14774,Freddie Woodman,2630,"[2014, 2015, 2017, 2018]",Newcastle United,0,0,0,0,0,0,0,0,0,0,0,0,0,0,0,0,0,0,0.0,0.0,0.0,0,0,0,0,0,0,0,0,0,2020-12-27 19:15:002020-12-27 19:15:002020-12-27 19:15:002020-12-27 19:15:00
1688,3696,Fredi Bobic,3972,[2001],Bolton Wanderers,9,7,2,551,4,0,7,7,0,535,0,0,16,14,2,1086,4,0,0.0,0.0,0.0,2,0,2,0,0,0,0,0,0,2020-12-27 19:15:00
1689,11094,Fredrik Stoor,3563,"[2008, 2009, 2010]",Fulham FC,0,0,0,0,0,0,4,0,4,76,0,0,4,0,4,76,0,0,0.0,0.0,0.0,0,0,0,0,0,0,0,0,0,2020-12-27 19:15:002020-12-27 19:15:002020-12-27 19:15:00
1690,11103,Fredrik Ulvestad,1493,"[2014, 2016, 2017]",Burnley FC,1,0,1,2,0,0,1,1,0,65,0,0,2,1,1,67,0,0,0.0,0.0,0.0,0,0,0,0,0,0,0,0,0,2020-12-27 19:15:002020-12-27 19:15:002020-12-27 19:15:00
1691,7407,Frédéric Guilbert,2850,"[2019, 2020]",Aston Villa,11,9,2,861,0,0,14,13,1,1180,0,0,25,22,3,2041,0,0,0.0,0.0,0.0,0,0,0,0,0,0,0,0,0,2020-12-27 19:15:002020-12-27 19:15:00
1692,11118,Frédéric Kanouté,1130,"[2000, 2001, 2002]",West Ham United,34,31,3,2623,17,0,32,30,2,2493,10,0,66,61,5,5116,27,0,7.0,7.0,14.0,7,8,15,0,0,0,0,0,0,2020-12-27 19:15:002020-12-27 19:15:002020-12-27 19:15:00
1693,11127,Frédéric Kanouté,1130,"[2003, 2004, 2005]",Tottenham Hotspur,30,21,9,1965,10,0,30,20,10,1889,5,0,60,41,19,3854,15,0,3.0,6.0,9.0,5,4,9,0,0,0,0,0,0,2020-12-27 19:15:002020-12-27 19:15:002020-12-27 19:15:00
1694,3711,Frédéric Nimani,4315,[2009],Burnley FC,0,0,0,0,0,0,2,0,2,44,0,0,2,0,2,44,0,0,0.0,0.0,0.0,0,0,0,0,0,0,0,0,0,2020-12-27 19:15:00
1695,3712,Frédéric Piquionne,3334,[2009],Portsmouth FC,16,14,2,1166,3,0,18,12,6,1112,2,0,34,26,8,2278,5,0,0.0,0.0,0.0,1,2,3,0,0,0,0,0,0,2020-12-27 19:15:00
1696,3713,Frédéric Piquionne,3334,[2010],West Ham United,17,14,3,1172,3,0,17,12,5,1082,3,0,34,26,8,2254,6,0,4.0,0.0,4.0,3,3,6,1,0,1,0,0,0,2020-12-27 19:15:00
1697,14863,Fábio,2320,"[2009, 2010, 2011, 2013]",Manchester United,12,5,7,578,0,0,10,4,6,463,1,0,22,9,13,1041,1,0,0.0,0.0,0.0,0,0,0,0,0,0,0,0,0,2020-12-27 19:15:002020-12-27 19:15:002020-12-27 19:15:002020-12-27 19:15:00
1698,3717,Fábio,2320,[2012],Queens Park Rangers,12,7,5,595,0,0,9,6,3,540,0,0,21,13,8,1135,0,0,0.0,0.0,0.0,0,0,0,0,0,0,0,0,0,2020-12-27 19:15:00
1699,3719,Fábio,2320,[2016],Middlesbrough FC,12,11,1,931,0,0,12,10,2,918,0,0,24,21,3,1849,0,0,0.0,0.0,0.0,0,0,0,0,0,0,0,0,0,2020-12-27 19:15:00
1700,22335,Fábio Aurélio,2054,"[2006, 2007, 2008, 2009, 2010, 2011]",Liverpool FC,47,33,14,2878,0,0,40,25,15,2280,3,0,87,58,29,5158,3,0,0.0,0.0,0.0,0,1,1,0,0,0,0,0,0,2020-12-27 19:15:002020-12-27 19:15:002020-12-27 19:15:002020-12-27 19:15:002020-12-27 19:15:002020-12-27 19:15:00
1701,11181,Fábio Rochemback,1885,"[2005, 2006, 2007]",Middlesbrough FC,35,31,4,2759,4,0,33,29,4,2609,1,0,68,60,8,5368,5,0,0.0,0.0,0.0,2,1,3,0,0,0,0,0,0,2020-12-27 19:15:002020-12-27 19:15:002020-12-27 19:15:00
1702,3729,Fábio Silva,1008,[2020],Wolverhampton Wanderers,5,3,2,254,0,0,5,0,5,172,1,0,10,3,7,426,1,0,0.0,0.0,0.0,0,0,0,0,1,1,0,0,0,2020-12-27 19:15:00
1703,3730,Gabriel,1026,[2020],Arsenal FC,7,7,0,630,1,0,4,4,0,360,1,0,11,11,0,990,2,0,0.0,0.0,0.0,1,0,1,0,0,0,0,0,0,2020-12-27 19:15:00
1704,41096,Gabriel Agbonlahor,1442,"[2005, 2006, 2007, 2008, 2009, 2010, 2011, 2012, 2013, 2014, 2015]",Aston Villa,150,136,14,12105,33,0,164,148,16,13191,40,0,314,284,30,25296,73,0,2.0,35.0,37.0,18,26,44,0,0,0,0,0,0,2020-12-27 19:15:002020-12-27 19:15:002020-12-27 19:15:002020-12-27 19:15:002020-12-27 19:15:002020-12-27 19:15:002020-12-27 19:15:002020-12-27 19:15:002020-12-27 19:15:002020-12-27 19:15:002020-12-27 19:15:00
1705,11229,Gabriel Heinze,1728,"[2004, 2005, 2006]",Manchester United,26,23,3,2032,0,0,25,21,4,1901,1,0,51,44,7,3933,1,0,0.0,0.0,0.0,0,1,1,0,0,0,0,0,0,2020-12-27 19:15:002020-12-27 19:15:002020-12-27 19:15:00
1706,18735,Gabriel Jesus,1841,"[2016, 2017, 2018, 2019, 2020]",Manchester City,54,32,22,3059,22,0,54,30,24,2851,21,0,108,62,46,5910,43,0,4.0,7.0,11.0,10,10,20,2,0,2,0,0,0,2020-12-27 19:15:002020-12-27 19:15:002020-12-27 19:15:002020-12-27 19:15:002020-12-27 19:15:00
1707,7501,Gabriel Martinelli,1478,"[2019, 2020]",Arsenal FC,7,3,4,328,1,0,10,5,5,508,2,0,17,8,9,836,3,0,0.0,0.0,0.0,1,2,3,0,0,0,0,0,0,2020-12-27 19:15:002020-12-27 19:15:00
1708,7505,Gabriel Obertan,2283,"[2009, 2010]",Manchester United,7,3,4,315,0,0,7,1,6,132,0,0,14,4,10,447,0,0,0.0,0.0,0.0,0,0,0,0,0,0,0,0,0,2020-12-27 19:15:002020-12-27 19:15:00
1709,18780,Gabriel Obertan,2283,"[2011, 2012, 2013, 2014, 2015]",Newcastle United,29,13,16,1378,1,0,29,20,9,1557,1,0,58,33,25,2935,2,0,3.0,0.0,3.0,1,0,1,0,0,0,0,0,0,2020-12-27 19:15:002020-12-27 19:15:002020-12-27 19:15:002020-12-27 19:15:002020-12-27 19:15:00
1710,3759,Gabriel Paletta,3984,[2006],Liverpool FC,0,0,0,0,0,0,3,2,1,209,0,0,3,2,1,209,0,0,0.0,0.0,0.0,0,0,0,0,0,0,0,0,0,2020-12-27 19:15:00
1711,11283,Gabriel Paulista,1594,"[2014, 2015, 2016]",Arsenal FC,25,20,5,2029,1,0,21,17,4,1640,0,0,46,37,9,3669,1,0,0.0,0.0,0.0,1,0,1,0,0,0,0,0,0,2020-12-27 19:15:002020-12-27 19:15:002020-12-27 19:15:00
1712,11292,Gabriel Tamaş,2729,"[2010, 2011, 2012]",West Bromwich Albion,22,18,4,1662,0,0,23,18,5,1675,0,0,45,36,9,3337,0,0,0.0,0.0,0.0,0,0,0,0,0,0,0,0,0,2020-12-27 19:15:002020-12-27 19:15:002020-12-27 19:15:00
1713,3766,Gabriele Angella,4406,[2015],Watford FC,0,0,0,0,0,0,0,0,0,0,0,0,0,0,0,0,0,0,0.0,0.0,0.0,0,0,0,0,0,0,0,0,0,2020-12-27 19:15:00
1714,3767,Garath McCleary,1986,[2012],Reading FC,16,6,10,709,1,0,15,9,6,862,2,0,31,15,16,1571,3,0,0.0,0.0,0.0,1,0,1,0,0,0,0,0,0,2020-12-27 19:15:00
1715,26397,Gareth Bale,1274,"[2007, 2008, 2009, 2010, 2011, 2012, 2020]",Tottenham Hotspur,72,65,7,5803,21,0,76,70,6,6156,23,0,148,135,13,11959,44,0,15.0,10.0,25.0,12,12,24,0,0,0,0,0,0,2020-12-27 19:15:002020-12-27 19:15:002020-12-27 19:15:002020-12-27 19:15:002020-12-27 19:15:002020-12-27 19:15:002020-12-27 19:15:00
1716,34011,Gareth Barry,1418,"[2000, 2001, 2002, 2003, 2004, 2005, 2006, 2007, 2008]",Aston Villa,142,138,4,12207,18,0,145,143,2,12353,20,0,287,281,6,24560,38,0,7.0,4.0,11.0,12,11,23,8,10,18,0,0,0,2020-12-27 19:15:002020-12-27 19:15:002020-12-27 19:15:002020-12-27 19:15:002020-12-27 19:15:002020-12-27 19:15:002020-12-27 19:15:002020-12-27 19:15:002020-12-27 19:15:00
1717,15142,Gareth Barry,1418,"[2009, 2010, 2011, 2012]",Manchester City,61,56,5,5018,2,0,70,66,4,5746,4,0,131,122,9,10764,6,0,3.0,1.0,4.0,2,3,5,0,0,0,0,0,0,2020-12-27 19:15:002020-12-27 19:15:002020-12-27 19:15:002020-12-27 19:15:00
1718,15158,Gareth Barry,1418,"[2013, 2014, 2015, 2016]",Everton FC,62,55,7,5005,3,0,69,65,4,5620,1,0,131,120,11,10625,4,0,0.0,3.0,3.0,2,1,3,0,0,0,0,0,0,2020-12-27 19:15:002020-12-27 19:15:002020-12-27 19:15:002020-12-27 19:15:00
1719,3792,Gareth Barry,1418,[2017],West Bromwich Albion,13,12,1,1020,1,0,12,10,2,906,0,0,25,22,3,1926,1,0,0.0,0.0,0.0,0,0,0,0,0,0,0,0,0,2020-12-27 19:15:00
1720,3793,Gareth Evans,4534,[2000],Leeds United,1,0,1,33,0,0,0,0,0,0,0,0,1,0,1,33,0,0,0.0,0.0,0.0,0,0,0,0,0,0,0,0,0,2020-12-27 19:15:00
1721,7589,Gareth Farrelly,3071,"[2001, 2002]",Bolton Wanderers,12,8,4,647,0,0,14,9,5,979,1,0,26,17,9,1626,1,0,0.0,0.0,0.0,0,1,1,0,0,0,0,0,0,2020-12-27 19:15:002020-12-27 19:15:00
1722,3796,Gareth Grant,3980,[2000],Bradford City,3,0,3,21,0,0,2,0,2,22,0,0,5,0,5,43,0,0,0.0,0.0,0.0,0,0,0,0,0,0,0,0,0,2020-12-27 19:15:00
1723,26600,Gareth McAuley,1732,"[2011, 2012, 2013, 2014, 2015, 2016, 2017]",West Bromwich Albion,102,101,1,9011,8,0,101,98,3,8788,7,0,203,199,4,17799,15,0,6.0,2.0,8.0,6,5,11,0,0,0,0,0,0,2020-12-27 19:15:002020-12-27 19:15:002020-12-27 19:15:002020-12-27 19:15:002020-12-27 19:15:002020-12-27 19:15:002020-12-27 19:15:00
1724,3804,Gareth Southgate,1331,[2000],Aston Villa,17,17,0,1464,1,0,13,13,0,1109,1,0,30,30,0,2573,2,0,0.0,0.0,0.0,1,1,2,0,0,0,0,0,0,2020-12-27 19:15:00
1725,19035,Gareth Southgate,1331,"[2001, 2002, 2003, 2004, 2005]",Middlesbrough FC,79,79,0,7110,4,0,77,77,0,6849,0,0,156,156,0,13959,4,0,4.0,0.0,4.0,2,0,2,0,0,0,0,0,0,2020-12-27 19:15:002020-12-27 19:15:002020-12-27 19:15:002020-12-27 19:15:002020-12-27 19:15:00
1726,3810,Gareth Whalley,3977,[2000],Bradford City,8,6,2,497,0,0,7,7,0,627,0,0,15,13,2,1124,0,0,0.0,0.0,0.0,0,0,0,0,0,0,0,0,0,2020-12-27 19:15:00
1727,3811,Gareth Williams,3960,[2006],Watford FC,2,1,1,134,0,0,1,1,0,62,0,0,3,2,1,196,0,0,0.0,0.0,0.0,0,0,0,0,0,0,0,0,0,2020-12-27 19:15:00
1728,7625,Garry Monk,2808,"[2000, 2001]",Southampton FC,4,3,1,278,0,0,0,0,0,0,0,0,4,3,1,278,0,0,0.0,0.0,0.0,0,0,0,0,0,0,0,0,0,2020-12-27 19:15:002020-12-27 19:15:00
1729,3814,Garry Monk,2808,[2002],Charlton Athletic,1,1,0,66,0,0,0,0,0,0,0,0,1,1,0,66,0,0,0.0,0.0,0.0,0,0,0,0,0,0,0,0,0,2020-12-27 19:15:00
1730,7631,Garry Monk,2808,"[2011, 2012]",Swansea City,14,11,3,1017,0,0,13,13,0,1170,0,0,27,24,3,2187,0,0,0.0,0.0,0.0,0,0,0,0,0,0,0,0,0,2020-12-27 19:15:002020-12-27 19:15:00
1731,11454,Garry O'Connor,1967,"[2007, 2009, 2010]",Birmingham City,20,7,13,809,1,0,16,5,11,674,2,0,36,12,24,1483,3,0,0.0,4.0,4.0,1,2,3,0,0,0,0,0,0,2020-12-27 19:15:002020-12-27 19:15:002020-12-27 19:15:00
1732,3820,Gary Borrowdale,3827,[2004],Crystal Palace,4,0,4,64,0,0,3,2,1,210,0,0,7,2,5,274,0,0,0.0,0.0,0.0,0,0,0,0,0,0,0,0,0,2020-12-27 19:15:00
1733,3821,Gary Breen,2098,[2000],Leeds United,1,1,0,90,0,0,0,0,0,0,0,0,1,1,0,90,0,0,0.0,0.0,0.0,0,0,0,0,0,0,0,0,0,2020-12-27 19:15:00
1734,3822,Gary Breen,2098,[2002],West Ham United,5,4,1,381,0,0,9,5,4,479,0,0,14,9,5,860,0,0,0.0,0.0,0.0,0,0,0,0,0,0,0,0,0,2020-12-27 19:15:00
1735,3823,Gary Breen,2098,[2005],Sunderland AFC,16,15,1,1376,1,0,19,18,1,1555,0,0,35,33,2,2931,1,0,0.0,0.0,0.0,1,0,1,0,0,0,0,0,0,2020-12-27 19:15:00
1736,7649,Gary Cahill,1533,"[2005, 2006]",Aston Villa,14,14,0,1260,1,0,13,11,2,1062,0,0,27,25,2,2322,1,0,0.0,0.0,0.0,1,0,1,0,0,0,0,0,0,2020-12-27 19:15:002020-12-27 19:15:00
1737,15310,Gary Cahill,1533,"[2007, 2008, 2009, 2010]",Bolton Wanderers,53,53,0,4770,7,0,55,55,0,4929,4,0,108,108,0,9699,11,0,0.0,3.0,3.0,5,3,8,0,0,0,0,0,0,2020-12-27 19:15:002020-12-27 19:15:002020-12-27 19:15:002020-12-27 19:15:00
1738,30668,Gary Cahill,1533,"[2011, 2012, 2013, 2014, 2015, 2016, 2017, 2018]",Chelsea FC,100,91,9,8311,7,0,90,84,6,7714,6,0,190,175,15,16025,13,0,0.0,3.0,3.0,4,5,9,0,0,0,0,0,0,2020-12-27 19:15:002020-12-27 19:15:002020-12-27 19:15:002020-12-27 19:15:002020-12-27 19:15:002020-12-27 19:15:002020-12-27 19:15:002020-12-27 19:15:00
1739,7677,Gary Cahill,1533,"[2019, 2020]",Crystal Palace,17,17,0,1448,0,0,13,13,0,1170,0,0,30,30,0,2618,0,0,0.0,0.0,0.0,0,0,0,0,0,0,0,0,0,2020-12-27 19:15:002020-12-27 19:15:00
1740,15366,Gary Caldwell,2673,"[2009, 2010, 2011, 2012]",Wigan Athletic,47,47,0,4059,3,0,52,52,0,4615,3,0,99,99,0,8674,6,0,0.0,3.0,3.0,3,3,6,0,0,0,0,0,0,2020-12-27 19:15:002020-12-27 19:15:002020-12-27 19:15:002020-12-27 19:15:00
1741,3844,Gary Charles,4546,[2000],West Ham United,1,0,1,45,0,0,0,0,0,0,0,0,1,0,1,45,0,0,0.0,0.0,0.0,0,0,0,0,0,0,0,0,0,2020-12-27 19:15:00
1742,3845,Gary Croft,3923,[2000],Ipswich Town,3,2,1,185,0,0,5,4,1,299,0,0,8,6,2,484,0,0,0.0,0.0,0.0,0,0,0,0,0,0,0,0,0,2020-12-27 19:15:00
1743,15390,Gary Doherty,2792,"[2000, 2001, 2002, 2003]",Tottenham Hotspur,28,21,7,2161,2,0,30,21,9,2065,2,0,58,42,16,4226,4,0,0.0,3.0,3.0,2,2,4,0,0,0,0,0,0,2020-12-27 19:15:002020-12-27 19:15:002020-12-27 19:15:002020-12-27 19:15:00
1744,3850,Gary Doherty,2792,[2004],Norwich City,9,8,1,718,1,0,11,9,2,782,1,0,20,17,3,1500,2,0,0.0,1.0,1.0,1,1,2,0,0,0,0,0,0,2020-12-27 19:15:00
1745,19265,Gary Flitcroft,1135,"[2001, 2002, 2003, 2004, 2005]",Blackburn Rovers,52,48,4,4179,4,0,59,55,4,4693,2,0,111,103,8,8872,6,0,6.0,1.0,7.0,4,2,6,0,0,0,0,0,0,2020-12-27 19:15:002020-12-27 19:15:002020-12-27 19:15:002020-12-27 19:15:002020-12-27 19:15:00
1746,11571,Gary Gardner,1449,"[2011, 2012, 2013]",Aston Villa,4,2,2,212,0,0,12,3,9,412,0,0,16,5,11,624,0,0,0.0,0.0,0.0,0,0,0,0,0,0,0,0,0,2020-12-27 19:15:002020-12-27 19:15:002020-12-27 19:15:00
1747,3859,Gary Holt,2387,[2004],Norwich City,13,9,4,865,0,0,14,12,2,1051,0,0,27,21,6,1916,0,0,0.0,0.0,0.0,0,0,0,0,0,0,0,0,0,2020-12-27 19:15:00
1748,7721,Gary Hooper,1377,"[2013, 2015]",Norwich City,18,11,7,1040,5,0,16,11,5,990,1,0,34,22,12,2030,6,0,4.0,0.0,4.0,4,1,5,1,0,1,0,0,0,2020-12-27 19:15:002020-12-27 19:15:00
1749,15454,Gary Kelly,2290,"[2000, 2001, 2002, 2003]",Leeds United,45,45,0,4033,0,0,50,46,4,4215,0,0,95,91,4,8248,0,0,0.0,0.0,0.0,0,0,0,0,0,0,0,0,0,2020-12-27 19:15:002020-12-27 19:15:002020-12-27 19:15:002020-12-27 19:15:00
1750,3866,Gary Locke,3978,[2000],Bradford City,2,2,0,117,0,0,4,3,1,254,0,0,6,5,1,371,0,0,0.0,0.0,0.0,0,0,0,0,0,0,0,0,0,2020-12-27 19:15:00
1751,3867,Gary Madine,4235,[2018],Cardiff City,3,0,3,17,0,0,2,0,2,15,0,0,5,0,5,32,0,0,0.0,0.0,0.0,0,0,0,0,0,0,0,0,0,2020-12-27 19:15:00
1752,3868,Gary McAllister,2693,[2000],Liverpool FC,14,10,4,982,2,0,15,10,5,914,3,0,29,20,9,1896,5,0,0.0,3.0,3.0,2,1,3,1,0,1,0,0,0,2020-12-27 19:15:00
1753,3869,Gary McAllister,2693,[2001],West Ham United,1,1,0,45,0,0,0,0,0,0,0,0,1,1,0,45,0,0,0.0,0.0,0.0,0,0,0,0,0,0,0,0,0,2020-12-27 19:15:00
1754,7741,Gary McSheffrey,1966,"[2007, 2009]",Birmingham City,16,11,5,984,2,0,21,14,7,1166,1,0,37,25,12,2150,3,0,0.0,0.0,0.0,0,1,1,2,1,3,0,0,0,2020-12-27 19:15:002020-12-27 19:15:00
1755,3872,Gary Medel,3458,[2013],Cardiff City,16,16,0,1398,0,0,18,18,0,1472,0,0,34,34,0,2870,0,0,0.0,0.0,0.0,0,0,0,0,0,0,0,0,0,2020-12-27 19:15:00
1756,23256,Gary Naysmith,1804,"[2000, 2001, 2002, 2004, 2005, 2006]",Everton FC,56,48,8,4198,3,0,49,38,11,3569,1,0,105,86,19,7767,4,0,0.0,3.0,3.0,1,1,2,0,0,0,0,0,0,2020-12-27 19:15:002020-12-27 19:15:002020-12-27 19:15:002020-12-27 19:15:002020-12-27 19:15:002020-12-27 19:15:00
1757,3876,Gary Naysmith,1804,[2003],Leeds United,1,1,0,90,0,0,0,0,0,0,0,0,1,1,0,90,0,0,0.0,0.0,0.0,0,0,0,0,0,0,0,0,0,2020-12-27 19:15:00
1758,38845,Gary Neville,1105,"[2000, 2001, 2002, 2003, 2004, 2005, 2006, 2008, 2009, 2010]",Manchester United,113,105,8,9108,3,0,110,102,8,9195,0,0,223,207,16,18303,3,0,3.0,0.0,3.0,2,0,2,0,0,0,0,0,0,2020-12-27 19:15:002020-12-27 19:15:002020-12-27 19:15:002020-12-27 19:15:002020-12-27 19:15:002020-12-27 19:15:002020-12-27 19:15:002020-12-27 19:15:002020-12-27 19:15:002020-12-27 19:15:00
1759,15566,Gary O'Neil,1389,"[2003, 2004, 2005, 2006]",Portsmouth FC,46,45,1,3961,6,0,51,49,2,4297,5,0,97,94,3,8258,11,0,6.0,1.0,7.0,5,4,9,0,0,0,0,0,0,2020-12-27 19:15:002020-12-27 19:15:002020-12-27 19:15:002020-12-27 19:15:00
1760,7789,Gary O'Neil,1389,"[2007, 2008]",Middlesbrough FC,24,24,0,2099,1,0,31,29,2,2567,3,0,55,53,2,4666,4,0,0.0,0.0,0.0,0,3,3,0,0,0,0,0,0,2020-12-27 19:15:002020-12-27 19:15:00
1761,7793,Gary O'Neil,1389,"[2010, 2012]",West Ham United,17,12,5,981,1,0,15,12,3,1053,0,0,32,24,8,2034,1,0,0.0,0.0,0.0,0,0,0,0,0,0,0,0,0,2020-12-27 19:15:002020-12-27 19:15:00
1762,3898,Gary O'Neil,1389,[2015],Norwich City,13,10,3,963,0,0,14,9,5,845,0,0,27,19,8,1808,0,0,0.0,0.0,0.0,0,0,0,0,0,0,0,0,0,2020-12-27 19:15:00
1763,3899,Gary Pallister,2064,[2000],Middlesbrough FC,4,4,0,360,0,0,4,4,0,318,0,0,8,8,0,678,0,0,0.0,0.0,0.0,0,0,0,0,0,0,0,0,0,2020-12-27 19:15:00
1764,7801,Gary Rowett,1303,"[2000, 2001]",Leicester City,24,22,2,2044,2,0,25,25,0,2181,0,0,49,47,2,4225,2,0,3.0,0.0,3.0,2,0,2,0,0,0,0,0,0,2020-12-27 19:15:002020-12-27 19:15:00
1765,7805,Gary Rowett,1303,"[2002, 2003]",Charlton Athletic,7,7,0,630,1,0,6,6,0,456,0,0,13,13,0,1086,1,0,1.0,0.0,1.0,1,0,1,0,0,0,0,0,0,2020-12-27 19:15:002020-12-27 19:15:00
1766,15622,Gary Speed,1716,"[2000, 2001, 2002, 2003]",Newcastle United,61,59,2,5207,10,0,57,56,1,4930,5,0,118,115,3,10137,15,0,3.0,1.0,4.0,8,3,11,0,0,0,0,0,0,2020-12-27 19:15:002020-12-27 19:15:002020-12-27 19:15:002020-12-27 19:15:00
1767,15638,Gary Speed,1716,"[2004, 2005, 2006, 2007]",Bolton Wanderers,62,57,5,4979,6,0,57,57,0,4933,8,0,119,114,5,9912,14,0,3.0,7.0,10.0,5,4,9,2,5,7,0,0,0,2020-12-27 19:15:002020-12-27 19:15:002020-12-27 19:15:002020-12-27 19:15:00
1768,3912,Gary Taylor-Fletcher,3592,[2010],Blackpool FC,16,15,1,1260,3,0,15,14,1,1201,3,0,31,29,2,2461,6,0,0.0,0.0,0.0,1,3,4,0,0,0,0,0,0,2020-12-27 19:15:00
1769,3913,Gary Taylor-Fletcher,3592,[2014],Leicester City,0,0,0,0,0,0,1,0,1,17,0,0,1,0,1,17,0,0,0.0,0.0,0.0,0,0,0,0,0,0,0,0,0,2020-12-27 19:15:00
1770,7829,Gary Teale,1817,"[2005, 2006]",Wigan Athletic,18,14,4,1220,0,0,18,13,5,1064,0,0,36,27,9,2284,0,0,0.0,0.0,0.0,0,0,0,0,0,0,0,0,0,2020-12-27 19:15:002020-12-27 19:15:00
1771,3916,Gary Teale,1817,[2007],Derby County,8,5,3,382,0,0,10,4,6,534,0,0,18,9,9,916,0,0,0.0,0.0,0.0,0,0,0,0,0,0,0,0,0,2020-12-27 19:15:00
1772,3917,Gary Twigg,4381,[2001],Derby County,0,0,0,0,0,0,1,0,1,24,0,0,1,0,1,24,0,0,0.0,0.0,0.0,0,0,0,0,0,0,0,0,0,2020-12-27 19:15:00
1773,3918,Gary Walsh,2833,[2000],Bradford City,8,8,0,720,0,0,7,7,0,630,0,0,15,15,0,1350,0,0,0.0,0.0,0.0,0,0,0,0,0,0,0,0,0,2020-12-27 19:15:00
1774,11761,Gastón Ramírez,2226,"[2012, 2013, 2015]",Southampton FC,22,13,9,1236,4,0,25,10,15,1015,2,0,47,23,24,2251,6,0,0.0,0.0,0.0,3,2,5,0,0,0,0,0,0,2020-12-27 19:15:002020-12-27 19:15:002020-12-27 19:15:00
1775,3921,Gastón Ramírez,2226,[2014],Hull City,12,6,6,550,0,0,10,5,5,476,1,0,22,11,11,1026,1,0,0.0,0.0,0.0,0,1,1,0,0,0,0,0,0,2020-12-27 19:15:00
1776,3923,Gastón Ramírez,2226,[2016],Middlesbrough FC,12,10,2,821,2,0,12,10,2,799,0,0,24,20,4,1620,2,0,3.0,0.0,3.0,2,0,2,0,0,0,0,0,0,2020-12-27 19:15:00
1777,3924,Gavin Hoyte,3493,[2008],Arsenal FC,0,0,0,0,0,0,1,1,0,60,0,0,1,1,0,60,0,0,0.0,0.0,0.0,0,0,0,0,0,0,0,0,0,2020-12-27 19:15:00
1778,3925,Gavin Kilkenny,4403,[2019],AFC Bournemouth,0,0,0,0,0,0,0,0,0,0,0,0,0,0,0,0,0,0,0.0,0.0,0.0,0,0,0,0,0,0,0,0,0,2020-12-27 19:15:00
1779,3926,Gavin Mahon,2118,[2006],Watford FC,14,14,0,1194,1,0,17,16,1,1476,0,0,31,30,1,2670,1,0,0.0,0.0,0.0,1,0,1,0,0,0,0,0,0,2020-12-27 19:15:00
1780,11784,Gavin McCann,1096,"[2000, 2001, 2002]",Sunderland AFC,37,36,1,3166,2,0,40,40,0,3467,2,0,77,76,1,6633,4,0,1.0,1.0,2.0,2,2,4,0,0,0,0,0,0,2020-12-27 19:15:002020-12-27 19:15:002020-12-27 19:15:00
1781,15726,Gavin McCann,1096,"[2003, 2004, 2005, 2006]",Aston Villa,52,51,1,4458,1,0,53,52,1,4621,2,0,105,103,2,9079,3,0,0.0,1.0,1.0,0,2,2,0,0,0,0,0,0,2020-12-27 19:15:002020-12-27 19:15:002020-12-27 19:15:002020-12-27 19:15:00
1782,11805,Gavin McCann,1096,"[2007, 2008, 2009]",Bolton Wanderers,35,24,11,2316,0,0,38,29,9,2772,1,0,73,53,20,5088,1,0,0.0,3.0,3.0,0,1,1,0,0,0,0,0,0,2020-12-27 19:15:002020-12-27 19:15:002020-12-27 19:15:00
1783,3937,Gavin Peacock,4064,[2001],Charlton Athletic,1,0,1,45,0,0,4,1,3,122,0,0,5,1,4,167,0,0,0.0,0.0,0.0,0,0,0,0,0,0,0,0,0,2020-12-27 19:15:00
1784,7877,Gaël Bigirimana,4161,"[2012, 2013]",Newcastle United,6,0,6,161,1,0,7,3,4,243,0,0,13,3,10,404,1,0,0.0,0.0,0.0,0,0,0,0,0,0,0,0,0,2020-12-27 19:15:002020-12-27 19:15:00
1785,31548,Gaël Clichy,1230,"[2003, 2004, 2005, 2006, 2007, 2008, 2009, 2010]",Arsenal FC,91,83,8,7565,0,0,90,80,10,7262,1,0,181,163,18,14827,1,0,0.0,0.0,0.0,0,0,0,0,0,0,0,0,0,2020-12-27 19:15:002020-12-27 19:15:002020-12-27 19:15:002020-12-27 19:15:002020-12-27 19:15:002020-12-27 19:15:002020-12-27 19:15:002020-12-27 19:15:00
1786,23703,Gaël Clichy,1230,"[2011, 2012, 2013, 2014, 2015, 2016]",Manchester City,69,63,6,5726,1,0,69,68,1,6059,1,0,138,131,7,11785,2,0,0.0,0.0,0.0,1,0,1,0,0,0,0,0,0,2020-12-27 19:15:002020-12-27 19:15:002020-12-27 19:15:002020-12-27 19:15:002020-12-27 19:15:002020-12-27 19:15:00
1787,11867,Gaël Givet,2654,"[2008, 2010, 2011]",Blackburn Rovers,32,31,1,2634,0,0,32,32,0,2684,1,0,64,63,1,5318,1,0,0.0,0.0,0.0,0,0,0,0,0,0,0,0,0,2020-12-27 19:15:002020-12-27 19:15:002020-12-27 19:15:00
1788,3955,Gaël Givet,2654,[2009],Wigan Athletic,1,1,0,90,0,0,0,0,0,0,0,0,1,1,0,90,0,0,0.0,0.0,0.0,0,0,0,0,0,0,0,0,0,2020-12-27 19:15:00
1789,3958,Gaël Kakuta,2651,[2009],Chelsea FC,1,0,1,31,0,0,0,0,0,0,0,0,1,0,1,31,0,0,0.0,0.0,0.0,0,0,0,0,0,0,0,0,0,2020-12-27 19:15:00
1790,3959,Gaël Kakuta,2651,[2010],Fulham FC,3,0,3,45,0,0,4,2,2,187,1,0,7,2,5,232,1,0,0.0,0.0,0.0,0,1,1,0,0,0,0,0,0,2020-12-27 19:15:00
1791,3960,Gaël Kakuta,2651,[2011],Bolton Wanderers,2,0,2,44,0,0,2,0,2,24,0,0,4,0,4,68,0,0,0.0,0.0,0.0,0,0,0,0,0,0,0,0,0,2020-12-27 19:15:00
1792,11886,Gaëtan Bong,2483,"[2017, 2018, 2019]",Brighton & Hove Albion,21,19,2,1713,0,0,30,25,5,2386,0,0,51,44,7,4099,0,0,0.0,0.0,0.0,0,0,0,0,0,0,0,0,0,2020-12-27 19:15:002020-12-27 19:15:002020-12-27 19:15:00
1793,3964,Gedion Zelalem,3436,[2013],Arsenal FC,0,0,0,0,0,0,0,0,0,0,0,0,0,0,0,0,0,0,0.0,0.0,0.0,0,0,0,0,0,0,0,0,0,2020-12-27 19:15:00
1794,3965,Gedo,3797,[2013],Hull City,1,0,1,12,0,0,1,0,1,16,0,0,2,0,2,28,0,0,0.0,0.0,0.0,0,0,0,0,0,0,0,0,0,2020-12-27 19:15:00
1795,7933,Gedson Fernandes,2983,"[2019, 2020]",Tottenham Hotspur,4,0,4,44,0,0,3,0,3,18,0,0,7,0,7,62,0,0,0.0,0.0,0.0,0,0,0,0,0,0,0,0,0,2020-12-27 19:15:002020-12-27 19:15:00
1796,7937,Gelson Fernandes,3090,"[2007, 2008]",Manchester City,23,11,12,1162,2,0,19,12,7,1268,1,0,42,23,19,2430,3,0,0.0,0.0,0.0,0,0,0,0,0,0,0,0,0,2020-12-27 19:15:002020-12-27 19:15:00
1797,23835,Geoff Cameron,1548,"[2012, 2013, 2014, 2015, 2016, 2017]",Stoke City,81,73,8,6572,0,0,86,75,11,6918,2,0,167,148,19,13490,2,0,0.0,0.0,0.0,0,1,1,0,0,0,0,0,0,2020-12-27 19:15:002020-12-27 19:15:002020-12-27 19:15:002020-12-27 19:15:002020-12-27 19:15:002020-12-27 19:15:00
1798,7953,Geoff Horsfield,1326,"[2002, 2003]",Birmingham City,17,10,7,966,4,0,17,7,10,791,1,0,34,17,17,1757,5,0,3.0,0.0,3.0,2,0,2,0,0,0,0,0,0,2020-12-27 19:15:002020-12-27 19:15:00
1799,7957,Geoff Horsfield,1326,"[2004, 2005]",West Bromwich Albion,28,16,12,1477,5,0,19,12,7,1010,2,0,47,28,19,2487,7,0,0.0,0.0,0.0,3,1,4,0,0,0,0,0,0,2020-12-27 19:15:002020-12-27 19:15:00
1800,7961,Geoffrey Mujangi Bia,3630,"[2009, 2010]",Wolverhampton Wanderers,1,0,1,14,0,0,3,1,2,57,0,0,4,1,3,71,0,0,0.0,0.0,0.0,0,0,0,0,0,0,0,0,0,2020-12-27 19:15:002020-12-27 19:15:00
1801,7965,George Baldock,3465,"[2019, 2020]",Sheffield United,27,27,0,2430,0,0,26,26,0,2340,2,0,53,53,0,4770,2,0,0.0,4.0,4.0,0,2,2,0,0,0,0,0,0,2020-12-27 19:15:002020-12-27 19:15:00
1802,7969,George Boateng,1333,"[2000, 2001]",Aston Villa,34,32,2,2827,0,0,33,31,2,2753,2,0,67,63,4,5580,2,0,0.0,0.0,0.0,0,1,1,0,0,0,0,0,0,2020-12-27 19:15:002020-12-27 19:15:00
1803,23931,George Boateng,1333,"[2002, 2003, 2004, 2005, 2006, 2007]",Middlesbrough FC,90,86,4,7779,5,0,88,87,1,7707,2,0,178,173,5,15486,7,0,4.0,0.0,4.0,4,1,5,0,0,0,0,0,0,2020-12-27 19:15:002020-12-27 19:15:002020-12-27 19:15:002020-12-27 19:15:002020-12-27 19:15:002020-12-27 19:15:00
1804,7985,George Boateng,1333,"[2008, 2009]",Hull City,26,23,3,1947,1,0,26,24,2,2066,0,0,52,47,5,4013,1,0,0.0,0.0,0.0,0,0,0,0,0,0,0,0,0,2020-12-27 19:15:002020-12-27 19:15:00
1805,3994,George Boyd,1258,[2013],Hull City,15,6,9,703,2,0,14,3,11,496,0,0,29,9,20,1199,2,0,3.0,0.0,3.0,1,0,1,0,0,0,0,0,0,2020-12-27 19:15:00
1806,7991,George Boyd,1258,"[2014, 2016]",Burnley FC,34,33,1,2921,5,0,37,35,2,2938,2,0,71,68,3,5859,7,0,6.0,1.0,7.0,3,1,4,0,0,0,0,0,0,2020-12-27 19:15:002020-12-27 19:15:00
1807,3997,George Dobson,4507,[2015],West Ham United,0,0,0,0,0,0,0,0,0,0,0,0,0,0,0,0,0,0,0.0,0.0,0.0,0,0,0,0,0,0,0,0,0,2020-12-27 19:15:00
1808,11997,George Elokobi,2884,"[2009, 2010, 2011]",Wolverhampton Wanderers,28,21,7,1980,1,0,29,21,8,1986,1,0,57,42,15,3966,2,0,0.0,0.0,0.0,1,0,1,0,0,0,0,0,0,2020-12-27 19:15:002020-12-27 19:15:002020-12-27 19:15:00
1809,8003,George Evans,3963,"[2012, 2015]",Manchester City,0,0,0,0,0,0,0,0,0,0,0,0,0,0,0,0,0,0,0.0,0.0,0.0,0,0,0,0,0,0,0,0,0,2020-12-27 19:15:002020-12-27 19:15:00
1810,4003,George Friend,3002,[2009],Wolverhampton Wanderers,0,0,0,0,0,0,1,1,0,61,0,0,1,1,0,61,0,0,0.0,0.0,0.0,0,0,0,0,0,0,0,0,0,2020-12-27 19:15:00
1811,4004,George Friend,3002,[2016],Middlesbrough FC,12,9,3,967,0,0,12,11,1,993,0,0,24,20,4,1960,0,0,0.0,0.0,0.0,0,0,0,0,0,0,0,0,0,2020-12-27 19:15:00
1812,4005,George Hirst,4433,[2019],Leicester City,1,0,1,2,0,0,1,0,1,7,0,0,2,0,2,9,0,0,0.0,0.0,0.0,0,0,0,0,0,0,0,0,0,2020-12-27 19:15:00
1813,12021,George Honeyman,3139,"[2014, 2015, 2016]",Sunderland AFC,2,0,2,53,0,0,4,2,2,218,0,0,6,2,4,271,0,0,0.0,0.0,0.0,0,0,0,0,0,0,0,0,0,2020-12-27 19:15:002020-12-27 19:15:002020-12-27 19:15:00
1814,4009,George Marsh,4129,[2018],Tottenham Hotspur,0,0,0,0,0,0,0,0,0,0,0,0,0,0,0,0,0,0,0.0,0.0,0.0,0,0,0,0,0,0,0,0,0,2020-12-27 19:15:00
1815,24079,George McCartney,1340,"[2000, 2001, 2002, 2005, 2008, 2009]",Sunderland AFC,43,34,9,2997,0,0,54,43,11,3954,0,0,97,77,20,6951,0,0,0.0,0.0,0.0,0,0,0,0,0,0,0,0,0,2020-12-27 19:15:002020-12-27 19:15:002020-12-27 19:15:002020-12-27 19:15:002020-12-27 19:15:002020-12-27 19:15:00
1816,16066,George McCartney,1340,"[2006, 2007, 2012, 2013]",West Ham United,49,43,6,3941,1,0,43,39,4,3365,0,0,92,82,10,7306,1,0,0.0,0.0,0.0,1,0,1,0,0,0,0,0,0,2020-12-27 19:15:002020-12-27 19:15:002020-12-27 19:15:002020-12-27 19:15:00
1817,4020,George Moncur,4007,[2012],West Ham United,0,0,0,0,0,0,0,0,0,0,0,0,0,0,0,0,0,0,0.0,0.0,0.0,0,0,0,0,0,0,0,0,0,2020-12-27 19:15:00
1818,4021,George Thomas,2571,[2017],Leicester City,0,0,0,0,0,0,0,0,0,0,0,0,0,0,0,0,0,0,0.0,0.0,0.0,0,0,0,0,0,0,0,0,0,2020-12-27 19:15:00
1819,12069,George Thorne,1740,"[2010, 2011, 2012]",West Bromwich Albion,2,0,2,7,0,0,7,4,3,355,0,0,9,4,5,362,0,0,0.0,0.0,0.0,0,0,0,0,0,0,0,0,0,2020-12-27 19:15:002020-12-27 19:15:002020-12-27 19:15:00
1820,4025,George Weah,3855,[2000],Manchester City,3,3,0,233,0,0,3,1,2,152,1,0,6,4,2,385,1,0,0.0,0.0,0.0,0,0,0,0,0,0,0,0,0,2020-12-27 19:15:00
1821,4026,George Williams,4556,[2013],Fulham FC,0,0,0,0,0,0,0,0,0,0,0,0,0,0,0,0,0,0,0.0,0.0,0.0,0,0,0,0,0,0,0,0,0,2020-12-27 19:15:00
1822,12086,Georges-Kévin N'Koudou,2801,"[2016, 2018, 2019]",Tottenham Hotspur,4,0,4,14,0,0,6,0,6,41,0,0,10,0,10,55,0,0,0.0,0.0,0.0,0,0,0,0,0,0,0,0,0,2020-12-27 19:15:002020-12-27 19:15:002020-12-27 19:15:00
1823,4028,Georges-Kévin N'Koudou,2801,[2017],Burnley FC,2,0,2,27,0,0,6,2,4,197,0,0,8,2,6,224,0,0,0.0,0.0,0.0,0,0,0,0,0,0,0,0,0,2020-12-27 19:15:00
1824,4031,Georginio Wijnaldum,1183,[2015],Newcastle United,19,18,1,1579,11,0,19,18,1,1589,0,0,38,36,2,3168,11,0,0.0,0.0,0.0,4,0,4,1,0,1,0,0,0,2020-12-27 19:15:00
1825,20170,Georginio Wijnaldum,1183,"[2016, 2017, 2018, 2019, 2020]",Liverpool FC,78,71,7,6198,12,0,77,69,8,6002,3,0,155,140,15,12200,15,0,4.0,3.0,7.0,5,3,8,0,0,0,0,0,0,2020-12-27 19:15:002020-12-27 19:15:002020-12-27 19:15:002020-12-27 19:15:002020-12-27 19:15:00
1826,12114,Georgios Samaras,1814,"[2005, 2006, 2007]",Manchester City,27,13,14,1429,7,0,28,15,13,1494,1,0,55,28,27,2923,8,0,0.0,0.0,0.0,4,0,4,1,0,1,0,0,0,2020-12-27 19:15:002020-12-27 19:15:002020-12-27 19:15:00
1827,4040,Georgios Samaras,1814,[2014],West Bromwich Albion,4,0,4,64,0,0,1,0,1,3,0,0,5,0,5,67,0,0,0.0,0.0,0.0,0,0,0,0,0,0,0,0,0,2020-12-27 19:15:00
1828,12126,Gerard Deulofeu,1927,"[2013, 2015, 2016]",Everton FC,29,14,15,1275,4,0,33,15,18,1460,1,0,62,29,33,2735,5,0,0.0,1.0,1.0,4,1,5,0,0,0,0,0,0,2020-12-27 19:15:002020-12-27 19:15:002020-12-27 19:15:00
1829,12135,Gerard Deulofeu,1927,"[2017, 2018, 2019]",Watford FC,31,27,4,2198,6,0,34,29,5,2431,9,0,65,56,9,4629,15,0,0.0,0.0,0.0,2,4,6,1,0,1,0,0,0,2020-12-27 19:15:002020-12-27 19:15:002020-12-27 19:15:00
1830,8095,Gerard Wiekens,3306,"[2000, 2002]",Manchester City,18,15,3,1298,0,0,19,16,3,1394,2,0,37,31,6,2692,2,0,0.0,0.0,0.0,0,1,1,0,0,0,0,0,0,2020-12-27 19:15:002020-12-27 19:15:00
1831,4049,Geremi,1764,[2002],Middlesbrough FC,17,17,0,1530,4,0,15,15,0,1348,3,0,32,32,0,2878,7,0,3.0,0.0,3.0,2,1,3,0,0,0,0,0,0,2020-12-27 19:15:00
1832,16206,Geremi,1764,"[2003, 2004, 2005, 2006]",Chelsea FC,33,22,11,1979,3,0,38,25,13,2222,1,0,71,47,24,4201,4,0,3.0,0.0,3.0,2,0,2,0,0,0,0,0,0,2020-12-27 19:15:002020-12-27 19:15:002020-12-27 19:15:002020-12-27 19:15:00
1833,8109,Geremi,1764,"[2007, 2008]",Newcastle United,22,18,4,1614,0,0,20,17,3,1472,2,0,42,35,7,3086,2,0,0.0,1.0,1.0,0,2,2,0,0,0,0,0,0,2020-12-27 19:15:002020-12-27 19:15:00
1834,24351,Gerhard Tremmel,1706,"[2011, 2012, 2013, 2014, 2015, 2016]",Swansea City,11,11,0,990,0,0,18,15,3,1400,0,0,29,26,3,2390,0,0,0.0,0.0,0.0,0,0,0,0,0,0,0,0,0,2020-12-27 19:15:002020-12-27 19:15:002020-12-27 19:15:002020-12-27 19:15:002020-12-27 19:15:002020-12-27 19:15:00
1835,12189,Gerry Taggart,2647,"[2000, 2001, 2003]",Leicester City,19,18,1,1582,2,0,15,15,0,1213,0,0,34,33,1,2795,2,0,3.0,0.0,3.0,1,0,1,0,0,0,0,0,0,2020-12-27 19:15:002020-12-27 19:15:002020-12-27 19:15:00
1836,8131,Gervinho,3301,"[2011, 2012]",Arsenal FC,23,15,8,1332,6,0,23,16,7,1387,3,0,46,31,15,2719,9,0,0.0,0.0,0.0,4,1,5,0,0,0,0,0,0,2020-12-27 19:15:002020-12-27 19:15:00
1837,12204,Gianfranco Zola,2617,"[2000, 2001, 2002]",Chelsea FC,56,40,16,3571,16,0,50,38,12,3318,10,0,106,78,28,6889,26,0,1.0,3.0,4.0,8,7,15,0,0,0,0,0,0,2020-12-27 19:15:002020-12-27 19:15:002020-12-27 19:15:00
1838,8141,Gianluca Festa,3551,"[2000, 2001]",Middlesbrough FC,18,16,2,1399,1,0,15,13,2,1218,2,0,33,29,4,2617,3,0,3.0,0.0,3.0,1,1,2,0,0,0,0,0,0,2020-12-27 19:15:002020-12-27 19:15:00
1839,8145,Giannelli Imbula,1583,"[2015, 2016]",Stoke City,13,12,1,1045,1,0,13,11,2,1011,1,0,26,23,3,2056,2,0,0.0,0.0,0.0,1,1,2,0,0,0,0,0,0,2020-12-27 19:15:002020-12-27 19:15:00
1840,8149,Gianni Zuiverloon,2002,"[2008, 2010]",West Bromwich Albion,17,16,1,1406,0,0,18,18,0,1607,0,0,35,34,1,3013,0,0,0.0,0.0,0.0,0,0,0,0,0,0,0,0,0,2020-12-27 19:15:002020-12-27 19:15:00
1841,8153,Giannis Skopelitis,3565,"[2004, 2005]",Portsmouth FC,7,5,2,406,0,0,11,4,7,468,0,0,18,9,9,874,0,0,0.0,0.0,0.0,0,0,0,0,0,0,0,0,0,2020-12-27 19:15:002020-12-27 19:15:00
1842,8157,Giedrius Arlauskis,3183,"[2015, 2016]",Watford FC,0,0,0,0,0,0,1,0,1,23,0,0,1,0,1,23,0,0,0.0,0.0,0.0,0,0,0,0,0,0,0,0,0,2020-12-27 19:15:002020-12-27 19:15:00
1843,8161,Gilberto,3158,"[2007, 2008]",Tottenham Hotspur,5,2,3,258,1,0,3,2,1,154,0,0,8,4,4,412,1,0,0.0,0.0,0.0,0,0,0,0,0,0,0,0,0,2020-12-27 19:15:002020-12-27 19:15:00
1844,24507,Gilberto Silva,1234,"[2002, 2003, 2004, 2005, 2006, 2007]",Arsenal FC,84,74,10,6614,12,0,81,74,7,6727,5,0,165,148,17,13341,17,0,3.0,0.0,3.0,7,2,9,5,0,5,0,0,0,2020-12-27 19:15:002020-12-27 19:15:002020-12-27 19:15:002020-12-27 19:15:002020-12-27 19:15:002020-12-27 19:15:00
1845,4088,Giles Barnes,1580,[2007],Derby County,10,8,2,738,0,0,11,6,5,642,1,0,21,14,7,1380,1,0,0.0,0.0,0.0,0,1,1,0,0,0,0,0,0,2020-12-27 19:15:00
1846,4089,Giles Barnes,1580,[2010],West Bromwich Albion,9,1,8,243,0,0,5,0,5,61,0,0,14,1,13,304,0,0,0.0,0.0,0.0,0,0,0,0,0,0,0,0,0,2020-12-27 19:15:00
1847,4090,Gilles De Bilde,4513,[2000],Aston Villa,1,1,0,67,0,0,3,3,0,236,0,0,4,4,0,303,0,0,0.0,0.0,0.0,0,0,0,0,0,0,0,0,0,2020-12-27 19:15:00
1848,8183,Gilles Grimandi,3245,"[2000, 2001]",Arsenal FC,29,20,9,1811,1,0,27,19,8,1743,0,0,56,39,17,3554,1,0,0.0,0.0,0.0,1,0,1,0,0,0,0,0,0,2020-12-27 19:15:002020-12-27 19:15:00
1849,4093,Gio McGregor,4493,[2019],Crystal Palace,0,0,0,0,0,0,0,0,0,0,0,0,0,0,0,0,0,0,0.0,0.0,0.0,0,0,0,0,0,0,0,0,0,2020-12-27 19:15:00
1850,8189,Giorgi Kinkladze,3361,"[2000, 2001]",Derby County,24,14,10,1468,1,0,19,9,10,1028,1,0,43,23,20,2496,2,0,1.0,0.0,1.0,1,1,2,0,0,0,0,0,0,2020-12-27 19:15:002020-12-27 19:15:00
1851,8193,Giorgios Karagounis,2560,"[2012, 2013]",Fulham FC,20,14,6,1117,1,0,19,12,7,1088,0,0,39,26,13,2205,1,0,0.0,0.0,0.0,1,0,1,0,0,0,0,0,0,2020-12-27 19:15:002020-12-27 19:15:00
1852,8197,Giovani Lo Celso,2982,"[2019, 2020]",Tottenham Hotspur,18,11,7,1055,1,0,21,8,13,868,0,0,39,19,20,1923,1,0,0.0,0.0,0.0,0,0,0,0,0,0,0,0,0,2020-12-27 19:15:002020-12-27 19:15:00
1853,16406,Giovani dos Santos,2499,"[2008, 2009, 2010, 2011]",Tottenham Hotspur,9,0,9,150,0,0,8,2,6,189,0,0,17,2,15,339,0,0,0.0,0.0,0.0,0,0,0,0,0,0,0,0,0,2020-12-27 19:15:002020-12-27 19:15:002020-12-27 19:15:002020-12-27 19:15:00
1854,8209,Giovanni van Bronckhorst,2358,"[2001, 2002]",Arsenal FC,20,11,9,1161,1,0,19,10,9,1013,1,0,39,21,18,2174,2,0,0.0,0.0,0.0,0,1,1,0,0,0,0,0,0,2020-12-27 19:15:002020-12-27 19:15:00
1855,4106,Giuseppe Rossi,3511,[2005],Manchester United,4,1,3,119,0,0,1,0,1,12,1,0,5,1,4,131,1,0,0.0,0.0,0.0,0,0,0,0,0,0,0,0,0,2020-12-27 19:15:00
1856,4107,Giuseppe Rossi,3511,[2006],Newcastle United,7,2,5,227,0,0,4,1,3,152,0,0,11,3,8,379,0,0,0.0,0.0,0.0,0,0,0,0,0,0,0,0,0,2020-12-27 19:15:00
1857,4108,Glen Johnson,1386,[2002],West Ham United,6,6,0,540,0,0,8,7,1,657,0,0,14,13,1,1197,0,0,0.0,0.0,0.0,0,0,0,0,0,0,0,0,0,2020-12-27 19:15:00
1858,12330,Glen Johnson,1386,"[2003, 2004, 2005]",Chelsea FC,19,16,3,1369,2,0,20,18,2,1587,1,0,39,34,5,2956,3,0,0.0,3.0,3.0,1,1,2,0,0,0,0,0,0,2020-12-27 19:15:002020-12-27 19:15:002020-12-27 19:15:00
1859,12339,Glen Johnson,1386,"[2006, 2007, 2008]",Portsmouth FC,42,42,0,3780,2,0,41,40,1,3554,2,0,83,82,1,7334,4,0,0.0,0.0,0.0,2,0,2,0,0,0,0,0,0,2020-12-27 19:15:002020-12-27 19:15:002020-12-27 19:15:00
1860,24705,Glen Johnson,1386,"[2009, 2010, 2011, 2012, 2013, 2014]",Liverpool FC,78,76,2,6738,4,0,82,78,4,6867,4,0,160,154,6,13605,8,0,3.0,3.0,6.0,2,3,5,0,0,0,0,0,0,2020-12-27 19:15:002020-12-27 19:15:002020-12-27 19:15:002020-12-27 19:15:002020-12-27 19:15:002020-12-27 19:15:00
1861,12366,Glen Johnson,1386,"[2015, 2016, 2017]",Stoke City,32,29,3,2562,0,0,25,24,1,2129,0,0,57,53,4,4691,0,0,0.0,0.0,0.0,0,0,0,0,0,0,0,0,0,2020-12-27 19:15:002020-12-27 19:15:002020-12-27 19:15:00
1862,4124,Glen Little,2595,[2003],Bolton Wanderers,2,0,2,18,0,0,2,0,2,12,0,0,4,0,4,30,0,0,0.0,0.0,0.0,0,0,0,0,0,0,0,0,0,2020-12-27 19:15:00
1863,8251,Glen Little,2595,"[2006, 2007]",Reading FC,12,9,3,814,0,0,13,8,5,744,0,0,25,17,8,1558,0,0,0.0,0.0,0.0,0,0,0,0,0,0,0,0,0,2020-12-27 19:15:002020-12-27 19:15:00
1864,4127,Glen Little,2595,[2008],Portsmouth FC,3,3,0,178,0,0,2,1,1,115,0,0,5,4,1,293,0,0,0.0,0.0,0.0,0,0,0,0,0,0,0,0,0,2020-12-27 19:15:00
1865,8257,Glenn Murray,1010,"[2013, 2014]",Crystal Palace,17,8,9,798,2,0,14,4,10,483,6,0,31,12,19,1281,8,0,0.0,1.0,1.0,1,4,5,0,2,2,0,0,0,2020-12-27 19:15:002020-12-27 19:15:00
1866,4130,Glenn Murray,1010,[2015],AFC Bournemouth,8,3,5,298,1,0,11,3,8,371,2,0,19,6,13,669,3,0,0.0,3.0,3.0,1,1,2,0,0,0,0,0,0,2020-12-27 19:15:00
1867,12396,Glenn Murray,1010,"[2017, 2018, 2019]",Brighton & Hove Albion,50,34,16,2999,15,0,46,28,18,2500,11,0,96,62,34,5499,26,0,8.0,6.0,14.0,11,8,19,4,4,8,0,0,0,2020-12-27 19:15:002020-12-27 19:15:002020-12-27 19:15:00
1868,37242,Glenn Whelan,1549,"[2008, 2009, 2010, 2011, 2012, 2013, 2014, 2015, 2016]",Stoke City,137,116,21,10269,2,0,140,119,21,10664,2,0,277,235,42,20933,4,0,0.0,4.0,4.0,1,2,3,0,0,0,0,0,0,2020-12-27 19:15:002020-12-27 19:15:002020-12-27 19:15:002020-12-27 19:15:002020-12-27 19:15:002020-12-27 19:15:002020-12-27 19:15:002020-12-27 19:15:002020-12-27 19:15:00
1869,4143,Gláuber,4525,[2008],Manchester City,1,0,1,6,0,0,0,0,0,0,0,0,1,0,1,6,0,0,0.0,0.0,0.0,0,0,0,0,0,0,0,0,0,2020-12-27 19:15:00
1870,20730,Gomes,1266,"[2008, 2009, 2010, 2011, 2013]",Tottenham Hotspur,48,48,0,4320,0,0,44,44,0,3886,0,0,92,92,0,8206,0,0,0.0,0.0,0.0,0,0,0,0,0,0,0,0,0,2020-12-27 19:15:002020-12-27 19:15:002020-12-27 19:15:002020-12-27 19:15:002020-12-27 19:15:00
1871,20755,Gomes,1266,"[2015, 2016, 2017, 2018, 2019]",Watford FC,50,50,0,4476,0,0,50,50,0,4389,0,0,100,100,0,8865,0,0,0.0,0.0,0.0,0,0,0,0,0,0,0,0,0,2020-12-27 19:15:002020-12-27 19:15:002020-12-27 19:15:002020-12-27 19:15:002020-12-27 19:15:00
1872,4154,Gonzalo Higuaín,1850,[2018],Chelsea FC,6,6,0,496,4,0,8,7,1,596,1,0,14,13,1,1092,5,0,0.0,0.0,0.0,2,1,3,0,0,0,0,0,0,2020-12-27 19:15:00
1873,12468,Gonzalo Jara,1738,"[2010, 2011, 2012]",West Bromwich Albion,19,14,5,1255,0,0,15,11,4,1118,1,0,34,25,9,2373,1,0,0.0,0.0,0.0,0,0,0,0,0,0,0,0,0,2020-12-27 19:15:002020-12-27 19:15:002020-12-27 19:15:00
1874,4158,Gonzalo Sorondo,3438,[2004],Crystal Palace,10,8,2,705,0,0,10,8,2,759,0,0,20,16,4,1464,0,0,0.0,0.0,0.0,0,0,0,0,0,0,0,0,0,2020-12-27 19:15:00
1875,8319,Gonzalo Sorondo,3438,"[2005, 2006]",Charlton Athletic,4,4,0,319,0,0,4,3,1,331,0,0,8,7,1,650,0,0,0.0,0.0,0.0,0,0,0,0,0,0,0,0,0,2020-12-27 19:15:002020-12-27 19:15:00
1876,4161,Gonçalo Cardoso,3900,[2019],West Ham United,0,0,0,0,0,0,0,0,0,0,0,0,0,0,0,0,0,0,0.0,0.0,0.0,0,0,0,0,0,0,0,0,0,2020-12-27 19:15:00
1877,16654,Goran Bunjevčević,1937,"[2001, 2002, 2003, 2004]",Tottenham Hotspur,26,19,7,1732,0,0,25,22,3,1933,0,0,51,41,10,3665,0,0,0.0,0.0,0.0,0,0,0,0,0,0,0,0,0,2020-12-27 19:15:002020-12-27 19:15:002020-12-27 19:15:002020-12-27 19:15:00
1878,8333,Goran Popov,2304,"[2012, 2013]",West Bromwich Albion,7,7,0,622,0,0,7,4,3,392,0,0,14,11,3,1014,0,0,0.0,0.0,0.0,0,0,0,0,0,0,0,0,0,2020-12-27 19:15:002020-12-27 19:15:00
1879,8337,Grady Diangana,3518,"[2017, 2018]",West Ham United,9,3,6,327,0,0,8,3,5,278,0,0,17,6,11,605,0,0,0.0,0.0,0.0,0,0,0,0,0,0,0,0,0,2020-12-27 19:15:002020-12-27 19:15:00
1880,4170,Grady Diangana,3518,[2020],West Bromwich Albion,6,5,1,401,0,0,7,7,0,556,1,0,13,12,1,957,1,0,0.0,0.0,0.0,0,1,1,0,0,0,0,0,0,2020-12-27 19:15:00
1881,12516,Graeme Le Saux,2615,"[2000, 2001, 2002]",Chelsea FC,39,35,4,2898,3,0,35,35,0,3037,0,0,74,70,4,5935,3,0,0.0,0.0,0.0,1,0,1,0,0,0,0,0,0,2020-12-27 19:15:002020-12-27 19:15:002020-12-27 19:15:00
1882,8349,Graeme Le Saux,2615,"[2003, 2004]",Southampton FC,23,22,1,1753,1,0,17,17,0,1386,0,0,40,39,1,3139,1,0,0.0,0.0,0.0,1,0,1,0,0,0,0,0,0,2020-12-27 19:15:002020-12-27 19:15:00
1883,8353,Graeme Murty,2589,"[2006, 2007]",Reading FC,27,27,0,2316,0,0,21,21,0,1856,0,0,48,48,0,4172,0,0,0.0,0.0,0.0,0,0,0,0,0,0,0,0,0,2020-12-27 19:15:002020-12-27 19:15:00
1884,4178,Graham Alexander,2546,[2009],Burnley FC,16,16,0,1377,4,0,17,17,0,1366,3,0,33,33,0,2743,7,0,1.0,0.0,1.0,3,2,5,3,3,6,0,0,0,2020-12-27 19:15:00
1885,8359,Graham Burke,3874,"[2011, 2012]",Aston Villa,0,0,0,0,0,0,0,0,0,0,0,0,0,0,0,0,0,0,0.0,0.0,0.0,0,0,0,0,0,0,0,0,0,2020-12-27 19:15:002020-12-27 19:15:00
1886,25101,Graham Dorrans,1737,"[2008, 2010, 2011, 2012, 2013, 2014]",West Bromwich Albion,61,42,19,3740,5,0,60,47,13,4094,3,0,121,89,32,7834,8,0,3.0,3.0,6.0,3,1,4,0,1,1,0,0,0,2020-12-27 19:15:002020-12-27 19:15:002020-12-27 19:15:002020-12-27 19:15:002020-12-27 19:15:002020-12-27 19:15:00
1887,4187,Graham Dorrans,1737,[2015],Norwich City,11,7,4,654,0,0,10,7,3,633,0,0,21,14,7,1287,0,0,0.0,0.0,0.0,0,0,0,0,0,0,0,0,0,2020-12-27 19:15:00
1888,8377,Graham Kavanagh,1816,"[2005, 2006]",Wigan Athletic,18,16,2,1370,0,0,19,16,3,1437,0,0,37,32,5,2807,0,0,0.0,0.0,0.0,0,0,0,0,0,0,0,0,0,2020-12-27 19:15:002020-12-27 19:15:00
1889,4190,Graham Stack,4515,[2003],Arsenal FC,0,0,0,0,0,0,0,0,0,0,0,0,0,0,0,0,0,0,0.0,0.0,0.0,0,0,0,0,0,0,0,0,0,2020-12-27 19:15:00
1890,20965,Graham Stuart,1673,"[2000, 2001, 2002, 2003, 2004]",Charlton Athletic,48,44,4,4012,6,0,49,45,4,3777,5,0,97,89,8,7789,11,0,0.0,6.0,6.0,2,4,6,1,1,2,0,0,0,2020-12-27 19:15:002020-12-27 19:15:002020-12-27 19:15:002020-12-27 19:15:002020-12-27 19:15:00
1891,4196,Granero,2532,[2012],Queens Park Rangers,9,8,1,658,0,0,15,11,4,1005,1,0,24,19,5,1663,1,0,0.0,0.0,0.0,0,0,0,0,0,0,0,0,0,2020-12-27 19:15:00
1892,20995,Granit Xhaka,1475,"[2016, 2017, 2018, 2019, 2020]",Arsenal FC,68,65,3,5773,6,0,72,69,3,5945,3,0,140,134,6,11718,9,0,0.0,0.0,0.0,4,2,6,0,0,0,0,0,0,2020-12-27 19:15:002020-12-27 19:15:002020-12-27 19:15:002020-12-27 19:15:002020-12-27 19:15:00
1893,12609,Grant Hanley,1837,"[2009, 2010, 2011]",Blackburn Rovers,14,10,4,1010,0,0,17,15,2,1347,2,0,31,25,6,2357,2,0,0.0,3.0,3.0,0,2,2,0,0,0,0,0,0,2020-12-27 19:15:002020-12-27 19:15:002020-12-27 19:15:00
1894,4205,Grant Hanley,1837,[2019],Norwich City,8,7,1,642,0,0,7,7,0,620,0,0,15,14,1,1262,0,0,0.0,0.0,0.0,0,0,0,0,0,0,0,0,0,2020-12-27 19:15:00
1895,8413,Grant Holt,1446,"[2011, 2012]",Norwich City,36,26,10,2468,14,0,34,26,8,2356,9,0,70,52,18,4824,23,0,14.0,1.0,15.0,11,7,18,3,0,3,0,0,0,2020-12-27 19:15:002020-12-27 19:15:00
1896,4208,Grant Holt,1446,[2013],Aston Villa,6,1,5,169,1,0,4,2,2,207,0,0,10,3,7,376,1,0,0.0,0.0,0.0,1,0,1,0,0,0,0,0,0,2020-12-27 19:15:00
1897,16842,Grant Leadbitter,1219,"[2005, 2007, 2008, 2009]",Sunderland AFC,35,17,18,1907,3,0,31,21,10,1931,1,0,66,38,28,3838,4,0,0.0,0.0,0.0,2,1,3,0,0,0,0,0,0,2020-12-27 19:15:002020-12-27 19:15:002020-12-27 19:15:002020-12-27 19:15:00
1898,4213,Grant Leadbitter,1219,[2016],Middlesbrough FC,8,3,5,340,0,0,5,4,1,367,1,0,13,7,6,707,1,0,0.0,0.0,0.0,0,1,1,0,0,0,0,0,0,2020-12-27 19:15:00
1899,8429,Grant McCann,4267,"[2000, 2001]",West Ham United,1,0,1,7,0,0,3,0,3,66,0,0,4,0,4,73,0,0,0.0,0.0,0.0,0,0,0,0,0,0,0,0,0,2020-12-27 19:15:002020-12-27 19:15:00
1900,8433,Graziano Pellè,1152,"[2014, 2015]",Southampton FC,35,32,3,2901,18,0,33,28,5,2555,5,0,68,60,8,5456,23,0,3.0,0.0,3.0,8,2,10,0,0,0,0,0,0,2020-12-27 19:15:002020-12-27 19:15:00
1901,4218,Greg Cunningham,3152,[2009],Manchester City,1,0,1,1,0,0,1,0,1,1,0,0,2,0,2,2,0,0,0.0,0.0,0.0,0,0,0,0,0,0,0,0,0,2020-12-27 19:15:00
1902,4219,Greg Cunningham,3152,[2018],Cardiff City,5,5,0,450,0,0,2,2,0,180,0,0,7,7,0,630,0,0,0.0,0.0,0.0,0,0,0,0,0,0,0,0,0,2020-12-27 19:15:00
1903,4220,Greg Halford,1968,[2006],Reading FC,2,1,1,91,0,0,1,1,0,90,0,0,3,2,1,181,0,0,0.0,0.0,0.0,0,0,0,0,0,0,0,0,0,2020-12-27 19:15:00
1904,4221,Greg Halford,1968,[2007],Sunderland AFC,3,3,0,270,0,0,5,5,0,430,0,0,8,8,0,700,0,0,0.0,0.0,0.0,0,0,0,0,0,0,0,0,0,2020-12-27 19:15:00
1905,8445,Greg Halford,1968,"[2009, 2010]",Wolverhampton Wanderers,8,5,3,410,0,0,9,7,2,509,0,0,17,12,5,919,0,0,0.0,0.0,0.0,0,0,0,0,0,0,0,0,0,2020-12-27 19:15:002020-12-27 19:15:00
1906,4224,Greg Luer,4030,[2016],Hull City,0,0,0,0,0,0,0,0,0,0,0,0,0,0,0,0,0,0,0.0,0.0,0.0,0,0,0,0,0,0,0,0,0,2020-12-27 19:15:00
1907,4225,Greg Olley,4029,[2016],Hull City,0,0,0,0,0,0,0,0,0,0,0,0,0,0,0,0,0,0,0.0,0.0,0.0,0,0,0,0,0,0,0,0,0,2020-12-27 19:15:00
1908,4226,Greg Shields,3995,[2000],Charlton Athletic,2,1,1,102,0,0,2,1,1,103,0,0,4,2,2,205,0,0,0.0,0.0,0.0,0,0,0,0,0,0,0,0,0,2020-12-27 19:15:00
1909,4227,Gregor Zabret,3733,[2013],Swansea City,0,0,0,0,0,0,0,0,0,0,0,0,0,0,0,0,0,0,0.0,0.0,0.0,0,0,0,0,0,0,0,0,0,2020-12-27 19:15:00
1910,4228,Grzegorz Krychowiak,1662,[2017],West Bromwich Albion,13,8,5,673,0,0,14,12,2,970,0,0,27,20,7,1643,0,0,0.0,0.0,0.0,0,0,0,0,0,0,0,0,0,2020-12-27 19:15:00
1911,4229,Grzegorz Rasiak,4047,[2005],Tottenham Hotspur,3,1,2,97,0,0,5,3,2,240,0,0,8,4,4,337,0,0,0.0,0.0,0.0,0,0,0,0,0,0,0,0,0,2020-12-27 19:15:00
1912,4230,Grzegorz Rasiak,4047,[2007],Bolton Wanderers,3,0,3,86,0,0,4,2,2,194,0,0,7,2,5,280,0,0,0.0,0.0,0.0,0,0,0,0,0,0,0,0,0,2020-12-27 19:15:00
1913,12696,Grégory Vignal,2645,"[2000, 2001, 2002]",Liverpool FC,4,2,2,236,0,0,6,4,2,377,0,0,10,6,4,613,0,0,0.0,0.0,0.0,0,0,0,0,0,0,0,0,0,2020-12-27 19:15:002020-12-27 19:15:002020-12-27 19:15:00
1914,4234,Grégory Vignal,2645,[2005],Portsmouth FC,6,6,0,510,0,0,8,7,1,662,0,0,14,13,1,1172,0,0,0.0,0.0,0.0,0,0,0,0,0,0,0,0,0,2020-12-27 19:15:00
1915,4235,Grégory Vignal,2645,[2009],Birmingham City,3,3,0,215,0,0,5,3,2,287,0,0,8,6,2,502,0,0,0.0,0.0,0.0,0,0,0,0,0,0,0,0,0,2020-12-27 19:15:00
1916,21190,Grétar Steinsson,2410,"[2007, 2008, 2009, 2010, 2011]",Bolton Wanderers,57,55,2,4804,4,0,66,63,3,5707,1,0,123,118,5,10511,5,0,0.0,0.0,0.0,2,1,3,0,0,0,0,0,0,2020-12-27 19:15:002020-12-27 19:15:002020-12-27 19:15:002020-12-27 19:15:002020-12-27 19:15:00
1917,12726,Guaita,2701,"[2018, 2019, 2020]",Crystal Palace,37,37,0,3285,0,0,33,33,0,2970,0,0,70,70,0,6255,0,0,0.0,0.0,0.0,0,0,0,0,0,0,0,0,0,2020-12-27 19:15:002020-12-27 19:15:002020-12-27 19:15:00
1918,4244,Guido Carrillo,3774,[2017],Southampton FC,3,2,1,213,0,0,4,3,1,238,0,0,7,5,2,451,0,0,0.0,0.0,0.0,0,0,0,0,0,0,0,0,0,2020-12-27 19:15:00
1919,4245,Guillermo Franco,1286,[2009],West Ham United,13,9,4,782,2,0,10,7,3,589,3,0,23,16,7,1371,5,0,0.0,0.0,0.0,0,2,2,0,0,0,0,0,0,2020-12-27 19:15:00
1920,4246,Guillermo Varela,2193,[2015],Manchester United,3,2,1,224,0,0,1,1,0,90,0,0,4,3,1,314,0,0,0.0,0.0,0.0,0,0,0,0,0,0,0,0,0,2020-12-27 19:15:00
1921,8495,Guly,2871,"[2012, 2013]",Southampton FC,16,3,13,369,0,0,11,5,6,467,0,0,27,8,19,836,0,0,0.0,0.0,0.0,0,0,0,0,0,0,0,0,0,2020-12-27 19:15:002020-12-27 19:15:00
1922,4249,Gunnar Halle,3976,[2000],Bradford City,5,4,1,414,0,0,4,3,1,331,0,0,9,7,2,745,0,0,0.0,0.0,0.0,0,0,0,0,0,0,0,0,0,2020-12-27 19:15:00
1923,4250,Gunnar Nielsen,4222,[2009],Manchester City,0,0,0,0,0,0,1,0,1,17,0,0,1,0,1,17,0,0,0.0,0.0,0.0,0,0,0,0,0,0,0,0,0,2020-12-27 19:15:00
1924,4251,Gustavo Poyet,1128,[2000],Chelsea FC,15,13,2,1151,7,0,13,8,5,775,4,0,28,21,7,1926,11,0,4.0,0.0,4.0,5,1,6,0,0,0,0,0,0,2020-12-27 19:15:00
1925,12759,Gustavo Poyet,1128,"[2001, 2002, 2003]",Tottenham Hotspur,40,32,8,2830,12,0,41,33,8,2805,6,0,81,65,16,5635,18,0,10.0,0.0,10.0,8,2,10,0,0,0,0,0,0,2020-12-27 19:15:002020-12-27 19:15:002020-12-27 19:15:00
1926,12768,Guy Demel,3093,"[2012, 2013, 2014]",West Ham United,34,29,5,2572,1,0,35,32,3,2802,0,0,69,61,8,5374,1,0,0.0,0.0,0.0,1,0,1,0,0,0,0,0,0,2020-12-27 19:15:002020-12-27 19:15:002020-12-27 19:15:00
1927,8517,Guðni Bergsson,3500,"[2001, 2002]",Bolton Wanderers,30,30,0,2664,0,0,31,31,0,2776,1,0,61,61,0,5440,1,0,0.0,0.0,0.0,0,1,1,0,0,0,0,0,0,2020-12-27 19:15:002020-12-27 19:15:00
1928,4260,Gwion Edwards,4338,[2011],Swansea City,0,0,0,0,0,0,0,0,0,0,0,0,0,0,0,0,0,0,0.0,0.0,0.0,0,0,0,0,0,0,0,0,0,2020-12-27 19:15:00
1929,17056,Gylfi Sigurðsson,1055,"[2011, 2014, 2015, 2016]",Swansea City,64,61,3,5419,12,0,60,57,3,5019,22,0,124,118,6,10438,34,0,12.0,7.0,19.0,11,15,26,3,3,6,0,0,0,2020-12-27 19:15:002020-12-27 19:15:002020-12-27 19:15:002020-12-27 19:15:00
1930,8525,Gylfi Sigurðsson,1055,"[2012, 2013]",Tottenham Hotspur,29,15,14,1381,6,0,29,11,18,1119,2,0,58,26,32,2500,8,0,4.0,1.0,5.0,4,2,6,0,0,0,0,0,0,2020-12-27 19:15:002020-12-27 19:15:00
1931,17074,Gylfi Sigurðsson,1055,"[2017, 2018, 2019, 2020]",Everton FC,56,48,8,4401,13,0,58,49,9,4316,8,0,114,97,17,8717,21,0,6.0,6.0,12.0,6,4,10,2,2,4,0,0,0,2020-12-27 19:15:002020-12-27 19:15:002020-12-27 19:15:002020-12-27 19:15:00
1932,4271,Gábor Király,2020,[2004],Crystal Palace,16,16,0,1440,0,0,15,15,0,1350,0,0,31,31,0,2790,0,0,0.0,0.0,0.0,0,0,0,0,0,0,0,0,0,2020-12-27 19:15:00
1933,4272,Gábor Király,2020,[2006],Aston Villa,3,3,0,270,0,0,2,2,0,180,0,0,5,5,0,450,0,0,0.0,0.0,0.0,0,0,0,0,0,0,0,0,0,2020-12-27 19:15:00
1934,4273,Géovanni,1613,[2007],Manchester City,10,1,9,236,1,0,9,1,8,163,2,0,19,2,17,399,3,0,3.0,0.0,3.0,1,1,2,0,0,0,0,0,0,2020-12-27 19:15:00
1935,8549,Géovanni,1613,"[2008, 2009]",Hull City,29,21,8,1910,5,0,31,27,4,2186,6,0,60,48,12,4096,11,0,1.0,3.0,4.0,3,4,7,0,1,1,0,0,0,2020-12-27 19:15:002020-12-27 19:15:00
1936,4276,Gérald Cid,3750,[2007],Bolton Wanderers,4,4,0,316,0,0,3,2,1,193,0,0,7,6,1,509,0,0,0.0,0.0,0.0,0,0,0,0,0,0,0,0,0,2020-12-27 19:15:00
1937,4277,Gökhan Inler,3440,[2015],Leicester City,4,2,2,149,0,0,1,1,0,46,0,0,5,3,2,195,0,0,0.0,0.0,0.0,0,0,0,0,0,0,0,0,0,2020-12-27 19:15:00
1938,4278,Gökhan Töre,3618,[2016],West Ham United,3,2,1,140,0,0,2,1,1,101,0,0,5,3,2,241,0,0,0.0,0.0,0.0,0,0,0,0,0,0,0,0,0,2020-12-27 19:15:00
1939,8559,Habib Beye,2173,"[2007, 2008]",Newcastle United,26,25,1,2299,1,0,25,23,2,2061,0,0,51,48,3,4360,1,0,3.0,0.0,3.0,1,0,1,0,0,0,0,0,0,2020-12-27 19:15:002020-12-27 19:15:00
1940,12846,Habib Beye,2173,"[2009, 2010, 2011]",Aston Villa,4,4,0,338,0,0,4,3,1,288,0,0,8,7,1,626,0,0,0.0,0.0,0.0,0,0,0,0,0,0,0,0,0,2020-12-27 19:15:002020-12-27 19:15:002020-12-27 19:15:00
1941,4284,Hakan Ünsal,3612,[2001],Blackburn Rovers,4,3,1,244,0,0,4,4,0,306,0,0,8,7,1,550,0,0,0.0,0.0,0.0,0,0,0,0,0,0,0,0,0,2020-12-27 19:15:00
1942,4285,Hakan Şükür,4191,[2002],Blackburn Rovers,5,4,1,350,0,0,4,3,1,265,2,0,9,7,2,615,2,0,0.0,0.0,0.0,0,0,0,0,0,0,0,0,0,2020-12-27 19:15:00
1943,4286,Hakim Ziyech,1018,[2020],Chelsea FC,4,3,1,221,0,0,3,2,1,169,1,0,7,5,2,390,1,0,0.0,0.0,0.0,0,1,1,0,0,0,0,0,0,2020-12-27 19:15:00
1944,4287,Hal Robson-Kanu,1984,[2012],Reading FC,12,6,6,618,3,0,13,7,6,658,4,0,25,13,12,1276,7,0,1.0,0.0,1.0,2,1,3,0,1,1,0,0,0,2020-12-27 19:15:00
1945,12867,Hal Robson-Kanu,1984,"[2016, 2017, 2020]",West Bromwich Albion,26,4,22,655,2,0,29,9,20,993,3,0,55,13,42,1648,5,0,0.0,6.0,6.0,2,2,4,0,0,0,0,0,0,2020-12-27 19:15:002020-12-27 19:15:002020-12-27 19:15:00
1946,4291,Hameur Bouazza,1566,[2006],Watford FC,15,12,3,1046,3,0,14,12,2,1039,2,0,29,24,5,2085,5,0,0.0,1.0,1.0,2,2,4,1,0,1,0,0,0,2020-12-27 19:15:00
1947,4292,Hameur Bouazza,1566,[2007],Fulham FC,11,10,1,738,1,0,9,5,4,469,0,0,20,15,5,1207,1,0,0.0,0.0,0.0,1,0,1,0,0,0,0,0,0,2020-12-27 19:15:00
1948,17178,Hamza Choudhury,2447,"[2017, 2018, 2019, 2020]",Leicester City,22,10,12,933,0,0,17,11,6,956,1,0,39,21,18,1889,1,0,0.0,0.0,0.0,0,0,0,0,0,0,0,0,0,2020-12-27 19:15:002020-12-27 19:15:002020-12-27 19:15:002020-12-27 19:15:00
1949,4297,Hannu Tihinen,2339,[2000],West Ham United,2,1,1,78,0,0,4,2,2,232,0,0,6,3,3,310,0,0,0.0,0.0,0.0,0,0,0,0,0,0,0,0,0,2020-12-27 19:15:00
1950,4298,Harald Wapenaar,3514,[2003],Portsmouth FC,2,2,0,180,0,0,2,2,0,180,0,0,4,4,0,360,0,0,0.0,0.0,0.0,0,0,0,0,0,0,0,0,0,2020-12-27 19:15:00
1951,17202,Haris Vučkić,3708,"[2010, 2011, 2013, 2014]",Newcastle United,3,1,2,109,0,0,2,1,1,73,0,0,5,2,3,182,0,0,0.0,0.0,0.0,0,0,0,0,0,0,0,0,0,2020-12-27 19:15:002020-12-27 19:15:002020-12-27 19:15:002020-12-27 19:15:00
1952,17218,Harrison Reed,1153,"[2013, 2014, 2015, 2016]",Southampton FC,9,3,6,287,0,0,8,3,5,256,0,0,17,6,11,543,0,0,0.0,0.0,0.0,0,0,0,0,0,0,0,0,0,2020-12-27 19:15:002020-12-27 19:15:002020-12-27 19:15:002020-12-27 19:15:00
1953,4307,Harrison Reed,1153,[2020],Fulham FC,7,4,3,397,0,0,4,4,0,318,0,0,11,8,3,715,0,0,0.0,0.0,0.0,0,0,0,0,0,0,0,0,0,2020-12-27 19:15:00
1954,12927,Harry Arter,1007,"[2015, 2016, 2017]",AFC Bournemouth,33,31,2,2650,2,0,36,34,2,2958,1,0,69,65,4,5608,3,0,0.0,0.0,0.0,1,0,1,0,0,0,0,0,0,2020-12-27 19:15:002020-12-27 19:15:002020-12-27 19:15:00
1955,4311,Harry Arter,1007,[2018],Cardiff City,14,14,0,1186,0,0,11,10,1,823,0,0,25,24,1,2009,0,0,0.0,0.0,0.0,0,0,0,0,0,0,0,0,0,2020-12-27 19:15:00
1956,38852,Harry Kane,1169,"[2011, 2013, 2014, 2015, 2016, 2017, 2018, 2019, 2020]",Tottenham Hotspur,109,104,5,9293,72,0,112,103,9,9140,80,0,221,207,14,18433,152,0,27.0,20.0,47.0,36,45,81,9,13,22,0,0,0,2020-12-27 19:15:002020-12-27 19:15:002020-12-27 19:15:002020-12-27 19:15:002020-12-27 19:15:002020-12-27 19:15:002020-12-27 19:15:002020-12-27 19:15:002020-12-27 19:15:00
1957,4313,Harry Kane,1169,[2012],Norwich City,2,0,2,64,0,0,1,1,0,70,0,0,3,1,2,134,0,0,0.0,0.0,0.0,0,0,0,0,0,0,0,0,0,2020-12-27 19:15:00
1958,12969,Harry Kewell,1296,"[2000, 2001, 2002]",Leeds United,36,34,2,2887,12,0,34,30,4,2748,12,0,70,64,6,5635,24,0,6.0,0.0,6.0,7,7,14,0,0,0,0,0,0,2020-12-27 19:15:002020-12-27 19:15:002020-12-27 19:15:00
1959,21635,Harry Kewell,1296,"[2003, 2004, 2005, 2006, 2007]",Liverpool FC,44,42,2,3492,7,0,46,36,10,3427,5,0,90,78,12,6919,12,0,7.0,0.0,7.0,5,2,7,1,0,1,0,0,0,2020-12-27 19:15:002020-12-27 19:15:002020-12-27 19:15:002020-12-27 19:15:002020-12-27 19:15:00
1960,8661,Harry Lewis,3025,"[2016, 2019]",Southampton FC,0,0,0,0,0,0,0,0,0,0,0,0,0,0,0,0,0,0,0.0,0.0,0.0,0,0,0,0,0,0,0,0,0,2020-12-27 19:15:002020-12-27 19:15:00
1961,8665,Harry Maguire,2229,"[2014, 2016]",Hull City,17,12,5,1178,1,0,15,13,2,1218,1,0,32,25,7,2396,2,0,0.0,0.0,0.0,0,1,1,0,0,0,0,0,0,2020-12-27 19:15:002020-12-27 19:15:00
1962,8669,Harry Maguire,2229,"[2017, 2018]",Leicester City,34,34,0,3060,2,0,35,35,0,3045,3,0,69,69,0,6105,5,0,1.0,4.0,5.0,1,2,3,0,0,0,0,0,0,2020-12-27 19:15:002020-12-27 19:15:00
1963,8673,Harry Maguire,2229,"[2019, 2020]",Manchester United,26,26,0,2340,0,0,26,26,0,2340,2,0,52,52,0,4680,2,0,0.0,0.0,0.0,0,1,1,0,0,0,0,0,0,2020-12-27 19:15:002020-12-27 19:15:00
1964,4338,Harry Souttar,4010,[2017],Stoke City,0,0,0,0,0,0,0,0,0,0,0,0,0,0,0,0,0,0,0.0,0.0,0.0,0,0,0,0,0,0,0,0,0,2020-12-27 19:15:00
1965,4339,Harry Wilson,3341,[2016],Liverpool FC,0,0,0,0,0,0,0,0,0,0,0,0,0,0,0,0,0,0,0.0,0.0,0.0,0,0,0,0,0,0,0,0,0,2020-12-27 19:15:00
1966,4340,Harry Wilson,3341,[2019],AFC Bournemouth,14,9,5,808,2,0,17,11,6,845,5,0,31,20,11,1653,7,0,0.0,0.0,0.0,1,1,2,0,0,0,0,0,0,2020-12-27 19:15:00
1967,34756,Harry Winks,1857,"[2013, 2014, 2015, 2016, 2017, 2018, 2019, 2020]",Tottenham Hotspur,54,33,21,2944,1,0,46,26,20,2497,1,0,100,59,41,5441,2,0,0.0,3.0,3.0,1,1,2,0,0,0,0,0,0,2020-12-27 19:15:002020-12-27 19:15:002020-12-27 19:15:002020-12-27 19:15:002020-12-27 19:15:002020-12-27 19:15:002020-12-27 19:15:002020-12-27 19:15:00
1968,17402,Harvey Barnes,2441,"[2017, 2018, 2019, 2020]",Leicester City,38,24,14,2295,7,0,31,22,9,1823,4,0,69,46,23,4118,11,0,0.0,4.0,4.0,5,4,9,0,0,0,0,0,0,2020-12-27 19:15:002020-12-27 19:15:002020-12-27 19:15:002020-12-27 19:15:00
1969,4353,Harvey Elliott,2308,[2018],Fulham FC,1,0,1,16,0,0,1,0,1,2,0,0,2,0,2,18,0,0,0.0,0.0,0.0,0,0,0,0,0,0,0,0,0,2020-12-27 19:15:00
1970,4354,Harvey Elliott,2308,[2019],Liverpool FC,2,0,2,7,0,0,0,0,0,0,0,0,2,0,2,7,0,0,0.0,0.0,0.0,0,0,0,0,0,0,0,0,0,2020-12-27 19:15:00
1971,4355,Harvey White,2986,[2019],Tottenham Hotspur,0,0,0,0,0,0,0,0,0,0,0,0,0,0,0,0,0,0,0.0,0.0,0.0,0,0,0,0,0,0,0,0,0,2020-12-27 19:15:00
1972,4356,Hassan Kachloul,3484,[2000],Southampton FC,13,12,1,1019,2,0,16,12,4,1108,2,0,29,24,5,2127,4,0,0.0,0.0,0.0,2,1,3,0,0,0,0,0,0,2020-12-27 19:15:00
1973,4357,Hassan Kachloul,3484,[2001],Aston Villa,13,11,2,848,1,0,8,5,3,465,1,0,21,16,5,1313,2,0,3.0,1.0,4.0,1,1,2,0,0,0,0,0,0,2020-12-27 19:15:00
1974,4358,Hassan Kachloul,3484,[2003],Wolverhampton Wanderers,3,0,3,66,0,0,1,0,1,4,0,0,4,0,4,70,0,0,0.0,0.0,0.0,0,0,0,0,0,0,0,0,0,2020-12-27 19:15:00
1975,4359,Hassan Yebda,3333,[2009],Portsmouth FC,11,9,2,793,0,0,7,6,1,487,2,0,18,15,3,1280,2,0,0.0,6.0,6.0,0,2,2,0,1,1,0,0,0,2020-12-27 19:15:00
1976,17446,Hatem Ben Arfa,2457,"[2010, 2011, 2012, 2013]",Newcastle United,40,21,19,2280,4,0,36,27,9,2212,9,0,76,48,28,4492,13,0,7.0,3.0,10.0,4,6,10,1,2,3,0,0,0,2020-12-27 19:15:002020-12-27 19:15:002020-12-27 19:15:002020-12-27 19:15:00
1977,4364,Hatem Ben Arfa,2457,[2014],Hull City,4,2,2,157,0,0,4,3,1,226,0,0,8,5,3,383,0,0,0.0,0.0,0.0,0,0,0,0,0,0,0,0,0,2020-12-27 19:15:00
1978,4365,Hatem Trabelsi,1879,[2006],Manchester City,11,10,1,832,0,0,9,6,3,537,1,0,20,16,4,1369,1,0,0.0,0.0,0.0,0,0,0,0,0,0,0,0,0,2020-12-27 19:15:00
1979,8733,Hayden Foxe,4035,"[2000, 2001]",West Ham United,4,2,2,239,0,0,6,4,2,410,0,0,10,6,4,649,0,0,0.0,0.0,0.0,0,0,0,0,0,0,0,0,0,2020-12-27 19:15:002020-12-27 19:15:00
1980,4368,Hayden Foxe,4035,[2003],Portsmouth FC,5,4,1,390,1,0,5,4,1,348,0,0,10,8,2,738,1,0,0.0,0.0,0.0,0,0,0,0,0,0,0,0,0,2020-12-27 19:15:00
1981,17482,Hayden Mullins,1941,"[2005, 2006, 2007, 2008]",West Ham United,56,43,13,3913,2,0,57,48,9,4403,1,0,113,91,22,8316,3,0,3.0,0.0,3.0,1,1,2,0,0,0,0,0,0,2020-12-27 19:15:002020-12-27 19:15:002020-12-27 19:15:002020-12-27 19:15:00
1982,4373,Hayden Mullins,1941,[2009],Portsmouth FC,9,6,3,522,0,0,9,9,0,795,0,0,18,15,3,1317,0,0,0.0,0.0,0.0,0,0,0,0,0,0,0,0,0,2020-12-27 19:15:00
1983,8749,Heiðar Helguson,1759,"[2005, 2006]",Fulham FC,29,14,15,1394,6,0,26,16,10,1345,5,0,55,30,25,2739,11,0,3.0,0.0,3.0,5,3,8,3,1,4,0,0,0,2020-12-27 19:15:002020-12-27 19:15:00
1984,8753,Heiðar Helguson,1759,"[2007, 2008]",Bolton Wanderers,2,0,2,39,0,0,5,3,2,258,2,0,7,3,4,297,2,0,0.0,0.0,0.0,0,1,1,0,0,0,0,0,0,2020-12-27 19:15:002020-12-27 19:15:00
1985,4378,Heiðar Helguson,1759,[2011],Queens Park Rangers,10,8,2,714,6,0,6,5,1,440,2,0,16,13,3,1154,8,0,3.0,0.0,3.0,5,1,6,2,0,2,0,0,0,2020-12-27 19:15:00
1986,13140,Hendry Thomas,2058,"[2009, 2010, 2011]",Wigan Athletic,27,24,3,2077,0,0,27,24,3,2080,0,0,54,48,6,4157,0,0,0.0,0.0,0.0,0,0,0,0,0,0,0,0,0,2020-12-27 19:15:002020-12-27 19:15:002020-12-27 19:15:00
1987,4382,Henning Berg,1346,[2000],Manchester United,0,0,0,0,0,0,1,0,1,45,0,0,1,0,1,45,0,0,0.0,0.0,0.0,0,0,0,0,0,0,0,0,0,2020-12-27 19:15:00
1988,8767,Henning Berg,1346,"[2001, 2002]",Blackburn Rovers,24,24,0,2016,1,0,22,21,1,1887,1,0,46,45,1,3903,2,0,0.0,0.0,0.0,0,1,1,0,0,0,0,0,0,2020-12-27 19:15:002020-12-27 19:15:00
1989,4385,Henri Camara,1818,[2003],Wolverhampton Wanderers,15,15,0,1337,5,0,15,14,1,1252,2,0,30,29,1,2589,7,0,3.0,0.0,3.0,3,2,5,0,0,0,0,0,0,2020-12-27 19:15:00
1990,4386,Henri Camara,1818,[2004],Southampton FC,6,4,2,361,2,0,5,4,1,368,2,0,11,8,3,729,4,0,3.0,0.0,3.0,2,0,2,0,0,0,0,0,0,2020-12-27 19:15:00
1991,13165,Henri Camara,1818,"[2005, 2006, 2008]",Wigan Athletic,37,25,12,2334,15,0,32,21,11,2017,5,0,69,46,23,4351,20,0,4.0,6.0,10.0,8,4,12,0,1,1,0,0,0,2020-12-27 19:15:002020-12-27 19:15:002020-12-27 19:15:00
1992,4389,Henri Camara,1818,[2007],West Ham United,5,1,4,177,0,0,5,2,3,159,0,0,10,3,7,336,0,0,0.0,0.0,0.0,0,0,0,0,0,0,0,0,0,2020-12-27 19:15:00
1993,8783,Henri Lansbury,2851,"[2009, 2011]",Arsenal FC,2,0,2,32,0,0,0,0,0,0,0,0,2,0,2,32,0,0,0.0,0.0,0.0,0,0,0,0,0,0,0,0,0,2020-12-27 19:15:002020-12-27 19:15:00
1994,4393,Henri Lansbury,2851,[2019],Aston Villa,4,0,4,14,0,0,6,2,4,178,0,0,10,2,8,192,0,0,0.0,0.0,0.0,0,0,0,0,0,0,0,0,0,2020-12-27 19:15:00
1995,8789,Henri Saivet,4133,"[2015, 2017]",Newcastle United,2,0,2,34,0,0,3,3,0,198,1,0,5,3,2,232,1,0,0.0,0.0,0.0,0,1,1,0,0,0,0,0,0,2020-12-27 19:15:002020-12-27 19:15:00
1996,4396,Henrik Larsson,4229,[2006],Manchester United,3,1,2,131,1,0,4,4,0,328,0,0,7,5,2,459,1,0,0.0,0.0,0.0,0,0,0,0,0,0,0,0,0,2020-12-27 19:15:00
1997,26397,Henrik Pedersen,1722,"[2001, 2002, 2003, 2004, 2005, 2006]",Bolton Wanderers,70,47,23,4299,11,0,72,45,27,4110,11,0,142,92,50,8409,22,0,4.0,4.0,8.0,7,8,15,0,0,0,0,0,0,2020-12-27 19:15:002020-12-27 19:15:002020-12-27 19:15:002020-12-27 19:15:002020-12-27 19:15:002020-12-27 19:15:00
1998,4403,Henrikh Mkhitaryan,2572,[2016],Manchester United,12,7,5,638,2,0,12,8,4,712,2,0,24,15,9,1350,4,0,3.0,0.0,3.0,1,1,2,0,0,0,0,0,0,2020-12-27 19:15:00
1999,13215,Henrikh Mkhitaryan,2572,"[2017, 2018, 2019]",Arsenal FC,17,12,5,1035,4,0,22,17,5,1515,4,0,39,29,10,2550,8,0,1.0,0.0,1.0,1,3,4,0,0,0,0,0,0,2020-12-27 19:15:002020-12-27 19:15:002020-12-27 19:15:00
2000,8815,Hermann Hreiðarsson,1953,"[2000, 2001]",Ipswich Town,37,37,0,3289,1,0,35,34,1,3059,1,0,72,71,1,6348,2,0,0.0,0.0,0.0,1,0,1,0,0,0,0,0,0,2020-12-27 19:15:002020-12-27 19:15:00
2001,17642,Hermann Hreiðarsson,1953,"[2003, 2004, 2005, 2006]",Charlton Athletic,67,65,2,5816,2,0,63,63,0,5647,1,0,130,128,2,11463,3,0,0.0,3.0,3.0,1,1,2,0,0,0,0,0,0,2020-12-27 19:15:002020-12-27 19:15:002020-12-27 19:15:002020-12-27 19:15:00
2002,13242,Hermann Hreiðarsson,1953,"[2007, 2008, 2009]",Portsmouth FC,35,32,3,2790,5,0,36,33,3,2865,1,0,71,65,6,5655,6,0,0.0,0.0,0.0,4,0,4,0,0,0,0,0,0,2020-12-27 19:15:002020-12-27 19:15:002020-12-27 19:15:00
2003,8833,Hernán Crespo,2372,"[2003, 2005]",Chelsea FC,23,18,5,1350,7,0,26,15,11,1475,13,0,49,33,16,2825,20,0,3.0,9.0,12.0,4,9,13,0,0,0,0,0,0,2020-12-27 19:15:002020-12-27 19:15:00
2004,26523,Heung-min Son,1859,"[2015, 2016, 2017, 2018, 2019, 2020]",Tottenham Hotspur,88,67,21,5817,33,0,87,62,25,5581,31,0,175,129,46,11398,64,0,13.0,11.0,24.0,16,18,34,0,0,0,0,0,0,2020-12-27 19:15:002020-12-27 19:15:002020-12-27 19:15:002020-12-27 19:15:002020-12-27 19:15:002020-12-27 19:15:00
2005,4424,Hidetoshi Nakata,3692,[2005],Bolton Wanderers,10,7,3,626,1,0,11,7,4,725,0,0,21,14,7,1351,1,0,0.0,0.0,0.0,1,0,1,0,0,0,0,0,0,2020-12-27 19:15:00
2006,4425,Hierro,3260,[2004],Bolton Wanderers,13,6,7,601,0,0,14,8,6,737,1,0,27,14,13,1338,1,0,0.0,0.0,0.0,0,1,1,0,0,0,0,0,0,2020-12-27 19:15:00
2007,35436,Hilário,2709,"[2006, 2007, 2008, 2009, 2010, 2011, 2012, 2013]",Chelsea FC,12,12,0,1080,0,0,8,6,2,605,0,0,20,18,2,1685,0,0,0.0,0.0,0.0,0,0,0,0,0,0,0,0,0,2020-12-27 19:15:002020-12-27 19:15:002020-12-27 19:15:002020-12-27 19:15:002020-12-27 19:15:002020-12-27 19:15:002020-12-27 19:15:002020-12-27 19:15:00
2008,17742,Hiram Boateng,3611,"[2013, 2014, 2015, 2016]",Crystal Palace,0,0,0,0,0,0,1,0,1,18,0,0,1,0,1,18,0,0,0.0,0.0,0.0,0,0,0,0,0,0,0,0,0,2020-12-27 19:15:002020-12-27 19:15:002020-12-27 19:15:002020-12-27 19:15:00
2009,8877,Hogan Ephraim,3652,"[2011, 2012]",Queens Park Rangers,0,0,0,0,0,0,2,0,2,41,0,0,2,0,2,41,0,0,0.0,0.0,0.0,0,0,0,0,0,0,0,0,0,2020-12-27 19:15:002020-12-27 19:15:00
2010,4440,Hope Akpan,3746,[2012],Reading FC,5,4,1,251,0,0,4,2,2,220,0,0,9,6,3,471,0,0,0.0,0.0,0.0,0,0,0,0,0,0,0,0,0,2020-12-27 19:15:00
2011,8883,Horacio Carbonari,3372,"[2000, 2001]",Derby County,16,16,0,1385,1,0,12,12,0,1035,0,0,28,28,0,2420,1,0,0.0,0.0,0.0,1,0,1,0,0,0,0,0,0,2020-12-27 19:15:002020-12-27 19:15:00
2012,4443,Hossam Ghaly,1396,[2006],Tottenham Hotspur,9,5,4,538,1,0,11,11,0,824,0,0,20,16,4,1362,1,0,0.0,0.0,0.0,0,0,0,0,0,0,0,0,0,2020-12-27 19:15:00
2013,4444,Hossam Ghaly,1396,[2007],Derby County,7,6,1,538,0,0,8,7,1,569,0,0,15,13,2,1107,0,0,0.0,0.0,0.0,0,0,0,0,0,0,0,0,0,2020-12-27 19:15:00
2014,40041,Hugo Lloris,1160,"[2012, 2013, 2014, 2015, 2016, 2017, 2018, 2019, 2020]",Tottenham Hotspur,140,140,0,12514,0,0,135,135,0,12013,0,0,275,275,0,24527,0,0,0.0,0.0,0.0,0,0,0,0,0,0,0,0,0,2020-12-27 19:15:002020-12-27 19:15:002020-12-27 19:15:002020-12-27 19:15:002020-12-27 19:15:002020-12-27 19:15:002020-12-27 19:15:002020-12-27 19:15:002020-12-27 19:15:00
2015,17822,Hugo Rodallega,2061,"[2008, 2009, 2010, 2011]",Wigan Athletic,57,45,12,4295,14,0,54,46,8,4228,10,0,111,91,20,8523,24,0,17.0,6.0,23.0,12,9,21,1,0,1,0,0,0,2020-12-27 19:15:002020-12-27 19:15:002020-12-27 19:15:002020-12-27 19:15:00
2016,8917,Hugo Rodallega,2061,"[2012, 2013]",Fulham FC,18,10,8,1118,3,0,24,10,14,1008,2,0,42,20,22,2126,5,0,6.0,3.0,9.0,3,2,5,0,0,0,0,0,0,2020-12-27 19:15:002020-12-27 19:15:00
2017,8921,Hugo Viana,2374,"[2002, 2003]",Newcastle United,22,8,14,895,1,0,17,8,9,738,1,0,39,16,23,1633,2,0,3.0,1.0,4.0,1,1,2,0,0,0,0,0,0,2020-12-27 19:15:002020-12-27 19:15:00
2018,8925,Hámilton Ricard,2073,"[2000, 2001]",Middlesbrough FC,16,13,3,1075,1,0,19,14,5,1120,3,0,35,27,8,2195,4,0,0.0,0.0,0.0,0,2,2,1,0,1,0,0,0,2020-12-27 19:15:002020-12-27 19:15:00
2019,4464,Håvard Nordtveit,2641,[2016],West Ham United,7,5,2,423,0,0,9,6,3,533,0,0,16,11,5,956,0,0,0.0,0.0,0.0,0,0,0,0,0,0,0,0,0,2020-12-27 19:15:00
2020,4465,Håvard Nordtveit,2641,[2018],Fulham FC,1,1,0,90,0,0,4,3,1,271,0,0,5,4,1,361,0,0,0.0,0.0,0.0,0,0,0,0,0,0,0,0,0,2020-12-27 19:15:00
2021,35756,Héctor Bellerín,1499,"[2013, 2014, 2015, 2016, 2017, 2018, 2019, 2020]",Arsenal FC,86,81,5,7370,5,0,84,76,8,6726,2,0,170,157,13,14096,7,0,1.0,1.0,2.0,3,2,5,0,0,0,0,0,0,2020-12-27 19:15:002020-12-27 19:15:002020-12-27 19:15:002020-12-27 19:15:002020-12-27 19:15:002020-12-27 19:15:002020-12-27 19:15:002020-12-27 19:15:00
2022,4474,Hélder Costa,2149,[2018],Wolverhampton Wanderers,11,8,3,658,0,0,14,8,6,688,1,0,25,16,9,1346,1,0,0.0,0.0,0.0,0,0,0,0,0,0,0,0,0,2020-12-27 19:15:00
2023,4475,Hélder Costa,2149,[2020],Leeds United,5,4,1,385,2,0,5,4,1,286,0,0,10,8,2,671,2,0,0.0,0.0,0.0,1,0,1,0,0,0,1,0,1,2020-12-27 19:15:00
2024,4476,Hélder Postiga,2793,[2003],Tottenham Hotspur,11,4,7,472,1,0,8,5,3,427,0,0,19,9,10,899,1,0,0.0,0.0,0.0,0,0,0,0,0,0,0,0,0,2020-12-27 19:15:00
2025,13434,Hérita Ilunga,1280,"[2008, 2009, 2010]",West Ham United,32,31,1,2616,0,0,29,29,0,2493,0,0,61,60,1,5109,0,0,0.0,0.0,0.0,0,0,0,0,0,0,0,0,0,2020-12-27 19:15:002020-12-27 19:15:002020-12-27 19:15:00
2026,4480,Hérold Goulon,3589,[2010],Blackburn Rovers,2,0,2,24,0,0,2,1,1,34,0,0,4,1,3,58,0,0,0.0,0.0,0.0,0,0,0,0,0,0,0,0,0,2020-12-27 19:15:00
2027,4481,Iago Aspas,1433,[2013],Liverpool FC,8,4,4,255,0,0,6,1,5,123,0,0,14,5,9,378,0,0,0.0,0.0,0.0,0,0,0,0,0,0,0,0,0,2020-12-27 19:15:00
2028,8965,Iago Falqué,3477,"[2011, 2012]",Tottenham Hotspur,0,0,0,0,0,0,1,0,1,5,0,0,1,0,1,5,0,0,0.0,0.0,0.0,0,0,0,0,0,0,0,0,0,2020-12-27 19:15:002020-12-27 19:15:00
2029,8969,Iain Turner,3933,"[2005, 2006]",Everton FC,3,3,0,270,0,0,1,0,1,36,0,0,4,3,1,306,0,0,0.0,0.0,0.0,0,0,0,0,0,0,0,0,0,2020-12-27 19:15:002020-12-27 19:15:00
2030,4486,Ian Ashbee,2323,[2008],Hull City,16,16,0,1440,1,0,15,15,0,1254,0,0,31,31,0,2694,1,0,0.0,0.0,0.0,0,0,0,0,0,0,0,0,0,2020-12-27 19:15:00
2031,8975,Ian Bennett,2580,"[2002, 2003]",Birmingham City,7,7,0,630,0,0,9,7,2,731,0,0,16,14,2,1361,0,0,0.0,0.0,0.0,0,0,0,0,0,0,0,0,0,2020-12-27 19:15:002020-12-27 19:15:00
2032,4489,Ian Bennett,2580,[2006],Sheffield United,1,1,0,90,0,0,1,1,0,90,0,0,2,2,0,180,0,0,0.0,0.0,0.0,0,0,0,0,0,0,0,0,0,2020-12-27 19:15:00
2033,4490,Ian Bishop,3876,[2000],Manchester City,8,2,6,392,0,0,2,1,1,133,0,0,10,3,7,525,0,0,0.0,0.0,0.0,0,0,0,0,0,0,0,0,0,2020-12-27 19:15:00
2034,8983,Ian Evatt,2608,"[2000, 2001]",Derby County,3,0,3,90,0,0,1,1,0,90,0,0,4,1,3,180,0,0,0.0,0.0,0.0,0,0,0,0,0,0,0,0,0,2020-12-27 19:15:002020-12-27 19:15:00
2035,4493,Ian Evatt,2608,[2010],Blackpool FC,19,18,1,1638,0,0,19,18,1,1635,1,0,38,36,2,3273,1,0,0.0,0.0,0.0,0,1,1,0,0,0,0,0,0,2020-12-27 19:15:00
2036,4494,Ian Feuer,4037,[2001],Derby County,1,1,0,90,0,0,1,1,0,90,0,0,2,2,0,180,0,0,0.0,0.0,0.0,0,0,0,0,0,0,0,0,0,2020-12-27 19:15:00
2037,17986,Ian Harte,1291,"[2000, 2001, 2002, 2003]",Leeds United,49,46,3,4208,8,0,51,47,4,4323,8,0,100,93,7,8531,16,0,0.0,3.0,3.0,3,6,9,2,3,5,0,0,0,2020-12-27 19:15:002020-12-27 19:15:002020-12-27 19:15:002020-12-27 19:15:00
2038,4499,Ian Harte,1291,[2007],Sunderland AFC,3,1,2,114,0,0,5,2,3,194,0,0,8,3,5,308,0,0,0.0,0.0,0.0,0,0,0,0,0,0,0,0,0,2020-12-27 19:15:00
2039,4500,Ian Harte,1291,[2012],Reading FC,10,9,1,824,0,0,6,6,0,537,0,0,16,15,1,1361,0,0,0.0,0.0,0.0,0,0,0,0,0,0,0,0,0,2020-12-27 19:15:00
2040,4501,Ian Henderson,3681,[2004],Norwich City,2,0,2,45,0,0,1,0,1,9,0,0,3,0,3,54,0,0,0.0,0.0,0.0,0,0,0,0,0,0,0,0,0,2020-12-27 19:15:00
2041,4502,Ian Marshall,3958,[2001],Bolton Wanderers,0,0,0,0,0,0,1,0,1,14,0,0,1,0,1,14,0,0,0.0,0.0,0.0,0,0,0,0,0,0,0,0,0,2020-12-27 19:15:00
2042,4503,Ian Nolan,3060,[2000],Bradford City,10,7,3,699,0,0,10,9,1,806,0,0,20,16,4,1505,0,0,0.0,0.0,0.0,0,0,0,0,0,0,0,0,0,2020-12-27 19:15:00
2043,13515,Ian Pearce,1082,"[2000, 2001, 2002]",West Ham United,21,17,4,1570,3,0,26,23,3,2085,2,0,47,40,7,3655,5,0,3.0,1.0,4.0,2,2,4,0,0,0,0,0,0,2020-12-27 19:15:002020-12-27 19:15:002020-12-27 19:15:00
2044,22545,Ian Pearce,1082,"[2003, 2004, 2005, 2006, 2007]",Fulham FC,27,26,1,2254,1,0,28,27,1,2299,0,0,55,53,2,4553,1,0,1.0,0.0,1.0,1,0,1,0,0,0,0,0,0,2020-12-27 19:15:002020-12-27 19:15:002020-12-27 19:15:002020-12-27 19:15:002020-12-27 19:15:00
2045,4512,Ian Poveda,1073,[2020],Leeds United,5,0,5,137,0,0,3,0,3,62,0,0,8,0,8,199,0,0,0.0,0.0,0.0,0,0,0,0,0,0,0,0,0,2020-12-27 19:15:00
2046,13542,Ian Taylor,2767,"[2000, 2001, 2002]",Aston Villa,28,19,9,1881,5,0,28,21,7,2007,2,0,56,40,16,3888,7,0,3.0,0.0,3.0,3,2,5,0,0,0,0,0,0,2020-12-27 19:15:002020-12-27 19:15:002020-12-27 19:15:00
2047,4516,Ian Walker,2646,[2000],West Ham United,1,1,0,90,0,0,0,0,0,0,0,0,1,1,0,90,0,0,0.0,0.0,0.0,0,0,0,0,0,0,0,0,0,2020-12-27 19:15:00
2048,9035,Ian Walker,2646,"[2001, 2003]",Leicester City,36,36,0,3148,0,0,35,35,0,3138,0,0,71,71,0,6286,0,0,0.0,0.0,0.0,0,0,0,0,0,0,0,0,0,2020-12-27 19:15:002020-12-27 19:15:00
2049,9039,Iborra,2570,"[2017, 2018]",Leicester City,12,11,1,827,0,0,15,9,6,815,3,0,27,20,7,1642,3,0,0.0,0.0,0.0,0,2,2,0,0,0,0,0,0,2020-12-27 19:15:002020-12-27 19:15:00
2050,13566,Ibrahim Afellay,1907,"[2015, 2016, 2017]",Stoke City,23,14,9,1330,1,0,26,14,12,1379,1,0,49,28,21,2709,2,0,0.0,0.0,0.0,1,0,1,0,0,0,0,0,0,2020-12-27 19:15:002020-12-27 19:15:002020-12-27 19:15:00
2051,4524,Ibrahim Amadou,1829,[2019],Norwich City,4,4,0,360,0,0,7,4,3,397,0,0,11,8,3,757,0,0,0.0,0.0,0.0,0,0,0,0,0,0,0,0,0,2020-12-27 19:15:00
2052,4525,Ibrahim Ba,3569,[2003],Bolton Wanderers,5,0,5,125,0,0,4,0,4,141,0,0,9,0,9,266,0,0,0.0,0.0,0.0,0,0,0,0,0,0,0,0,0,2020-12-27 19:15:00
2053,4526,Ibrahima Cissé,4137,[2018],Fulham FC,1,0,1,9,0,0,2,1,1,78,0,0,3,1,2,87,0,0,0.0,0.0,0.0,0,0,0,0,0,0,0,0,0,2020-12-27 19:15:00
2054,4527,Ibrahima Diallo,1013,[2020],Southampton FC,3,0,3,9,0,0,4,1,3,105,0,0,7,1,6,114,0,0,0.0,0.0,0.0,0,0,0,0,0,0,0,0,0,2020-12-27 19:15:00
2055,9057,Ibrahima Sonko,1609,"[2006, 2007]",Reading FC,20,19,1,1635,0,0,17,17,0,1513,1,0,37,36,1,3148,1,0,0.0,0.0,0.0,0,1,1,0,0,0,0,0,0,2020-12-27 19:15:002020-12-27 19:15:00
2056,4530,Ibrahima Sonko,1609,[2008],Stoke City,7,3,4,290,0,0,7,4,3,408,0,0,14,7,7,698,0,0,0.0,0.0,0.0,0,0,0,0,0,0,0,0,0,2020-12-27 19:15:00
2057,4531,Ibrahima Sonko,1609,[2009],Hull City,5,5,0,450,0,0,4,4,0,360,0,0,9,9,0,810,0,0,0.0,0.0,0.0,0,0,0,0,0,0,0,0,0,2020-12-27 19:15:00
2058,9065,Idan Tal,1721,"[2000, 2001]",Everton FC,13,4,9,538,2,0,16,9,7,768,0,0,29,13,16,1306,2,0,1.0,0.0,1.0,2,0,2,0,0,0,0,0,0,2020-12-27 19:15:002020-12-27 19:15:00
2059,4534,Idan Tal,1721,[2006],Bolton Wanderers,8,1,7,174,0,0,9,4,5,465,0,0,17,5,12,639,0,0,0.0,0.0,0.0,0,0,0,0,0,0,0,0,0,2020-12-27 19:15:00
2060,4535,Idrissa Gueye,1054,[2015],Aston Villa,18,18,0,1592,0,0,17,17,0,1484,0,0,35,35,0,3076,0,0,0.0,0.0,0.0,0,0,0,0,0,0,0,0,0,2020-12-27 19:15:00
2061,13611,Idrissa Gueye,1054,"[2016, 2017, 2018]",Everton FC,48,46,2,4056,1,0,51,50,1,4236,2,0,99,96,3,8292,3,0,0.0,0.0,0.0,1,1,2,0,0,0,0,0,0,2020-12-27 19:15:002020-12-27 19:15:002020-12-27 19:15:00
2062,4539,Ifeanyi Udeze,3078,[2002],West Bromwich Albion,8,5,3,392,0,0,2,2,0,115,0,0,10,7,3,507,0,0,0.0,0.0,0.0,0,0,0,0,0,0,0,0,0,2020-12-27 19:15:00
2063,4540,Ignacio González,3948,[2008],Newcastle United,1,0,1,29,0,0,1,0,1,10,0,0,2,0,2,39,0,0,0.0,0.0,0.0,0,0,0,0,0,0,0,0,0,2020-12-27 19:15:00
2064,4541,Ignacio Pussetto,3556,[2019],Watford FC,4,0,4,28,0,0,3,0,3,39,0,0,7,0,7,67,0,0,0.0,0.0,0.0,0,0,0,0,0,0,0,0,0,2020-12-27 19:15:00
2065,4542,Ignacio Scocco,2267,[2013],Sunderland AFC,2,0,2,18,0,0,4,0,4,75,0,0,6,0,6,93,0,0,0.0,0.0,0.0,0,0,0,0,0,0,0,0,0,2020-12-27 19:15:00
2066,13632,Ignasi Miquel,3275,"[2010, 2011, 2012]",Arsenal FC,2,0,2,82,0,0,3,1,2,136,0,0,5,1,4,218,0,0,0.0,0.0,0.0,0,0,0,0,0,0,0,0,0,2020-12-27 19:15:002020-12-27 19:15:002020-12-27 19:15:00
2067,4546,Igor Bališ,3376,[2002],West Bromwich Albion,14,13,1,1149,1,0,13,13,0,1084,1,0,27,26,1,2233,2,0,0.0,0.0,0.0,1,1,2,1,0,1,0,0,0,2020-12-27 19:15:00
2068,22745,Igor Bišćan,2365,"[2000, 2001, 2002, 2003, 2004]",Liverpool FC,33,21,12,1874,1,0,38,28,10,2313,1,0,71,49,22,4187,2,0,3.0,0.0,3.0,1,0,1,0,0,0,0,0,0,2020-12-27 19:15:002020-12-27 19:15:002020-12-27 19:15:002020-12-27 19:15:002020-12-27 19:15:00
2069,4552,Igor Štimac,3778,[2000],West Ham United,5,5,0,367,0,0,9,9,0,795,0,0,14,14,0,1162,0,0,0.0,0.0,0.0,0,0,0,0,0,0,0,0,0,2020-12-27 19:15:00
2070,13662,Igors Stepanovs,3330,"[2000, 2001, 2002]",Arsenal FC,9,9,0,810,0,0,8,8,0,675,0,0,17,17,0,1485,0,0,0.0,0.0,0.0,0,0,0,0,0,0,0,0,0,2020-12-27 19:15:002020-12-27 19:15:002020-12-27 19:15:00
2071,9113,Ikechi Anya,3184,"[2015, 2016]",Watford FC,13,10,3,889,0,0,16,7,9,800,0,0,29,17,12,1689,0,0,0.0,0.0,0.0,0,0,0,0,0,0,0,0,0,2020-12-27 19:15:002020-12-27 19:15:00
2072,4558,Ilan,4135,[2009],West Ham United,6,3,3,316,2,0,5,3,2,260,2,0,11,6,5,576,4,0,3.0,1.0,4.0,2,1,3,0,0,0,0,0,0,2020-12-27 19:15:00
2073,4559,Illan Meslier,1061,[2020],Leeds United,8,8,0,720,0,0,7,7,0,630,0,0,15,15,0,1350,0,0,0.0,0.0,0.0,0,0,0,0,0,0,0,0,0,2020-12-27 19:15:00
2074,9121,Imants Bleidelis,4336,"[2000, 2001]",Southampton FC,2,0,2,7,0,0,0,0,0,0,0,0,2,0,2,7,0,0,0.0,0.0,0.0,0,0,0,0,0,0,0,0,0,2020-12-27 19:15:002020-12-27 19:15:00
2075,4562,Indiana Vassilev,2857,[2019],Aston Villa,2,0,2,19,0,0,2,0,2,28,0,0,4,0,4,47,0,0,0.0,0.0,0.0,0,0,0,0,0,0,0,0,0,2020-12-27 19:15:00
2076,4563,Ionel Ganea,3922,[2003],Wolverhampton Wanderers,8,3,5,298,1,0,8,3,5,341,2,0,16,6,10,639,3,0,0.0,1.0,1.0,1,2,3,0,0,0,0,0,0,2020-12-27 19:15:00
2077,4564,Isaac Hayden,2470,[2013],Arsenal FC,0,0,0,0,0,0,0,0,0,0,0,0,0,0,0,0,0,0,0.0,0.0,0.0,0,0,0,0,0,0,0,0,0,2020-12-27 19:15:00
2078,18266,Isaac Hayden,2470,"[2017, 2018, 2019, 2020]",Newcastle United,45,37,8,3238,1,0,46,34,12,3116,2,0,91,71,20,6354,3,0,3.0,0.0,3.0,1,2,3,0,0,0,0,0,0,2020-12-27 19:15:002020-12-27 19:15:002020-12-27 19:15:002020-12-27 19:15:00
2079,4569,Isaac Mbenza,3398,[2018],Huddersfield Town,13,5,8,589,1,0,9,5,4,393,0,0,22,10,12,982,1,0,1.0,0.0,1.0,1,0,1,0,0,0,0,0,0,2020-12-27 19:15:00
2080,4570,Isaac Okoronkwo,3075,[2003],Wolverhampton Wanderers,4,4,0,360,0,0,3,3,0,270,0,0,7,7,0,630,0,0,0.0,0.0,0.0,0,0,0,0,0,0,0,0,0,2020-12-27 19:15:00
2081,18290,Isaac Success,2331,"[2016, 2017, 2018, 2019]",Watford FC,27,3,24,643,2,0,27,8,19,965,0,0,54,11,43,1608,2,0,1.0,0.0,1.0,1,0,1,0,0,0,0,0,0,2020-12-27 19:15:002020-12-27 19:15:002020-12-27 19:15:002020-12-27 19:15:00
2082,13728,Isaiah Osbourne,2708,"[2006, 2007, 2010]",Aston Villa,6,1,5,185,0,0,13,6,7,625,0,0,19,7,12,810,0,0,0.0,0.0,0.0,0,0,0,0,0,0,0,0,0,2020-12-27 19:15:002020-12-27 19:15:002020-12-27 19:15:00
2083,4578,Isaiah Rankin,2842,[2000],Bradford City,0,0,0,0,0,0,1,0,1,3,0,0,1,0,1,3,0,0,0.0,0.0,0.0,0,0,0,0,0,0,0,0,0,2020-12-27 19:15:00
2084,9159,Ishmael Miller,1813,"[2005, 2006]",Manchester City,10,2,8,338,0,0,7,1,6,153,0,0,17,3,14,491,0,0,0.0,0.0,0.0,0,0,0,0,0,0,0,0,0,2020-12-27 19:15:002020-12-27 19:15:00
2085,9163,Ishmael Miller,1813,"[2008, 2010]",West Bromwich Albion,8,6,2,513,1,0,13,5,8,619,2,0,21,11,10,1132,3,0,0.0,0.0,0.0,1,1,2,0,0,0,0,0,0,2020-12-27 19:15:002020-12-27 19:15:00
2086,4583,Ishmel Demontagnac,4259,[2010],Blackpool FC,0,0,0,0,0,0,1,0,1,33,0,0,1,0,1,33,0,0,0.0,0.0,0.0,0,0,0,0,0,0,0,0,0,2020-12-27 19:15:00
2087,13755,Islam Slimani,2667,"[2016, 2017, 2020]",Leicester City,22,10,12,1018,7,0,14,5,9,520,1,0,36,15,21,1538,8,0,4.0,0.0,4.0,5,1,6,1,0,1,0,0,0,2020-12-27 19:15:002020-12-27 19:15:002020-12-27 19:15:00
2088,4587,Ismaïla Sarr,3555,[2019],Watford FC,15,11,4,1066,4,0,13,11,2,964,1,0,28,22,6,2030,5,0,0.0,0.0,0.0,2,1,3,0,0,0,0,0,0,2020-12-27 19:15:00
2089,13767,Issa Diop,2213,"[2018, 2019, 2020]",West Ham United,37,36,1,3241,3,0,32,31,1,2792,1,0,69,67,2,6033,4,0,0.0,0.0,0.0,3,1,4,0,0,0,0,0,0,2020-12-27 19:15:002020-12-27 19:15:002020-12-27 19:15:00
2090,4591,Itay Shechter,3703,[2012],Swansea City,8,2,6,201,0,0,10,5,5,422,1,0,18,7,11,623,1,0,0.0,0.0,0.0,0,1,1,0,0,0,0,0,0,2020-12-27 19:15:00
2091,4592,Ivan Cavaleiro,2151,[2018],Wolverhampton Wanderers,13,3,10,331,2,0,10,3,7,351,1,0,23,6,17,682,3,0,0.0,0.0,0.0,1,1,2,0,0,0,0,0,0,2020-12-27 19:15:00
2092,4593,Ivan Cavaleiro,2151,[2020],Fulham FC,7,6,1,545,0,0,6,5,1,425,1,0,13,11,2,970,1,0,0.0,0.0,0.0,0,0,0,0,1,1,0,0,0,2020-12-27 19:15:00
2093,13785,Ivan Klasnić,2496,"[2009, 2010, 2011]",Bolton Wanderers,42,15,27,1654,15,0,36,13,23,1411,5,0,78,28,50,3065,20,0,12.0,0.0,12.0,11,3,14,1,1,2,0,0,0,2020-12-27 19:15:002020-12-27 19:15:002020-12-27 19:15:00
2094,4597,Ivan Toney,4169,[2015],Newcastle United,2,0,2,10,0,0,0,0,0,0,0,0,2,0,2,10,0,0,0.0,0.0,0.0,0,0,0,0,0,0,0,0,0,2020-12-27 19:15:00
2095,9197,Ivica Mornar,3566,"[2003, 2005]",Portsmouth FC,5,3,2,209,0,0,5,1,4,197,1,0,10,4,6,406,1,0,0.0,0.0,0.0,0,1,1,0,0,0,0,0,0,2020-12-27 19:15:002020-12-27 19:15:00
2096,4600,Ivo Pinto,3989,[2015],Norwich City,5,5,0,450,0,0,5,4,1,361,0,0,10,9,1,811,0,0,0.0,0.0,0.0,0,0,0,0,0,0,0,0,0,2020-12-27 19:15:00
2097,27621,Iván Campo,1713,"[2002, 2003, 2004, 2005, 2006, 2007]",Bolton Wanderers,83,77,6,6739,8,0,86,70,16,6414,5,0,169,147,22,13153,13,0,1.0,3.0,4.0,5,2,7,0,0,0,0,0,0,2020-12-27 19:15:002020-12-27 19:15:002020-12-27 19:15:002020-12-27 19:15:002020-12-27 19:15:002020-12-27 19:15:00
2098,4607,Iván Guerrero,4176,[2000],Coventry City,1,1,0,90,0,0,2,2,0,137,0,0,3,3,0,227,0,0,0.0,0.0,0.0,0,0,0,0,0,0,0,0,0,2020-12-27 19:15:00
2099,4608,Iván Kaviedes,2971,[2004],Crystal Palace,3,1,2,96,0,0,1,0,1,6,0,0,4,1,3,102,0,0,0.0,0.0,0.0,0,0,0,0,0,0,0,0,0,2020-12-27 19:15:00
2100,4609,Iván Ramis,4044,[2012],Wigan Athletic,8,8,0,679,1,0,8,8,0,720,1,0,16,16,0,1399,2,0,0.0,0.0,0.0,1,1,2,0,0,0,0,0,0,2020-12-27 19:15:00
2101,4610,Izzy Brown,2659,[2012],West Bromwich Albion,1,0,1,4,0,0,0,0,0,0,0,0,1,0,1,4,0,0,0.0,0.0,0.0,0,0,0,0,0,0,0,0,0,2020-12-27 19:15:00
2102,4611,Izzy Brown,2659,[2014],Chelsea FC,0,0,0,0,0,0,1,0,1,11,0,0,1,0,1,11,0,0,0.0,0.0,0.0,0,0,0,0,0,0,0,0,0,2020-12-27 19:15:00
2103,4612,Izzy Brown,2659,[2017],Brighton & Hove Albion,8,2,6,136,0,0,5,2,3,170,0,0,13,4,9,306,0,0,0.0,0.0,0.0,0,0,0,0,0,0,0,0,0,2020-12-27 19:15:00
2104,9227,Jaap Stam,1107,"[2000, 2001]",Manchester United,9,9,0,765,0,0,6,6,0,470,0,0,15,15,0,1235,0,0,0.0,0.0,0.0,0,0,0,0,0,0,0,0,0,2020-12-27 19:15:002020-12-27 19:15:00
2105,23085,Jack Butland,1901,"[2013, 2014, 2015, 2016, 2017]",Stoke City,37,36,1,3284,0,0,39,39,0,3510,0,0,76,75,1,6794,0,0,0.0,0.0,0.0,0,0,0,0,0,0,0,0,0,2020-12-27 19:15:002020-12-27 19:15:002020-12-27 19:15:002020-12-27 19:15:002020-12-27 19:15:00
2106,4620,Jack Butland,1901,[2020],Crystal Palace,0,0,0,0,0,0,0,0,0,0,0,0,0,0,0,0,0,0,0.0,0.0,0.0,0,0,0,0,0,0,0,0,0,2020-12-27 19:15:00
2107,23115,Jack Colback,1404,"[2009, 2010, 2011, 2012, 2013]",Sunderland AFC,57,48,9,4457,2,0,58,45,13,4047,2,0,115,93,22,8504,4,0,0.0,1.0,1.0,2,1,3,0,0,0,0,0,0,2020-12-27 19:15:002020-12-27 19:15:002020-12-27 19:15:002020-12-27 19:15:002020-12-27 19:15:00
2108,9253,Jack Colback,1404,"[2014, 2015]",Newcastle United,33,33,0,2884,4,0,31,30,1,2641,1,0,64,63,1,5525,5,0,0.0,1.0,1.0,3,1,4,0,0,0,0,0,0,2020-12-27 19:15:002020-12-27 19:15:00
2109,27783,Jack Collison,1285,"[2007, 2008, 2009, 2010, 2012, 2013]",West Ham United,36,22,14,2007,3,0,37,26,11,2474,4,0,73,48,25,4481,7,0,3.0,3.0,6.0,3,3,6,0,0,0,0,0,0,2020-12-27 19:15:002020-12-27 19:15:002020-12-27 19:15:002020-12-27 19:15:002020-12-27 19:15:002020-12-27 19:15:00
2110,18557,Jack Cork,1701,"[2009, 2017, 2018, 2019]",Burnley FC,58,56,2,5046,3,0,58,57,1,5077,1,0,116,113,3,10123,4,0,0.0,3.0,3.0,3,1,4,0,0,0,0,0,0,2020-12-27 19:15:002020-12-27 19:15:002020-12-27 19:15:002020-12-27 19:15:00
2111,9271,Jack Cork,1701,"[2012, 2013]",Southampton FC,28,25,3,2111,0,0,28,24,4,2057,0,0,56,49,7,4168,0,0,0.0,0.0,0.0,0,0,0,0,0,0,0,0,0,2020-12-27 19:15:002020-12-27 19:15:00
2112,13914,Jack Cork,1701,"[2014, 2015, 2016]",Swansea City,38,32,6,2873,1,0,42,36,6,3229,1,0,80,68,12,6102,2,0,0.0,0.0,0.0,0,0,0,0,0,0,0,0,0,2020-12-27 19:15:002020-12-27 19:15:002020-12-27 19:15:00
2113,27873,Jack Grealish,1870,"[2011, 2013, 2014, 2015, 2019, 2020]",Aston Villa,43,31,12,3047,6,0,40,34,6,3005,8,0,83,65,18,6052,14,0,0.0,1.0,1.0,1,6,7,0,0,0,0,0,0,2020-12-27 19:15:002020-12-27 19:15:002020-12-27 19:15:002020-12-27 19:15:002020-12-27 19:15:002020-12-27 19:15:00
2114,4649,Jack Harrison,1068,[2020],Leeds United,7,7,0,568,1,0,7,7,0,596,1,0,14,14,0,1164,2,0,0.0,0.0,0.0,0,1,1,0,0,0,0,0,0,2020-12-27 19:15:00
2115,4650,Jack Hobbs,3441,[2007],Liverpool FC,1,0,1,39,0,0,1,1,0,90,0,0,2,1,1,129,0,0,0.0,0.0,0.0,0,0,0,0,0,0,0,0,0,2020-12-27 19:15:00
2116,4651,Jack Jenkins,1084,[2020],Leeds United,0,0,0,0,0,0,0,0,0,0,0,0,0,0,0,0,0,0,0.0,0.0,0.0,0,0,0,0,0,0,0,0,0,2020-12-27 19:15:00
2117,9305,Jack O'Connell,3466,"[2019, 2020]",Sheffield United,19,19,0,1710,0,0,16,15,1,1385,0,0,35,34,1,3095,0,0,0.0,0.0,0.0,0,0,0,0,0,0,0,0,0,2020-12-27 19:15:002020-12-27 19:15:00
2118,4654,Jack Price,4388,[2011],Wolverhampton Wanderers,0,0,0,0,0,0,0,0,0,0,0,0,0,0,0,0,0,0,0.0,0.0,0.0,0,0,0,0,0,0,0,0,0,2020-12-27 19:15:00
2119,18626,Jack Robinson,3118,"[2009, 2010, 2011, 2012]",Liverpool FC,1,1,0,79,0,0,2,0,2,71,0,0,3,1,2,150,0,0,0.0,0.0,0.0,0,0,0,0,0,0,0,0,0,2020-12-27 19:15:002020-12-27 19:15:002020-12-27 19:15:002020-12-27 19:15:00
2120,9319,Jack Robinson,3118,"[2019, 2020]",Sheffield United,6,4,2,459,0,0,7,7,0,595,0,0,13,11,2,1054,0,0,0.0,0.0,0.0,0,0,0,0,0,0,0,0,0,2020-12-27 19:15:002020-12-27 19:15:00
2121,23315,Jack Rodwell,1748,"[2007, 2008, 2009, 2010, 2011]",Everton FC,41,21,20,2205,2,0,43,30,13,2717,2,0,84,51,33,4922,4,0,0.0,0.0,0.0,0,0,0,0,0,0,0,0,0,2020-12-27 19:15:002020-12-27 19:15:002020-12-27 19:15:002020-12-27 19:15:002020-12-27 19:15:00
2122,9333,Jack Rodwell,1748,"[2012, 2013]",Manchester City,9,5,4,438,2,0,7,2,5,170,0,0,16,7,9,608,2,0,0.0,0.0,0.0,2,0,2,0,0,0,0,0,0,2020-12-27 19:15:002020-12-27 19:15:00
2123,14007,Jack Rodwell,1748,"[2014, 2015, 2016]",Sunderland AFC,31,19,12,1791,1,0,34,24,10,2344,3,0,65,43,22,4135,4,0,1.0,1.0,2.0,1,2,3,0,0,0,0,0,0,2020-12-27 19:15:002020-12-27 19:15:002020-12-27 19:15:00
2124,4671,Jack Rodwell,1748,[2019],Sheffield United,0,0,0,0,0,0,1,0,1,15,0,0,1,0,1,15,0,0,0.0,0.0,0.0,0,0,0,0,0,0,0,0,0,2020-12-27 19:15:00
2125,14019,Jack Rose,3000,"[2014, 2015, 2016]",West Bromwich Albion,0,0,0,0,0,0,0,0,0,0,0,0,0,0,0,0,0,0,0.0,0.0,0.0,0,0,0,0,0,0,0,0,0,2020-12-27 19:15:002020-12-27 19:15:002020-12-27 19:15:00
2126,14028,Jack Simpson,1045,"[2017, 2018, 2019]",AFC Bournemouth,5,3,2,385,0,0,6,3,3,328,0,0,11,6,5,713,0,0,0.0,0.0,0.0,0,0,0,0,0,0,0,0,0,2020-12-27 19:15:002020-12-27 19:15:002020-12-27 19:15:00
2127,4678,Jack Stacey,3340,[2019],AFC Bournemouth,9,8,1,746,0,0,10,9,1,804,0,0,19,17,2,1550,0,0,0.0,0.0,0.0,0,0,0,0,0,0,0,0,0,2020-12-27 19:15:00
2128,28089,Jack Stephens,2329,"[2014, 2016, 2017, 2018, 2019, 2020]",Southampton FC,46,43,3,3955,2,0,50,44,6,4053,2,0,96,87,9,8008,4,0,1.0,0.0,1.0,2,1,3,0,0,0,0,0,0,2020-12-27 19:15:002020-12-27 19:15:002020-12-27 19:15:002020-12-27 19:15:002020-12-27 19:15:002020-12-27 19:15:00
2129,32823,Jack Wilshere,1694,"[2008, 2010, 2012, 2013, 2014, 2015, 2017]",Arsenal FC,61,52,9,4357,4,0,61,40,21,3807,3,0,122,92,30,8164,7,0,0.0,1.0,1.0,3,2,5,0,0,0,0,0,0,2020-12-27 19:15:002020-12-27 19:15:002020-12-27 19:15:002020-12-27 19:15:002020-12-27 19:15:002020-12-27 19:15:002020-12-27 19:15:00
2130,4686,Jack Wilshere,1694,[2009],Bolton Wanderers,6,6,0,499,0,0,8,7,1,592,1,0,14,13,1,1091,1,0,0.0,0.0,0.0,0,0,0,0,0,0,0,0,0,2020-12-27 19:15:00
2131,4692,Jack Wilshere,1694,[2016],AFC Bournemouth,14,11,3,967,0,0,13,11,2,945,0,0,27,22,5,1912,0,0,0.0,0.0,0.0,0,0,0,0,0,0,0,0,0,2020-12-27 19:15:00
2132,9389,Jack Wilshere,1694,"[2018, 2019]",West Ham United,8,3,5,291,0,0,8,3,5,309,0,0,16,6,10,600,0,0,0.0,0.0,0.0,0,0,0,0,0,0,0,0,0,2020-12-27 19:15:002020-12-27 19:15:00
2133,4696,Jack Young,4114,[2019],Newcastle United,0,0,0,0,0,0,0,0,0,0,0,0,0,0,0,0,0,0,0.0,0.0,0.0,0,0,0,0,0,0,0,0,0,2020-12-27 19:15:00
2134,9395,Jacob Burns,4253,"[2000, 2002]",Leeds United,3,3,0,270,0,0,3,2,1,154,0,0,6,5,1,424,0,0,0.0,0.0,0.0,0,0,0,0,0,0,0,0,0,2020-12-27 19:15:002020-12-27 19:15:00
2135,9399,Jacob Butterfield,4368,"[2012, 2013]",Norwich City,0,0,0,0,0,0,0,0,0,0,0,0,0,0,0,0,0,0,0.0,0.0,0.0,0,0,0,0,0,0,0,0,0,2020-12-27 19:15:002020-12-27 19:15:00
2136,4701,Jacob Laursen,2681,[2001],Leicester City,6,6,0,540,0,0,3,3,0,270,0,0,9,9,0,810,0,0,0.0,0.0,0.0,0,0,0,0,0,0,0,0,0,2020-12-27 19:15:00
2137,4702,Jacob Maddox,4484,[2019],Southampton FC,0,0,0,0,0,0,0,0,0,0,0,0,0,0,0,0,0,0,0.0,0.0,0.0,0,0,0,0,0,0,0,0,0,2020-12-27 19:15:00
2138,4703,Jacob Mellis,4414,[2010],Chelsea FC,0,0,0,0,0,0,0,0,0,0,0,0,0,0,0,0,0,0,0.0,0.0,0.0,0,0,0,0,0,0,0,0,0,2020-12-27 19:15:00
2139,14115,Jacob Murphy,2578,"[2017, 2018, 2020]",Newcastle United,16,8,8,763,0,0,26,14,12,1237,2,0,42,22,20,2000,2,0,0.0,1.0,1.0,0,1,1,0,0,0,0,0,0,2020-12-27 19:15:002020-12-27 19:15:002020-12-27 19:15:00
2140,4707,Jacob Ramsey,1049,[2020],Aston Villa,1,0,1,1,0,0,2,1,1,103,0,0,3,1,2,104,0,0,0.0,0.0,0.0,0,0,0,0,0,0,0,0,0,2020-12-27 19:15:00
2141,4708,Jacopo Sala,4262,[2010],Chelsea FC,0,0,0,0,0,0,0,0,0,0,0,0,0,0,0,0,0,0,0.0,0.0,0.0,0,0,0,0,0,0,0,0,0,2020-12-27 19:15:00
2142,14130,Jak Alnwick,3590,"[2012, 2013, 2014]",Newcastle United,4,3,1,314,0,0,2,2,0,180,0,0,6,5,1,494,0,0,0.0,0.0,0.0,0,0,0,0,0,0,0,0,0,2020-12-27 19:15:002020-12-27 19:15:002020-12-27 19:15:00
2143,4712,Jake Cain,1083,[2020],Liverpool FC,0,0,0,0,0,0,0,0,0,0,0,0,0,0,0,0,0,0,0.0,0.0,0.0,0,0,0,0,0,0,0,0,0,2020-12-27 19:15:00
2144,4713,Jake Clarke-Salter,4250,[2015],Chelsea FC,0,0,0,0,0,0,1,0,1,16,0,0,1,0,1,16,0,0,0.0,0.0,0.0,0,0,0,0,0,0,0,0,0,2020-12-27 19:15:00
2145,4714,Jake Eastwood,4224,[2019],Sheffield United,0,0,0,0,0,0,0,0,0,0,0,0,0,0,0,0,0,0,0.0,0.0,0.0,0,0,0,0,0,0,0,0,0,2020-12-27 19:15:00
2146,4715,Jake Flannigan,4091,[2014],Southampton FC,0,0,0,0,0,0,0,0,0,0,0,0,0,0,0,0,0,0,0.0,0.0,0.0,0,0,0,0,0,0,0,0,0,2020-12-27 19:15:00
2147,9433,Jake Gray,4363,"[2014, 2015]",Crystal Palace,0,0,0,0,0,0,0,0,0,0,0,0,0,0,0,0,0,0,0.0,0.0,0.0,0,0,0,0,0,0,0,0,0,2020-12-27 19:15:002020-12-27 19:15:00
2148,9437,Jake Hesketh,2790,"[2014, 2016]",Southampton FC,1,0,1,20,0,0,1,1,0,32,0,0,2,1,1,52,0,0,0.0,0.0,0.0,0,0,0,0,0,0,0,0,0,2020-12-27 19:15:002020-12-27 19:15:00
2149,4720,Jake Kean,3513,[2011],Blackburn Rovers,0,0,0,0,0,0,1,1,0,90,0,0,1,1,0,90,0,0,0.0,0.0,0.0,0,0,0,0,0,0,0,0,0,2020-12-27 19:15:00
2150,4721,Jake Larkins,4569,[2010],West Ham United,0,0,0,0,0,0,0,0,0,0,0,0,0,0,0,0,0,0,0.0,0.0,0.0,0,0,0,0,0,0,0,0,0,2020-12-27 19:15:00
2151,18894,Jake Livermore,1657,"[2009, 2010, 2011, 2012]",Tottenham Hotspur,19,6,13,727,0,0,17,5,12,547,0,0,36,11,25,1274,0,0,0.0,0.0,0.0,0,0,0,0,0,0,0,0,0,2020-12-27 19:15:002020-12-27 19:15:002020-12-27 19:15:002020-12-27 19:15:00
2152,14181,Jake Livermore,1657,"[2013, 2014, 2016]",Hull City,47,46,1,3967,3,0,45,43,2,3844,2,0,92,89,3,7811,5,0,0.0,0.0,0.0,3,1,4,0,0,0,0,0,0,2020-12-27 19:15:002020-12-27 19:15:002020-12-27 19:15:00
2153,9459,Jake Livermore,1657,"[2017, 2020]",West Bromwich Albion,22,19,3,1748,2,0,22,21,1,1755,0,0,44,40,4,3503,2,0,3.0,0.0,3.0,1,0,1,0,0,0,1,0,1,2020-12-27 19:15:002020-12-27 19:15:00
2154,9463,Jake Vokins,4123,"[2019, 2020]",Southampton FC,1,1,0,90,0,0,0,0,0,0,0,0,1,1,0,90,0,0,0.0,0.0,0.0,0,0,0,0,0,0,0,0,0,2020-12-27 19:15:002020-12-27 19:15:00
2155,14202,Jakob Haugaard,1587,"[2015, 2016, 2017]",Stoke City,2,2,0,180,0,0,3,2,1,224,0,0,5,4,1,404,0,0,0.0,0.0,0.0,0,0,0,0,0,0,0,0,0,2020-12-27 19:15:002020-12-27 19:15:002020-12-27 19:15:00
2156,23690,Jamaal Lascelles,2631,"[2015, 2017, 2018, 2019, 2020]",Newcastle United,56,53,3,4580,4,0,59,53,6,4995,2,0,115,106,9,9575,6,0,3.0,3.0,6.0,4,1,5,0,0,0,0,0,0,2020-12-27 19:15:002020-12-27 19:15:002020-12-27 19:15:002020-12-27 19:15:002020-12-27 19:15:00
2157,14226,Jamal Blackman,3650,"[2011, 2014, 2015]",Chelsea FC,0,0,0,0,0,0,0,0,0,0,0,0,0,0,0,0,0,0,0.0,0.0,0.0,0,0,0,0,0,0,0,0,0,2020-12-27 19:15:002020-12-27 19:15:002020-12-27 19:15:00
2158,9489,Jamal Campbell-Ryce,3920,"[2002, 2003]",Charlton Athletic,2,0,2,34,0,0,1,0,1,4,0,0,3,0,3,38,0,0,0.0,0.0,0.0,0,0,0,0,0,0,0,0,0,2020-12-27 19:15:002020-12-27 19:15:00
2159,4746,Jamal Lewis,1825,[2019],Norwich City,15,13,2,1215,1,0,13,12,1,1090,0,0,28,25,3,2305,1,0,3.0,0.0,3.0,1,0,1,0,0,0,0,0,0,2020-12-27 19:15:00
2160,4747,Jamal Lewis,1825,[2020],Newcastle United,6,6,0,519,0,0,7,5,2,495,0,0,13,11,2,1014,0,0,0.0,0.0,0.0,0,0,0,0,0,0,0,0,0,2020-12-27 19:15:00
2161,4748,Jamar Loza,4463,[2013],Norwich City,1,0,1,32,0,0,0,0,0,0,0,0,1,0,1,32,0,0,0.0,0.0,0.0,0,0,0,0,0,0,0,0,0,2020-12-27 19:15:00
2162,19002,James Beattie,2050,"[2000, 2001, 2002, 2003]",Southampton FC,68,58,10,5311,36,0,64,55,9,4959,24,0,132,113,19,10270,60,0,21.0,10.0,31.0,26,15,41,8,1,9,0,0,0,2020-12-27 19:15:002020-12-27 19:15:002020-12-27 19:15:002020-12-27 19:15:00
2163,14262,James Beattie,2050,"[2004, 2005, 2006]",Everton FC,41,27,14,2470,11,0,34,23,11,2065,2,0,75,50,25,4535,13,0,9.0,1.0,10.0,8,2,10,4,0,4,0,0,0,2020-12-27 19:15:002020-12-27 19:15:002020-12-27 19:15:00
2164,9513,James Beattie,2050,"[2008, 2009]",Stoke City,19,14,5,1087,7,0,19,13,6,1087,2,0,38,27,11,2174,9,0,6.0,0.0,6.0,6,0,6,2,0,2,0,0,0,2020-12-27 19:15:002020-12-27 19:15:00
2165,4758,James Beattie,2050,[2010],Blackpool FC,5,2,3,222,0,0,4,3,1,211,0,0,9,5,4,433,0,0,0.0,0.0,0.0,0,0,0,0,0,0,0,0,0,2020-12-27 19:15:00
2166,4759,James Chambers,3609,[2002],West Bromwich Albion,6,1,5,204,0,0,2,1,1,94,0,0,8,2,6,298,0,0,0.0,0.0,0.0,0,0,0,0,0,0,0,0,0,2020-12-27 19:15:00
2167,4760,James Chambers,3609,[2006],Watford FC,4,3,1,271,0,0,7,4,3,364,0,0,11,7,4,635,0,0,0.0,0.0,0.0,0,0,0,0,0,0,0,0,0,2020-12-27 19:15:00
2168,9523,James Chester,2223,"[2013, 2014]",Hull City,21,20,1,1771,1,0,26,25,1,2050,2,0,47,45,2,3821,3,0,0.0,3.0,3.0,1,2,3,0,0,0,0,0,0,2020-12-27 19:15:002020-12-27 19:15:00
2169,4763,James Chester,2223,[2015],West Bromwich Albion,6,3,3,400,0,0,7,6,1,562,0,0,13,9,4,962,0,0,0.0,0.0,0.0,0,0,0,0,0,0,0,0,0,2020-12-27 19:15:00
2170,4764,James Chester,2223,[2019],Aston Villa,0,0,0,0,0,0,0,0,0,0,0,0,0,0,0,0,0,0,0.0,0.0,0.0,0,0,0,0,0,0,0,0,0,2020-12-27 19:15:00
2171,47713,James Collins,1618,"[2005, 2006, 2007, 2008, 2012, 2013, 2014, 2015, 2016, 2017]",West Ham United,92,84,8,7192,1,0,93,83,10,7367,5,0,185,167,18,14559,6,0,0.0,1.0,1.0,1,5,6,0,0,0,0,0,0,2020-12-27 19:15:002020-12-27 19:15:002020-12-27 19:15:002020-12-27 19:15:002020-12-27 19:15:002020-12-27 19:15:002020-12-27 19:15:002020-12-27 19:15:002020-12-27 19:15:002020-12-27 19:15:00
2172,14310,James Collins,1618,"[2009, 2010, 2011]",Aston Villa,44,43,1,3860,4,0,45,43,2,3961,1,0,89,86,3,7821,5,0,9.0,1.0,10.0,3,1,4,0,0,0,0,0,0,2020-12-27 19:15:002020-12-27 19:15:002020-12-27 19:15:00
2173,4778,James Coppinger,4258,[2000],Newcastle United,1,0,1,11,0,0,0,0,0,0,0,0,1,0,1,11,0,0,0.0,0.0,0.0,0,0,0,0,0,0,0,0,0,2020-12-27 19:15:00
2174,9559,James Daly,4171,"[2017, 2019]",Crystal Palace,0,0,0,0,0,0,0,0,0,0,0,0,0,0,0,0,0,0,0.0,0.0,0.0,0,0,0,0,0,0,0,0,0,2020-12-27 19:15:002020-12-27 19:15:00
2175,9563,James Garner,4071,"[2018, 2019]",Manchester United,0,0,0,0,0,0,2,0,2,9,0,0,2,0,2,9,0,0,0.0,0.0,0.0,0,0,0,0,0,0,0,0,0,2020-12-27 19:15:002020-12-27 19:15:00
2176,9567,James Harper,2591,"[2006, 2007]",Reading FC,38,37,1,3253,3,0,34,33,1,2941,6,0,72,70,2,6194,9,0,3.0,3.0,6.0,2,5,7,0,0,0,0,0,0,2020-12-27 19:15:002020-12-27 19:15:00
2177,4785,James Horsfield,4529,[2015],Manchester City,0,0,0,0,0,0,0,0,0,0,0,0,0,0,0,0,0,0,0.0,0.0,0.0,0,0,0,0,0,0,0,0,0,2020-12-27 19:15:00
2178,9573,James Hurst,3297,"[2010, 2011]",West Bromwich Albion,0,0,0,0,0,0,1,1,0,90,0,0,1,1,0,90,0,0,0.0,0.0,0.0,0,0,0,0,0,0,0,0,0,2020-12-27 19:15:002020-12-27 19:15:00
2179,4788,James Husband,4511,[2016],Middlesbrough FC,0,0,0,0,0,0,1,1,0,59,0,0,1,1,0,59,0,0,0.0,0.0,0.0,0,0,0,0,0,0,0,0,0,2020-12-27 19:15:00
2180,9579,James Justin,2445,"[2019, 2020]",Leicester City,14,13,1,1180,1,0,14,13,1,1180,0,0,28,26,2,2360,1,0,0.0,0.0,0.0,0,0,0,0,0,0,0,0,0,2020-12-27 19:15:002020-12-27 19:15:00
2181,4791,James Keene,4409,[2004],Portsmouth FC,1,0,1,30,0,0,1,1,0,81,0,0,2,1,1,111,0,0,0.0,0.0,0.0,0,0,0,0,0,0,0,0,0,2020-12-27 19:15:00
2182,14379,James Maddison,2440,"[2018, 2019, 2020]",Leicester City,40,38,2,3317,8,0,41,35,6,3108,8,0,81,73,8,6425,16,0,3.0,1.0,4.0,3,3,6,0,1,1,0,0,0,2020-12-27 19:15:002020-12-27 19:15:002020-12-27 19:15:00
2183,14388,James McArthur,1023,"[2010, 2011, 2012]",Wigan Athletic,41,23,18,2337,2,0,42,22,20,2372,4,0,83,45,38,4709,6,0,0.0,3.0,3.0,1,2,3,0,0,0,0,0,0,2020-12-27 19:15:002020-12-27 19:15:002020-12-27 19:15:00
2184,33607,James McArthur,1023,"[2014, 2015, 2016, 2017, 2018, 2019, 2020]",Crystal Palace,107,98,9,8307,12,0,103,94,9,8206,5,0,210,192,18,16513,17,0,3.0,0.0,3.0,8,4,12,0,0,0,0,0,0,2020-12-27 19:15:002020-12-27 19:15:002020-12-27 19:15:002020-12-27 19:15:002020-12-27 19:15:002020-12-27 19:15:002020-12-27 19:15:00
2185,19226,James McCarthy,1053,"[2009, 2010, 2011, 2012]",Wigan Athletic,60,59,1,5084,6,0,55,55,0,4797,1,0,115,114,1,9881,7,0,1.0,0.0,1.0,4,1,5,0,0,0,0,0,0,2020-12-27 19:15:002020-12-27 19:15:002020-12-27 19:15:002020-12-27 19:15:00
2186,28869,James McCarthy,1053,"[2013, 2014, 2015, 2016, 2017, 2018]",Everton FC,56,50,6,4342,4,0,52,47,5,4223,2,0,108,97,11,8565,6,0,0.0,0.0,0.0,3,2,5,0,0,0,0,0,0,2020-12-27 19:15:002020-12-27 19:15:002020-12-27 19:15:002020-12-27 19:15:002020-12-27 19:15:002020-12-27 19:15:00
2187,9631,James McCarthy,1053,"[2019, 2020]",Crystal Palace,18,9,9,964,0,0,20,11,9,1037,0,0,38,20,18,2001,0,0,0.0,0.0,0.0,0,0,0,0,0,0,0,0,0,2020-12-27 19:15:002020-12-27 19:15:00
2188,9635,James McClean,1407,"[2011, 2012]",Sunderland AFC,30,22,8,2098,5,0,29,22,7,2078,2,0,59,44,15,4176,7,0,0.0,3.0,3.0,3,1,4,0,0,0,0,0,0,2020-12-27 19:15:002020-12-27 19:15:00
2189,14460,James McClean,1407,"[2015, 2016, 2017]",West Bromwich Albion,51,25,26,2517,2,0,48,30,18,2813,2,0,99,55,44,5330,4,0,1.0,1.0,2.0,1,2,3,0,0,0,0,0,0,2020-12-27 19:15:002020-12-27 19:15:002020-12-27 19:15:00
2190,24123,James McFadden,1413,"[2003, 2004, 2005, 2006, 2011]",Everton FC,50,24,26,2185,4,0,51,25,26,2502,5,0,101,49,52,4687,9,0,3.0,3.0,6.0,3,3,6,0,0,0,0,0,0,2020-12-27 19:15:002020-12-27 19:15:002020-12-27 19:15:002020-12-27 19:15:002020-12-27 19:15:00
2191,14481,James McFadden,1413,"[2007, 2009, 2010]",Birmingham City,27,25,2,2023,6,0,25,20,5,1830,3,0,52,45,7,3853,9,0,7.0,4.0,11.0,5,3,8,3,1,4,0,0,0,2020-12-27 19:15:002020-12-27 19:15:002020-12-27 19:15:00
2192,4830,James McFadden,1413,[2012],Sunderland AFC,1,0,1,2,0,0,2,0,2,33,0,0,3,0,3,35,0,0,0.0,0.0,0.0,0,0,0,0,0,0,0,0,0,2020-12-27 19:15:00
2193,9663,James Milner,1189,"[2002, 2003]",Leeds United,20,11,9,1215,3,0,23,13,10,1281,2,0,43,24,19,2496,5,0,1.0,3.0,4.0,1,2,3,0,0,0,0,0,0,2020-12-27 19:15:002020-12-27 19:15:00
2194,14504,James Milner,1189,"[2004, 2006, 2007]",Newcastle United,42,32,10,2893,5,0,44,34,10,3011,1,0,86,66,20,5904,6,0,0.0,1.0,1.0,2,1,3,0,0,0,0,0,0,2020-12-27 19:15:002020-12-27 19:15:002020-12-27 19:15:00
2195,14509,James Milner,1189,"[2005, 2008, 2009]",Aston Villa,49,47,2,4138,6,0,44,41,3,3712,5,0,93,88,5,7850,11,0,3.0,3.0,6.0,3,3,6,2,1,3,0,0,0,2020-12-27 19:15:002020-12-27 19:15:002020-12-27 19:15:00
2196,24205,James Milner,1189,"[2010, 2011, 2012, 2013, 2014]",Manchester City,72,38,34,3712,7,0,75,51,24,4826,6,0,147,89,58,8538,13,0,1.0,0.0,1.0,1,3,4,1,0,1,0,0,0,2020-12-27 19:15:002020-12-27 19:15:002020-12-27 19:15:002020-12-27 19:15:002020-12-27 19:15:00
2197,29079,James Milner,1189,"[2015, 2016, 2017, 2018, 2019, 2020]",Liverpool FC,79,56,23,5266,7,0,78,54,24,5069,12,0,157,110,47,10335,19,0,6.0,6.0,12.0,3,9,12,5,8,13,0,0,0,2020-12-27 19:15:002020-12-27 19:15:002020-12-27 19:15:002020-12-27 19:15:002020-12-27 19:15:002020-12-27 19:15:00
2198,19406,James Morrison,1735,"[2003, 2004, 2005, 2006]",Middlesbrough FC,30,16,14,1495,2,0,36,24,12,2226,1,0,66,40,26,3721,3,0,0.0,0.0,0.0,2,1,3,0,0,0,0,0,0,2020-12-27 19:15:002020-12-27 19:15:002020-12-27 19:15:002020-12-27 19:15:00
2199,43722,James Morrison,1735,"[2008, 2010, 2011, 2012, 2013, 2014, 2015, 2016, 2017]",West Bromwich Albion,117,100,17,8799,15,0,127,99,28,8901,14,0,244,199,45,17700,29,0,4.0,5.0,9.0,7,11,18,1,1,2,0,0,0,2020-12-27 19:15:002020-12-27 19:15:002020-12-27 19:15:002020-12-27 19:15:002020-12-27 19:15:002020-12-27 19:15:002020-12-27 19:15:002020-12-27 19:15:002020-12-27 19:15:00
2200,14592,James Perch,2400,"[2010, 2011, 2012]",Newcastle United,27,19,8,1804,0,0,37,21,16,2129,1,0,64,40,24,3933,1,0,0.0,0.0,0.0,0,1,1,0,0,0,0,0,0,2020-12-27 19:15:002020-12-27 19:15:002020-12-27 19:15:00
2201,4866,James Rodríguez,1014,[2020],Everton FC,5,5,0,416,3,0,5,5,0,430,0,0,10,10,0,846,3,0,0.0,0.0,0.0,1,0,1,0,0,0,0,0,0,2020-12-27 19:15:00
2202,4867,James Scowcroft,2649,[2000],Ipswich Town,17,11,6,1098,3,0,14,9,5,898,1,0,31,20,11,1996,4,0,0.0,0.0,0.0,1,1,2,0,0,0,0,0,0,2020-12-27 19:15:00
2203,9737,James Scowcroft,2649,"[2001, 2003]",Leicester City,28,26,2,2305,6,0,30,27,3,2380,4,0,58,53,5,4685,10,0,1.0,1.0,2.0,4,3,7,0,0,0,0,0,0,2020-12-27 19:15:002020-12-27 19:15:00
2204,4870,James Shea,3822,[2010],Arsenal FC,0,0,0,0,0,0,0,0,0,0,0,0,0,0,0,0,0,0,0.0,0.0,0.0,0,0,0,0,0,0,0,0,0,2020-12-27 19:15:00
2205,4871,James Sinclair,4155,[2006],Bolton Wanderers,0,0,0,0,0,0,2,0,2,45,0,0,2,0,2,45,0,0,0.0,0.0,0.0,0,0,0,0,0,0,0,0,0,2020-12-27 19:15:00
2206,24370,James Tarkowski,1264,"[2016, 2017, 2018, 2019, 2020]",Burnley FC,69,60,9,5538,3,0,66,60,6,5394,2,0,135,120,15,10932,5,0,3.0,0.0,3.0,3,0,3,0,0,0,0,0,0,2020-12-27 19:15:002020-12-27 19:15:002020-12-27 19:15:002020-12-27 19:15:002020-12-27 19:15:00
2207,19514,James Tavernier,2458,"[2010, 2011, 2012, 2013]",Newcastle United,0,0,0,0,0,0,2,0,2,35,0,0,2,0,2,35,0,0,0.0,0.0,0.0,0,0,0,0,0,0,0,0,0,2020-12-27 19:15:002020-12-27 19:15:002020-12-27 19:15:002020-12-27 19:15:00
2208,39076,James Tomkins,1281,"[2007, 2008, 2009, 2010, 2012, 2013, 2014, 2015]",West Ham United,75,68,7,6039,2,0,89,80,9,7229,2,0,164,148,16,13268,4,0,0.0,3.0,3.0,0,1,1,0,0,0,0,0,0,2020-12-27 19:15:002020-12-27 19:15:002020-12-27 19:15:002020-12-27 19:15:002020-12-27 19:15:002020-12-27 19:15:002020-12-27 19:15:002020-12-27 19:15:00
2209,24455,James Tomkins,1281,"[2016, 2017, 2018, 2019, 2020]",Crystal Palace,49,47,2,4122,4,0,51,50,1,4418,4,0,100,97,3,8540,8,0,0.0,0.0,0.0,1,3,4,0,0,0,0,0,0,2020-12-27 19:15:002020-12-27 19:15:002020-12-27 19:15:002020-12-27 19:15:002020-12-27 19:15:00
2210,29384,James Vaughan,3240,"[2004, 2006, 2007, 2008, 2009, 2010]",Everton FC,23,5,18,602,5,0,22,2,20,384,2,0,45,7,38,986,7,0,0.0,1.0,1.0,1,2,3,0,0,0,0,0,0,2020-12-27 19:15:002020-12-27 19:15:002020-12-27 19:15:002020-12-27 19:15:002020-12-27 19:15:002020-12-27 19:15:00
2211,4895,James Vaughan,3240,[2005],Fulham FC,1,0,1,13,0,0,0,0,0,0,0,0,1,0,1,13,0,0,0.0,0.0,0.0,0,0,0,0,0,0,0,0,0,2020-12-27 19:15:00
2212,9803,James Vaughan,3240,"[2011, 2012]",Norwich City,3,0,3,76,0,0,2,1,1,72,0,0,5,1,4,148,0,0,0.0,0.0,0.0,0,0,0,0,0,0,0,0,0,2020-12-27 19:15:002020-12-27 19:15:00
2213,44163,James Ward-Prowse,1150,"[2012, 2013, 2014, 2015, 2016, 2017, 2018, 2019, 2020]",Southampton FC,124,80,44,7497,14,0,122,86,36,7948,12,0,246,166,80,15445,26,0,7.0,0.0,7.0,9,5,14,3,1,4,0,0,0,2020-12-27 19:15:002020-12-27 19:15:002020-12-27 19:15:002020-12-27 19:15:002020-12-27 19:15:002020-12-27 19:15:002020-12-27 19:15:002020-12-27 19:15:002020-12-27 19:15:00
2214,4912,James Weir,2785,[2015],Manchester United,1,0,1,1,0,0,0,0,0,0,0,0,1,0,1,1,0,0,0.0,0.0,0.0,0,0,0,0,0,0,0,0,0,2020-12-27 19:15:00
2215,4913,James Weir,2785,[2016],Hull City,0,0,0,0,0,0,0,0,0,0,0,0,0,0,0,0,0,0,0.0,0.0,0.0,0,0,0,0,0,0,0,0,0,2020-12-27 19:15:00
2216,14745,James Wilson,2378,"[2013, 2014, 2015]",Manchester United,9,3,6,324,2,0,6,0,6,97,1,0,15,3,12,421,3,0,0.0,0.0,0.0,1,0,1,0,0,0,0,0,0,2020-12-27 19:15:002020-12-27 19:15:002020-12-27 19:15:00
2217,19674,Jamie Ashdown,3122,"[2004, 2005, 2007, 2009]",Portsmouth FC,19,19,0,1710,0,0,23,22,1,1981,0,0,42,41,1,3691,0,0,0.0,0.0,0.0,0,0,0,0,0,0,0,0,0,2020-12-27 19:15:002020-12-27 19:15:002020-12-27 19:15:002020-12-27 19:15:00
2218,59129,Jamie Carragher,1778,"[2000, 2002, 2003, 2004, 2005, 2006, 2007, 2008, 2009, 2010, 2011, 2012]",Liverpool FC,188,179,9,16032,1,0,189,181,8,16176,0,0,377,360,17,32208,1,0,0.0,0.0,0.0,0,0,0,0,0,0,0,0,0,2020-12-27 19:15:002020-12-27 19:15:002020-12-27 19:15:002020-12-27 19:15:002020-12-27 19:15:002020-12-27 19:15:002020-12-27 19:15:002020-12-27 19:15:002020-12-27 19:15:002020-12-27 19:15:002020-12-27 19:15:002020-12-27 19:15:00
2219,4922,Jamie Carragher,1778,[2001],West Ham United,1,1,0,90,0,0,0,0,0,0,0,0,1,1,0,90,0,0,0.0,0.0,0.0,0,0,0,0,0,0,0,0,0,2020-12-27 19:15:00
2220,9869,Jamie Clapham,1513,"[2000, 2001]",Ipswich Town,33,23,10,2175,2,0,32,25,7,2314,2,0,65,48,17,4489,4,0,0.0,0.0,0.0,0,0,0,0,0,0,0,0,0,2020-12-27 19:15:002020-12-27 19:15:00
2221,19750,Jamie Clapham,1513,"[2002, 2003, 2004, 2005]",Birmingham City,42,35,7,3203,1,0,41,34,7,3129,0,0,83,69,14,6332,1,0,0.0,0.0,0.0,1,0,1,0,0,0,0,0,0,2020-12-27 19:15:002020-12-27 19:15:002020-12-27 19:15:002020-12-27 19:15:00
2222,4940,Jamie Lawrence,3058,[2000],Bradford City,8,6,2,575,1,0,6,6,0,540,0,0,14,12,2,1115,1,0,0.0,0.0,0.0,1,0,1,0,0,0,0,0,0,2020-12-27 19:15:00
2223,9883,Jamie Mackie,2534,"[2011, 2012]",Queens Park Rangers,29,21,8,2002,4,0,31,20,11,1885,5,0,60,41,19,3887,9,0,4.0,1.0,5.0,3,3,6,0,0,0,0,0,0,2020-12-27 19:15:002020-12-27 19:15:00
2224,9887,Jamie McClen,3971,"[2001, 2002]",Newcastle United,3,2,1,160,0,0,1,1,0,90,0,0,4,3,1,250,0,0,0.0,0.0,0.0,0,0,0,0,0,0,0,0,0,2020-12-27 19:15:002020-12-27 19:15:00
2225,4945,Jamie McMaster,4334,[2002],Leeds United,2,0,2,10,0,0,2,0,2,39,0,0,4,0,4,49,0,0,0.0,0.0,0.0,0,0,0,0,0,0,0,0,0,2020-12-27 19:15:00
2226,4946,Jamie Murphy,3016,[2017],Brighton & Hove Albion,2,0,2,75,0,0,2,1,1,91,0,0,4,1,3,166,0,0,0.0,0.0,0.0,0,0,0,0,0,0,0,0,0,2020-12-27 19:15:00
2227,9895,Jamie Ness,4426,"[2012, 2013]",Stoke City,0,0,0,0,0,0,0,0,0,0,0,0,0,0,0,0,0,0,0.0,0.0,0.0,0,0,0,0,0,0,0,0,0,2020-12-27 19:15:002020-12-27 19:15:00
2228,9899,Jamie O'Hara,2505,"[2007, 2008]",Tottenham Hotspur,15,8,7,663,1,0,16,6,10,740,1,0,31,14,17,1403,2,0,0.0,0.0,0.0,0,0,0,0,0,0,0,0,0,2020-12-27 19:15:002020-12-27 19:15:00
2229,4951,Jamie O'Hara,2505,[2009],Portsmouth FC,12,12,0,1061,1,0,14,13,1,1195,1,0,26,25,1,2256,2,0,0.0,0.0,0.0,1,1,2,0,0,0,0,0,0,2020-12-27 19:15:00
2230,9905,Jamie O'Hara,2505,"[2010, 2011]",Wolverhampton Wanderers,15,15,0,1303,4,0,18,17,1,1475,1,0,33,32,1,2778,5,0,1.0,0.0,1.0,2,1,3,0,0,0,0,0,0,2020-12-27 19:15:002020-12-27 19:15:00
2231,4954,Jamie Redknapp,1123,[2001],Liverpool FC,2,0,2,33,0,0,2,2,0,150,1,0,4,2,2,183,1,0,0.0,0.0,0.0,0,1,1,0,0,0,0,0,0,2020-12-27 19:15:00
2232,14868,Jamie Redknapp,1123,"[2002, 2003, 2004]",Tottenham Hotspur,24,20,4,1739,2,0,24,17,7,1579,2,0,48,37,11,3318,4,0,3.0,3.0,6.0,1,1,2,0,0,0,0,0,0,2020-12-27 19:15:002020-12-27 19:15:002020-12-27 19:15:00
2233,4958,Jamie Shackleton,1069,[2020],Leeds United,4,1,3,115,0,0,3,0,3,122,0,0,7,1,6,237,0,0,0.0,0.0,0.0,0,0,0,0,0,0,0,0,0,2020-12-27 19:15:00
2234,4959,Jamie Slabber,4295,[2002],Tottenham Hotspur,1,0,1,11,0,0,0,0,0,0,0,0,1,0,1,11,0,0,0.0,0.0,0.0,0,0,0,0,0,0,0,0,0,2020-12-27 19:15:00
2235,14883,Jamie Sterry,2632,"[2014, 2015, 2018]",Newcastle United,1,0,1,6,0,0,0,0,0,0,0,0,1,0,1,6,0,0,0.0,0.0,0.0,0,0,0,0,0,0,0,0,0,2020-12-27 19:15:002020-12-27 19:15:002020-12-27 19:15:00
2236,34762,Jamie Vardy,2443,"[2014, 2015, 2016, 2017, 2018, 2019, 2020]",Leicester City,114,106,8,9417,56,0,111,103,8,9113,58,0,225,209,16,18530,114,0,7.0,27.0,34.0,29,34,63,9,15,24,0,0,0,2020-12-27 19:15:002020-12-27 19:15:002020-12-27 19:15:002020-12-27 19:15:002020-12-27 19:15:002020-12-27 19:15:002020-12-27 19:15:00
2237,19886,Jan Bednarek,2478,"[2017, 2018, 2019, 2020]",Southampton FC,39,39,0,3466,3,0,40,39,1,3433,0,0,79,78,1,6899,3,0,0.0,0.0,0.0,2,0,2,0,0,0,0,0,0,2020-12-27 19:15:002020-12-27 19:15:002020-12-27 19:15:002020-12-27 19:15:00
2238,9949,Jan Kirchhoff,3552,"[2015, 2016]",Sunderland AFC,13,12,1,884,0,0,9,7,2,635,0,0,22,19,3,1519,0,0,0.0,0.0,0.0,0,0,0,0,0,0,0,0,0,2020-12-27 19:15:002020-12-27 19:15:00
2239,9953,Jan Kromkamp,3558,"[2005, 2006]",Liverpool FC,4,3,1,271,0,0,10,4,6,422,0,0,14,7,7,693,0,0,0.0,0.0,0.0,0,0,0,0,0,0,0,0,0,2020-12-27 19:15:002020-12-27 19:15:00
2240,4978,Jan Laštůvka,3685,[2006],Fulham FC,4,3,1,299,0,0,4,4,0,360,0,0,8,7,1,659,0,0,0.0,0.0,0.0,0,0,0,0,0,0,0,0,0,2020-12-27 19:15:00
2241,4979,Jan Vennegoor of Hesselink,1612,[2009],Hull City,16,9,7,799,3,0,15,8,7,690,0,0,31,17,14,1489,3,0,3.0,0.0,3.0,3,0,3,0,0,0,0,0,0,2020-12-27 19:15:00
2242,39868,Jan Vertonghen,1161,"[2012, 2013, 2014, 2015, 2016, 2017, 2018, 2019]",Tottenham Hotspur,114,113,1,10044,2,0,118,114,4,10094,6,0,232,227,5,20138,8,0,3.0,3.0,6.0,2,6,8,0,0,0,0,0,0,2020-12-27 19:15:002020-12-27 19:15:002020-12-27 19:15:002020-12-27 19:15:002020-12-27 19:15:002020-12-27 19:15:002020-12-27 19:15:002020-12-27 19:15:00
2243,14967,Jannik Vestergaard,2156,"[2018, 2019, 2020]",Southampton FC,28,27,1,2347,1,0,27,25,2,2305,3,0,55,52,3,4652,4,0,1.0,1.0,2.0,1,3,4,0,0,0,0,0,0,2020-12-27 19:15:002020-12-27 19:15:002020-12-27 19:15:00
2244,4991,Janoi Donacien,4443,[2013],Aston Villa,0,0,0,0,0,0,0,0,0,0,0,0,0,0,0,0,0,0,0.0,0.0,0.0,0,0,0,0,0,0,0,0,0,2020-12-27 19:15:00
2245,16993,Japhet Tanganga,3859,"[2019, 2020]",Tottenham Hotspur,3,3,0,256,0,0,3,3,0,270,0,0,6,6,0,526,0,0,0.0,0.0,0.0,0,0,0,0,0,0,0,0,0,2020-12-27 19:15:002020-12-27 19:15:00
2246,4993,Jardel,4335,[2003],Bolton Wanderers,3,0,3,80,0,0,4,0,4,79,0,0,7,0,7,159,0,0,0.0,0.0,0.0,0,0,0,0,0,0,0,0,0,2020-12-27 19:15:00
2247,4994,Jared Borgetti,2866,[2005],Bolton Wanderers,11,3,8,351,2,0,8,2,6,192,0,0,19,5,14,543,2,0,0.0,0.0,0.0,1,0,1,0,0,0,0,0,0,2020-12-27 19:15:00
2248,4995,Jared Hodgkiss,4266,[2005],West Bromwich Albion,0,0,0,0,0,0,1,0,1,27,0,0,1,0,1,27,0,0,0.0,0.0,0.0,0,0,0,0,0,0,0,0,0,2020-12-27 19:15:00
2249,4996,Jari Litmanen,2900,[2000],Liverpool FC,2,2,0,141,0,0,3,2,1,195,1,0,5,4,1,336,1,0,0.0,1.0,1.0,0,1,1,0,1,1,0,0,0,2020-12-27 19:15:00
2250,4997,Jari Litmanen,2900,[2001],West Ham United,1,0,1,15,0,0,0,0,0,0,0,0,1,0,1,15,0,0,0.0,0.0,0.0,0,0,0,0,0,0,0,0,0,2020-12-27 19:15:00
2251,4998,Jarosław Fojut,4473,[2005],Bolton Wanderers,0,0,0,0,0,0,1,0,1,4,0,0,1,0,1,4,0,0,0.0,0.0,0.0,0,0,0,0,0,0,0,0,0,2020-12-27 19:15:00
2252,4999,Jarosław Jach,4538,[2017],Crystal Palace,0,0,0,0,0,0,0,0,0,0,0,0,0,0,0,0,0,0,0.0,0.0,0.0,0,0,0,0,0,0,0,0,0,2020-12-27 19:15:00
2253,10001,Jarrad Branthwaite,4015,"[2019, 2020]",Everton FC,2,1,1,164,0,0,2,1,1,134,0,0,4,2,2,298,0,0,0.0,0.0,0.0,0,0,0,0,0,0,0,0,0,2020-12-27 19:15:002020-12-27 19:15:00
2254,5002,Jarrod Bowen,2739,[2016],Hull City,1,1,0,72,0,0,6,0,6,105,0,0,7,1,6,177,0,0,0.0,0.0,0.0,0,0,0,0,0,0,0,0,0,2020-12-27 19:15:00
2255,10007,Jarrod Bowen,2739,"[2019, 2020]",West Ham United,14,14,0,1062,4,0,14,12,2,1074,1,0,28,26,2,2136,5,0,3.0,0.0,3.0,3,0,3,0,0,0,0,0,0,2020-12-27 19:15:002020-12-27 19:15:00
2256,15018,Jason Brown,3748,"[2006, 2008, 2009]",Blackburn Rovers,5,4,1,404,0,0,4,2,2,289,0,0,9,6,3,693,0,0,0.0,0.0,0.0,0,0,0,0,0,0,0,0,0,2020-12-27 19:15:002020-12-27 19:15:002020-12-27 19:15:00
2257,5008,Jason Davidson,3567,[2014],West Bromwich Albion,0,0,0,0,0,0,2,1,1,102,0,0,2,1,1,102,0,0,0.0,0.0,0.0,0,0,0,0,0,0,0,0,0,2020-12-27 19:15:00
2258,5009,Jason Denayer,3135,[2015],Manchester City,0,0,0,0,0,0,0,0,0,0,0,0,0,0,0,0,0,0,0.0,0.0,0.0,0,0,0,0,0,0,0,0,0,2020-12-27 19:15:00
2259,5010,Jason Denayer,3135,[2016],Sunderland AFC,13,12,1,973,0,0,11,10,1,907,0,0,24,22,2,1880,0,0,0.0,0.0,0.0,0,0,0,0,0,0,0,0,0,2020-12-27 19:15:00
2260,25065,Jason Dodd,2046,"[2000, 2001, 2002, 2003, 2004]",Southampton FC,53,48,5,4343,1,0,49,45,4,4019,1,0,102,93,9,8362,2,0,0.0,0.0,0.0,1,1,2,0,0,0,0,0,0,2020-12-27 19:15:002020-12-27 19:15:002020-12-27 19:15:002020-12-27 19:15:002020-12-27 19:15:00
2261,25090,Jason Euell,1886,"[2001, 2002, 2003, 2004, 2005]",Charlton Athletic,70,51,19,4895,21,0,63,46,17,4328,13,0,133,97,36,9223,34,0,9.0,6.0,15.0,15,7,22,4,2,6,0,0,0,2020-12-27 19:15:002020-12-27 19:15:002020-12-27 19:15:002020-12-27 19:15:002020-12-27 19:15:00
2262,5021,Jason Euell,1886,[2006],Middlesbrough FC,6,5,1,412,0,0,10,3,7,314,0,0,16,8,8,726,0,0,0.0,0.0,0.0,0,0,0,0,0,0,0,0,0,2020-12-27 19:15:00
2263,5022,Jason Euell,1886,[2010],Blackpool FC,1,0,1,19,0,0,2,1,1,83,0,0,3,1,2,102,0,0,0.0,0.0,0.0,0,0,0,0,0,0,0,0,0,2020-12-27 19:15:00
2264,10047,Jason Gavin,3682,"[2000, 2001]",Middlesbrough FC,12,7,5,777,0,0,11,8,3,717,0,0,23,15,8,1494,0,0,0.0,0.0,0.0,0,0,0,0,0,0,0,0,0,2020-12-27 19:15:002020-12-27 19:15:00
2265,10051,Jason Kennedy,2860,"[2004, 2005]",Middlesbrough FC,3,0,3,34,0,0,1,1,0,85,0,0,4,1,3,119,0,0,0.0,0.0,0.0,0,0,0,0,0,0,0,0,0,2020-12-27 19:15:002020-12-27 19:15:00
2266,10055,Jason Koumas,2062,"[2002, 2004]",West Bromwich Albion,22,16,6,1526,2,0,19,15,4,1269,2,0,41,31,10,2795,4,0,0.0,1.0,1.0,1,2,3,0,0,0,0,0,0,2020-12-27 19:15:002020-12-27 19:15:00
2267,15090,Jason Koumas,2062,"[2007, 2008, 2009]",Wigan Athletic,28,16,12,1605,1,0,26,16,10,1556,1,0,54,32,22,3161,2,0,1.0,0.0,1.0,1,0,1,1,0,1,0,0,0,2020-12-27 19:15:002020-12-27 19:15:002020-12-27 19:15:00
2268,5032,Jason Lokilo,4212,[2017],Crystal Palace,0,0,0,0,0,0,0,0,0,0,0,0,0,0,0,0,0,0,0.0,0.0,0.0,0,0,0,0,0,0,0,0,0,2020-12-27 19:15:00
2269,10067,Jason Lowe,3426,"[2010, 2011]",Blackburn Rovers,16,15,1,1365,0,0,17,15,2,1371,0,0,33,30,3,2736,0,0,0.0,0.0,0.0,0,0,0,0,0,0,0,0,0,2020-12-27 19:15:002020-12-27 19:15:00
2270,5035,Jason McAteer,1352,[2001],Blackburn Rovers,2,1,1,111,0,0,2,0,2,41,0,0,4,1,3,152,0,0,0.0,0.0,0.0,0,0,0,0,0,0,0,0,0,2020-12-27 19:15:00
2271,5036,Jason McAteer,1352,[2002],Sunderland AFC,4,4,0,303,0,0,5,5,0,405,1,0,9,9,0,708,1,0,0.0,3.0,3.0,0,1,1,0,0,0,0,0,0,2020-12-27 19:15:00
2272,5037,Jason McCarthy,4254,[2014],Southampton FC,0,0,0,0,0,0,1,0,1,3,0,0,1,0,1,3,0,0,0.0,0.0,0.0,0,0,0,0,0,0,0,0,0,2020-12-27 19:15:00
2273,5038,Jason Puncheon,1026,[2010],Blackpool FC,6,3,3,342,2,0,5,3,2,306,1,0,11,6,5,648,3,0,0.0,0.0,0.0,1,1,2,0,0,0,0,0,0,2020-12-27 19:15:00
2274,5039,Jason Puncheon,1026,[2011],Queens Park Rangers,2,0,2,15,0,0,0,0,0,0,0,0,2,0,2,15,0,0,0.0,0.0,0.0,0,0,0,0,0,0,0,0,0,2020-12-27 19:15:00
2275,5040,Jason Puncheon,1026,[2012],Southampton FC,16,14,2,1134,2,0,16,11,5,933,3,0,32,25,7,2067,5,0,3.0,2.0,5.0,2,2,4,0,0,0,0,0,0,2020-12-27 19:15:00
2276,30261,Jason Puncheon,1026,"[2013, 2014, 2015, 2016, 2017, 2018]",Crystal Palace,78,66,12,5780,8,0,75,66,9,5863,7,0,153,132,21,11643,15,0,16.0,0.0,16.0,7,5,12,1,0,1,0,0,0,2020-12-27 19:15:002020-12-27 19:15:002020-12-27 19:15:002020-12-27 19:15:002020-12-27 19:15:002020-12-27 19:15:00
2277,5047,Jason Roberts,1820,[2002],West Bromwich Albion,16,16,0,1399,1,0,15,14,1,1243,2,0,31,30,1,2642,3,0,1.0,3.0,4.0,1,1,2,0,0,0,0,0,0,2020-12-27 19:15:00
2278,5048,Jason Roberts,1820,[2003],Portsmouth FC,4,1,3,146,1,0,5,2,3,244,0,0,9,3,6,390,1,0,0.0,0.0,0.0,1,0,1,0,0,0,0,0,0,2020-12-27 19:15:00
2279,10102,Jason Roberts,1820,"[2005, 2009]",Wigan Athletic,18,17,1,1548,4,0,17,17,0,1489,4,0,35,34,1,3037,8,0,6.0,0.0,6.0,3,3,6,1,0,1,0,0,0,2020-12-27 19:15:002020-12-27 19:15:00
2280,25262,Jason Roberts,1820,"[2006, 2007, 2008, 2010, 2011]",Blackburn Rovers,54,32,22,3222,11,0,49,25,24,2639,8,0,103,57,46,5861,19,0,0.0,9.0,9.0,4,6,10,0,0,0,0,0,0,2020-12-27 19:15:002020-12-27 19:15:002020-12-27 19:15:002020-12-27 19:15:002020-12-27 19:15:00
2281,5056,Jason Roberts,1820,[2012],Reading FC,5,4,1,339,0,0,6,4,2,368,0,0,11,8,3,707,0,0,0.0,0.0,0.0,0,0,0,0,0,0,0,0,0,2020-12-27 19:15:00
2282,10115,Jason Scotland,2063,"[2009, 2010]",Wigan Athletic,16,8,8,816,0,0,15,5,10,645,1,0,31,13,18,1461,1,0,0.0,0.0,0.0,0,1,1,0,0,0,0,0,0,2020-12-27 19:15:002020-12-27 19:15:00
2283,5059,Jason Shackell,1489,[2004],Norwich City,6,6,0,540,0,0,5,5,0,450,0,0,11,11,0,990,0,0,0.0,0.0,0.0,0,0,0,0,0,0,0,0,0,2020-12-27 19:15:00
2284,5060,Jason Shackell,1489,[2014],Burnley FC,19,19,0,1710,0,0,19,19,0,1637,0,0,38,38,0,3347,0,0,0.0,0.0,0.0,0,0,0,0,0,0,0,0,0,2020-12-27 19:15:00
2285,10123,Jason Steele,2944,"[2018, 2020]",Brighton & Hove Albion,0,0,0,0,0,0,0,0,0,0,0,0,0,0,0,0,0,0,0.0,0.0,0.0,0,0,0,0,0,0,0,0,0,2020-12-27 19:15:002020-12-27 19:15:00
2286,20258,Jason Wilcox,1301,"[2000, 2001, 2002, 2003]",Leeds United,25,16,9,1409,0,0,30,15,15,1617,1,0,55,31,24,3026,1,0,0.0,0.0,0.0,0,0,0,0,0,0,0,0,0,2020-12-27 19:15:002020-12-27 19:15:002020-12-27 19:15:002020-12-27 19:15:00
2287,10135,Javi García,1416,"[2012, 2013]",Manchester City,23,13,10,1245,0,0,30,18,12,1780,2,0,53,31,22,3025,2,0,0.0,1.0,1.0,0,1,1,0,0,0,0,0,0,2020-12-27 19:15:002020-12-27 19:15:00
2288,15210,Javi Garrido,1381,"[2007, 2008, 2009]",Manchester City,26,20,6,1845,1,0,22,18,4,1589,1,0,48,38,10,3434,2,0,0.0,0.0,0.0,0,0,0,0,0,0,0,0,0,2020-12-27 19:15:002020-12-27 19:15:002020-12-27 19:15:00
2289,10145,Javi Garrido,1381,"[2012, 2013]",Norwich City,22,22,0,1959,0,0,18,18,0,1596,0,0,40,40,0,3555,0,0,0.0,0.0,0.0,0,0,0,0,0,0,0,0,0,2020-12-27 19:15:002020-12-27 19:15:00
2290,5074,Javi Moreno,4185,[2003],Bolton Wanderers,4,1,3,142,0,0,4,0,4,84,0,0,8,1,7,226,0,0,0.0,0.0,0.0,0,0,0,0,0,0,0,0,0,2020-12-27 19:15:00
2291,30465,Javier Hernández,2257,"[2010, 2011, 2012, 2013, 2014, 2015]",Manchester United,48,24,24,2305,13,0,54,25,29,2463,24,0,102,49,53,4768,37,0,9.0,20.0,29.0,9,13,22,1,0,1,0,0,0,2020-12-27 19:15:002020-12-27 19:15:002020-12-27 19:15:002020-12-27 19:15:002020-12-27 19:15:002020-12-27 19:15:00
2292,15246,Javier Hernández,2257,"[2017, 2018, 2019]",West Ham United,28,14,14,1409,8,0,27,17,10,1577,8,0,55,31,24,2986,16,0,4.0,1.0,5.0,6,6,12,0,0,0,0,0,0,2020-12-27 19:15:002020-12-27 19:15:002020-12-27 19:15:00
2293,5084,Javier Margas,3882,[2000],West Ham United,2,2,0,148,0,0,1,1,0,90,0,0,3,3,0,238,0,0,0.0,0.0,0.0,0,0,0,0,0,0,0,0,0,2020-12-27 19:15:00
2294,25435,Javier Mascherano,1893,"[2006, 2007, 2008, 2009, 2010]",Liverpool FC,48,46,2,4055,1,0,46,45,1,3957,0,0,94,91,3,8012,1,0,0.0,0.0,0.0,1,0,1,0,0,0,0,0,0,2020-12-27 19:15:002020-12-27 19:15:002020-12-27 19:15:002020-12-27 19:15:002020-12-27 19:15:00
2295,5090,Jay Bothroyd,1960,[2000],Leeds United,1,0,1,14,0,0,0,0,0,0,0,0,1,0,1,14,0,0,0.0,0.0,0.0,0,0,0,0,0,0,0,0,0,2020-12-27 19:15:00
2296,5091,Jay Bothroyd,1960,[2004],Blackburn Rovers,5,3,2,270,1,0,6,3,3,264,0,0,11,6,5,534,1,0,0.0,0.0,0.0,1,0,1,0,0,0,0,0,0,2020-12-27 19:15:00
2297,5092,Jay Bothroyd,1960,[2005],Charlton Athletic,10,3,7,388,2,0,8,0,8,175,0,0,18,3,15,563,2,0,0.0,0.0,0.0,0,0,0,0,0,0,0,0,0,2020-12-27 19:15:00
2298,10187,Jay Bothroyd,1960,"[2011, 2012]",Queens Park Rangers,10,6,4,517,1,0,15,8,7,823,2,0,25,14,11,1340,3,0,0.0,3.0,3.0,1,1,2,0,0,0,0,0,0,2020-12-27 19:15:002020-12-27 19:15:00
2299,5095,Jay DeMerit,2122,[2006],Watford FC,16,14,2,1318,1,0,13,12,1,1125,1,0,29,26,3,2443,2,0,3.0,0.0,3.0,1,1,2,0,0,0,0,0,0,2020-12-27 19:15:00
2300,5096,Jay Emmanuel-Thomas,3284,[2010],Arsenal FC,0,0,0,0,0,0,1,0,1,9,0,0,1,0,1,9,0,0,0.0,0.0,0.0,0,0,0,0,0,0,0,0,0,2020-12-27 19:15:00
2301,25495,Jay Fulton,3196,"[2013, 2014, 2015, 2016, 2017]",Swansea City,8,3,5,277,0,0,11,8,3,648,0,0,19,11,8,925,0,0,0.0,0.0,0.0,0,0,0,0,0,0,0,0,0,2020-12-27 19:15:002020-12-27 19:15:002020-12-27 19:15:002020-12-27 19:15:002020-12-27 19:15:00
2302,20414,Jay Jay Okocha,2865,"[2002, 2003, 2004, 2005]",Bolton Wanderers,59,53,6,4777,8,0,63,52,11,4503,6,0,122,105,17,9280,14,0,6.0,0.0,6.0,6,4,10,2,3,5,0,0,0,2020-12-27 19:15:002020-12-27 19:15:002020-12-27 19:15:002020-12-27 19:15:00
2303,5106,Jay Lynch,3897,[2011],Bolton Wanderers,0,0,0,0,0,0,0,0,0,0,0,0,0,0,0,0,0,0,0.0,0.0,0.0,0,0,0,0,0,0,0,0,0,2020-12-27 19:15:00
2304,15324,Jay McEveley,1569,"[2002, 2004, 2006]",Blackburn Rovers,6,6,0,459,0,0,12,11,1,844,0,0,18,17,1,1303,0,0,0.0,0.0,0.0,0,0,0,0,0,0,0,0,0,2020-12-27 19:15:002020-12-27 19:15:002020-12-27 19:15:00
2305,5110,Jay McEveley,1569,[2007],Derby County,13,9,4,915,2,0,16,12,4,1001,0,0,29,21,8,1916,2,0,0.0,0.0,0.0,2,0,2,0,0,0,0,0,0,2020-12-27 19:15:00
2306,5111,Jay O’Shea,4539,[2009],Birmingham City,0,0,0,0,0,0,1,0,1,9,0,0,1,0,1,9,0,0,0.0,0.0,0.0,0,0,0,0,0,0,0,0,0,2020-12-27 19:15:00
2307,20454,Jay Rodriguez,1247,"[2012, 2013, 2015, 2016]",Southampton FC,52,28,24,2794,11,0,52,38,14,3186,15,0,104,66,38,5980,26,0,1.0,5.0,6.0,4,12,16,0,0,0,0,0,0,2020-12-27 19:15:002020-12-27 19:15:002020-12-27 19:15:002020-12-27 19:15:00
2308,5116,Jay Rodriguez,1247,[2017],West Bromwich Albion,18,15,3,1354,4,0,19,16,3,1470,3,0,37,31,6,2824,7,0,1.0,3.0,4.0,4,3,7,1,0,1,0,0,0,2020-12-27 19:15:00
2309,10235,Jay Rodriguez,1247,"[2019, 2020]",Burnley FC,24,11,13,1150,3,0,24,15,9,1413,5,0,48,26,22,2563,8,0,3.0,7.0,10.0,1,4,5,1,0,1,0,0,0,2020-12-27 19:15:002020-12-27 19:15:00
2310,5119,Jay Simpson,3091,[2008],West Bromwich Albion,6,5,1,307,0,0,7,4,3,397,1,0,13,9,4,704,1,0,0.0,0.0,0.0,0,1,1,0,0,0,0,0,0,2020-12-27 19:15:00
2311,15363,Jay Spearing,2995,"[2009, 2010, 2011]",Liverpool FC,14,12,2,1050,0,0,16,14,2,1144,0,0,30,26,4,2194,0,0,0.0,0.0,0.0,0,0,0,0,0,0,0,0,0,2020-12-27 19:15:002020-12-27 19:15:002020-12-27 19:15:00
2312,5123,Jay Tabb,1982,[2012],Reading FC,5,5,0,429,0,0,7,7,0,591,0,0,12,12,0,1020,0,0,0.0,0.0,0.0,0,0,0,0,0,0,0,0,0,2020-12-27 19:15:00
2313,5124,Jayden Bogle,1000,[2020],Sheffield United,0,0,0,0,0,0,1,0,1,36,1,0,1,0,1,36,1,0,0.0,0.0,0.0,0,1,1,0,0,0,0,0,0,2020-12-27 19:15:00
2314,15378,Jayson Molumby,4079,"[2017, 2018, 2020]",Brighton & Hove Albion,0,0,0,0,0,0,1,0,1,1,0,0,1,0,1,1,0,0,0.0,0.0,0.0,0,0,0,0,0,0,0,0,0,2020-12-27 19:15:002020-12-27 19:15:002020-12-27 19:15:00
2315,20518,Jazz Richards,1703,"[2011, 2012, 2013, 2014]",Swansea City,8,6,2,579,0,0,10,7,3,632,0,0,18,13,5,1211,0,0,0.0,0.0,0.0,0,0,0,0,0,0,0,0,0,2020-12-27 19:15:002020-12-27 19:15:002020-12-27 19:15:002020-12-27 19:15:00
2316,5132,Jazz Richards,1703,[2018],Cardiff City,2,0,2,52,0,0,2,0,2,76,0,0,4,0,4,128,0,0,0.0,0.0,0.0,0,0,0,0,0,0,0,0,0,2020-12-27 19:15:00
2317,20538,Jaïro Riedewald,2256,"[2017, 2018, 2019, 2020]",Crystal Palace,20,9,11,887,0,0,21,7,14,833,1,0,41,16,25,1720,1,0,0.0,0.0,0.0,0,1,1,0,0,0,0,0,0,2020-12-27 19:15:002020-12-27 19:15:002020-12-27 19:15:002020-12-27 19:15:00
2318,5137,Jean Beausejour,2544,[2010],Birmingham City,9,4,5,452,1,0,8,5,3,441,1,0,17,9,8,893,2,0,0.0,0.0,0.0,1,1,2,0,0,0,0,0,0,2020-12-27 19:15:00
2319,10277,Jean Beausejour,2544,"[2011, 2012]",Wigan Athletic,24,24,0,2055,1,0,26,24,2,2120,0,0,50,48,2,4175,1,0,0.0,0.0,0.0,1,0,1,0,0,0,0,0,0,2020-12-27 19:15:002020-12-27 19:15:00
2320,10281,Jean Makoun,3290,"[2010, 2011]",Aston Villa,3,3,0,247,0,0,4,4,0,327,0,0,7,7,0,574,0,0,0.0,0.0,0.0,0,0,0,0,0,0,0,0,0,2020-12-27 19:15:002020-12-27 19:15:00
2321,5142,Jean Michaël Seri,3908,[2018],Fulham FC,15,14,1,1112,1,0,17,13,4,1140,0,0,32,27,5,2252,1,0,0.0,0.0,0.0,1,0,1,0,0,0,0,0,0,2020-12-27 19:15:00
2322,10287,Jean-Alain Boumsong,1946,"[2004, 2005]",Newcastle United,22,21,1,1949,0,0,24,22,2,1952,0,0,46,43,3,3901,0,0,0.0,0.0,0.0,0,0,0,0,0,0,0,0,0,2020-12-27 19:15:002020-12-27 19:15:00
2323,5145,Jean-Philippe Gbamin,3616,[2019],Everton FC,1,1,0,90,0,0,1,0,1,45,0,0,2,1,1,135,0,0,0.0,0.0,0.0,0,0,0,0,0,0,0,0,0,2020-12-27 19:15:00
2324,10293,Jed Steer,1447,"[2011, 2012]",Norwich City,0,0,0,0,0,0,0,0,0,0,0,0,0,0,0,0,0,0,0.0,0.0,0.0,0,0,0,0,0,0,0,0,0,2020-12-27 19:15:002020-12-27 19:15:00
2325,20598,Jed Steer,1447,"[2013, 2014, 2019, 2020]",Aston Villa,1,1,0,90,0,0,1,1,0,8,0,0,2,2,0,98,0,0,0.0,0.0,0.0,0,0,0,0,0,0,0,0,0,2020-12-27 19:15:002020-12-27 19:15:002020-12-27 19:15:002020-12-27 19:15:00
2326,20614,Jeff Hendrick,1254,"[2016, 2017, 2018, 2019]",Burnley FC,59,53,6,4374,5,0,63,54,9,4753,4,0,122,107,15,9127,9,0,6.0,4.0,10.0,5,4,9,0,0,0,0,0,0,2020-12-27 19:15:002020-12-27 19:15:002020-12-27 19:15:002020-12-27 19:15:00
2327,5156,Jeff Hendrick,1254,[2020],Newcastle United,4,4,0,358,0,0,6,6,0,467,2,0,10,10,0,825,2,0,0.0,0.0,0.0,0,1,1,0,0,0,0,0,0,2020-12-27 19:15:00
2328,10315,Jeff Kenna,2620,"[2002, 2003]",Birmingham City,26,24,2,1957,3,0,28,26,2,2303,0,0,54,50,4,4260,3,0,4.0,0.0,4.0,3,0,3,0,0,0,0,0,0,2020-12-27 19:15:002020-12-27 19:15:00
2329,10319,Jeff Reine-Adélaïde,1595,"[2015, 2016]",Arsenal FC,0,0,0,0,0,0,0,0,0,0,0,0,0,0,0,0,0,0,0.0,0.0,0.0,0,0,0,0,0,0,0,0,0,2020-12-27 19:15:002020-12-27 19:15:00
2330,5161,Jeff Smith,4567,[2001],Bolton Wanderers,0,0,0,0,0,0,1,0,1,31,0,0,1,0,1,31,0,0,0.0,0.0,0.0,0,0,0,0,0,0,0,0,0,2020-12-27 19:15:00
2331,5162,Jeff Whitley,3309,[2000],Manchester City,14,13,1,1129,0,0,15,14,1,1221,1,0,29,27,2,2350,1,0,0.0,0.0,0.0,0,1,1,0,0,0,0,0,0,2020-12-27 19:15:00
2332,10327,Jefferson Lerma,2741,"[2018, 2019]",AFC Bournemouth,33,31,2,2762,1,0,30,29,1,2496,2,0,63,60,3,5258,3,0,0.0,0.0,0.0,1,0,1,0,0,0,0,0,0,2020-12-27 19:15:002020-12-27 19:15:00
2333,15498,Jefferson Montero,1700,"[2014, 2015, 2016]",Swansea City,31,17,14,1709,1,0,35,14,21,1627,0,0,66,31,35,3336,1,0,0.0,0.0,0.0,1,0,1,0,0,0,0,0,0,2020-12-27 19:15:002020-12-27 19:15:002020-12-27 19:15:00
2334,10337,Jeffrey Bruma,2868,"[2009, 2010]",Chelsea FC,3,1,2,132,0,0,1,0,1,34,0,0,4,1,3,166,0,0,0.0,0.0,0.0,0,0,0,0,0,0,0,0,0,2020-12-27 19:15:002020-12-27 19:15:00
2335,10341,Jeffrey Schlupp,2252,"[2014, 2015]",Leicester City,29,21,8,1921,1,0,27,23,4,2000,3,0,56,44,12,3921,4,0,0.0,1.0,1.0,1,2,3,0,0,0,0,0,0,2020-12-27 19:15:002020-12-27 19:15:00
2336,25870,Jeffrey Schlupp,2252,"[2016, 2017, 2018, 2019, 2020]",Crystal Palace,46,36,10,3210,4,0,53,35,18,3095,4,0,99,71,28,6305,8,0,5.0,0.0,5.0,3,2,5,0,0,0,0,0,0,2020-12-27 19:15:002020-12-27 19:15:002020-12-27 19:15:002020-12-27 19:15:002020-12-27 19:15:00
2337,5177,Jelle Van Damme,4039,[2004],Southampton FC,3,2,1,225,0,0,3,2,1,166,0,0,6,4,2,391,0,0,0.0,0.0,0.0,0,0,0,0,0,0,0,0,0,2020-12-27 19:15:00
2338,5178,Jelle Van Damme,4039,[2010],Wolverhampton Wanderers,3,2,1,150,0,0,3,2,1,128,1,0,6,4,2,278,1,0,0.0,0.0,0.0,0,1,1,0,0,0,0,0,0,2020-12-27 19:15:00
2339,5179,Jem Karacan,3743,[2012],Reading FC,11,11,0,857,0,0,10,10,0,750,1,0,21,21,0,1607,1,0,0.0,0.0,0.0,0,0,0,0,0,0,0,0,0,2020-12-27 19:15:00
2340,10361,Jemal Johnson,4333,"[2004, 2005]",Blackburn Rovers,3,0,3,32,0,0,3,0,3,68,0,0,6,0,6,100,0,0,0.0,0.0,0.0,0,0,0,0,0,0,0,0,0,2020-12-27 19:15:002020-12-27 19:15:00
2341,31107,Jens Lehmann,1522,"[2003, 2004, 2005, 2006, 2007, 2010]",Arsenal FC,71,70,1,6321,0,0,74,74,0,6660,0,0,145,144,1,12981,0,0,0.0,0.0,0.0,0,0,0,0,0,0,0,0,0,2020-12-27 19:15:002020-12-27 19:15:002020-12-27 19:15:002020-12-27 19:15:002020-12-27 19:15:002020-12-27 19:15:00
2342,10377,Jeremain Lens,2819,"[2015, 2016]",Sunderland AFC,11,7,4,696,1,0,11,7,4,698,2,0,22,14,8,1394,3,0,0.0,1.0,1.0,0,2,2,0,0,0,0,0,0,2020-12-27 19:15:002020-12-27 19:15:00
2343,5190,Jeremy Ngakia,3901,[2019],West Ham United,3,3,0,261,0,0,2,2,0,180,0,0,5,5,0,441,0,0,0.0,0.0,0.0,0,0,0,0,0,0,0,0,0,2020-12-27 19:15:00
2344,15576,Jermain Defoe,1127,"[2000, 2001, 2002]",West Ham United,33,17,16,1833,9,0,35,20,15,2087,9,0,68,37,31,3920,18,0,5.0,8.0,13.0,5,8,13,0,0,0,0,0,0,2020-12-27 19:15:002020-12-27 19:15:002020-12-27 19:15:00
2345,57189,Jermain Defoe,1127,"[2003, 2004, 2005, 2006, 2007, 2008, 2009, 2010, 2011, 2012, 2013]",Tottenham Hotspur,139,91,48,8705,60,0,132,89,43,8340,31,0,271,180,91,17045,91,0,28.0,2.0,30.0,35,17,52,2,2,4,0,0,0,2020-12-27 19:15:002020-12-27 19:15:002020-12-27 19:15:002020-12-27 19:15:002020-12-27 19:15:002020-12-27 19:15:002020-12-27 19:15:002020-12-27 19:15:002020-12-27 19:15:002020-12-27 19:15:002020-12-27 19:15:00
2346,15618,Jermain Defoe,1127,"[2014, 2015, 2016]",Sunderland AFC,45,42,3,3753,14,0,42,40,2,3577,20,0,87,82,5,7330,34,0,8.0,8.0,16.0,9,11,20,3,3,6,0,0,0,2020-12-27 19:15:002020-12-27 19:15:002020-12-27 19:15:00
2347,10417,Jermain Defoe,1127,"[2017, 2018]",AFC Bournemouth,14,7,7,642,1,0,14,4,10,464,3,0,28,11,17,1106,4,0,3.0,2.0,5.0,1,3,4,0,0,0,0,0,0,2020-12-27 19:15:002020-12-27 19:15:00
2348,10421,Jermaine Beckford,3620,"[2010, 2011]",Everton FC,18,10,8,888,5,0,16,5,11,502,3,0,34,15,19,1390,8,0,4.0,1.0,5.0,4,3,7,0,0,0,0,0,0,2020-12-27 19:15:002020-12-27 19:15:00
2349,26070,Jermaine Jenas,1275,"[2001, 2002, 2003, 2004, 2005]",Newcastle United,53,39,14,3759,5,0,52,42,10,3931,4,0,105,81,24,7690,9,0,3.0,4.0,7.0,2,4,6,0,0,0,0,0,0,2020-12-27 19:15:002020-12-27 19:15:002020-12-27 19:15:002020-12-27 19:15:002020-12-27 19:15:00
2350,31317,Jermaine Jenas,1275,"[2006, 2007, 2008, 2009, 2010, 2011]",Tottenham Hotspur,50,40,10,3677,10,0,70,60,10,5437,5,0,120,100,20,9114,15,0,4.0,3.0,7.0,5,3,8,0,0,0,0,0,0,2020-12-27 19:15:002020-12-27 19:15:002020-12-27 19:15:002020-12-27 19:15:002020-12-27 19:15:002020-12-27 19:15:00
2351,5223,Jermaine Jenas,1275,[2012],Queens Park Rangers,6,3,3,346,1,0,6,5,1,465,1,0,12,8,4,811,2,0,0.0,0.0,0.0,0,1,1,0,0,0,0,0,0,2020-12-27 19:15:00
2352,10449,Jermaine Johnson,3074,"[2001, 2002]",Bolton Wanderers,6,2,4,254,0,0,6,2,4,222,0,0,12,4,8,476,0,0,0.0,0.0,0.0,0,0,0,0,0,0,0,0,0,2020-12-27 19:15:002020-12-27 19:15:00
2353,5226,Jermaine Jones,3621,[2010],Blackburn Rovers,8,8,0,678,0,0,7,7,0,618,0,0,15,15,0,1296,0,0,0.0,0.0,0.0,0,0,0,0,0,0,0,0,0,2020-12-27 19:15:00
2354,5227,Jermaine Pennant,1514,[2002],Arsenal FC,2,1,1,103,3,0,3,0,3,65,0,0,5,1,4,168,3,0,0.0,0.0,0.0,0,0,0,0,0,0,0,0,0,2020-12-27 19:15:00
2355,5228,Jermaine Pennant,1514,[2003],Leeds United,14,14,0,1233,2,0,18,16,2,1373,0,0,32,30,2,2606,2,0,0.0,0.0,0.0,2,0,2,0,0,0,0,0,0,2020-12-27 19:15:00
2356,10459,Jermaine Pennant,1514,"[2004, 2005]",Birmingham City,25,24,1,2042,2,0,25,23,2,2117,0,0,50,47,3,4159,2,0,0.0,0.0,0.0,1,0,1,0,0,0,0,0,0,2020-12-27 19:15:002020-12-27 19:15:00
2357,10463,Jermaine Pennant,1514,"[2006, 2007]",Liverpool FC,25,20,5,1716,2,0,27,14,13,1388,1,0,52,34,18,3104,3,0,0.0,0.0,0.0,1,1,2,0,0,0,0,0,0,2020-12-27 19:15:002020-12-27 19:15:00
2358,5233,Jermaine Pennant,1514,[2008],Portsmouth FC,6,5,1,382,0,0,7,4,3,383,0,0,13,9,4,765,0,0,0.0,0.0,0.0,0,0,0,0,0,0,0,0,0,2020-12-27 19:15:00
2359,20942,Jermaine Pennant,1514,"[2010, 2011, 2012, 2013]",Stoke City,37,28,9,2473,3,0,28,17,11,1506,1,0,65,45,20,3979,4,0,0.0,3.0,3.0,0,1,1,0,0,0,0,0,0,2020-12-27 19:15:002020-12-27 19:15:002020-12-27 19:15:002020-12-27 19:15:00
2360,10477,Jermaine Wright,2720,"[2000, 2001]",Ipswich Town,34,29,5,2506,1,0,30,28,2,2330,2,0,64,57,7,4836,3,0,0.0,4.0,4.0,0,2,2,0,0,0,0,0,0,2020-12-27 19:15:002020-12-27 19:15:00
2361,10481,Jerome Sinclair,1931,"[2014, 2015]",Liverpool FC,1,0,1,3,0,0,1,0,1,22,0,0,2,0,2,25,0,0,0.0,0.0,0.0,0,0,0,0,0,0,0,0,0,2020-12-27 19:15:002020-12-27 19:15:00
2362,10485,Jerome Sinclair,1931,"[2016, 2017]",Watford FC,3,0,3,21,0,0,6,1,5,122,0,0,9,1,8,143,0,0,0.0,0.0,0.0,0,0,0,0,0,0,0,0,0,2020-12-27 19:15:002020-12-27 19:15:00
2363,20982,Jerome Thomas,1736,"[2003, 2004, 2005, 2006]",Charlton Athletic,38,30,8,2499,5,0,31,22,9,1941,2,0,69,52,17,4440,7,0,0.0,0.0,0.0,2,0,2,1,0,1,0,0,0,2020-12-27 19:15:002020-12-27 19:15:002020-12-27 19:15:002020-12-27 19:15:00
2364,5248,Jerome Thomas,1736,[2008],Portsmouth FC,1,0,1,34,0,0,2,0,2,35,0,0,3,0,3,69,0,0,0.0,0.0,0.0,0,0,0,0,0,0,0,0,0,2020-12-27 19:15:00
2365,15750,Jerome Thomas,1736,"[2010, 2011, 2012]",West Bromwich Albion,38,33,5,2741,3,0,34,29,5,2255,1,0,72,62,10,4996,4,0,0.0,0.0,0.0,2,0,2,0,0,0,0,0,0,2020-12-27 19:15:002020-12-27 19:15:002020-12-27 19:15:00
2366,10505,Jerome Thomas,1736,"[2013, 2014]",Crystal Palace,6,2,4,225,0,0,4,1,3,149,0,0,10,3,7,374,0,0,0.0,0.0,0.0,0,0,0,0,0,0,0,0,0,2020-12-27 19:15:002020-12-27 19:15:00
2367,5254,Jerzy Dudek,2899,[2001],West Ham United,1,1,0,90,0,0,0,0,0,0,0,0,1,1,0,90,0,0,0.0,0.0,0.0,0,0,0,0,0,0,0,0,0,2020-12-27 19:15:00
2368,26285,Jerzy Dudek,2899,"[2002, 2003, 2004, 2005, 2006]",Liverpool FC,44,44,0,3960,0,0,45,44,1,3954,0,0,89,88,1,7914,0,0,0.0,0.0,0.0,0,0,0,0,0,0,0,0,0,2020-12-27 19:15:002020-12-27 19:15:002020-12-27 19:15:002020-12-27 19:15:002020-12-27 19:15:00
2369,5260,Jesper Blomqvist,3813,[2001],Everton FC,9,7,2,574,1,0,6,3,3,312,0,0,15,10,5,886,1,0,3.0,0.0,3.0,1,0,1,0,0,0,0,0,0,2020-12-27 19:15:00
2370,5261,Jesper Blomqvist,3813,[2002],Charlton Athletic,1,0,1,23,0,0,2,0,2,30,0,0,3,0,3,53,0,0,0.0,0.0,0.0,0,0,0,0,0,0,0,0,0,2020-12-27 19:15:00
2371,15791,Jesper Grønkjær,2618,"[2000, 2002, 2003]",Chelsea FC,38,23,15,2056,4,0,36,21,15,1893,3,0,74,44,30,3949,7,0,6.0,0.0,6.0,2,2,4,0,0,0,0,0,0,2020-12-27 19:15:002020-12-27 19:15:002020-12-27 19:15:00
2372,5263,Jesper Grønkjær,2618,[2001],Charlton Athletic,1,0,1,15,0,0,0,0,0,0,0,0,1,0,1,15,0,0,0.0,0.0,0.0,0,0,0,0,0,0,0,0,0,2020-12-27 19:15:00
2373,5266,Jesper Grønkjær,2618,[2004],Birmingham City,8,7,1,608,0,0,8,6,2,536,0,0,16,13,3,1144,0,0,0.0,0.0,0.0,0,0,0,0,0,0,0,0,0,2020-12-27 19:15:00
2374,5267,Jesse Joronen,4531,[2013],Fulham FC,0,0,0,0,0,0,0,0,0,0,0,0,0,0,0,0,0,0,0.0,0.0,0.0,0,0,0,0,0,0,0,0,0,2020-12-27 19:15:00
2375,52725,Jesse Lingard,1646,"[2011, 2012, 2013, 2014, 2015, 2016, 2017, 2018, 2019, 2020]",Manchester United,67,44,23,3851,6,0,67,43,24,3716,12,0,134,87,47,7567,18,0,5.0,0.0,5.0,5,2,7,0,1,1,0,0,0,2020-12-27 19:15:002020-12-27 19:15:002020-12-27 19:15:002020-12-27 19:15:002020-12-27 19:15:002020-12-27 19:15:002020-12-27 19:15:002020-12-27 19:15:002020-12-27 19:15:002020-12-27 19:15:00
2376,5278,Jesé,3526,[2017],Stoke City,7,4,3,342,1,0,5,3,2,212,0,0,12,7,5,554,1,0,3.0,0.0,3.0,1,0,1,0,0,0,0,0,0,2020-12-27 19:15:00
2377,5279,Jesús Gámez,2579,[2017],Newcastle United,0,0,0,0,0,0,2,1,1,97,0,0,2,1,1,97,0,0,0.0,0.0,0.0,0,0,0,0,0,0,0,0,0,2020-12-27 19:15:00
2378,21126,Jesús Navas,1361,"[2013, 2014, 2015, 2016]",Manchester City,60,40,20,3728,3,0,63,37,26,3631,1,0,123,77,46,7359,4,0,0.0,0.0,0.0,2,1,3,0,0,0,0,0,0,2020-12-27 19:15:002020-12-27 19:15:002020-12-27 19:15:002020-12-27 19:15:00
2379,5284,Jesús Vallejo,2184,[2019],Wolverhampton Wanderers,2,1,1,162,0,0,0,0,0,0,0,0,2,1,1,162,0,0,0.0,0.0,0.0,0,0,0,0,0,0,0,0,0,2020-12-27 19:15:00
2380,5285,Jetro Willems,2468,[2019],Newcastle United,11,10,1,800,1,0,8,8,0,698,1,0,19,18,1,1498,2,0,0.0,0.0,0.0,1,1,2,0,0,0,0,0,0,2020-12-27 19:15:00
2381,5286,Jhon Viáfara,2965,[2005],Portsmouth FC,5,3,2,265,0,0,9,7,2,658,1,0,14,10,4,923,1,0,0.0,0.0,0.0,0,1,1,0,0,0,0,0,0,2020-12-27 19:15:00
2382,37030,Ji-Sung Park,1788,"[2005, 2006, 2007, 2008, 2009, 2010, 2011]",Manchester United,65,51,14,4365,16,0,67,41,26,3690,4,0,132,92,40,8055,20,0,9.0,0.0,9.0,10,1,11,0,0,0,0,0,0,2020-12-27 19:15:002020-12-27 19:15:002020-12-27 19:15:002020-12-27 19:15:002020-12-27 19:15:002020-12-27 19:15:002020-12-27 19:15:00
2383,5294,Ji-Sung Park,1788,[2012],Queens Park Rangers,9,7,2,629,0,0,11,8,3,713,0,0,20,15,5,1342,0,0,0.0,0.0,0.0,0,0,0,0,0,0,0,0,0,2020-12-27 19:15:00
2384,31785,Jihai Sun,1808,"[2002, 2003, 2004, 2005, 2006, 2007]",Manchester City,58,40,18,3990,0,0,60,48,12,4444,3,0,118,88,30,8434,3,0,0.0,0.0,0.0,0,1,1,0,0,0,0,0,0,2020-12-27 19:15:002020-12-27 19:15:002020-12-27 19:15:002020-12-27 19:15:002020-12-27 19:15:002020-12-27 19:15:00
2385,5301,Jim Brennan,3680,[2004],Norwich City,3,1,2,127,0,0,7,5,2,477,0,0,10,6,4,604,0,0,0.0,0.0,0.0,0,0,0,0,0,0,0,0,0,2020-12-27 19:15:00
2386,10605,Jim Magilton,2719,"[2000, 2001]",Ipswich Town,28,23,5,2056,0,0,27,23,4,2056,1,0,55,46,9,4112,1,0,0.0,0.0,0.0,0,0,0,0,1,1,0,0,0,2020-12-27 19:15:002020-12-27 19:15:00
2387,5304,Jimmy Bullard,1610,[2005],Wigan Athletic,18,18,0,1606,2,0,18,17,1,1530,2,0,36,35,1,3136,4,0,0.0,3.0,3.0,1,2,3,0,0,0,0,0,0,2020-12-27 19:15:00
2388,15918,Jimmy Bullard,1610,"[2006, 2007, 2008]",Fulham FC,17,16,1,1470,5,0,17,16,1,1325,1,0,34,32,2,2795,6,0,8.0,1.0,9.0,5,1,6,1,0,1,0,0,0,2020-12-27 19:15:002020-12-27 19:15:002020-12-27 19:15:00
2389,5308,Jimmy Bullard,1610,[2009],Hull City,7,7,0,581,3,0,7,6,1,473,1,0,14,13,1,1054,4,0,0.0,1.0,1.0,3,1,4,3,1,4,0,0,0,2020-12-27 19:15:00
2390,10619,Jimmy Dunne,2679,"[2019, 2020]",Burnley FC,1,1,0,90,0,0,1,1,0,90,1,0,2,2,0,180,1,0,0.0,0.0,0.0,0,0,0,0,0,0,0,0,0,2020-12-27 19:15:002020-12-27 19:15:00
2391,21250,Jimmy Floyd Hasselbaink,1337,"[2000, 2001, 2002, 2003]",Chelsea FC,66,58,8,5137,44,0,67,58,9,4981,26,0,133,116,17,10118,70,0,17.0,15.0,32.0,26,17,43,10,2,12,0,0,0,2020-12-27 19:15:002020-12-27 19:15:002020-12-27 19:15:002020-12-27 19:15:00
2392,10631,Jimmy Floyd Hasselbaink,1337,"[2004, 2005]",Middlesbrough FC,31,24,7,2180,12,0,27,24,3,2158,11,0,58,48,10,4338,23,0,7.0,0.0,7.0,7,6,13,1,0,1,0,0,0,2020-12-27 19:15:002020-12-27 19:15:00
2393,5317,Jimmy Floyd Hasselbaink,1337,[2006],Charlton Athletic,14,6,8,683,1,0,11,5,6,426,1,0,25,11,14,1109,2,0,0.0,0.0,0.0,1,1,2,0,0,0,0,0,0,2020-12-27 19:15:00
2394,10637,Jimmy Kébé,3134,"[2007, 2012]",Reading FC,11,9,2,783,5,0,12,8,4,697,0,0,23,17,6,1480,5,0,3.0,0.0,3.0,3,0,3,0,0,0,0,0,0,2020-12-27 19:15:002020-12-27 19:15:00
2395,5320,Jimmy Kébé,3134,[2013],Crystal Palace,2,0,2,42,0,0,4,2,2,148,0,0,6,2,4,190,0,0,0.0,0.0,0.0,0,0,0,0,0,0,0,0,0,2020-12-27 19:15:00
2396,5321,Jimmy Smith,2976,[2005],Chelsea FC,0,0,0,0,0,0,1,0,1,9,0,0,1,0,1,9,0,0,0.0,0.0,0.0,0,0,0,0,0,0,0,0,0,2020-12-27 19:15:00
2397,5322,Jimmy Walker,2952,[2005],West Ham United,3,3,0,270,0,0,0,0,0,0,0,0,3,3,0,270,0,0,0.0,0.0,0.0,0,0,0,0,0,0,0,0,0,2020-12-27 19:15:00
2398,5323,Jimmy Walker,2952,[2009],Tottenham Hotspur,1,1,0,90,0,0,1,1,0,90,0,0,2,2,0,180,0,0,0.0,0.0,0.0,0,0,0,0,0,0,0,0,0,2020-12-27 19:15:00
2399,5324,Jindřich Staněk,4340,[2015],Everton FC,0,0,0,0,0,0,0,0,0,0,0,0,0,0,0,0,0,0,0.0,0.0,0.0,0,0,0,0,0,0,0,0,0,2020-12-27 19:15:00
2400,5325,Jiří Jarošík,2774,[2004],Chelsea FC,5,1,4,160,0,0,8,2,6,276,0,0,13,3,10,436,0,0,0.0,0.0,0.0,0,0,0,0,0,0,0,0,0,2020-12-27 19:15:00
2401,5326,Jiří Jarošík,2774,[2005],Birmingham City,12,10,2,905,2,0,12,9,3,755,3,0,24,19,5,1660,5,0,3.0,1.0,4.0,2,2,4,0,0,0,0,0,0,2020-12-27 19:15:00
2402,5327,Jiří Skalák,3019,[2017],Brighton & Hove Albion,0,0,0,0,0,0,0,0,0,0,0,0,0,0,0,0,0,0,0.0,0.0,0.0,0,0,0,0,0,0,0,0,0,2020-12-27 19:15:00
2403,37317,Jlloyd Samuel,1789,"[2000, 2001, 2002, 2003, 2004, 2005, 2006]",Aston Villa,79,70,9,6324,1,0,75,64,11,5819,1,0,154,134,20,12143,2,0,0.0,3.0,3.0,0,1,1,0,0,0,0,0,0,2020-12-27 19:15:002020-12-27 19:15:002020-12-27 19:15:002020-12-27 19:15:002020-12-27 19:15:002020-12-27 19:15:002020-12-27 19:15:00
2404,16008,Jlloyd Samuel,1789,"[2007, 2008, 2009]",Bolton Wanderers,31,29,2,2581,0,0,37,32,5,2856,0,0,68,61,7,5437,0,0,0.0,0.0,0.0,0,0,0,0,0,0,0,0,0,2020-12-27 19:15:002020-12-27 19:15:002020-12-27 19:15:00
2405,5338,Jo Inge Berget,3662,[2013],Cardiff City,1,0,1,11,0,0,0,0,0,0,0,0,1,0,1,11,0,0,0.0,0.0,0.0,0,0,0,0,0,0,0,0,0,2020-12-27 19:15:00
2406,21362,Jo Tessem,2696,"[2000, 2001, 2002, 2003]",Southampton FC,42,22,20,2255,4,0,40,20,20,2139,4,0,82,42,40,4394,8,0,6.0,3.0,9.0,3,3,6,0,0,0,0,0,0,2020-12-27 19:15:002020-12-27 19:15:002020-12-27 19:15:002020-12-27 19:15:00
2407,5343,Joachim Andersen,1039,[2020],Fulham FC,5,5,0,450,0,0,4,4,0,360,0,0,9,9,0,810,0,0,0.0,0.0,0.0,0,0,0,0,0,0,0,0,0,2020-12-27 19:15:00
2408,10689,Joachim Björklund,1633,"[2001, 2002]",Sunderland AFC,14,13,1,1215,0,0,18,17,1,1369,0,0,32,30,2,2584,0,0,0.0,0.0,0.0,0,0,0,0,0,0,0,0,0,2020-12-27 19:15:002020-12-27 19:15:00
2409,16041,Jody Craddock,1093,"[2000, 2001, 2002]",Sunderland AFC,37,37,0,3285,0,0,43,42,1,3812,2,0,80,79,1,7097,2,0,0.0,0.0,0.0,0,0,0,0,0,0,0,0,0,2020-12-27 19:15:002020-12-27 19:15:002020-12-27 19:15:00
2410,21402,Jody Craddock,1093,"[2003, 2009, 2010, 2011]",Wolverhampton Wanderers,41,40,1,3500,2,0,39,38,1,3421,5,0,80,78,2,6921,7,0,0.0,1.0,1.0,1,4,5,0,0,0,0,0,0,2020-12-27 19:15:002020-12-27 19:15:002020-12-27 19:15:002020-12-27 19:15:00
2411,16062,Jody Morris,2293,"[2000, 2001, 2002]",Chelsea FC,25,15,10,1481,0,0,25,18,7,1813,0,0,50,33,17,3294,0,0,0.0,0.0,0.0,0,0,0,0,0,0,0,0,0,2020-12-27 19:15:002020-12-27 19:15:002020-12-27 19:15:00
2412,5356,Jody Morris,2293,[2003],Leeds United,6,5,1,424,0,0,6,6,0,515,0,0,12,11,1,939,0,0,0.0,0.0,0.0,0,0,0,0,0,0,0,0,0,2020-12-27 19:15:00
2413,5357,Joe Allen,1430,[2011],Swansea City,17,14,3,1329,2,0,19,17,2,1571,2,0,36,31,5,2900,4,0,0.0,0.0,0.0,1,0,1,0,0,0,0,0,0,2020-12-27 19:15:00
2414,21438,Joe Allen,1430,"[2012, 2013, 2014, 2015]",Liverpool FC,46,25,21,2481,3,0,45,35,10,3080,1,0,91,60,31,5561,4,0,1.0,0.0,1.0,2,1,3,0,0,0,0,0,0,2020-12-27 19:15:002020-12-27 19:15:002020-12-27 19:15:002020-12-27 19:15:00
2415,10725,Joe Allen,1430,"[2016, 2017]",Stoke City,36,35,1,3024,7,0,35,34,1,2964,1,0,71,69,2,5988,8,0,3.0,1.0,4.0,5,1,6,0,0,0,0,0,0,2020-12-27 19:15:002020-12-27 19:15:00
2416,5364,Joe Bennett,2978,[2008],Middlesbrough FC,0,0,0,0,0,0,1,0,1,44,0,0,1,0,1,44,0,0,0.0,0.0,0.0,0,0,0,0,0,0,0,0,0,2020-12-27 19:15:00
2417,10731,Joe Bennett,2978,"[2012, 2013]",Aston Villa,14,12,2,1084,0,0,15,12,3,1028,0,0,29,24,5,2112,0,0,0.0,0.0,0.0,0,0,0,0,0,0,0,0,0,2020-12-27 19:15:002020-12-27 19:15:00
2418,5367,Joe Bennett,2978,[2015],AFC Bournemouth,0,0,0,0,0,0,0,0,0,0,0,0,0,0,0,0,0,0,0.0,0.0,0.0,0,0,0,0,0,0,0,0,0,2020-12-27 19:15:00
2419,5368,Joe Bennett,2978,[2018],Cardiff City,13,13,0,1142,0,0,17,17,0,1499,0,0,30,30,0,2641,0,0,0.0,0.0,0.0,0,0,0,0,0,0,0,0,0,2020-12-27 19:15:00
2420,10739,Joe Bryan,3907,"[2018, 2020]",Fulham FC,19,16,3,1397,0,0,17,15,2,1295,0,0,36,31,5,2692,0,0,0.0,0.0,0.0,0,0,0,0,0,0,0,0,0,2020-12-27 19:15:002020-12-27 19:15:00
2421,21499,Joe Cole,1630,"[2000, 2001, 2002, 2013]",West Ham United,50,43,7,3840,10,0,52,38,14,3656,2,0,102,81,21,7496,12,0,0.0,0.0,0.0,8,1,9,0,0,0,0,0,0,2020-12-27 19:15:002020-12-27 19:15:002020-12-27 19:15:002020-12-27 19:15:00
2422,37639,Joe Cole,1630,"[2003, 2004, 2005, 2006, 2007, 2008, 2009]",Chelsea FC,94,66,28,5755,13,0,88,56,32,4848,15,0,182,122,60,10603,28,0,6.0,12.0,18.0,7,8,15,0,0,0,0,0,0,2020-12-27 19:15:002020-12-27 19:15:002020-12-27 19:15:002020-12-27 19:15:002020-12-27 19:15:002020-12-27 19:15:002020-12-27 19:15:00
2423,10763,Joe Cole,1630,"[2010, 2012]",Liverpool FC,13,4,9,461,2,0,13,5,8,557,1,0,26,9,17,1018,3,0,3.0,0.0,3.0,1,1,2,0,0,0,0,0,0,2020-12-27 19:15:002020-12-27 19:15:00
2424,10769,Joe Cole,1630,"[2014, 2015]",Aston Villa,4,0,4,38,0,0,8,3,5,241,1,0,12,3,9,279,1,0,0.0,0.0,0.0,0,1,1,0,0,0,0,0,0,2020-12-27 19:15:002020-12-27 19:15:00
2425,5386,Joe Dodoo,3892,[2015],Leicester City,0,0,0,0,0,0,1,0,1,19,0,0,1,0,1,19,0,0,0.0,0.0,0.0,0,0,0,0,0,0,0,0,0,2020-12-27 19:15:00
2426,32337,Joe Gomez,1180,"[2015, 2016, 2017, 2018, 2019, 2020]",Liverpool FC,40,33,7,3026,0,0,39,33,6,2963,0,0,79,66,13,5989,0,0,0.0,0.0,0.0,0,0,0,0,0,0,0,0,0,2020-12-27 19:15:002020-12-27 19:15:002020-12-27 19:15:002020-12-27 19:15:002020-12-27 19:15:002020-12-27 19:15:00
2427,53982,Joe Hart,1363,"[2006, 2007, 2008, 2010, 2011, 2012, 2013, 2014, 2015, 2016]",Manchester City,135,135,0,12110,0,0,129,129,0,11539,0,0,264,264,0,23649,0,0,0.0,0.0,0.0,0,0,0,0,0,0,0,0,0,2020-12-27 19:15:002020-12-27 19:15:002020-12-27 19:15:002020-12-27 19:15:002020-12-27 19:15:002020-12-27 19:15:002020-12-27 19:15:002020-12-27 19:15:002020-12-27 19:15:002020-12-27 19:15:00
2428,5396,Joe Hart,1363,[2009],Birmingham City,18,18,0,1620,0,0,18,18,0,1620,0,0,36,36,0,3240,0,0,0.0,0.0,0.0,0,0,0,0,0,0,0,0,0,2020-12-27 19:15:00
2429,5404,Joe Hart,1363,[2017],West Ham United,9,9,0,810,0,0,10,10,0,900,0,0,19,19,0,1710,0,0,0.0,0.0,0.0,0,0,0,0,0,0,0,0,0,2020-12-27 19:15:00
2430,10811,Joe Hart,1363,"[2018, 2019]",Burnley FC,9,9,0,810,0,0,10,10,0,900,0,0,19,19,0,1710,0,0,0.0,0.0,0.0,0,0,0,0,0,0,0,0,0,2020-12-27 19:15:002020-12-27 19:15:00
2431,5407,Joe Hart,1363,[2020],Tottenham Hotspur,0,0,0,0,0,0,0,0,0,0,0,0,0,0,0,0,0,0,0.0,0.0,0.0,0,0,0,0,0,0,0,0,0,2020-12-27 19:15:00
2432,10817,Joe Keenan,4492,"[2001, 2002]",Chelsea FC,1,0,1,1,0,0,1,0,1,14,0,0,2,0,2,15,0,0,0.0,0.0,0.0,0,0,0,0,0,0,0,0,0,2020-12-27 19:15:002020-12-27 19:15:00
2433,21646,Joe Ledley,1025,"[2013, 2014, 2015, 2016]",Crystal Palace,38,30,8,2677,3,0,45,38,7,3325,3,0,83,68,15,6002,6,0,0.0,3.0,3.0,2,1,3,0,0,0,0,0,0,2020-12-27 19:15:002020-12-27 19:15:002020-12-27 19:15:002020-12-27 19:15:00
2434,5414,Joe Lewis,3461,[2013],Cardiff City,0,0,0,0,0,0,1,1,0,90,0,0,1,1,0,90,0,0,0.0,0.0,0.0,0,0,0,0,0,0,0,0,0,2020-12-27 19:15:00
2435,5415,Joe Lolley,3799,[2017],Huddersfield Town,4,1,3,131,1,0,2,1,1,88,0,0,6,2,4,219,1,0,0.0,0.0,0.0,1,0,1,0,0,0,0,0,0,2020-12-27 19:15:00
2436,5416,Joe Mason,4448,[2013],Cardiff City,0,0,0,0,0,0,0,0,0,0,0,0,0,0,0,0,0,0,0.0,0.0,0.0,0,0,0,0,0,0,0,0,0,2020-12-27 19:15:00
2437,5417,Joe Mattock,3990,[2011],West Bromwich Albion,0,0,0,0,0,0,0,0,0,0,0,0,0,0,0,0,0,0,0.0,0.0,0.0,0,0,0,0,0,0,0,0,0,2020-12-27 19:15:00
2438,5418,Joe Murphy,4374,[2002],West Bromwich Albion,0,0,0,0,0,0,2,1,1,145,0,0,2,1,1,145,0,0,0.0,0.0,0.0,0,0,0,0,0,0,0,0,0,2020-12-27 19:15:00
2439,5419,Joe Powell,4533,[2018],West Ham United,0,0,0,0,0,0,0,0,0,0,0,0,0,0,0,0,0,0,0.0,0.0,0.0,0,0,0,0,0,0,0,0,0,2020-12-27 19:15:00
2440,5420,Joe Ralls,3146,[2018],Cardiff City,15,9,6,848,0,0,13,13,0,1144,0,0,28,22,6,1992,0,0,0.0,0.0,0.0,0,0,0,0,0,0,0,0,0,2020-12-27 19:15:00
2441,5421,Joe Riley,3898,[2011],Bolton Wanderers,1,1,0,90,0,0,2,1,1,111,0,0,3,2,1,201,0,0,0.0,0.0,0.0,0,0,0,0,0,0,0,0,0,2020-12-27 19:15:00
2442,5422,Joe Riley,3898,[2015],Manchester United,0,0,0,0,0,0,0,0,0,0,0,0,0,0,0,0,0,0,0.0,0.0,0.0,0,0,0,0,0,0,0,0,0,2020-12-27 19:15:00
2443,5423,Joe Rodon,4108,[2017],Swansea City,0,0,0,0,0,0,0,0,0,0,0,0,0,0,0,0,0,0,0.0,0.0,0.0,0,0,0,0,0,0,0,0,0,2020-12-27 19:15:00
2444,5424,Joe Rodon,4108,[2020],Tottenham Hotspur,2,0,2,10,0,0,2,1,1,91,0,0,4,1,3,101,0,0,0.0,0.0,0.0,0,0,0,0,0,0,0,0,0,2020-12-27 19:15:00
2445,5425,Joe Rothwell,4565,[2015],Manchester United,0,0,0,0,0,0,0,0,0,0,0,0,0,0,0,0,0,0,0.0,0.0,0.0,0,0,0,0,0,0,0,0,0,2020-12-27 19:15:00
2446,5426,Joe Tupper,4372,[2018],Crystal Palace,0,0,0,0,0,0,0,0,0,0,0,0,0,0,0,0,0,0,0.0,0.0,0.0,0,0,0,0,0,0,0,0,0,2020-12-27 19:15:00
2447,5427,Joe Williams,3947,[2016],Everton FC,0,0,0,0,0,0,0,0,0,0,0,0,0,0,0,0,0,0,0.0,0.0,0.0,0,0,0,0,0,0,0,0,0,2020-12-27 19:15:00
2448,21718,Joe Willock,1480,"[2017, 2018, 2019, 2020]",Arsenal FC,15,4,11,478,0,0,23,8,15,734,1,0,38,12,26,1212,1,0,0.0,0.0,0.0,0,0,0,0,0,0,0,0,0,2020-12-27 19:15:002020-12-27 19:15:002020-12-27 19:15:002020-12-27 19:15:00
2449,10865,Joe-Max Moore,2827,"[2000, 2001]",Everton FC,17,6,11,768,1,0,20,5,15,727,1,0,37,11,26,1495,2,0,3.0,0.0,3.0,1,0,1,0,0,0,0,0,0,2020-12-27 19:15:002020-12-27 19:15:00
2450,5434,Joel,1060,[2012],Wigan Athletic,4,4,0,360,0,0,5,5,0,450,0,0,9,9,0,810,0,0,0.0,0.0,0.0,0,0,0,0,0,0,0,0,0,2020-12-27 19:15:00
2451,27185,Joel,1060,"[2013, 2014, 2015, 2016, 2017]",Everton FC,22,19,3,1846,0,0,20,20,0,1800,0,0,42,39,3,3646,0,0,0.0,0.0,0.0,0,0,0,0,0,0,0,0,0,2020-12-27 19:15:002020-12-27 19:15:002020-12-27 19:15:002020-12-27 19:15:002020-12-27 19:15:00
2452,5440,Joel Asoro,3363,[2016],Sunderland AFC,1,0,1,9,0,0,0,0,0,0,0,0,1,0,1,9,0,0,0.0,0.0,0.0,0,0,0,0,0,0,0,0,0,2020-12-27 19:15:00
2453,10883,Joel Campbell,1593,"[2014, 2015]",Arsenal FC,12,6,6,473,2,0,11,5,6,453,1,0,23,11,12,926,3,0,0.0,0.0,0.0,2,0,2,0,0,0,0,0,0,2020-12-27 19:15:002020-12-27 19:15:00
2454,10887,Joel Coleman,3193,"[2017, 2018]",Huddersfield Town,0,0,0,0,0,0,1,1,0,90,0,0,1,1,0,90,0,0,0.0,0.0,0.0,0,0,0,0,0,0,0,0,0,2020-12-27 19:15:002020-12-27 19:15:00
2455,27235,Joel Matip,1182,"[2016, 2017, 2018, 2019, 2020]",Liverpool FC,47,40,7,3613,3,0,46,41,5,3634,2,0,93,81,12,7247,5,0,0.0,0.0,0.0,1,1,2,0,0,0,0,0,0,2020-12-27 19:15:002020-12-27 19:15:002020-12-27 19:15:002020-12-27 19:15:002020-12-27 19:15:00
2456,5450,Joel McAnuff,1981,[2012],Reading FC,19,19,0,1625,0,0,19,19,0,1649,0,0,38,38,0,3274,0,0,0.0,0.0,0.0,0,0,0,0,0,0,0,0,0,2020-12-27 19:15:00
2457,17457,Joel Mumbongo,3758,"[2019, 2020]",Burnley FC,0,0,0,0,0,0,0,0,0,0,0,0,0,0,0,0,0,0,0.0,0.0,0.0,0,0,0,0,0,0,0,0,0,2020-12-27 19:15:002020-12-27 19:15:00
2458,10905,Joel Pereira,1649,"[2016, 2017]",Manchester United,1,1,0,90,0,0,0,0,0,0,0,0,1,1,0,90,0,0,0.0,0.0,0.0,0,0,0,0,0,0,0,0,0,2020-12-27 19:15:002020-12-27 19:15:00
2459,5454,Joel Taylor,3366,[2016],Stoke City,0,0,0,0,0,0,0,0,0,0,0,0,0,0,0,0,0,0,0.0,0.0,0.0,0,0,0,0,0,0,0,0,0,2020-12-27 19:15:00
2460,5455,Joel Ward,1019,[2009],Portsmouth FC,2,0,2,54,0,0,1,1,0,90,0,0,3,1,2,144,0,0,0.0,0.0,0.0,0,0,0,0,0,0,0,0,0,2020-12-27 19:15:00
2461,43676,Joel Ward,1019,"[2013, 2014, 2015, 2016, 2017, 2018, 2019, 2020]",Crystal Palace,101,99,2,8897,3,0,102,101,1,8962,1,0,203,200,3,17859,4,0,0.0,3.0,3.0,1,1,2,0,0,0,0,0,0,2020-12-27 19:15:002020-12-27 19:15:002020-12-27 19:15:002020-12-27 19:15:002020-12-27 19:15:002020-12-27 19:15:002020-12-27 19:15:002020-12-27 19:15:00
2462,10929,Joelinton,2472,"[2019, 2020]",Newcastle United,25,22,3,1845,1,0,26,19,7,1651,2,0,51,41,10,3496,3,0,0.0,3.0,3.0,0,1,1,0,0,0,0,0,0,2020-12-27 19:15:002020-12-27 19:15:00
2463,27340,Joey Barton,1876,"[2002, 2003, 2004, 2005, 2006]",Manchester City,63,59,4,5249,5,0,59,56,3,5068,10,0,122,115,7,10317,15,0,3.0,4.0,7.0,1,6,7,2,0,2,0,0,0,2020-12-27 19:15:002020-12-27 19:15:002020-12-27 19:15:002020-12-27 19:15:002020-12-27 19:15:00
2464,16416,Joey Barton,1876,"[2007, 2008, 2010]",Newcastle United,30,28,2,2458,5,0,33,29,4,2623,1,0,63,57,6,5081,6,0,0.0,3.0,3.0,3,1,4,3,1,4,0,0,0,2020-12-27 19:15:002020-12-27 19:15:002020-12-27 19:15:00
2465,10949,Joey Barton,1876,"[2011, 2014]",Queens Park Rangers,33,32,1,2840,2,0,26,26,0,2330,2,0,59,58,1,5170,4,0,0.0,0.0,0.0,2,1,3,0,0,0,0,0,0,2020-12-27 19:15:002020-12-27 19:15:00
2466,5476,Joey Barton,1876,[2016],Burnley FC,6,5,1,467,1,0,8,7,1,637,0,0,14,12,2,1104,1,0,3.0,0.0,3.0,1,0,1,0,0,0,0,0,0,2020-12-27 19:15:00
2467,21914,Joey O'Brien,2412,"[2004, 2005, 2007, 2008]",Bolton Wanderers,26,22,4,1933,0,0,25,21,4,1828,0,0,51,43,8,3761,0,0,0.0,0.0,0.0,0,0,0,0,0,0,0,0,0,2020-12-27 19:15:002020-12-27 19:15:002020-12-27 19:15:002020-12-27 19:15:00
2468,21930,Joey O'Brien,2412,"[2012, 2013, 2014, 2015]",West Ham United,31,25,6,2241,2,0,28,26,2,2244,0,0,59,51,8,4485,2,0,1.0,0.0,1.0,1,0,1,0,0,0,0,0,0,2020-12-27 19:15:002020-12-27 19:15:002020-12-27 19:15:002020-12-27 19:15:00
2469,5485,Johan Cavalli,4283,[2006],Watford FC,2,1,1,73,0,0,1,1,0,75,0,0,3,2,1,148,0,0,0.0,0.0,0.0,0,0,0,0,0,0,0,0,0,2020-12-27 19:15:00
2470,43916,Johan Djourou,1229,"[2005, 2006, 2007, 2008, 2009, 2010, 2011, 2012]",Arsenal FC,41,37,4,3334,0,0,43,33,10,2896,1,0,84,70,14,6230,1,0,0.0,0.0,0.0,0,0,0,0,0,0,0,0,0,2020-12-27 19:15:002020-12-27 19:15:002020-12-27 19:15:002020-12-27 19:15:002020-12-27 19:15:002020-12-27 19:15:002020-12-27 19:15:002020-12-27 19:15:00
2471,16485,Johan Elmander,1378,"[2008, 2009, 2010]",Bolton Wanderers,45,40,5,3409,5,0,46,41,5,3336,13,0,91,81,10,6745,18,0,0.0,1.0,1.0,1,4,5,0,0,0,0,0,0,2020-12-27 19:15:002020-12-27 19:15:002020-12-27 19:15:00
2472,5497,Johan Elmander,1378,[2013],Norwich City,13,9,4,712,0,0,16,7,9,774,1,0,29,16,13,1486,1,0,0.0,0.0,0.0,0,0,0,0,0,0,0,0,0,2020-12-27 19:15:00
2473,5498,Johann Smith,1723,[2006],Bolton Wanderers,1,0,1,5,0,0,0,0,0,0,0,0,1,0,1,5,0,0,0.0,0.0,0.0,0,0,0,0,0,0,0,0,0,2020-12-27 19:15:00
2474,10999,Johann Vogel,3117,"[2007, 2008]",Blackburn Rovers,4,3,1,243,0,0,3,3,0,231,0,0,7,6,1,474,0,0,0.0,0.0,0.0,0,0,0,0,0,0,0,0,0,2020-12-27 19:15:002020-12-27 19:15:00
2475,5501,John Aloisi,3986,[2000],Coventry City,10,2,8,375,1,0,8,6,2,424,2,0,18,8,10,799,3,0,0.0,0.0,0.0,1,2,3,0,0,0,0,0,0,2020-12-27 19:15:00
2476,5502,John Arne Riise,2362,[2001],West Ham United,1,1,0,90,0,0,0,0,0,0,0,0,1,1,0,90,0,0,0.0,0.0,0.0,0,0,0,0,0,0,0,0,0,2020-12-27 19:15:00
2477,33033,John Arne Riise,2362,"[2002, 2003, 2004, 2005, 2006, 2007]",Liverpool FC,98,84,14,7682,6,0,95,75,20,6840,8,0,193,159,34,14522,14,0,1.0,9.0,10.0,4,6,10,0,0,0,0,0,0,2020-12-27 19:15:002020-12-27 19:15:002020-12-27 19:15:002020-12-27 19:15:002020-12-27 19:15:002020-12-27 19:15:00
2478,16530,John Arne Riise,2362,"[2011, 2012, 2013]",Fulham FC,44,43,1,3736,1,0,43,38,5,3423,0,0,87,81,6,7159,1,0,0.0,0.0,0.0,1,0,1,0,0,0,0,0,0,2020-12-27 19:15:002020-12-27 19:15:002020-12-27 19:15:00
2479,5512,John Bostock,3993,[2010],Tottenham Hotspur,0,0,0,0,0,0,0,0,0,0,0,0,0,0,0,0,0,0,0.0,0.0,0.0,0,0,0,0,0,0,0,0,0,2020-12-27 19:15:00
2480,22058,John Carew,1621,"[2006, 2007, 2008, 2009]",Aston Villa,51,39,12,3608,22,0,50,43,7,3617,15,0,101,82,19,7225,37,0,15.0,3.0,18.0,12,13,25,2,0,2,0,0,0,2020-12-27 19:15:002020-12-27 19:15:002020-12-27 19:15:002020-12-27 19:15:00
2481,5517,John Carew,1621,[2010],Stoke City,3,2,1,167,1,0,7,5,2,449,0,0,10,7,3,616,1,0,0.0,0.0,0.0,1,0,1,0,0,0,0,0,0,2020-12-27 19:15:00
2482,11037,John Collins,2895,"[2001, 2002]",Fulham FC,17,12,5,1079,0,0,19,15,4,1369,0,0,36,27,9,2448,0,0,0.0,0.0,0.0,0,0,0,0,0,0,0,0,0,2020-12-27 19:15:002020-12-27 19:15:00
2483,11041,John Curtis,2461,"[2001, 2002]",Blackburn Rovers,6,6,0,445,0,0,7,7,0,509,0,0,13,13,0,954,0,0,0.0,0.0,0.0,0,0,0,0,0,0,0,0,0,2020-12-27 19:15:002020-12-27 19:15:00
2484,5522,John Curtis,2461,[2003],Leicester City,8,7,1,663,0,0,7,7,0,544,0,0,15,14,1,1207,0,0,0.0,0.0,0.0,0,0,0,0,0,0,0,0,0,2020-12-27 19:15:00
2485,5523,John Curtis,2461,[2004],Portsmouth FC,0,0,0,0,0,0,1,0,1,20,0,0,1,0,1,20,0,0,0.0,0.0,0.0,0,0,0,0,0,0,0,0,0,2020-12-27 19:15:00
2486,5524,John Egan,3467,[2011],Sunderland AFC,0,0,0,0,0,0,0,0,0,0,0,0,0,0,0,0,0,0,0.0,0.0,0.0,0,0,0,0,0,0,0,0,0,2020-12-27 19:15:00
2487,11051,John Egan,3467,"[2019, 2020]",Sheffield United,25,25,0,2239,1,0,25,25,0,2250,1,0,50,50,0,4489,2,0,3.0,1.0,4.0,1,1,2,0,0,0,0,0,0,2020-12-27 19:15:002020-12-27 19:15:00
2488,5527,John Eustace,2101,[2000],Leeds United,1,1,0,90,0,0,0,0,0,0,0,0,1,1,0,90,0,0,0.0,0.0,0.0,0,0,0,0,0,0,0,0,0,2020-12-27 19:15:00
2489,5528,John Eustace,2101,[2002],Middlesbrough FC,0,0,0,0,0,0,1,0,1,3,0,0,1,0,1,3,0,0,0.0,0.0,0.0,0,0,0,0,0,0,0,0,0,2020-12-27 19:15:00
2490,11059,John Filan,1815,"[2005, 2006]",Wigan Athletic,13,13,0,1125,0,0,12,12,0,1080,0,0,25,25,0,2205,0,0,0.0,0.0,0.0,0,0,0,0,0,0,0,0,0,2020-12-27 19:15:002020-12-27 19:15:00
2491,11063,John Fleck,3468,"[2019, 2020]",Sheffield United,19,18,1,1589,4,0,20,18,2,1590,1,0,39,36,3,3179,5,0,0.0,1.0,1.0,2,1,3,0,0,0,0,0,0,2020-12-27 19:15:002020-12-27 19:15:00
2492,5533,John Guidetti,1558,[2010],Manchester City,0,0,0,0,0,0,0,0,0,0,0,0,0,0,0,0,0,0,0.0,0.0,0.0,0,0,0,0,0,0,0,0,0,2020-12-27 19:15:00
2493,5534,John Guidetti,1558,[2013],Stoke City,2,0,2,27,0,0,4,0,4,44,0,0,6,0,6,71,0,0,0.0,0.0,0.0,0,0,0,0,0,0,0,0,0,2020-12-27 19:15:00
2494,5535,John Halls,4479,[2007],Reading FC,0,0,0,0,0,0,1,0,1,7,0,0,1,0,1,7,0,0,0.0,0.0,0.0,0,0,0,0,0,0,0,0,0,2020-12-27 19:15:00
2495,5536,John Hartson,3832,[2000],West Ham United,1,1,0,90,0,0,0,0,0,0,0,0,1,1,0,90,0,0,0.0,0.0,0.0,0,0,0,0,0,0,0,0,0,2020-12-27 19:15:00
2496,27695,John Heitinga,1745,"[2009, 2010, 2011, 2012, 2013]",Everton FC,61,53,8,4645,2,0,54,45,9,4007,0,0,115,98,17,8652,2,0,1.0,0.0,1.0,1,0,1,0,0,0,0,0,0,2020-12-27 19:15:002020-12-27 19:15:002020-12-27 19:15:002020-12-27 19:15:002020-12-27 19:15:00
2497,5542,John Johnson,4469,[2008],Middlesbrough FC,1,0,1,36,0,0,0,0,0,0,0,0,1,0,1,36,0,0,0.0,0.0,0.0,0,0,0,0,0,0,0,0,0,2020-12-27 19:15:00
2498,5543,John Lukic,3495,[2000],Arsenal FC,2,2,0,180,0,0,1,1,0,90,0,0,3,3,0,270,0,0,0.0,0.0,0.0,0,0,0,0,0,0,0,0,0,2020-12-27 19:15:00
2499,11089,John Lundstram,3471,"[2019, 2020]",Sheffield United,23,16,7,1496,4,0,23,19,4,1778,1,0,46,35,11,3274,5,0,6.0,0.0,6.0,3,1,4,0,0,0,0,0,0,2020-12-27 19:15:002020-12-27 19:15:00
2500,11093,John McGinn,2846,"[2019, 2020]",Aston Villa,22,21,1,1790,2,0,19,19,0,1697,2,0,41,40,1,3487,4,0,0.0,0.0,0.0,1,2,3,0,0,0,0,0,0,2020-12-27 19:15:002020-12-27 19:15:00
2501,5548,John McGrath,3917,[2000],Aston Villa,1,0,1,45,0,0,1,0,1,1,0,0,2,0,2,46,0,0,0.0,0.0,0.0,0,0,0,0,0,0,0,0,0,2020-12-27 19:15:00
2502,11099,John McGreal,2718,"[2000, 2001]",Ipswich Town,25,23,2,2107,1,0,28,27,1,2362,1,0,53,50,3,4469,2,0,3.0,0.0,3.0,1,1,2,0,0,0,0,0,0,2020-12-27 19:15:002020-12-27 19:15:00
2503,11103,John Mensah,1685,"[2009, 2010]",Sunderland AFC,21,18,3,1304,0,0,13,11,2,975,1,0,34,29,5,2279,1,0,0.0,0.0,0.0,0,0,0,0,0,0,0,0,0,2020-12-27 19:15:002020-12-27 19:15:00
2504,55575,John Mikel Obi,1769,"[2006, 2007, 2008, 2009, 2010, 2011, 2012, 2013, 2014, 2015]",Chelsea FC,116,82,34,7313,1,0,132,100,32,8919,0,0,248,182,66,16232,1,0,0.0,0.0,0.0,0,0,0,0,0,0,0,0,0,2020-12-27 19:15:002020-12-27 19:15:002020-12-27 19:15:002020-12-27 19:15:002020-12-27 19:15:002020-12-27 19:15:002020-12-27 19:15:002020-12-27 19:15:002020-12-27 19:15:002020-12-27 19:15:00
2505,16692,John Moncur,2043,"[2000, 2001, 2002]",West Ham United,20,5,15,558,0,0,20,7,13,665,0,0,40,12,28,1223,0,0,0.0,0.0,0.0,0,0,0,0,0,0,0,0,0,2020-12-27 19:15:002020-12-27 19:15:002020-12-27 19:15:00
2506,55705,John O'Shea,1729,"[2001, 2002, 2003, 2004, 2005, 2006, 2007, 2008, 2009, 2010]",Manchester United,121,90,31,8314,3,0,130,93,37,8563,7,0,251,183,68,16877,10,0,3.0,6.0,9.0,1,3,4,0,0,0,0,0,0,2020-12-27 19:15:002020-12-27 19:15:002020-12-27 19:15:002020-12-27 19:15:002020-12-27 19:15:002020-12-27 19:15:002020-12-27 19:15:002020-12-27 19:15:002020-12-27 19:15:002020-12-27 19:15:00
2507,33471,John O'Shea,1729,"[2011, 2012, 2013, 2014, 2015, 2016]",Sunderland AFC,96,92,4,7736,3,0,93,90,3,8072,0,0,189,182,7,15808,3,0,1.0,0.0,1.0,3,0,3,0,0,0,0,0,0,2020-12-27 19:15:002020-12-27 19:15:002020-12-27 19:15:002020-12-27 19:15:002020-12-27 19:15:002020-12-27 19:15:00
2508,11165,John Oster,2704,"[2000, 2002]",Sunderland AFC,5,2,3,205,0,0,6,1,5,168,0,0,11,3,8,373,0,0,0.0,0.0,0.0,0,0,0,0,0,0,0,0,0,2020-12-27 19:15:002020-12-27 19:15:00
2509,11169,John Oster,2704,"[2006, 2007]",Reading FC,24,9,15,933,0,0,19,9,10,923,1,0,43,18,25,1856,1,0,0.0,0.0,0.0,0,0,0,0,0,0,0,0,0,2020-12-27 19:15:002020-12-27 19:15:00
2510,11173,John Paintsil,2036,"[2006, 2007]",West Ham United,8,2,6,326,0,0,10,5,5,623,0,0,18,7,11,949,0,0,0.0,0.0,0.0,0,0,0,0,0,0,0,0,0,2020-12-27 19:15:002020-12-27 19:15:00
2511,16767,John Paintsil,2036,"[2008, 2009, 2010]",Fulham FC,36,35,1,3146,0,0,33,33,0,2851,0,0,69,68,1,5997,0,0,0.0,0.0,0.0,0,0,0,0,0,0,0,0,0,2020-12-27 19:15:002020-12-27 19:15:002020-12-27 19:15:00
2512,5591,John Piercy,3965,[2000],Tottenham Hotspur,2,0,2,21,0,0,3,0,3,41,0,0,5,0,5,62,0,0,0.0,0.0,0.0,0,0,0,0,0,0,0,0,0,2020-12-27 19:15:00
2513,16779,John Robinson,1678,"[2000, 2001, 2002]",Charlton Athletic,35,25,10,2332,3,0,33,21,12,1813,0,0,68,46,22,4145,3,0,1.0,0.0,1.0,1,0,1,0,0,0,0,0,0,2020-12-27 19:15:002020-12-27 19:15:002020-12-27 19:15:00
2514,5595,John Ruddy,1367,[2005],Everton FC,1,0,1,80,0,0,0,0,0,0,0,0,1,0,1,80,0,0,0.0,0.0,0.0,0,0,0,0,0,0,0,0,0,2020-12-27 19:15:00
2515,22390,John Ruddy,1367,"[2011, 2012, 2013, 2015]",Norwich City,58,58,0,5220,0,0,59,59,0,5302,0,0,117,117,0,10522,0,0,0.0,0.0,0.0,0,0,0,0,0,0,0,0,0,2020-12-27 19:15:002020-12-27 19:15:002020-12-27 19:15:002020-12-27 19:15:00
2516,16803,John Ruddy,1367,"[2018, 2019, 2020]",Wolverhampton Wanderers,1,1,0,90,0,0,0,0,0,0,0,0,1,1,0,90,0,0,0.0,0.0,0.0,0,0,0,0,0,0,0,0,0,2020-12-27 19:15:002020-12-27 19:15:002020-12-27 19:15:00
2517,11207,John Salako,2336,"[2000, 2001]",Charlton Athletic,11,4,7,364,0,0,8,2,6,205,0,0,19,6,13,569,0,0,0.0,0.0,0.0,0,0,0,0,0,0,0,0,0,2020-12-27 19:15:002020-12-27 19:15:00
2518,5605,John Scales,3877,[2000],Ipswich Town,0,0,0,0,0,0,2,2,0,180,0,0,2,2,0,180,0,0,0.0,0.0,0.0,0,0,0,0,0,0,0,0,0,2020-12-27 19:15:00
2519,22430,John Stones,1197,"[2012, 2013, 2014, 2015]",Everton FC,41,35,6,3133,1,0,36,34,2,3060,0,0,77,69,8,6193,1,0,0.0,0.0,0.0,0,0,0,0,0,0,0,0,0,2020-12-27 19:15:002020-12-27 19:15:002020-12-27 19:15:002020-12-27 19:15:00
2520,28060,John Stones,1197,"[2016, 2017, 2018, 2019, 2020]",Manchester City,46,39,7,3422,0,0,45,38,7,3319,0,0,91,77,14,6741,0,0,0.0,0.0,0.0,0,0,0,0,0,0,0,0,0,2020-12-27 19:15:002020-12-27 19:15:002020-12-27 19:15:002020-12-27 19:15:002020-12-27 19:15:00
2521,5615,John Swift,4355,[2013],Chelsea FC,0,0,0,0,0,0,1,0,1,1,0,0,1,0,1,1,0,0,0.0,0.0,0.0,0,0,0,0,0,0,0,0,0,2020-12-27 19:15:00
2522,95608,John Terry,1534,"[2000, 2001, 2002, 2003, 2004, 2005, 2006, 2007, 2008, 2009, 2010, 2011, 2012, 2013, 2014, 2015, 2016]",Chelsea FC,247,237,10,20900,20,0,234,229,5,20462,21,0,481,466,15,41362,41,0,10.0,9.0,19.0,16,15,31,0,0,0,0,0,0,2020-12-27 19:15:002020-12-27 19:15:002020-12-27 19:15:002020-12-27 19:15:002020-12-27 19:15:002020-12-27 19:15:002020-12-27 19:15:002020-12-27 19:15:002020-12-27 19:15:002020-12-27 19:15:002020-12-27 19:15:002020-12-27 19:15:002020-12-27 19:15:002020-12-27 19:15:002020-12-27 19:15:002020-12-27 19:15:002020-12-27 19:15:00
2523,16902,John Utaka,2813,"[2007, 2008, 2009]",Portsmouth FC,31,18,13,1674,3,0,33,20,13,2015,4,0,64,38,26,3689,7,0,0.0,0.0,0.0,3,1,4,0,0,0,0,0,0,2020-12-27 19:15:002020-12-27 19:15:002020-12-27 19:15:00
2524,11273,John Welsh,4139,"[2003, 2004]",Liverpool FC,2,1,1,81,0,0,2,1,1,102,0,0,4,2,2,183,0,0,0.0,0.0,0.0,0,0,0,0,0,0,0,0,0,2020-12-27 19:15:002020-12-27 19:15:00
2525,5638,John-Kymani Gordon,4514,[2019],Crystal Palace,0,0,0,0,0,0,0,0,0,0,0,0,0,0,0,0,0,0,0.0,0.0,0.0,0,0,0,0,0,0,0,0,0,2020-12-27 19:15:00
2526,16920,Johnnie Jackson,3392,"[2003, 2004, 2005]",Tottenham Hotspur,13,8,5,750,0,0,7,4,3,302,1,0,20,12,8,1052,1,0,0.0,0.0,0.0,0,0,0,0,0,0,0,0,0,2020-12-27 19:15:002020-12-27 19:15:002020-12-27 19:15:00
2527,5642,Johnny Gorman,4387,[2011],Wolverhampton Wanderers,0,0,0,0,0,0,1,0,1,1,0,0,1,0,1,1,0,0,0.0,0.0,0.0,0,0,0,0,0,0,0,0,0,2020-12-27 19:15:00
2528,16932,Joleon Lescott,1365,"[2006, 2007, 2008]",Everton FC,55,53,2,4855,7,0,51,49,2,4490,7,0,106,102,4,9345,14,0,3.0,3.0,6.0,6,5,11,0,0,0,0,0,0,2020-12-27 19:15:002020-12-27 19:15:002020-12-27 19:15:00
2529,28240,Joleon Lescott,1365,"[2009, 2010, 2011, 2012, 2013]",Manchester City,58,50,8,4694,5,0,48,41,7,3678,2,0,106,91,15,8372,7,0,0.0,3.0,3.0,2,2,4,0,0,0,0,0,0,2020-12-27 19:15:002020-12-27 19:15:002020-12-27 19:15:002020-12-27 19:15:002020-12-27 19:15:00
2530,5651,Joleon Lescott,1365,[2014],West Bromwich Albion,17,17,0,1530,0,0,17,17,0,1530,1,0,34,34,0,3060,1,0,0.0,0.0,0.0,0,1,1,0,0,0,0,0,0,2020-12-27 19:15:00
2531,5652,Joleon Lescott,1365,[2015],Aston Villa,15,15,0,1306,2,0,15,15,0,1325,1,0,30,30,0,2631,3,0,3.0,0.0,3.0,2,1,3,0,0,0,0,0,0,2020-12-27 19:15:00
2532,5653,Joleon Lescott,1365,[2016],Sunderland AFC,0,0,0,0,0,0,2,1,1,123,0,0,2,1,1,123,0,0,0.0,0.0,0.0,0,0,0,0,0,0,0,0,0,2020-12-27 19:15:00
2533,5654,Jon Ashton,3830,[2001],Leicester City,5,3,2,259,0,0,2,0,2,83,0,0,7,3,4,342,0,0,0.0,0.0,0.0,0,0,0,0,0,0,0,0,0,2020-12-27 19:15:00
2534,28286,Jon Flanagan,1263,"[2010, 2011, 2013, 2015, 2017]",Liverpool FC,20,20,0,1674,0,0,20,20,0,1651,1,0,40,40,0,3325,1,0,0.0,0.0,0.0,0,0,0,0,0,0,0,0,0,2020-12-27 19:15:002020-12-27 19:15:002020-12-27 19:15:002020-12-27 19:15:002020-12-27 19:15:00
2535,5659,Jon Flanagan,1263,[2016],Burnley FC,3,2,1,187,0,0,3,1,2,172,0,0,6,3,3,359,0,0,0.0,0.0,0.0,0,0,0,0,0,0,0,0,0,2020-12-27 19:15:00
2536,5661,Jon Harley,3053,[2000],Chelsea FC,3,2,1,194,0,0,7,4,3,324,0,0,10,6,4,518,0,0,0.0,0.0,0.0,0,0,0,0,0,0,0,0,0,2020-12-27 19:15:00
2537,16989,Jon Harley,3053,"[2001, 2002, 2003]",Fulham FC,13,9,4,883,1,0,9,7,2,663,0,0,22,16,6,1546,1,0,3.0,0.0,3.0,1,0,1,0,0,0,0,0,0,2020-12-27 19:15:002020-12-27 19:15:002020-12-27 19:15:00
2538,16998,Jon Macken,3125,"[2002, 2003, 2004]",Manchester City,23,10,13,1024,2,0,18,11,7,944,0,0,41,21,20,1968,2,0,0.0,0.0,0.0,1,0,1,0,0,0,0,0,0,2020-12-27 19:15:002020-12-27 19:15:002020-12-27 19:15:00
2539,5668,Jon Macken,3125,[2007],Derby County,2,0,2,16,0,0,1,0,1,25,0,0,3,0,3,41,0,0,0.0,0.0,0.0,0,0,0,0,0,0,0,0,0,2020-12-27 19:15:00
2540,5669,Jon Otsemobor,4302,[2003],Liverpool FC,2,2,0,180,0,0,2,2,0,118,0,0,4,4,0,298,0,0,0.0,0.0,0.0,0,0,0,0,0,0,0,0,0,2020-12-27 19:15:00
2541,5670,Jon Routledge,4208,[2008],Wigan Athletic,1,0,1,1,0,0,0,0,0,0,0,0,1,0,1,1,0,0,0.0,0.0,0.0,0,0,0,0,0,0,0,0,0,2020-12-27 19:15:00
2542,11343,Jon Stanković,3215,"[2017, 2018]",Huddersfield Town,3,3,0,218,0,0,8,6,2,502,1,0,11,9,2,720,1,0,0.0,0.0,0.0,0,0,0,0,0,0,0,0,0,2020-12-27 19:15:002020-12-27 19:15:00
2543,11347,Jon Stead,1139,"[2003, 2004]",Blackburn Rovers,19,14,5,1281,2,0,21,17,4,1501,6,0,40,31,9,2782,8,0,4.0,12.0,16.0,2,5,7,0,0,0,0,0,0,2020-12-27 19:15:002020-12-27 19:15:00
2544,5675,Jon Stead,1139,[2005],Sunderland AFC,17,12,5,1047,0,0,13,9,4,649,1,0,30,21,9,1696,1,0,0.0,0.0,0.0,0,1,1,0,0,0,0,0,0,2020-12-27 19:15:00
2545,5676,Jon Stead,1139,[2006],Sheffield United,7,7,0,585,3,0,5,3,2,297,2,0,12,10,2,882,5,0,0.0,1.0,1.0,2,2,4,0,0,0,0,0,0,2020-12-27 19:15:00
2546,5677,Jon Walters,1555,[2002],Bolton Wanderers,4,0,4,36,0,0,0,0,0,0,0,0,4,0,4,36,0,0,0.0,0.0,0.0,0,0,0,0,0,0,0,0,0,2020-12-27 19:15:00
2547,39767,Jon Walters,1555,"[2010, 2011, 2012, 2013, 2014, 2015, 2016]",Stoke City,114,92,22,8150,30,0,112,97,15,8530,13,0,226,189,37,16680,43,0,13.0,1.0,14.0,19,9,28,6,5,11,0,0,0,2020-12-27 19:15:002020-12-27 19:15:002020-12-27 19:15:002020-12-27 19:15:002020-12-27 19:15:002020-12-27 19:15:002020-12-27 19:15:00
2548,11371,Jon Walters,1555,"[2017, 2018]",Burnley FC,1,0,1,12,0,0,2,0,2,24,0,0,3,0,3,36,0,0,0.0,0.0,0.0,0,0,0,0,0,0,0,0,0,2020-12-27 19:15:002020-12-27 19:15:00
2549,11375,Jonas Lössl,2449,"[2017, 2018]",Huddersfield Town,35,34,1,3137,0,0,34,34,0,3060,0,0,69,68,1,6197,0,0,0.0,0.0,0.0,0,0,0,0,0,0,0,0,0,2020-12-27 19:15:002020-12-27 19:15:00
2550,11379,Jonas Lössl,2449,"[2019, 2020]",Everton FC,0,0,0,0,0,0,0,0,0,0,0,0,0,0,0,0,0,0,0.0,0.0,0.0,0,0,0,0,0,0,0,0,0,2020-12-27 19:15:002020-12-27 19:15:00
2551,45556,Jonas Olsson,1771,"[2008, 2010, 2011, 2012, 2013, 2014, 2015, 2016]",West Bromwich Albion,101,97,4,8434,2,0,100,97,3,8671,6,0,201,194,7,17105,8,0,0.0,7.0,7.0,1,6,7,0,0,0,0,0,0,2020-12-27 19:15:002020-12-27 19:15:002020-12-27 19:15:002020-12-27 19:15:002020-12-27 19:15:002020-12-27 19:15:002020-12-27 19:15:002020-12-27 19:15:00
2552,34209,Jonatan Johansson,1676,"[2000, 2001, 2002, 2003, 2004, 2005]",Charlton Athletic,72,45,27,4293,21,0,71,42,29,3836,6,0,143,87,56,8129,27,0,9.0,1.0,10.0,14,5,19,0,0,0,0,0,0,2020-12-27 19:15:002020-12-27 19:15:002020-12-27 19:15:002020-12-27 19:15:002020-12-27 19:15:002020-12-27 19:15:00
2553,5705,Jonathan Benteke,3013,[2016],Crystal Palace,0,0,0,0,0,0,1,0,1,6,0,0,1,0,1,6,0,0,0.0,0.0,0.0,0,0,0,0,0,0,0,0,0,2020-12-27 19:15:00
2554,11413,Jonathan Blondel,3480,"[2002, 2003]",Tottenham Hotspur,2,0,2,37,0,0,0,0,0,0,0,0,2,0,2,37,0,0,0.0,0.0,0.0,0,0,0,0,0,0,0,0,0,2020-12-27 19:15:002020-12-27 19:15:00
2555,5708,Jonathan Calleri,3039,[2016],West Ham United,8,3,5,369,0,0,8,1,7,166,1,0,16,4,12,535,1,0,0.0,0.0,0.0,0,0,0,0,0,0,0,0,0,2020-12-27 19:15:00
2556,17130,Jonathan Douglas,1138,"[2002, 2003, 2004]",Blackburn Rovers,9,8,1,592,0,0,6,5,1,495,1,0,15,13,2,1087,1,0,0.0,0.0,0.0,0,1,1,0,0,0,0,0,0,2020-12-27 19:15:002020-12-27 19:15:002020-12-27 19:15:00
2557,34287,Jonathan Fortune,2665,"[2001, 2002, 2003, 2004, 2005, 2006]",Charlton Athletic,54,43,11,4131,2,0,62,48,14,4628,3,0,116,91,25,8759,5,0,1.0,0.0,1.0,2,1,3,0,0,0,0,0,0,2020-12-27 19:15:002020-12-27 19:15:002020-12-27 19:15:002020-12-27 19:15:002020-12-27 19:15:002020-12-27 19:15:00
2558,5718,Jonathan Franks,4458,[2008],Middlesbrough FC,0,0,0,0,0,0,1,0,1,10,0,0,1,0,1,10,0,0,0.0,0.0,0.0,0,0,0,0,0,0,0,0,0,2020-12-27 19:15:00
2559,5719,Jonathan Greening,1321,[2000],Manchester United,6,3,3,253,0,0,1,0,1,20,0,0,7,3,4,273,0,0,0.0,0.0,0.0,0,0,0,0,0,0,0,0,0,2020-12-27 19:15:00
2560,17163,Jonathan Greening,1321,"[2001, 2002, 2003]",Middlesbrough FC,49,46,3,4059,3,0,47,42,5,3699,1,0,96,88,8,7758,4,0,0.0,3.0,3.0,1,1,2,0,0,0,0,0,0,2020-12-27 19:15:002020-12-27 19:15:002020-12-27 19:15:00
2561,17172,Jonathan Greening,1321,"[2004, 2005, 2008]",West Bromwich Albion,52,52,0,4560,3,0,53,49,4,4482,1,0,105,101,4,9042,4,0,0.0,0.0,0.0,2,1,3,0,0,0,0,0,0,2020-12-27 19:15:002020-12-27 19:15:002020-12-27 19:15:00
2562,11453,Jonathan Greening,1321,"[2009, 2010]",Fulham FC,15,10,5,906,1,0,18,11,7,1121,0,0,33,21,12,2027,1,0,3.0,0.0,3.0,1,0,1,0,0,0,0,0,0,2020-12-27 19:15:002020-12-27 19:15:00
2563,11457,Jonathan Grounds,4077,"[2007, 2008]",Middlesbrough FC,4,4,0,324,0,0,3,3,0,243,0,0,7,7,0,567,0,0,0.0,0.0,0.0,0,0,0,0,0,0,0,0,0,2020-12-27 19:15:002020-12-27 19:15:00
2564,5730,Jonathan Henly,4420,[2012],Reading FC,0,0,0,0,0,0,0,0,0,0,0,0,0,0,0,0,0,0,0.0,0.0,0.0,0,0,0,0,0,0,0,0,0,2020-12-27 19:15:00
2565,5731,Jonathan Hogg,2598,[2010],Aston Villa,3,3,0,226,0,0,2,2,0,171,0,0,5,5,0,397,0,0,0.0,0.0,0.0,0,0,0,0,0,0,0,0,0,2020-12-27 19:15:00
2566,11465,Jonathan Hogg,2598,"[2017, 2018]",Huddersfield Town,33,32,1,2682,0,0,26,26,0,2159,0,0,59,58,1,4841,0,0,0.0,0.0,0.0,0,0,0,0,0,0,0,0,0,2020-12-27 19:15:002020-12-27 19:15:00
2567,5734,Jonathan Hutchinson,4189,[2002],Birmingham City,0,0,0,0,0,0,1,1,0,90,0,0,1,1,0,90,0,0,0.0,0.0,0.0,0,0,0,0,0,0,0,0,0,2020-12-27 19:15:00
2568,5735,Jonathan Kodjia,4099,[2019],Aston Villa,2,0,2,38,0,0,4,0,4,73,0,0,6,0,6,111,0,0,0.0,0.0,0.0,0,0,0,0,0,0,0,0,0,2020-12-27 19:15:00
2569,17211,Jonathan Leko,3553,"[2015, 2016, 2017]",West Bromwich Albion,8,2,6,281,0,0,6,1,5,119,0,0,14,3,11,400,0,0,0.0,0.0,0.0,0,0,0,0,0,0,0,0,0,2020-12-27 19:15:002020-12-27 19:15:002020-12-27 19:15:00
2570,5739,Jonathan Parr,3409,[2013],Crystal Palace,7,2,5,290,0,0,8,5,3,462,0,0,15,7,8,752,0,0,0.0,0.0,0.0,0,0,0,0,0,0,0,0,0,2020-12-27 19:15:00
2571,5740,Jonathan Spector,1288,[2004],Manchester United,2,1,1,96,0,0,1,1,0,75,0,0,3,2,1,171,0,0,0.0,0.0,0.0,0,0,0,0,0,0,0,0,0,2020-12-27 19:15:00
2572,5741,Jonathan Spector,1288,[2005],Charlton Athletic,9,6,3,538,0,0,11,7,4,708,0,0,20,13,7,1246,0,0,0.0,0.0,0.0,0,0,0,0,0,0,0,0,0,2020-12-27 19:15:00
2573,28720,Jonathan Spector,1288,"[2006, 2007, 2008, 2009, 2010]",West Ham United,47,32,15,3352,0,0,52,32,20,3194,1,0,99,64,35,6546,1,0,0.0,0.0,0.0,0,1,1,0,0,0,0,0,0,2020-12-27 19:15:002020-12-27 19:15:002020-12-27 19:15:002020-12-27 19:15:002020-12-27 19:15:00
2574,5747,Jonathan Stevenson,3927,[2001],Leicester City,2,0,2,71,1,0,4,0,4,44,0,0,6,0,6,115,1,0,1.0,0.0,1.0,1,0,1,0,0,0,0,0,0,2020-12-27 19:15:00
2575,17247,Jonathan Williams,3415,"[2013, 2014, 2015]",Crystal Palace,7,0,7,121,0,0,5,0,5,104,0,0,12,0,12,225,0,0,0.0,0.0,0.0,0,0,0,0,0,0,0,0,0,2020-12-27 19:15:002020-12-27 19:15:002020-12-27 19:15:00
2576,17256,Jonathan Woodgate,1882,"[2000, 2001, 2002]",Leeds United,18,18,0,1546,2,0,23,21,2,1708,0,0,41,39,2,3254,2,0,0.0,0.0,0.0,1,0,1,0,0,0,0,0,0,2020-12-27 19:15:002020-12-27 19:15:002020-12-27 19:15:00
2577,5754,Jonathan Woodgate,1882,[2003],Newcastle United,11,11,0,933,0,0,7,7,0,630,0,0,18,18,0,1563,0,0,0.0,0.0,0.0,0,0,0,0,0,0,0,0,0,2020-12-27 19:15:00
2578,5755,Jonathan Woodgate,1882,[2006],Middlesbrough FC,14,14,0,1159,0,0,15,15,0,1350,0,0,29,29,0,2509,0,0,0.0,0.0,0.0,0,0,0,0,0,0,0,0,0,2020-12-27 19:15:00
2579,23030,Jonathan Woodgate,1882,"[2007, 2008, 2009, 2010]",Tottenham Hotspur,28,28,0,2307,1,0,20,20,0,1799,1,0,48,48,0,4106,2,0,0.0,3.0,3.0,1,1,2,0,0,0,0,0,0,2020-12-27 19:15:002020-12-27 19:15:002020-12-27 19:15:002020-12-27 19:15:00
2580,5760,Jonathan Woodgate,1882,[2011],Stoke City,7,6,1,522,0,0,10,10,0,758,0,0,17,16,1,1280,0,0,0.0,0.0,0.0,0,0,0,0,0,0,0,0,0,2020-12-27 19:15:00
2581,11523,Jonathan de Guzmán,2937,"[2012, 2013]",Swansea City,36,32,4,2701,7,0,35,27,8,2505,2,0,71,59,12,5206,9,0,0.0,0.0,0.0,2,0,2,0,0,0,0,0,0,2020-12-27 19:15:002020-12-27 19:15:00
2582,5763,Jonjo Dickman,4339,[2002],Sunderland AFC,0,0,0,0,0,0,1,0,1,44,0,0,1,0,1,44,0,0,0.0,0.0,0.0,0,0,0,0,0,0,0,0,0,2020-12-27 19:15:00
2583,17295,Jonjo Shelvey,1699,"[2010, 2011, 2012]",Liverpool FC,26,8,18,913,1,0,21,9,12,1105,0,0,47,17,30,2018,1,0,0.0,0.0,0.0,0,0,0,0,0,0,0,0,0,2020-12-27 19:15:002020-12-27 19:15:002020-12-27 19:15:00
2584,17304,Jonjo Shelvey,1699,"[2013, 2014, 2015]",Swansea City,39,34,5,2985,6,0,40,37,3,3186,4,0,79,71,8,6171,10,0,2.0,6.0,8.0,5,2,7,2,0,2,0,0,0,2020-12-27 19:15:002020-12-27 19:15:002020-12-27 19:15:00
2585,23086,Jonjo Shelvey,1699,"[2017, 2018, 2019, 2020]",Newcastle United,45,38,7,3362,3,0,35,30,5,2717,5,0,80,68,12,6079,8,0,2.0,0.0,2.0,3,2,5,0,0,0,0,0,0,2020-12-27 19:15:002020-12-27 19:15:002020-12-27 19:15:002020-12-27 19:15:00
2586,28880,Jonjoe Kenny,1050,"[2015, 2016, 2017, 2018, 2020]",Everton FC,17,11,6,1164,0,0,18,15,3,1367,0,0,35,26,9,2531,0,0,0.0,0.0,0.0,0,0,0,0,0,0,0,0,0,2020-12-27 19:15:002020-12-27 19:15:002020-12-27 19:15:002020-12-27 19:15:002020-12-27 19:15:00
2587,11559,Jonny,2145,"[2018, 2019]",Wolverhampton Wanderers,34,33,1,2862,2,0,34,32,2,2809,1,0,68,65,3,5671,3,0,0.0,1.0,1.0,0,1,1,0,0,0,0,0,0,2020-12-27 19:15:002020-12-27 19:15:00
2588,5781,Jonny Evans,1216,[2007],Sunderland AFC,8,8,0,707,0,0,6,6,0,540,0,0,14,14,0,1247,0,0,0.0,0.0,0.0,0,0,0,0,0,0,0,0,0,2020-12-27 19:15:00
2589,40495,Jonny Evans,1216,"[2008, 2009, 2010, 2011, 2012, 2013, 2014]",Manchester United,65,61,4,5472,2,0,65,61,4,5307,2,0,130,122,8,10779,4,0,0.0,0.0,0.0,2,2,4,0,0,0,0,0,0,2020-12-27 19:15:002020-12-27 19:15:002020-12-27 19:15:002020-12-27 19:15:002020-12-27 19:15:002020-12-27 19:15:002020-12-27 19:15:00
2590,17370,Jonny Evans,1216,"[2015, 2016, 2017]",West Bromwich Albion,43,42,1,3692,4,0,46,44,2,3812,1,0,89,86,3,7504,5,0,3.0,0.0,3.0,3,1,4,0,0,0,0,0,0,2020-12-27 19:15:002020-12-27 19:15:002020-12-27 19:15:00
2591,17379,Jonny Evans,1216,"[2018, 2019, 2020]",Leicester City,37,37,0,3324,1,0,36,33,3,3037,1,0,73,70,3,6361,2,0,0.0,0.0,0.0,1,0,1,0,0,0,1,0,1,2020-12-27 19:15:002020-12-27 19:15:002020-12-27 19:15:00
2592,23186,Jonny Howson,1374,"[2011, 2012, 2013, 2015]",Norwich City,51,42,9,3830,4,0,53,47,6,4202,4,0,104,89,15,8032,8,0,3.0,6.0,9.0,3,3,6,0,0,0,0,0,0,2020-12-27 19:15:002020-12-27 19:15:002020-12-27 19:15:002020-12-27 19:15:00
2593,5799,Jonny Maddison,3574,[2015],Leicester City,0,0,0,0,0,0,0,0,0,0,0,0,0,0,0,0,0,0,0.0,0.0,0.0,0,0,0,0,0,0,0,0,0,2020-12-27 19:15:00
2594,34815,Jonás Gutiérrez,2398,"[2008, 2010, 2011, 2012, 2013, 2014]",Newcastle United,72,67,5,5856,4,0,76,66,10,6058,3,0,148,133,15,11914,7,0,0.0,0.0,0.0,1,2,3,0,0,0,0,0,0,2020-12-27 19:15:002020-12-27 19:15:002020-12-27 19:15:002020-12-27 19:15:002020-12-27 19:15:002020-12-27 19:15:00
2595,5806,Joonas Kolkka,2028,[2004],Crystal Palace,12,10,2,897,1,0,10,9,1,720,2,0,22,19,3,1617,3,0,0.0,0.0,0.0,1,1,2,0,0,0,0,0,0,2020-12-27 19:15:00
2596,5807,Jordan Amavi,3405,[2015],Aston Villa,5,5,0,450,0,0,5,4,1,386,0,0,10,9,1,836,0,0,0.0,0.0,0.0,0,0,0,0,0,0,0,0,0,2020-12-27 19:15:00
2597,5808,Jordan Archer,3981,[2012],Tottenham Hotspur,0,0,0,0,0,0,0,0,0,0,0,0,0,0,0,0,0,0,0.0,0.0,0.0,0,0,0,0,0,0,0,0,0,2020-12-27 19:15:00
2598,5809,Jordan Ayew,1869,[2015],Aston Villa,15,14,1,1254,4,0,15,13,2,1173,3,0,30,27,3,2427,7,0,1.0,1.0,2.0,2,2,4,1,0,1,0,0,0,2020-12-27 19:15:00
2599,11621,Jordan Ayew,1869,"[2016, 2017]",Swansea City,26,22,4,2028,5,0,24,20,4,1774,3,0,50,42,8,3802,8,0,2.0,0.0,2.0,4,2,6,1,0,1,0,0,0,2020-12-27 19:15:002020-12-27 19:15:00
2600,17439,Jordan Ayew,1869,"[2018, 2019, 2020]",Crystal Palace,32,32,0,2653,5,0,36,27,9,2405,6,0,68,59,9,5058,11,0,10.0,7.0,17.0,4,5,9,0,0,0,0,0,0,2020-12-27 19:15:002020-12-27 19:15:002020-12-27 19:15:00
2601,11631,Jordan Bowery,1977,"[2012, 2013]",Aston Villa,10,2,8,270,0,0,8,3,5,251,0,0,18,5,13,521,0,0,0.0,0.0,0.0,0,0,0,0,0,0,0,0,0,2020-12-27 19:15:002020-12-27 19:15:00
2602,11635,Jordan Cook,4134,"[2010, 2011]",Sunderland AFC,1,0,1,3,0,0,2,0,2,26,0,0,3,0,3,29,0,0,0.0,0.0,0.0,0,0,0,0,0,0,0,0,0,2020-12-27 19:15:002020-12-27 19:15:00
2603,17460,Jordan Henderson,1426,"[2008, 2009, 2010]",Sunderland AFC,34,28,6,2589,3,0,36,31,5,2769,1,0,70,59,11,5358,4,0,3.0,0.0,3.0,2,1,3,0,0,0,0,0,0,2020-12-27 19:15:002020-12-27 19:15:002020-12-27 19:15:00
2604,58265,Jordan Henderson,1426,"[2011, 2012, 2013, 2014, 2015, 2016, 2017, 2018, 2019, 2020]",Liverpool FC,139,118,21,10500,12,0,141,121,20,10762,15,0,280,239,41,21262,27,0,6.0,3.0,9.0,8,3,11,0,1,1,0,0,0,2020-12-27 19:15:002020-12-27 19:15:002020-12-27 19:15:002020-12-27 19:15:002020-12-27 19:15:002020-12-27 19:15:002020-12-27 19:15:002020-12-27 19:15:002020-12-27 19:15:002020-12-27 19:15:00
2605,5832,Jordan Holmes,3208,[2015],AFC Bournemouth,0,0,0,0,0,0,0,0,0,0,0,0,0,0,0,0,0,0,0.0,0.0,0.0,0,0,0,0,0,0,0,0,0,2020-12-27 19:15:00
2606,5833,Jordan Hugill,2948,[2017],West Ham United,2,0,2,12,0,0,1,0,1,10,0,0,3,0,3,22,0,0,0.0,0.0,0.0,0,0,0,0,0,0,0,0,0,2020-12-27 19:15:00
2607,5834,Jordan Laidler,4419,[2012],Sunderland AFC,0,0,0,0,0,0,0,0,0,0,0,0,0,0,0,0,0,0,0.0,0.0,0.0,0,0,0,0,0,0,0,0,0,2020-12-27 19:15:00
2608,5835,Jordan Lyden,1868,[2015],Aston Villa,3,1,2,78,0,0,1,1,0,75,0,0,4,2,2,153,0,0,0.0,0.0,0.0,0,0,0,0,0,0,0,0,0,2020-12-27 19:15:00
2609,11673,Jordan Mustoe,4132,"[2010, 2012]",Wigan Athletic,0,0,0,0,0,0,0,0,0,0,0,0,0,0,0,0,0,0,0.0,0.0,0.0,0,0,0,0,0,0,0,0,0,2020-12-27 19:15:002020-12-27 19:15:00
2610,5838,Jordan Obita,4503,[2012],Reading FC,0,0,0,0,0,0,0,0,0,0,0,0,0,0,0,0,0,0,0.0,0.0,0.0,0,0,0,0,0,0,0,0,0,2020-12-27 19:15:00
2611,23362,Jordan Pickford,1046,"[2013, 2014, 2015, 2016]",Sunderland AFC,14,14,0,1260,0,0,17,17,0,1530,0,0,31,31,0,2790,0,0,0.0,0.0,0.0,0,0,0,0,0,0,0,0,0,2020-12-27 19:15:002020-12-27 19:15:002020-12-27 19:15:002020-12-27 19:15:00
2612,23378,Jordan Pickford,1046,"[2017, 2018, 2019, 2020]",Everton FC,64,64,0,5760,0,0,63,63,0,5670,0,0,127,127,0,11430,0,0,0.0,0.0,0.0,0,0,0,0,0,0,0,0,0,2020-12-27 19:15:002020-12-27 19:15:002020-12-27 19:15:002020-12-27 19:15:00
2613,5847,Jordan Rhodes,3011,[2016],Middlesbrough FC,4,0,4,50,0,0,2,2,0,158,0,0,6,2,4,208,0,0,0.0,0.0,0.0,0,0,0,0,0,0,0,0,0,2020-12-27 19:15:00
2614,5848,Jordan Robinson,3631,[2010],Wigan Athletic,0,0,0,0,0,0,0,0,0,0,0,0,0,0,0,0,0,0,0.0,0.0,0.0,0,0,0,0,0,0,0,0,0,2020-12-27 19:15:00
2615,17550,Jordan Rossiter,3521,"[2013, 2014, 2015]",Liverpool FC,0,0,0,0,0,0,1,0,1,14,0,0,1,0,1,14,0,0,0.0,0.0,0.0,0,0,0,0,0,0,0,0,0,2020-12-27 19:15:002020-12-27 19:15:002020-12-27 19:15:00
2616,5852,Jordan Slew,4231,[2011],Blackburn Rovers,0,0,0,0,0,0,1,0,1,1,0,0,1,0,1,1,0,0,0.0,0.0,0.0,0,0,0,0,0,0,0,0,0,2020-12-27 19:15:00
2617,17562,Jordan Spence,2760,"[2009, 2010, 2012]",West Ham United,6,1,5,114,0,0,1,1,0,90,0,0,7,2,5,204,0,0,0.0,0.0,0.0,0,0,0,0,0,0,0,0,0,2020-12-27 19:15:002020-12-27 19:15:002020-12-27 19:15:00
2618,11713,Jordan Stewart,2113,"[2001, 2003]",Leicester City,18,11,7,1083,0,0,18,13,5,1166,1,0,36,24,12,2249,1,0,0.0,0.0,0.0,0,1,1,0,0,0,0,0,0,2020-12-27 19:15:002020-12-27 19:15:00
2619,5858,Jordan Stewart,2113,[2006],Watford FC,14,13,1,1151,0,0,14,14,0,1260,0,0,28,27,1,2411,0,0,0.0,0.0,0.0,0,0,0,0,0,0,0,0,0,2020-12-27 19:15:00
2620,5859,Jordan Thomas,3722,[2019],Norwich City,0,0,0,0,0,0,1,0,1,1,0,0,1,0,1,1,0,0,0.0,0.0,0.0,0,0,0,0,0,0,0,0,0,2020-12-27 19:15:00
2621,5860,Jordan Veretout,3406,[2015],Aston Villa,13,11,2,970,0,0,12,10,2,854,0,0,25,21,4,1824,0,0,0.0,0.0,0.0,0,0,0,0,0,0,0,0,0,2020-12-27 19:15:00
2622,23450,Jordi Amat,2934,"[2013, 2014, 2015, 2016]",Swansea City,24,18,6,1728,0,0,28,22,6,1976,0,0,52,40,12,3704,0,0,0.0,0.0,0.0,0,0,0,0,0,0,0,0,0,2020-12-27 19:15:002020-12-27 19:15:002020-12-27 19:15:002020-12-27 19:15:00
2623,23466,Jordi Gómez,2059,"[2009, 2010, 2011, 2012]",Wigan Athletic,45,30,15,2539,7,0,50,30,20,2715,3,0,95,60,35,5254,10,0,4.0,3.0,7.0,6,2,8,0,2,2,0,0,0,2020-12-27 19:15:002020-12-27 19:15:002020-12-27 19:15:002020-12-27 19:15:00
2624,11739,Jordi Gómez,2059,"[2014, 2015]",Sunderland AFC,18,12,6,1032,3,0,17,15,2,1267,1,0,35,27,8,2299,4,0,3.0,0.0,3.0,3,1,4,3,0,3,0,0,0,2020-12-27 19:15:002020-12-27 19:15:00
2625,5871,Jordi Osei-Tutu,2573,[2017],Arsenal FC,0,0,0,0,0,0,0,0,0,0,0,0,0,0,0,0,0,0,0.0,0.0,0.0,0,0,0,0,0,0,0,0,0,2020-12-27 19:15:00
2626,23494,Jordon Ibe,1042,"[2012, 2013, 2014, 2015]",Liverpool FC,20,9,11,858,0,0,21,11,10,1011,1,0,41,20,21,1869,1,0,0.0,1.0,1.0,0,1,1,0,0,0,0,0,0,2020-12-27 19:15:002020-12-27 19:15:002020-12-27 19:15:002020-12-27 19:15:00
2627,23510,Jordon Ibe,1042,"[2016, 2017, 2018, 2019]",AFC Bournemouth,41,20,21,1842,2,0,37,24,13,2057,1,0,78,44,34,3899,3,0,3.0,0.0,3.0,2,0,2,0,0,0,0,0,0,2020-12-27 19:15:002020-12-27 19:15:002020-12-27 19:15:002020-12-27 19:15:00
2628,5880,Jordon Mutch,1024,[2010],Birmingham City,0,0,0,0,0,0,3,3,0,244,0,0,3,3,0,244,0,0,0.0,0.0,0.0,0,0,0,0,0,0,0,0,0,2020-12-27 19:15:00
2629,5881,Jordon Mutch,1024,[2013],Cardiff City,16,13,3,1086,3,0,19,13,6,1177,4,0,35,26,9,2263,7,0,0.0,3.0,3.0,2,2,4,0,0,0,0,0,0,2020-12-27 19:15:00
2630,23534,Jordon Mutch,1024,"[2014, 2015, 2016, 2017]",Crystal Palace,12,2,10,460,0,0,19,9,10,718,0,0,31,11,20,1178,0,0,0.0,0.0,0.0,0,0,0,0,0,0,0,0,0,2020-12-27 19:15:002020-12-27 19:15:002020-12-27 19:15:002020-12-27 19:15:00
2631,11773,Jordy Clasie,1242,"[2015, 2016]",Southampton FC,18,15,3,1145,0,0,20,17,3,1403,1,0,38,32,6,2548,1,0,0.0,3.0,3.0,0,1,1,0,0,0,0,0,0,2020-12-27 19:15:002020-12-27 19:15:00
2632,5888,Jordão,3084,[2002],West Bromwich Albion,1,0,1,4,0,0,2,0,2,23,0,0,3,0,3,27,0,0,0.0,0.0,0.0,0,0,0,0,0,0,0,0,0,2020-12-27 19:15:00
2633,17670,Jores Okore,2664,"[2013, 2014, 2015]",Aston Villa,20,19,1,1679,1,0,18,17,1,1577,0,0,38,36,2,3256,1,0,0.0,0.0,0.0,1,0,1,0,0,0,0,0,0,2020-12-27 19:15:002020-12-27 19:15:002020-12-27 19:15:00
2634,5892,Jorge Costa,2684,[2001],Charlton Athletic,10,10,0,900,0,0,11,9,2,864,0,0,21,19,2,1764,0,0,0.0,0.0,0.0,0,0,0,0,0,0,0,0,0,2020-12-27 19:15:00
2635,17682,Jorginho,1847,"[2018, 2019, 2020]",Chelsea FC,39,37,2,3166,5,0,38,33,5,2950,4,0,77,70,7,6116,9,0,0.0,3.0,3.0,3,3,6,5,2,7,0,0,0,2020-12-27 19:15:002020-12-27 19:15:002020-12-27 19:15:00
2636,17691,Jos Hooiveld,2869,"[2012, 2013, 2014]",Southampton FC,12,10,2,924,0,0,16,16,0,1378,0,0,28,26,2,2302,0,0,0.0,0.0,0.0,0,0,0,0,0,0,0,0,0,2020-12-27 19:15:002020-12-27 19:15:002020-12-27 19:15:00
2637,23602,Jose Baxter,2107,"[2008, 2009, 2010, 2011]",Everton FC,5,0,5,47,0,0,2,1,1,70,0,0,7,1,6,117,0,0,0.0,0.0,0.0,0,0,0,0,0,0,0,0,0,2020-12-27 19:15:002020-12-27 19:15:002020-12-27 19:15:002020-12-27 19:15:00
2638,5903,Joselu,2195,[2015],Stoke City,9,5,4,492,1,0,13,5,8,597,3,0,22,10,12,1089,4,0,0.0,0.0,0.0,1,1,2,0,0,0,0,0,0,2020-12-27 19:15:00
2639,11809,Joselu,2195,"[2017, 2018]",Newcastle United,26,13,13,1221,6,0,20,11,9,1082,0,0,46,24,22,2303,6,0,2.0,0.0,2.0,6,0,6,0,0,0,0,0,0,2020-12-27 19:15:002020-12-27 19:15:00
2640,11813,Josemi,3261,"[2004, 2005]",Liverpool FC,10,6,4,493,0,0,11,10,1,905,0,0,21,16,5,1398,0,0,0.0,0.0,0.0,0,0,0,0,0,0,0,0,0,2020-12-27 19:15:002020-12-27 19:15:00
2641,5908,Joseph Anang,4380,[2019],West Ham United,0,0,0,0,0,0,0,0,0,0,0,0,0,0,0,0,0,0,0.0,0.0,0.0,0,0,0,0,0,0,0,0,0,2020-12-27 19:15:00
2642,47300,Joseph Yobo,1801,"[2002, 2003, 2004, 2005, 2006, 2007, 2008, 2009]",Everton FC,106,99,7,8795,7,0,104,95,9,8601,1,0,210,194,16,17396,8,0,3.0,0.0,3.0,4,0,4,0,0,0,0,0,0,2020-12-27 19:15:002020-12-27 19:15:002020-12-27 19:15:002020-12-27 19:15:002020-12-27 19:15:002020-12-27 19:15:002020-12-27 19:15:002020-12-27 19:15:00
2643,5917,Joseph Yobo,1801,[2013],Norwich City,5,5,0,450,0,0,3,3,0,270,0,0,8,8,0,720,0,0,0.0,0.0,0.0,0,0,0,0,0,0,0,0,0,2020-12-27 19:15:00
2644,35523,Joseph-Désiré Job,2071,"[2000, 2001, 2002, 2003, 2004, 2005]",Middlesbrough FC,43,31,12,2601,10,0,46,30,16,2724,7,0,89,61,28,5325,17,0,6.0,4.0,10.0,7,4,11,0,0,0,0,0,0,2020-12-27 19:15:002020-12-27 19:15:002020-12-27 19:15:002020-12-27 19:15:002020-12-27 19:15:002020-12-27 19:15:00
2645,17775,Josh Benson,3757,"[2018, 2019, 2020]",Burnley FC,2,0,2,7,0,0,2,2,0,164,0,0,4,2,2,171,0,0,0.0,0.0,0.0,0,0,0,0,0,0,0,0,0,2020-12-27 19:15:002020-12-27 19:15:002020-12-27 19:15:00
2646,11855,Josh Brownhill,2675,"[2019, 2020]",Burnley FC,11,10,1,896,0,0,12,12,0,1080,0,0,23,22,1,1976,0,0,0.0,0.0,0.0,0,0,0,0,0,0,0,0,0,2020-12-27 19:15:002020-12-27 19:15:00
2647,5929,Josh Clackstone,4028,[2016],Hull City,0,0,0,0,0,0,0,0,0,0,0,0,0,0,0,0,0,0,0.0,0.0,0.0,0,0,0,0,0,0,0,0,0,2020-12-27 19:15:00
2648,17793,Josh Cullen,2947,"[2014, 2015, 2017]",West Ham United,1,0,1,1,0,0,2,0,2,6,0,0,3,0,3,7,0,0,0.0,0.0,0.0,0,0,0,0,0,0,0,0,0,2020-12-27 19:15:002020-12-27 19:15:002020-12-27 19:15:00
2649,5933,Josh Harrop,3277,[2016],Manchester United,1,1,0,90,1,0,0,0,0,0,0,0,1,1,0,90,1,0,0.0,0.0,0.0,1,0,1,0,0,0,0,0,0,2020-12-27 19:15:00
2650,5934,Josh Knight,4393,[2018],Leicester City,0,0,0,0,0,0,0,0,0,0,0,0,0,0,0,0,0,0,0.0,0.0,0.0,0,0,0,0,0,0,0,0,0,2020-12-27 19:15:00
2651,5935,Josh Maja,3364,[2016],Sunderland AFC,0,0,0,0,0,0,0,0,0,0,0,0,0,0,0,0,0,0,0.0,0.0,0.0,0,0,0,0,0,0,0,0,0,2020-12-27 19:15:00
2652,5936,Josh Martin,3724,[2019],Norwich City,2,0,2,21,0,0,3,0,3,11,0,0,5,0,5,32,0,0,0.0,0.0,0.0,0,0,0,0,0,0,0,0,0,2020-12-27 19:15:00
2653,5937,Josh McEachran,2809,[2010],Chelsea FC,4,1,3,103,0,0,5,0,5,69,0,0,9,1,8,172,0,0,0.0,0.0,0.0,0,0,0,0,0,0,0,0,0,2020-12-27 19:15:00
2654,5938,Josh McEachran,2809,[2011],Swansea City,2,1,1,82,0,0,2,0,2,43,0,0,4,1,3,125,0,0,0.0,0.0,0.0,0,0,0,0,0,0,0,0,0,2020-12-27 19:15:00
2655,11879,Josh Morris,3719,"[2010, 2011]",Blackburn Rovers,2,0,2,31,0,0,4,0,4,129,0,0,6,0,6,160,0,0,0.0,0.0,0.0,0,0,0,0,0,0,0,0,0,2020-12-27 19:15:002020-12-27 19:15:00
2656,5941,Josh Murphy,1379,[2013],Norwich City,3,0,3,31,0,0,6,0,6,100,0,0,9,0,9,131,0,0,0.0,0.0,0.0,0,0,0,0,0,0,0,0,0,2020-12-27 19:15:00
2657,5942,Josh Murphy,1379,[2018],Cardiff City,17,14,3,1123,2,0,12,8,4,702,1,0,29,22,7,1825,3,0,0.0,0.0,0.0,2,0,2,0,0,0,0,0,0,2020-12-27 19:15:00
2658,5943,Josh Pask,4486,[2017],West Ham United,0,0,0,0,0,0,0,0,0,0,0,0,0,0,0,0,0,0,0.0,0.0,0.0,0,0,0,0,0,0,0,0,0,2020-12-27 19:15:00
2659,5944,Josh Payne,4206,[2008],West Ham United,1,0,1,10,0,0,1,0,1,1,0,0,2,0,2,11,0,0,0.0,0.0,0.0,0,0,0,0,0,0,0,0,0,2020-12-27 19:15:00
2660,5945,Josh Robson,4483,[2016],Sunderland AFC,0,0,0,0,0,0,0,0,0,0,0,0,0,0,0,0,0,0,0.0,0.0,0.0,0,0,0,0,0,0,0,0,0,2020-12-27 19:15:00
2661,5946,Josh Sheehan,4301,[2014],Swansea City,0,0,0,0,0,0,0,0,0,0,0,0,0,0,0,0,0,0,0.0,0.0,0.0,0,0,0,0,0,0,0,0,0,2020-12-27 19:15:00
2662,17844,Josh Sims,3141,"[2016, 2017, 2018]",Southampton FC,9,3,6,354,0,0,11,1,10,221,0,0,20,4,16,575,0,0,0.0,0.0,0.0,0,0,0,0,0,0,0,0,0,2020-12-27 19:15:002020-12-27 19:15:002020-12-27 19:15:00
2663,5950,Josh Tymon,1909,[2016],Hull City,3,2,1,191,0,0,2,2,0,134,0,0,5,4,1,325,0,0,0.0,0.0,0.0,0,0,0,0,0,0,0,0,0,2020-12-27 19:15:00
2664,5951,Josh Tymon,1909,[2017],Stoke City,1,0,1,27,0,0,2,2,0,136,0,0,3,2,1,163,0,0,0.0,0.0,0.0,0,0,0,0,0,0,0,0,0,2020-12-27 19:15:00
2665,5952,Josh Vickers,4343,[2015],Swansea City,0,0,0,0,0,0,0,0,0,0,0,0,0,0,0,0,0,0,0.0,0.0,0.0,0,0,0,0,0,0,0,0,0,2020-12-27 19:15:00
2666,11907,Josh Walker,4026,"[2005, 2008]",Middlesbrough FC,5,2,3,224,0,0,2,0,2,72,0,0,7,2,5,296,0,0,0.0,0.0,0.0,0,0,0,0,0,0,0,0,0,2020-12-27 19:15:002020-12-27 19:15:00
2667,5955,Joshua King,1040,[2010],Manchester United,0,0,0,0,0,0,0,0,0,0,0,0,0,0,0,0,0,0,0.0,0.0,0.0,0,0,0,0,0,0,0,0,0,2020-12-27 19:15:00
2668,29790,Joshua King,1040,"[2015, 2016, 2017, 2018, 2019]",AFC Bournemouth,80,72,8,6090,25,0,81,68,13,6005,23,0,161,140,21,12095,48,0,13.0,5.0,18.0,18,14,32,4,8,12,0,0,0,2020-12-27 19:15:002020-12-27 19:15:002020-12-27 19:15:002020-12-27 19:15:002020-12-27 19:15:00
2669,17886,Joshua Onomah,2800,"[2014, 2015, 2016]",Tottenham Hotspur,10,0,10,48,0,0,3,0,3,47,0,0,13,0,13,95,0,0,0.0,0.0,0.0,0,0,0,0,0,0,0,0,0,2020-12-27 19:15:002020-12-27 19:15:002020-12-27 19:15:00
2670,5964,Joshua Onomah,2800,[2020],Fulham FC,1,1,0,75,0,0,1,1,0,58,0,0,2,2,0,133,0,0,0.0,0.0,0.0,0,0,0,0,0,0,0,0,0,2020-12-27 19:15:00
2671,5965,Joshua Passley,3688,[2013],Fulham FC,0,0,0,0,0,0,0,0,0,0,0,0,0,0,0,0,0,0,0.0,0.0,0.0,0,0,0,0,0,0,0,0,0,2020-12-27 19:15:00
2672,11933,Joshua Vela,2495,"[2010, 2011]",Bolton Wanderers,2,0,2,26,0,0,1,0,1,12,0,0,3,0,3,38,0,0,0.0,0.0,0.0,0,0,0,0,0,0,0,0,0,2020-12-27 19:15:002020-12-27 19:15:00
2673,5968,Josip Drmić,1834,[2019],Norwich City,10,4,6,397,1,0,11,1,10,283,0,0,21,5,16,680,1,0,0.0,0.0,0.0,0,0,0,0,0,0,0,0,0,2020-12-27 19:15:00
2674,17910,Josip Skoko,2743,"[2005, 2006, 2007]",Wigan Athletic,19,16,3,1360,0,0,26,18,8,1645,0,0,45,34,11,3005,0,0,0.0,0.0,0.0,0,0,0,0,0,0,0,0,0,2020-12-27 19:15:002020-12-27 19:15:002020-12-27 19:15:00
2675,11945,José Angeliño,2414,"[2015, 2019]",Manchester City,4,2,2,241,0,0,2,2,0,180,0,0,6,4,2,421,0,0,0.0,0.0,0.0,0,0,0,0,0,0,0,0,0,2020-12-27 19:15:002020-12-27 19:15:00
2676,29880,José Cholevas,1920,"[2015, 2016, 2017, 2018, 2019]",Watford FC,58,53,5,4707,3,0,56,55,1,4991,3,0,114,108,6,9698,6,0,1.0,4.0,5.0,1,2,3,0,0,0,0,0,0,2020-12-27 19:15:002020-12-27 19:15:002020-12-27 19:15:002020-12-27 19:15:002020-12-27 19:15:00
2677,5979,José Dominguez,4408,[2000],Tottenham Hotspur,1,0,1,19,0,0,1,0,1,6,0,0,2,0,2,25,0,0,0.0,0.0,0.0,0,0,0,0,0,0,0,0,0,2020-12-27 19:15:00
2678,17943,José Enrique,2394,"[2007, 2008, 2010]",Newcastle United,43,40,3,3407,0,0,41,37,4,3219,0,0,84,77,7,6626,0,0,0.0,0.0,0.0,0,0,0,0,0,0,0,0,0,2020-12-27 19:15:002020-12-27 19:15:002020-12-27 19:15:00
2679,23938,José Enrique,2394,"[2011, 2012, 2013, 2014]",Liverpool FC,37,32,5,2992,2,0,39,34,5,3061,0,0,76,66,10,6053,2,0,0.0,0.0,0.0,0,0,0,0,0,0,0,0,0,2020-12-27 19:15:002020-12-27 19:15:002020-12-27 19:15:002020-12-27 19:15:00
2680,29945,José Fonte,1146,"[2012, 2013, 2014, 2015, 2016]",Southampton FC,79,76,3,6890,6,0,75,75,0,6644,1,0,154,151,3,13534,7,0,2.0,3.0,5.0,5,1,6,0,0,0,0,0,0,2020-12-27 19:15:002020-12-27 19:15:002020-12-27 19:15:002020-12-27 19:15:002020-12-27 19:15:00
2681,5992,José Fonte,1146,[2017],West Ham United,4,4,0,344,0,0,4,4,0,346,0,0,8,8,0,690,0,0,0.0,0.0,0.0,0,0,0,0,0,0,0,0,0,2020-12-27 19:15:00
2682,11987,José Izquierdo,2658,"[2017, 2018]",Brighton & Hove Albion,24,15,9,1354,2,0,23,17,6,1427,3,0,47,32,15,2781,5,0,1.0,0.0,1.0,2,1,3,0,0,0,0,0,0,2020-12-27 19:15:002020-12-27 19:15:00
2683,5995,José Pozo,3925,[2014],Manchester City,1,0,1,83,0,0,2,1,1,81,0,0,3,1,2,164,0,0,0.0,0.0,0.0,0,0,0,0,0,0,0,0,0,2020-12-27 19:15:00
2684,5996,Jota,2856,[2019],Aston Villa,5,2,3,167,0,0,5,2,3,166,0,0,10,4,6,333,0,0,0.0,0.0,0.0,0,0,0,0,0,0,0,0,0,2020-12-27 19:15:00
2685,11995,Jovan Kirovski,2913,"[2002, 2003]",Birmingham City,11,2,9,238,1,0,12,3,9,357,1,0,23,5,18,595,2,0,0.0,3.0,3.0,1,1,2,0,0,0,0,0,0,2020-12-27 19:15:002020-12-27 19:15:00
2686,5999,Joy Mukena,3970,[2017],Watford FC,0,0,0,0,0,0,0,0,0,0,0,0,0,0,0,0,0,0,0.0,0.0,0.0,0,0,0,0,0,0,0,0,0,2020-12-27 19:15:00
2687,6000,Jozy Altidore,1615,[2009],Hull City,15,12,3,1031,1,0,13,4,9,479,0,0,28,16,12,1510,1,0,0.0,0.0,0.0,1,0,1,0,0,0,0,0,0,2020-12-27 19:15:00
2688,12003,Jozy Altidore,1615,"[2013, 2014]",Sunderland AFC,22,12,10,1226,1,0,20,9,11,855,0,0,42,21,21,2081,1,0,0.0,0.0,0.0,1,0,1,0,0,0,0,0,0,2020-12-27 19:15:002020-12-27 19:15:00
2689,12007,João Cancelo,1843,"[2019, 2020]",Manchester City,15,13,2,1179,0,0,12,10,2,927,0,0,27,23,4,2106,0,0,0.0,0.0,0.0,0,0,0,0,0,0,0,0,0,2020-12-27 19:15:002020-12-27 19:15:00
2690,12011,João Carlos Teixeira,3628,"[2013, 2015]",Liverpool FC,0,0,0,0,0,0,2,0,2,11,0,0,2,0,2,11,0,0,0.0,0.0,0.0,0,0,0,0,0,0,0,0,0,2020-12-27 19:15:002020-12-27 19:15:00
2691,18024,João Moutinho,2147,"[2018, 2019, 2020]",Wolverhampton Wanderers,45,39,6,3429,0,0,44,40,4,3611,2,0,89,79,10,7040,2,0,0.0,1.0,1.0,0,2,2,0,0,0,0,0,0,2020-12-27 19:15:002020-12-27 19:15:002020-12-27 19:15:00
2692,6010,João Mário,2946,[2017],West Ham United,9,8,1,709,1,0,5,5,0,408,1,0,14,13,1,1117,2,0,0.0,0.0,0.0,1,1,2,0,0,0,0,0,0,2020-12-27 19:15:00
2693,6011,João Pedro,3615,[2019],Watford FC,1,0,1,16,0,0,2,0,2,6,0,0,3,0,3,22,0,0,0.0,0.0,0.0,0,0,0,0,0,0,0,0,0,2020-12-27 19:15:00
2694,12025,João Virgínia,4014,"[2019, 2020]",Everton FC,0,0,0,0,0,0,0,0,0,0,0,0,0,0,0,0,0,0,0.0,0.0,0.0,0,0,0,0,0,0,0,0,0,2020-12-27 19:15:002020-12-27 19:15:00
2695,6014,Joël Veltman,1021,[2020],Brighton & Hove Albion,5,5,0,399,0,0,5,2,3,280,0,0,10,7,3,679,0,0,0.0,0.0,0.0,0,0,0,0,0,0,0,0,0,2020-12-27 19:15:00
2696,12031,Juan Cuadrado,3420,"[2014, 2015]",Chelsea FC,7,4,3,263,0,0,6,0,6,75,0,0,13,4,9,338,0,0,0.0,0.0,0.0,0,0,0,0,0,0,0,0,0,2020-12-27 19:15:002020-12-27 19:15:00
2697,18054,Juan Foyth,1862,"[2017, 2018, 2019]",Tottenham Hotspur,7,5,2,469,0,0,9,6,3,529,1,0,16,11,5,998,1,0,0.0,3.0,3.0,0,1,1,0,0,0,0,0,0,2020-12-27 19:15:002020-12-27 19:15:002020-12-27 19:15:00
2698,6020,Juan Iturbe,3232,[2015],AFC Bournemouth,2,0,2,55,0,0,0,0,0,0,0,0,2,0,2,55,0,0,0.0,0.0,0.0,0,0,0,0,0,0,0,0,0,2020-12-27 19:15:00
2699,6021,Juan Menseguez,3390,[2008],West Bromwich Albion,4,2,2,221,1,0,3,1,2,125,0,0,7,3,4,346,1,0,0.0,0.0,0.0,0,0,0,0,0,0,0,0,0,2020-12-27 19:15:00
2700,42175,Juan Pablo Ángel,1795,"[2000, 2001, 2002, 2003, 2004, 2005, 2006]",Aston Villa,87,68,19,6190,28,0,82,60,22,5239,16,0,169,128,41,11429,44,0,11.0,2.0,13.0,17,11,28,4,1,5,0,0,0,2020-12-27 19:15:002020-12-27 19:15:002020-12-27 19:15:002020-12-27 19:15:002020-12-27 19:15:002020-12-27 19:15:002020-12-27 19:15:00
2701,6029,Juan Paredes,3181,[2015],Watford FC,10,5,5,506,0,0,7,2,5,259,0,0,17,7,10,765,0,0,0.0,0.0,0.0,0,0,0,0,0,0,0,0,0,2020-12-27 19:15:00
2702,12061,Juan Sebastián Verón,1452,"[2001, 2002]",Manchester United,30,26,4,2135,4,0,19,17,2,1490,3,0,49,43,6,3625,7,0,0.0,0.0,0.0,3,3,6,0,0,0,0,0,0,2020-12-27 19:15:002020-12-27 19:15:00
2703,6032,Juan Sebastián Verón,1452,[2003],Chelsea FC,6,4,2,393,0,0,1,1,0,90,1,0,7,5,2,483,1,0,0.0,0.0,0.0,0,1,1,0,0,0,0,0,0,2020-12-27 19:15:00
2704,6033,Juan Zúñiga,3817,[2016],Watford FC,9,3,6,374,1,0,12,3,9,444,0,0,21,6,15,818,1,0,0.0,0.0,0.0,1,0,1,0,0,0,0,0,0,2020-12-27 19:15:00
2705,6034,Juanmi,3572,[2015],Southampton FC,7,0,7,105,0,0,5,0,5,56,0,0,12,0,12,161,0,0,0.0,0.0,0.0,0,0,0,0,0,0,0,0,0,2020-12-27 19:15:00
2706,12071,Julian Gray,2653,"[2004, 2005]",Birmingham City,27,18,9,1824,2,0,25,18,7,1758,1,0,52,36,16,3582,3,0,0.0,3.0,3.0,0,1,1,0,0,0,0,0,0,2020-12-27 19:15:002020-12-27 19:15:00
2707,6037,Julian Gray,2653,[2008],Fulham FC,1,0,1,5,0,0,0,0,0,0,0,0,1,0,1,5,0,0,0.0,0.0,0.0,0,0,0,0,0,0,0,0,0,2020-12-27 19:15:00
2708,6038,Julian Joachim,2770,[2000],Aston Villa,11,7,4,718,4,0,8,3,5,379,3,0,19,10,9,1097,7,0,3.0,0.0,3.0,3,2,5,0,0,0,0,0,0,2020-12-27 19:15:00
2709,42294,Julian Speroni,2249,"[2004, 2013, 2014, 2015, 2016, 2017, 2018]",Crystal Palace,46,46,0,4140,0,0,47,47,0,4194,0,0,93,93,0,8334,0,0,0.0,0.0,0.0,0,0,0,0,0,0,0,0,0,2020-12-27 19:15:002020-12-27 19:15:002020-12-27 19:15:002020-12-27 19:15:002020-12-27 19:15:002020-12-27 19:15:002020-12-27 19:15:00
2710,6046,Julien De Sart,4000,[2016],Middlesbrough FC,0,0,0,0,0,0,0,0,0,0,0,0,0,0,0,0,0,0,0.0,0.0,0.0,0,0,0,0,0,0,0,0,0,2020-12-27 19:15:00
2711,24194,Julien Faubert,1283,"[2007, 2008, 2009, 2010]",West Ham United,37,31,6,2749,1,0,31,26,5,2320,0,0,68,57,11,5069,1,0,0.0,0.0,0.0,0,0,0,0,0,0,0,0,0,2020-12-27 19:15:002020-12-27 19:15:002020-12-27 19:15:002020-12-27 19:15:00
2712,12103,Julien N'Goy,3365,"[2016, 2017]",Stoke City,2,0,2,18,0,0,4,0,4,45,0,0,6,0,6,63,0,0,0.0,0.0,0.0,0,0,0,0,0,0,0,0,0,2020-12-27 19:15:002020-12-27 19:15:00
2713,24218,Julio Arca,1341,"[2000, 2001, 2002, 2005]",Sunderland AFC,40,34,6,3148,3,0,38,33,5,2797,1,0,78,67,11,5945,4,0,0.0,0.0,0.0,3,0,3,0,0,0,0,0,0,2020-12-27 19:15:002020-12-27 19:15:002020-12-27 19:15:002020-12-27 19:15:00
2714,18174,Julio Arca,1341,"[2006, 2007, 2008]",Middlesbrough FC,35,29,6,2522,3,0,27,25,2,2004,1,0,62,54,8,4526,4,0,1.0,0.0,1.0,2,1,3,0,0,0,0,0,0,2020-12-27 19:15:002020-12-27 19:15:002020-12-27 19:15:00
2715,6060,Julius Aghahowa,2345,[2006],Wigan Athletic,3,2,1,189,0,0,3,1,2,122,0,0,6,3,3,311,0,0,0.0,0.0,0.0,0,0,0,0,0,0,0,0,0,2020-12-27 19:15:00
2716,6061,Julius Aghahowa,2345,[2007],Blackburn Rovers,0,0,0,0,0,0,1,0,1,52,0,0,1,0,1,52,0,0,0.0,0.0,0.0,0,0,0,0,0,0,0,0,0,2020-12-27 19:15:00
2717,12125,Junichi Inamoto,1084,"[2002, 2003]",Fulham FC,22,12,10,1110,2,0,17,10,7,977,2,0,39,22,17,2087,4,0,0.0,0.0,0.0,1,1,2,0,0,0,0,0,0,2020-12-27 19:15:002020-12-27 19:15:00
2718,12129,Junichi Inamoto,1084,"[2004, 2005]",West Bromwich Albion,9,8,1,689,0,0,16,8,8,952,0,0,25,16,9,1641,0,0,0.0,0.0,0.0,0,0,0,0,0,0,0,0,0,2020-12-27 19:15:002020-12-27 19:15:00
2719,6066,Juninho Bacuna,3217,[2018],Huddersfield Town,11,8,3,723,0,0,10,8,2,692,1,0,21,16,5,1415,1,0,0.0,0.0,0.0,0,1,1,0,0,0,0,0,0,2020-12-27 19:15:00
2720,12135,Juninho Paulista,2136,"[2002, 2003]",Middlesbrough FC,21,17,4,1570,6,0,18,16,2,1394,5,0,39,33,6,2964,11,0,1.0,0.0,1.0,4,4,8,0,0,0,0,0,0,2020-12-27 19:15:002020-12-27 19:15:00
2721,6069,Junior Hoilett,2535,[2009],Wigan Athletic,1,1,0,90,0,0,0,0,0,0,0,0,1,1,0,90,0,0,0.0,0.0,0.0,0,0,0,0,0,0,0,0,0,2020-12-27 19:15:00
2722,12141,Junior Hoilett,2535,"[2010, 2011]",Blackburn Rovers,26,25,1,2106,5,0,32,26,6,2347,7,0,58,51,7,4453,12,0,2.0,0.0,2.0,3,4,7,0,0,0,0,0,0,2020-12-27 19:15:002020-12-27 19:15:00
2723,12145,Junior Hoilett,2535,"[2012, 2014]",Queens Park Rangers,24,13,11,1196,2,0,24,11,13,1134,0,0,48,24,24,2330,2,0,0.0,0.0,0.0,1,0,1,0,0,0,0,0,0,2020-12-27 19:15:002020-12-27 19:15:00
2724,6074,Junior Hoilett,2535,[2018],Cardiff City,17,10,7,1008,2,0,15,13,2,1134,1,0,32,23,9,2142,3,0,3.0,0.0,3.0,2,0,2,0,0,0,0,0,0,2020-12-27 19:15:00
2725,12151,Junior Lewis,1307,"[2000, 2001]",Leicester City,9,8,1,763,0,0,12,11,1,1020,0,0,21,19,2,1783,0,0,0.0,0.0,0.0,0,0,0,0,0,0,0,0,0,2020-12-27 19:15:002020-12-27 19:15:00
2726,18234,Junior Stanislas,1009,"[2008, 2009, 2010]",West Ham United,17,11,6,1067,4,0,24,11,13,1150,1,0,41,22,19,2217,5,0,4.0,1.0,5.0,3,1,4,0,0,0,0,0,0,2020-12-27 19:15:002020-12-27 19:15:002020-12-27 19:15:00
2727,30410,Junior Stanislas,1009,"[2015, 2016, 2017, 2018, 2019]",AFC Bournemouth,48,35,13,3049,12,0,51,35,16,2900,8,0,99,70,29,5949,20,0,10.0,0.0,10.0,10,4,14,3,2,5,0,0,0,2020-12-27 19:15:002020-12-27 19:15:002020-12-27 19:15:002020-12-27 19:15:002020-12-27 19:15:00
2728,6085,Jurado,3180,[2015],Watford FC,15,15,0,1107,0,0,12,12,0,920,0,0,27,27,0,2027,0,0,0.0,0.0,0.0,0,0,0,0,0,0,0,0,0,2020-12-27 19:15:00
2729,67001,Jussi Jääskeläinen,1710,"[2001, 2002, 2003, 2004, 2005, 2006, 2007, 2008, 2009, 2010, 2011]",Bolton Wanderers,190,190,0,17100,0,0,186,186,0,16740,0,0,376,376,0,33840,0,0,0.0,0.0,0.0,0,0,0,0,0,0,0,0,0,2020-12-27 19:15:002020-12-27 19:15:002020-12-27 19:15:002020-12-27 19:15:002020-12-27 19:15:002020-12-27 19:15:002020-12-27 19:15:002020-12-27 19:15:002020-12-27 19:15:002020-12-27 19:15:002020-12-27 19:15:00
2730,18294,Jussi Jääskeläinen,1710,"[2012, 2013, 2014]",West Ham United,28,28,0,2520,0,0,29,28,1,2547,0,0,57,56,1,5067,0,0,0.0,0.0,0.0,0,0,0,0,0,0,0,0,0,2020-12-27 19:15:002020-12-27 19:15:002020-12-27 19:15:00
2731,30512,Justin Hoyte,3282,"[2002, 2003, 2004, 2006, 2007]",Arsenal FC,13,9,4,718,1,0,20,14,6,1226,0,0,33,23,10,1944,1,0,0.0,0.0,0.0,0,0,0,0,0,0,0,0,0,2020-12-27 19:15:002020-12-27 19:15:002020-12-27 19:15:002020-12-27 19:15:002020-12-27 19:15:00
2732,6103,Justin Hoyte,3282,[2005],Sunderland AFC,15,15,0,1321,1,0,12,12,0,1054,0,0,27,27,0,2375,1,0,0.0,0.0,0.0,1,0,1,0,0,0,0,0,0,2020-12-27 19:15:00
2733,6106,Justin Hoyte,3282,[2008],Middlesbrough FC,9,8,1,745,0,0,13,9,4,858,0,0,22,17,5,1603,0,0,0.0,0.0,0.0,0,0,0,0,0,0,0,0,0,2020-12-27 19:15:00
2734,6107,Ján Kozák,4389,[2005],West Bromwich Albion,4,2,2,195,0,0,2,2,0,153,0,0,6,4,2,348,0,0,0.0,0.0,0.0,0,0,0,0,0,0,0,0,0,2020-12-27 19:15:00
2735,18327,Ján Mucha,1752,"[2010, 2011, 2012]",Everton FC,2,2,0,180,0,0,0,0,0,0,0,0,2,2,0,180,0,0,0.0,0.0,0.0,0,0,0,0,0,0,0,0,0,2020-12-27 19:15:002020-12-27 19:15:002020-12-27 19:15:00
2736,30566,Jérémie Aliadiére,1530,"[2001, 2002, 2003, 2004, 2006]",Arsenal FC,15,2,13,269,1,0,13,5,8,483,0,0,28,7,21,752,1,0,0.0,0.0,0.0,0,0,0,0,0,0,0,0,0,2020-12-27 19:15:002020-12-27 19:15:002020-12-27 19:15:002020-12-27 19:15:002020-12-27 19:15:00
2737,6115,Jérémie Aliadiére,1530,[2005],West Ham United,3,0,3,52,0,0,4,1,3,121,0,0,7,1,6,173,0,0,0.0,0.0,0.0,0,0,0,0,0,0,0,0,0,2020-12-27 19:15:00
2738,12235,Jérémie Aliadiére,1530,"[2007, 2008]",Middlesbrough FC,31,28,3,2347,4,0,27,25,2,2092,3,0,58,53,5,4439,7,0,7.0,3.0,10.0,3,3,6,0,0,0,0,0,0,2020-12-27 19:15:002020-12-27 19:15:00
2739,12239,Jérémie Boga,4318,"[2014, 2017]",Chelsea FC,1,1,0,18,0,0,0,0,0,0,0,0,1,1,0,18,0,0,0.0,0.0,0.0,0,0,0,0,0,0,0,0,0,2020-12-27 19:15:002020-12-27 19:15:00
2740,12243,Jérémy Pied,3252,"[2016, 2017]",Southampton FC,4,1,3,126,0,0,2,2,0,180,0,0,6,3,3,306,0,0,0.0,0.0,0.0,0,0,0,0,0,0,0,0,0,2020-12-27 19:15:002020-12-27 19:15:00
2741,6123,Jérôme Boateng,3393,[2010],Manchester City,8,7,1,621,0,0,8,7,1,617,0,0,16,14,2,1238,0,0,0.0,0.0,0.0,0,0,0,0,0,0,0,0,0,2020-12-27 19:15:00
2742,6124,Jérôme Bonnissel,3672,[2003],Fulham FC,9,9,0,743,0,0,7,7,0,613,0,0,16,16,0,1356,0,0,0.0,0.0,0.0,0,0,0,0,0,0,0,0,0,2020-12-27 19:15:00
2743,30635,Jóhann Guðmundsson,1256,"[2016, 2017, 2018, 2019, 2020]",Burnley FC,56,36,20,3561,4,0,44,34,10,2884,3,0,100,70,30,6445,7,0,1.0,0.0,1.0,2,2,4,0,0,0,0,0,0,2020-12-27 19:15:002020-12-27 19:15:002020-12-27 19:15:002020-12-27 19:15:002020-12-27 19:15:00
2744,6130,Jóhannes Guðjónsson,3064,[2002],Aston Villa,5,4,1,277,0,0,6,5,1,513,2,0,11,9,2,790,2,0,0.0,0.0,0.0,0,1,1,0,0,0,0,0,0,2020-12-27 19:15:00
2745,6131,Jóhannes Guðjónsson,3064,[2003],Wolverhampton Wanderers,5,3,2,208,0,0,6,2,4,246,0,0,11,5,6,454,0,0,0.0,0.0,0.0,0,0,0,0,0,0,0,0,0,2020-12-27 19:15:00
2746,6132,Jóhannes Guðjónsson,3064,[2009],Burnley FC,4,0,4,108,0,0,6,1,5,203,0,0,10,1,9,311,0,0,0.0,0.0,0.0,0,0,0,0,0,0,0,0,0,2020-12-27 19:15:00
2747,12267,Jô,3298,"[2008, 2009]",Everton FC,14,8,6,669,5,0,13,9,4,776,0,0,27,17,10,1445,5,0,0.0,0.0,0.0,2,0,2,1,0,1,0,0,0,2020-12-27 19:15:002020-12-27 19:15:00
2748,6135,Jô,3298,[2010],Manchester City,4,0,4,72,0,0,8,3,5,269,0,0,12,3,9,341,0,0,0.0,0.0,0.0,0,0,0,0,0,0,0,0,0,2020-12-27 19:15:00
2749,6136,Jørgen Nielsen,4468,[2000],Liverpool FC,0,0,0,0,0,0,0,0,0,0,0,0,0,0,0,0,0,0,0.0,0.0,0.0,0,0,0,0,0,0,0,0,0,2020-12-27 19:15:00
2750,6137,Júlio Baptista,3443,[2006],Arsenal FC,13,5,8,544,3,0,10,5,5,496,0,0,23,10,13,1040,3,0,0.0,0.0,0.0,1,0,1,0,0,0,0,0,0,2020-12-27 19:15:00
2751,6138,Júlio César,2539,[2004],Bolton Wanderers,2,2,0,180,0,0,3,2,1,181,0,0,5,4,1,361,0,0,0.0,0.0,0.0,0,0,0,0,0,0,0,0,0,2020-12-27 19:15:00
2752,6139,Júlio César,2539,[2012],Queens Park Rangers,11,11,0,990,0,0,13,13,0,1110,0,0,24,24,0,2100,0,0,0.0,0.0,0.0,0,0,0,0,0,0,0,0,0,2020-12-27 19:15:00
2753,18423,Jürgen Locadia,2487,"[2017, 2018, 2019]",Brighton & Hove Albion,17,7,10,696,3,0,17,9,8,843,0,0,34,16,18,1539,3,0,4.0,0.0,4.0,2,0,2,0,0,0,0,0,0,2020-12-27 19:15:002020-12-27 19:15:002020-12-27 19:15:00
2754,18432,Jürgen Macho,3594,"[2000, 2001, 2002]",Sunderland AFC,8,7,1,672,0,0,11,10,1,963,0,0,19,17,2,1635,0,0,0.0,0.0,0.0,0,0,0,0,0,0,0,0,0,2020-12-27 19:15:002020-12-27 19:15:002020-12-27 19:15:00
2755,6146,Kaba Diawara,3779,[2000],West Ham United,4,2,2,237,0,0,7,4,3,385,0,0,11,6,5,622,0,0,0.0,0.0,0.0,0,0,0,0,0,0,0,0,0,2020-12-27 19:15:00
2756,6147,Kadeem Harris,3292,[2018],Cardiff City,5,1,4,133,1,0,8,2,6,233,0,0,13,3,10,366,1,0,0.0,0.0,0.0,0,0,0,0,0,0,0,0,0,2020-12-27 19:15:00
2757,6148,Kader Mangane,4023,[2012],Sunderland AFC,1,0,1,1,0,0,1,0,1,18,0,0,2,0,2,19,0,0,0.0,0.0,0.0,0,0,0,0,0,0,0,0,0,2020-12-27 19:15:00
2758,12299,Kagisho Dikgacoi,3401,"[2009, 2010]",Fulham FC,6,1,5,152,0,0,7,6,1,488,0,0,13,7,6,640,0,0,0.0,0.0,0.0,0,0,0,0,0,0,0,0,0,2020-12-27 19:15:002020-12-27 19:15:00
2759,6151,Kagisho Dikgacoi,3401,[2013],Crystal Palace,12,12,0,891,0,0,14,13,1,1111,0,0,26,25,1,2002,0,0,0.0,0.0,0.0,0,0,0,0,0,0,0,0,0,2020-12-27 19:15:00
2760,6152,Kai Havertz,1004,[2020],Chelsea FC,6,4,2,306,1,0,7,6,1,483,0,0,13,10,3,789,1,0,0.0,0.0,0.0,1,0,1,0,0,0,0,0,0,2020-12-27 19:15:00
2761,6153,Kaine Hayden,4341,[2019],Aston Villa,0,0,0,0,0,0,0,0,0,0,0,0,0,0,0,0,0,0,0.0,0.0,0.0,0,0,0,0,0,0,0,0,0,2020-12-27 19:15:00
2762,6154,Kalifa Cissé,3127,[2007],Reading FC,11,5,6,500,0,0,10,5,5,548,1,0,21,10,11,1048,1,0,0.0,0.0,0.0,0,1,1,0,0,0,0,0,0,2020-12-27 19:15:00
2763,6155,Kalvin Phillips,1075,[2020],Leeds United,7,7,0,630,0,0,5,5,0,406,0,0,12,12,0,1036,0,0,0.0,0.0,0.0,0,0,0,0,0,0,0,0,0,2020-12-27 19:15:00
2764,6156,Kamel Ghilas,4197,[2009],Hull City,6,1,5,168,1,0,7,5,2,415,0,0,13,6,7,583,1,0,3.0,0.0,3.0,1,0,1,0,0,0,0,0,0,2020-12-27 19:15:00
2765,6157,Kamil Grosicki,3765,[2016],Hull City,8,6,2,616,0,0,7,6,1,529,0,0,15,12,3,1145,0,0,0.0,0.0,0.0,0,0,0,0,0,0,0,0,0,2020-12-27 19:15:00
2766,6158,Kamil Grosicki,3765,[2020],West Bromwich Albion,0,0,0,0,0,0,1,0,1,10,0,0,1,0,1,10,0,0,0.0,0.0,0.0,0,0,0,0,0,0,0,0,0,2020-12-27 19:15:00
2767,12319,Kamil Zayatte,2322,"[2008, 2009]",Hull City,26,25,1,2181,1,0,29,27,2,2431,2,0,55,52,3,4612,3,0,0.0,0.0,0.0,1,2,3,0,0,0,0,0,0,2020-12-27 19:15:002020-12-27 19:15:00
2768,12323,Kane Wilson,3525,"[2016, 2017]",West Bromwich Albion,0,0,0,0,0,0,0,0,0,0,0,0,0,0,0,0,0,0,0.0,0.0,0.0,0,0,0,0,0,0,0,0,0,2020-12-27 19:15:002020-12-27 19:15:00
2769,6163,Karim Bagheri,4422,[2000],Charlton Athletic,0,0,0,0,0,0,1,0,1,18,0,0,1,0,1,18,0,0,0.0,0.0,0.0,0,0,0,0,0,0,0,0,0,2020-12-27 19:15:00
2770,18495,Karim El Ahmadi,1439,"[2012, 2013, 2014]",Aston Villa,26,19,7,1620,2,0,25,19,6,1739,1,0,51,38,13,3359,3,0,0.0,0.0,0.0,1,0,1,0,0,0,0,0,0,2020-12-27 19:15:002020-12-27 19:15:002020-12-27 19:15:00
2771,12335,Karim Rekik,1419,"[2011, 2012]",Manchester City,1,1,0,84,0,0,0,0,0,0,0,0,1,1,0,84,0,0,0.0,0.0,0.0,0,0,0,0,0,0,0,0,0,2020-12-27 19:15:002020-12-27 19:15:00
2772,6169,Karim Salisú,1078,[2020],Southampton FC,0,0,0,0,0,0,0,0,0,0,0,0,0,0,0,0,0,0,0.0,0.0,0.0,0,0,0,0,0,0,0,0,0,2020-12-27 19:15:00
2773,30860,Karl Darlow,2286,"[2015, 2017, 2018, 2019, 2020]",Newcastle United,16,16,0,1440,0,0,17,17,0,1530,0,0,33,33,0,2970,0,0,0.0,0.0,0.0,0,0,0,0,0,0,0,0,0,2020-12-27 19:15:002020-12-27 19:15:002020-12-27 19:15:002020-12-27 19:15:002020-12-27 19:15:00
2774,18528,Karl Henry,2921,"[2009, 2010, 2011]",Wolverhampton Wanderers,45,44,1,3925,0,0,49,48,1,4236,0,0,94,92,2,8161,0,0,0.0,0.0,0.0,0,0,0,0,0,0,0,0,0,2020-12-27 19:15:002020-12-27 19:15:002020-12-27 19:15:00
2775,6178,Karl Henry,2921,[2014],Queens Park Rangers,16,14,2,1317,0,0,17,13,4,1188,0,0,33,27,6,2505,0,0,0.0,0.0,0.0,0,0,0,0,0,0,0,0,0,2020-12-27 19:15:00
2776,6179,Karlan Grant,3218,[2018],Huddersfield Town,6,3,3,331,2,0,7,6,1,543,2,0,13,9,4,874,4,0,0.0,0.0,0.0,0,1,1,0,0,0,0,0,0,2020-12-27 19:15:00
2777,6180,Karlan Grant,3218,[2020],West Bromwich Albion,5,5,0,377,0,0,6,6,0,430,1,0,11,11,0,807,1,0,0.0,1.0,1.0,0,1,1,0,0,0,0,0,0,2020-12-27 19:15:00
2778,6181,Karlo Žiger,1056,[2020],Chelsea FC,0,0,0,0,0,0,0,0,0,0,0,0,0,0,0,0,0,0,0.0,0.0,0.0,0,0,0,0,0,0,0,0,0,2020-12-27 19:15:00
2779,18549,Kasey Keller,1117,"[2001, 2002, 2003]",Tottenham Hotspur,41,41,0,3690,0,0,43,43,0,3870,0,0,84,84,0,7560,0,0,0.0,0.0,0.0,0,0,0,0,0,0,0,0,0,2020-12-27 19:15:002020-12-27 19:15:002020-12-27 19:15:00
2780,6185,Kasey Keller,1117,[2004],Norwich City,1,1,0,90,0,0,0,0,0,0,0,0,1,1,0,90,0,0,0.0,0.0,0.0,0,0,0,0,0,0,0,0,0,2020-12-27 19:15:00
2781,6186,Kasey Keller,1117,[2007],Fulham FC,5,5,0,450,0,0,8,8,0,720,0,0,13,13,0,1170,0,0,0.0,0.0,0.0,0,0,0,0,0,0,0,0,0,2020-12-27 19:15:00
2782,6187,Kasey Palmer,4160,[2015],Chelsea FC,0,0,0,0,0,0,0,0,0,0,0,0,0,0,0,0,0,0,0.0,0.0,0.0,0,0,0,0,0,0,0,0,0,2020-12-27 19:15:00
2783,6188,Kasey Palmer,4160,[2017],Huddersfield Town,2,0,2,52,0,0,2,1,1,116,0,0,4,1,3,168,0,0,0.0,0.0,0.0,0,0,0,0,0,0,0,0,0,2020-12-27 19:15:00
2784,6189,Kaspars Gorkšs,3742,[2011],Queens Park Rangers,0,0,0,0,0,0,0,0,0,0,0,0,0,0,0,0,0,0,0.0,0.0,0.0,0,0,0,0,0,0,0,0,0,2020-12-27 19:15:00
2785,6190,Kaspars Gorkšs,3742,[2012],Reading FC,7,7,0,630,0,0,7,7,0,630,1,0,14,14,0,1260,1,0,0.0,0.0,0.0,0,1,1,0,0,0,0,0,0,2020-12-27 19:15:00
2786,12383,Kasper Schmeichel,2435,"[2007, 2008]",Manchester City,3,3,0,270,0,0,5,4,1,431,0,0,8,7,1,701,0,0,0.0,0.0,0.0,0,0,0,0,0,0,0,0,0,2020-12-27 19:15:002020-12-27 19:15:00
2787,43372,Kasper Schmeichel,2435,"[2014, 2015, 2016, 2017, 2018, 2019, 2020]",Leicester City,109,109,0,9777,0,0,107,107,0,9626,0,0,216,216,0,19403,0,0,0.0,0.0,0.0,0,0,0,0,0,0,0,0,0,2020-12-27 19:15:002020-12-27 19:15:002020-12-27 19:15:002020-12-27 19:15:002020-12-27 19:15:002020-12-27 19:15:002020-12-27 19:15:00
2788,12401,Kayne Ramsay,4170,"[2018, 2020]",Southampton FC,1,1,0,90,0,0,0,0,0,0,0,0,1,1,0,90,0,0,0.0,0.0,0.0,0,0,0,0,0,0,0,0,0,2020-12-27 19:15:002020-12-27 19:15:00
2789,12405,Kazaiah Sterling,2996,"[2017, 2018]",Tottenham Hotspur,0,0,0,0,0,0,0,0,0,0,0,0,0,0,0,0,0,0,0.0,0.0,0.0,0,0,0,0,0,0,0,0,0,2020-12-27 19:15:002020-12-27 19:15:00
2790,18615,Kazenga LuaLua,3619,"[2007, 2008, 2010]",Newcastle United,4,0,4,55,0,0,3,0,3,33,0,0,7,0,7,88,0,0,0.0,0.0,0.0,0,0,0,0,0,0,0,0,0,2020-12-27 19:15:002020-12-27 19:15:002020-12-27 19:15:00
2791,6207,Kazuyuki Toda,3737,[2002],Tottenham Hotspur,3,1,2,144,0,0,1,1,0,45,0,0,4,2,2,189,0,0,0.0,0.0,0.0,0,0,0,0,0,0,0,0,0,2020-12-27 19:15:00
2792,6208,Ke Li,3273,[2011],Arsenal FC,1,0,1,44,0,0,0,0,0,0,0,0,1,0,1,44,0,0,0.0,0.0,0.0,0,0,0,0,0,0,0,0,0,2020-12-27 19:15:00
2793,6209,Kean Bryan,1033,[2020],Sheffield United,1,1,0,90,0,0,1,1,0,63,0,0,2,2,0,153,0,0,0.0,0.0,0.0,0,0,0,0,0,0,0,0,0,2020-12-27 19:15:00
2794,6210,Kei Kamara,3704,[2012],Norwich City,6,3,3,313,1,0,5,4,1,342,0,0,11,7,4,655,1,0,0.0,0.0,0.0,1,0,1,0,0,0,0,0,0,2020-12-27 19:15:00
2795,18636,Keinan Davis,2853,"[2015, 2019, 2020]",Aston Villa,12,3,9,329,0,0,8,1,7,247,0,0,20,4,16,576,0,0,0.0,0.0,0.0,0,0,0,0,0,0,0,0,0,2020-12-27 19:15:002020-12-27 19:15:002020-12-27 19:15:00
2796,18645,Keiren Westwood,1410,"[2011, 2012, 2013]",Sunderland AFC,10,9,1,848,0,0,9,9,0,763,0,0,19,18,1,1611,0,0,0.0,0.0,0.0,0,0,0,0,0,0,0,0,0,2020-12-27 19:15:002020-12-27 19:15:002020-12-27 19:15:00
2797,6217,Keith Andrews,2656,[2003],Wolverhampton Wanderers,1,1,0,90,0,0,0,0,0,0,0,0,1,1,0,90,0,0,0.0,0.0,0.0,0,0,0,0,0,0,0,0,0,2020-12-27 19:15:00
2798,12438,Keith Andrews,2656,"[2008, 2010]",Blackburn Rovers,19,15,4,1324,1,0,18,13,5,1196,3,0,37,28,9,2520,4,0,1.0,1.0,2.0,1,1,2,0,0,0,0,0,0,2020-12-27 19:15:002020-12-27 19:15:00
2799,6219,Keith Andrews,2656,[2009],Wigan Athletic,1,1,0,90,0,0,0,0,0,0,0,0,1,1,0,90,0,0,0.0,0.0,0.0,0,0,0,0,0,0,0,0,0,2020-12-27 19:15:00
2800,6221,Keith Andrews,2656,[2011],West Bromwich Albion,7,4,3,385,1,0,7,4,3,403,1,0,14,8,6,788,2,0,0.0,0.0,0.0,0,0,0,0,0,0,0,0,0,2020-12-27 19:15:00
2801,12445,Keith Branagan,2724,"[2000, 2001]",Ipswich Town,2,2,0,180,0,0,1,0,1,29,0,0,3,2,1,209,0,0,0.0,0.0,0.0,0,0,0,0,0,0,0,0,0,2020-12-27 19:15:002020-12-27 19:15:00
2802,12449,Keith Fahey,1785,"[2009, 2010]",Birmingham City,28,16,12,1473,0,0,30,21,9,1750,1,0,58,37,21,3223,1,0,0.0,0.0,0.0,0,0,0,0,0,0,0,0,0,2020-12-27 19:15:002020-12-27 19:15:00
2803,12453,Keith Gillespie,1351,"[2001, 2002]",Blackburn Rovers,27,16,11,1669,2,0,27,13,14,1427,1,0,54,29,25,3096,3,0,0.0,0.0,0.0,2,1,3,0,0,0,0,0,0,2020-12-27 19:15:002020-12-27 19:15:00
2804,6228,Keith Gillespie,1351,[2003],Leicester City,6,5,1,386,0,0,6,2,4,232,0,0,12,7,5,618,0,0,0.0,0.0,0.0,0,0,0,0,0,0,0,0,0,2020-12-27 19:15:00
2805,6229,Keith Gillespie,1351,[2006],Sheffield United,15,13,2,1175,2,0,16,14,2,1241,0,0,31,27,4,2416,2,0,3.0,0.0,3.0,2,0,2,0,0,0,0,0,0,2020-12-27 19:15:00
2806,6230,Keith O'Neill,2068,[2000],Middlesbrough FC,8,8,0,639,0,0,6,5,1,517,0,0,14,13,1,1156,0,0,0.0,0.0,0.0,0,0,0,0,0,0,0,0,0,2020-12-27 19:15:00
2807,6231,Keith Southern,2604,[2010],Blackpool FC,10,7,3,642,0,0,11,4,7,443,0,0,21,11,10,1085,0,0,0.0,0.0,0.0,0,0,0,0,0,0,0,0,0,2020-12-27 19:15:00
2808,6232,Keith Treacy,2111,[2008],Blackburn Rovers,6,1,5,140,0,0,6,1,5,156,0,0,12,2,10,296,0,0,0.0,0.0,0.0,0,0,0,0,0,0,0,0,0,2020-12-27 19:15:00
2809,12467,Kelechi Iheanacho,1590,"[2015, 2016]",Manchester City,24,7,17,720,6,0,22,5,17,558,6,0,46,12,34,1278,12,0,4.0,3.0,7.0,3,2,5,0,0,0,0,0,0,2020-12-27 19:15:002020-12-27 19:15:00
2810,24946,Kelechi Iheanacho,1590,"[2017, 2018, 2019, 2020]",Leicester City,39,15,24,1442,4,0,39,14,25,1436,5,0,78,29,49,2878,9,0,3.0,0.0,3.0,4,1,5,0,0,0,0,0,0,2020-12-27 19:15:002020-12-27 19:15:002020-12-27 19:15:002020-12-27 19:15:00
2811,12479,Kelland Watts,4238,"[2018, 2019]",Newcastle United,1,0,1,16,0,0,0,0,0,0,0,0,1,0,1,16,0,0,0.0,0.0,0.0,0,0,0,0,0,0,0,0,0,2020-12-27 19:15:002020-12-27 19:15:00
2812,6241,Kelly Youga,4306,[2006],Charlton Athletic,0,0,0,0,0,0,1,1,0,90,0,0,1,1,0,90,0,0,0.0,0.0,0.0,0,0,0,0,0,0,0,0,0,2020-12-27 19:15:00
2813,6242,Kelvin Davis,1143,[2005],Sunderland AFC,16,16,0,1440,0,0,17,17,0,1530,0,0,33,33,0,2970,0,0,0.0,0.0,0.0,0,0,0,0,0,0,0,0,0,2020-12-27 19:15:00
2814,24978,Kelvin Davis,1143,"[2012, 2013, 2014, 2015]",Southampton FC,11,9,2,930,0,0,9,9,0,810,0,0,20,18,2,1740,0,0,0.0,0.0,0.0,0,0,0,0,0,0,0,0,0,2020-12-27 19:15:002020-12-27 19:15:002020-12-27 19:15:002020-12-27 19:15:00
2815,12495,Kelvin Etuhu,3678,"[2007, 2008]",Manchester City,3,1,2,121,1,0,6,2,4,184,0,0,9,3,6,305,1,0,0.0,0.0,0.0,0,0,0,0,0,0,0,0,0,2020-12-27 19:15:002020-12-27 19:15:00
2816,18750,Kemar Roofe,3486,"[2011, 2012, 2013]",West Bromwich Albion,0,0,0,0,0,0,0,0,0,0,0,0,0,0,0,0,0,0,0.0,0.0,0.0,0,0,0,0,0,0,0,0,0,2020-12-27 19:15:002020-12-27 19:15:002020-12-27 19:15:00
2817,12505,Kemy Agustien,3174,"[2011, 2012]",Swansea City,15,5,10,564,0,0,16,6,10,711,0,0,31,11,20,1275,0,0,0.0,0.0,0.0,0,0,0,0,0,0,0,0,0,2020-12-27 19:15:002020-12-27 19:15:00
2818,12509,Ken Sema,2092,"[2018, 2019]",Watford FC,8,4,4,301,0,0,9,5,4,477,1,0,17,9,8,778,1,0,0.0,0.0,0.0,0,1,1,0,0,0,0,0,0,2020-12-27 19:15:002020-12-27 19:15:00
2819,12516,Kenedy,2932,"[2015, 2019]",Chelsea FC,7,2,5,277,0,0,7,2,5,272,1,0,14,4,10,549,1,0,0.0,0.0,0.0,0,1,1,0,0,0,0,0,0,2020-12-27 19:15:002020-12-27 19:15:00
2820,6257,Kenedy,2932,[2016],Watford FC,0,0,0,0,0,0,1,0,1,15,0,0,1,0,1,15,0,0,0.0,0.0,0.0,0,0,0,0,0,0,0,0,0,2020-12-27 19:15:00
2821,12517,Kenedy,2932,"[2017, 2018]",Newcastle United,19,12,7,1115,2,0,19,15,4,1259,1,0,38,27,11,2374,3,0,0.0,0.0,0.0,1,1,2,0,0,0,0,0,0,2020-12-27 19:15:002020-12-27 19:15:00
2822,12523,Kenji Gorré,4293,"[2014, 2015]",Swansea City,0,0,0,0,0,0,1,0,1,6,0,0,1,0,1,6,0,0,0.0,0.0,0.0,0,0,0,0,0,0,0,0,0,2020-12-27 19:15:002020-12-27 19:15:00
2823,6263,Kenneth Zohoré,3150,[2018],Cardiff City,11,3,8,388,0,0,8,4,4,358,1,0,19,7,12,746,1,0,0.0,3.0,3.0,0,1,1,0,0,0,0,0,0,2020-12-27 19:15:00
2824,25062,Kenny Cunningham,1511,"[2002, 2003, 2004, 2005]",Birmingham City,67,67,0,5944,0,0,66,66,0,5870,0,0,133,133,0,11814,0,0,0.0,0.0,0.0,0,0,0,0,0,0,0,0,0,2020-12-27 19:15:002020-12-27 19:15:002020-12-27 19:15:002020-12-27 19:15:00
2825,6268,Kenny McLean,1828,[2019],Norwich City,18,15,3,1391,1,0,19,17,2,1575,0,0,37,32,5,2966,1,0,0.0,0.0,0.0,1,0,1,0,0,0,0,0,0,2020-12-27 19:15:00
2826,6269,Kenny Miller,1577,[2003],Wolverhampton Wanderers,11,9,2,712,2,0,14,8,6,713,0,0,25,17,8,1425,2,0,4.0,0.0,4.0,2,0,2,0,0,0,0,0,0,2020-12-27 19:15:00
2827,6270,Kenny Miller,1577,[2007],Derby County,15,14,1,1152,2,0,15,15,0,1340,2,0,30,29,1,2492,4,0,3.0,0.0,3.0,2,2,4,0,0,0,0,0,0,2020-12-27 19:15:00
2828,6271,Kenny Tete,1046,[2020],Fulham FC,1,1,0,39,0,0,1,1,0,90,0,0,2,2,0,129,0,0,0.0,0.0,0.0,0,0,0,0,0,0,0,0,0,2020-12-27 19:15:00
2829,6272,Kenwyne Jones,1222,[2004],Southampton FC,1,0,1,1,0,0,1,1,0,46,0,0,2,1,1,47,0,0,0.0,0.0,0.0,0,0,0,0,0,0,0,0,0,2020-12-27 19:15:00
2830,18822,Kenwyne Jones,1222,"[2007, 2008, 2009]",Sunderland AFC,48,44,4,3853,16,0,45,37,8,3402,10,0,93,81,12,7255,26,0,8.0,1.0,9.0,12,8,20,1,0,1,0,0,0,2020-12-27 19:15:002020-12-27 19:15:002020-12-27 19:15:00
2831,25110,Kenwyne Jones,1222,"[2010, 2011, 2012, 2013]",Stoke City,45,29,16,2742,9,0,43,28,15,2450,4,0,88,57,31,5192,13,0,2.0,1.0,3.0,8,3,11,0,0,0,0,0,0,2020-12-27 19:15:002020-12-27 19:15:002020-12-27 19:15:002020-12-27 19:15:00
2832,6280,Kepa,1853,[2006],West Ham United,4,0,4,54,1,0,4,1,3,116,0,0,8,1,7,170,1,0,0.0,0.0,0.0,0,0,0,0,0,0,0,0,0,2020-12-27 19:15:00
2833,18846,Kepa,1853,"[2018, 2019, 2020]",Chelsea FC,36,36,0,3240,0,0,36,36,0,3240,0,0,72,72,0,6480,0,0,0.0,0.0,0.0,0,0,0,0,0,0,0,0,0,2020-12-27 19:15:002020-12-27 19:15:002020-12-27 19:15:00
2834,12569,Kerim Frei,3119,"[2011, 2012]",Fulham FC,12,3,9,332,0,0,11,5,6,575,0,0,23,8,15,907,0,0,0.0,0.0,0.0,0,0,0,0,0,0,0,0,0,2020-12-27 19:15:002020-12-27 19:15:00
2835,6286,Kerrea Gilbert,4385,[2005],Arsenal FC,1,1,0,27,0,0,1,1,0,73,0,0,2,2,0,100,0,0,0.0,0.0,0.0,0,0,0,0,0,0,0,0,0,2020-12-27 19:15:00
2836,12575,Keshi Anderson,4213,"[2016, 2017]",Crystal Palace,0,0,0,0,0,0,0,0,0,0,0,0,0,0,0,0,0,0,0.0,0.0,0.0,0,0,0,0,0,0,0,0,0,2020-12-27 19:15:002020-12-27 19:15:00
2837,6289,Kevin Betsy,4369,[2001],Fulham FC,0,0,0,0,0,0,1,0,1,6,0,0,1,0,1,6,0,0,0.0,0.0,0.0,0,0,0,0,0,0,0,0,0,2020-12-27 19:15:00
2838,25166,Kevin Campbell,1601,"[2000, 2001, 2002, 2003]",Everton FC,53,42,11,3782,12,0,51,44,7,3957,12,0,104,86,18,7739,24,0,6.0,12.0,18.0,9,9,18,0,0,0,0,0,0,2020-12-27 19:15:002020-12-27 19:15:002020-12-27 19:15:002020-12-27 19:15:00
2839,12589,Kevin Campbell,1601,"[2004, 2005]",West Bromwich Albion,22,17,5,1407,5,0,23,18,5,1443,1,0,45,35,10,2850,6,0,0.0,0.0,0.0,3,0,3,0,0,0,0,0,0,2020-12-27 19:15:002020-12-27 19:15:00
2840,6296,Kevin Cooper,4517,[2003],Wolverhampton Wanderers,1,0,1,44,0,0,0,0,0,0,0,0,1,0,1,44,0,0,0.0,0.0,0.0,0,0,0,0,0,0,0,0,0,2020-12-27 19:15:00
2841,6297,Kevin Danso,3026,[2019],Southampton FC,3,2,1,180,0,0,3,1,2,113,0,0,6,3,3,293,0,0,0.0,0.0,0.0,0,0,0,0,0,0,0,0,0,2020-12-27 19:15:00
2842,18897,Kevin Davies,1718,"[2000, 2001, 2002]",Southampton FC,22,14,8,1206,3,0,34,24,10,2122,1,0,56,38,18,3328,4,0,1.0,1.0,2.0,2,1,3,0,0,0,0,0,0,2020-12-27 19:15:002020-12-27 19:15:002020-12-27 19:15:00
2843,56745,Kevin Davies,1718,"[2003, 2004, 2005, 2006, 2007, 2008, 2009, 2010, 2011]",Bolton Wanderers,159,151,8,13114,41,0,152,145,7,12801,26,0,311,296,15,25915,67,0,23.0,10.0,33.0,26,19,45,5,1,6,0,0,0,2020-12-27 19:15:002020-12-27 19:15:002020-12-27 19:15:002020-12-27 19:15:002020-12-27 19:15:002020-12-27 19:15:002020-12-27 19:15:002020-12-27 19:15:002020-12-27 19:15:00
2844,6310,Kevin De Bruyne,1201,[2013],Chelsea FC,2,1,1,72,0,0,1,1,0,60,0,0,3,2,1,132,0,0,0.0,0.0,0.0,0,0,0,0,0,0,0,0,0,2020-12-27 19:15:00
2845,37881,Kevin De Bruyne,1201,"[2015, 2016, 2017, 2018, 2019, 2020]",Manchester City,80,72,8,6272,26,0,84,73,11,6487,12,0,164,145,19,12759,38,0,0.0,3.0,3.0,9,8,17,3,1,4,0,0,0,2020-12-27 19:15:002020-12-27 19:15:002020-12-27 19:15:002020-12-27 19:15:002020-12-27 19:15:002020-12-27 19:15:00
2846,12635,Kevin Doyle,2594,"[2006, 2007]",Reading FC,35,33,2,2928,8,0,30,26,4,2286,11,0,65,59,6,5214,19,0,6.0,3.0,9.0,4,7,11,1,2,3,0,0,0,2020-12-27 19:15:002020-12-27 19:15:00
2847,18960,Kevin Doyle,2594,"[2009, 2010, 2011]",Wolverhampton Wanderers,47,44,3,3838,8,0,45,39,6,3505,10,0,92,83,9,7343,18,0,3.0,7.0,10.0,6,8,14,2,1,3,0,0,0,2020-12-27 19:15:002020-12-27 19:15:002020-12-27 19:15:00
2848,6322,Kevin Doyle,2594,[2014],Crystal Palace,1,0,1,29,0,0,2,0,2,5,0,0,3,0,3,34,0,0,0.0,0.0,0.0,0,0,0,0,0,0,0,0,0,2020-12-27 19:15:00
2849,6323,Kevin Ellison,4430,[2000],Leicester City,0,0,0,0,0,0,1,0,1,6,0,0,1,0,1,6,0,0,0.0,0.0,0.0,0,0,0,0,0,0,0,0,0,2020-12-27 19:15:00
2850,18975,Kevin Foley,2888,"[2009, 2010, 2011]",Wolverhampton Wanderers,37,32,5,2878,2,0,36,31,5,2811,0,0,73,63,10,5689,2,0,0.0,0.0,0.0,1,0,1,0,0,0,0,0,0,2020-12-27 19:15:002020-12-27 19:15:002020-12-27 19:15:00
2851,6327,Kevin Gallacher,3777,[2000],Newcastle United,9,7,2,605,1,0,9,4,5,424,1,0,18,11,7,1029,2,0,0.0,0.0,0.0,1,0,1,0,0,0,0,0,0,2020-12-27 19:15:00
2852,6328,Kevin Gibbens,4263,[2000],Southampton FC,1,0,1,1,0,0,2,1,1,72,0,0,3,1,2,73,0,0,0.0,0.0,0.0,0,0,0,0,0,0,0,0,0,2020-12-27 19:15:00
2853,6329,Kevin Harper,3785,[2003],Portsmouth FC,3,0,3,25,0,0,4,0,4,33,0,0,7,0,7,58,0,0,0.0,0.0,0.0,0,0,0,0,0,0,0,0,0,2020-12-27 19:15:00
2854,12661,Kevin Horlock,3205,"[2000, 2002]",Manchester City,19,14,5,1176,1,0,22,19,3,1628,1,0,41,33,8,2804,2,0,0.0,0.0,0.0,0,1,1,0,1,1,0,0,0,2020-12-27 19:15:002020-12-27 19:15:00
2855,18999,Kevin Kilbane,1103,"[2000, 2001, 2002]",Sunderland AFC,38,34,4,3019,3,0,42,38,4,3429,4,0,80,72,8,6448,7,0,0.0,3.0,3.0,3,3,6,0,0,0,0,0,0,2020-12-27 19:15:002020-12-27 19:15:002020-12-27 19:15:00
2856,19008,Kevin Kilbane,1103,"[2003, 2004, 2005]",Everton FC,52,40,12,3705,2,0,45,39,6,3469,2,0,97,79,18,7174,4,0,0.0,0.0,0.0,1,1,2,0,0,0,0,0,0,2020-12-27 19:15:002020-12-27 19:15:002020-12-27 19:15:00
2857,6338,Kevin Kilbane,1103,[2006],Wigan Athletic,15,14,1,1201,1,0,16,12,4,1157,0,0,31,26,5,2358,1,0,0.0,0.0,0.0,1,0,1,0,0,0,0,0,0,2020-12-27 19:15:00
2858,6339,Kevin Kilbane,1103,[2007],Blackburn Rovers,0,0,0,0,0,0,1,1,0,90,0,0,1,1,0,90,0,0,0.0,0.0,0.0,0,0,0,0,0,0,0,0,0,2020-12-27 19:15:00
2859,12681,Kevin Kilbane,1103,"[2008, 2009]",Hull City,19,14,5,1243,1,0,18,16,2,1422,0,0,37,30,7,2665,1,0,0.0,0.0,0.0,1,0,1,0,0,0,0,0,0,2020-12-27 19:15:002020-12-27 19:15:00
2860,25374,Kevin Kyle,1636,"[2000, 2001, 2002, 2005]",Sunderland AFC,20,8,12,909,0,0,19,10,9,1035,1,0,39,18,21,1944,1,0,0.0,0.0,0.0,0,0,0,0,0,0,0,0,0,2020-12-27 19:15:002020-12-27 19:15:002020-12-27 19:15:002020-12-27 19:15:00
2861,44443,Kevin Lisbie,2337,"[2000, 2001, 2002, 2003, 2004, 2005, 2006]",Charlton Athletic,59,28,31,2922,9,0,50,26,24,2562,5,0,109,54,55,5484,14,0,10.0,6.0,16.0,6,3,9,0,0,0,0,0,0,2020-12-27 19:15:002020-12-27 19:15:002020-12-27 19:15:002020-12-27 19:15:002020-12-27 19:15:002020-12-27 19:15:002020-12-27 19:15:00
2862,38133,Kevin Long,2350,"[2014, 2016, 2017, 2018, 2019, 2020]",Burnley FC,18,18,0,1620,1,0,22,18,4,1778,0,0,40,36,4,3398,1,0,0.0,0.0,0.0,0,0,0,0,0,0,0,0,0,2020-12-27 19:15:002020-12-27 19:15:002020-12-27 19:15:002020-12-27 19:15:002020-12-27 19:15:002020-12-27 19:15:00
2863,6359,Kevin Mbabu,3845,[2015],Newcastle United,1,1,0,90,0,0,2,1,1,54,0,0,3,2,1,144,0,0,0.0,0.0,0.0,0,0,0,0,0,0,0,0,0,2020-12-27 19:15:00
2864,6360,Kevin McDonald,2552,[2009],Burnley FC,12,7,5,661,0,0,14,8,6,800,1,0,26,15,11,1461,1,0,0.0,1.0,1.0,0,1,1,0,0,0,0,0,0,2020-12-27 19:15:00
2865,6361,Kevin McDonald,2552,[2018],Fulham FC,8,5,3,416,0,0,7,5,2,468,0,0,15,10,5,884,0,0,0.0,0.0,0.0,0,0,0,0,0,0,0,0,0,2020-12-27 19:15:00
2866,6362,Kevin McLeod,3770,[2000],Everton FC,2,0,2,33,0,0,2,0,2,24,0,0,4,0,4,57,0,0,0.0,0.0,0.0,0,0,0,0,0,0,0,0,0,2020-12-27 19:15:00
2867,6363,Kevin McNaughton,3999,[2013],Cardiff City,0,0,0,0,0,0,5,3,2,281,0,0,5,3,2,281,0,0,0.0,0.0,0.0,0,0,0,0,0,0,0,0,0,2020-12-27 19:15:00
2868,38199,Kevin Mirallas,2238,"[2012, 2013, 2014, 2015, 2016, 2017]",Everton FC,71,52,19,4331,19,0,80,52,28,4545,11,0,151,104,47,8876,30,0,9.0,0.0,9.0,7,6,13,0,0,0,0,0,0,2020-12-27 19:15:002020-12-27 19:15:002020-12-27 19:15:002020-12-27 19:15:002020-12-27 19:15:002020-12-27 19:15:00
2869,50988,Kevin Nolan,2396,"[2001, 2002, 2003, 2004, 2005, 2006, 2007, 2008]",Bolton Wanderers,127,111,16,9878,16,0,129,116,13,10237,23,0,256,227,29,20115,39,0,13.0,26.0,39.0,9,21,30,0,0,0,0,0,0,2020-12-27 19:15:002020-12-27 19:15:002020-12-27 19:15:002020-12-27 19:15:002020-12-27 19:15:002020-12-27 19:15:002020-12-27 19:15:002020-12-27 19:15:00
2870,6378,Kevin Nolan,2396,[2010],Newcastle United,14,14,0,1257,10,0,15,15,0,1310,2,0,29,29,0,2567,12,0,0.0,0.0,0.0,5,2,7,1,0,1,0,0,0,2020-12-27 19:15:00
2871,25522,Kevin Nolan,2396,"[2012, 2013, 2014, 2015]",West Ham United,50,44,6,3741,13,0,49,44,5,3797,5,0,99,88,11,7538,18,0,4.0,3.0,7.0,7,4,11,0,0,0,0,0,0,2020-12-27 19:15:002020-12-27 19:15:002020-12-27 19:15:002020-12-27 19:15:00
2872,19152,Kevin Phillips,1100,"[2000, 2001, 2002]",Sunderland AFC,46,46,0,4113,15,0,47,47,0,4037,16,0,93,93,0,8150,31,0,10.0,2.0,12.0,7,10,17,3,1,4,0,0,0,2020-12-27 19:15:002020-12-27 19:15:002020-12-27 19:15:00
2873,12773,Kevin Phillips,1100,"[2003, 2004]",Southampton FC,31,24,7,2190,12,0,29,22,7,2185,11,0,60,46,14,4375,23,0,4.0,1.0,5.0,8,3,11,0,1,1,0,0,0,2020-12-27 19:15:002020-12-27 19:15:00
2874,6388,Kevin Phillips,1100,[2005],Aston Villa,12,11,1,854,1,0,10,8,2,567,3,0,22,19,3,1421,4,0,0.0,3.0,3.0,1,2,3,0,0,0,0,0,0,2020-12-27 19:15:00
2875,12779,Kevin Phillips,1100,"[2009, 2010]",Birmingham City,21,5,16,569,5,0,12,2,10,334,0,0,33,7,26,903,5,0,4.0,0.0,4.0,5,0,5,0,0,0,0,0,0,2020-12-27 19:15:002020-12-27 19:15:00
2876,6391,Kevin Phillips,1100,[2013],Crystal Palace,2,0,2,45,0,0,2,0,2,31,0,0,4,0,4,76,0,0,0.0,0.0,0.0,0,0,0,0,0,0,0,0,0,2020-12-27 19:15:00
2877,19179,Kevin Poole,3502,"[2001, 2002, 2004]",Bolton Wanderers,3,3,0,270,0,0,2,1,1,92,0,0,5,4,1,362,0,0,0.0,0.0,0.0,0,0,0,0,0,0,0,0,0,2020-12-27 19:15:002020-12-27 19:15:002020-12-27 19:15:00
2878,12791,Kevin Stewart,3625,"[2015, 2016]",Liverpool FC,4,3,1,284,0,0,6,3,3,296,0,0,10,6,4,580,0,0,0.0,0.0,0.0,0,0,0,0,0,0,0,0,0,2020-12-27 19:15:002020-12-27 19:15:00
2879,6397,Kevin Stuhr-Ellegaard,3694,[2003],Manchester City,2,2,0,180,0,0,2,0,2,115,0,0,4,2,2,295,0,0,0.0,0.0,0.0,0,0,0,0,0,0,0,0,0,2020-12-27 19:15:00
2880,6398,Kevin Toner,1866,[2015],Aston Villa,2,1,1,134,0,0,2,2,0,180,0,0,4,3,1,314,0,0,0.0,0.0,0.0,0,0,0,0,0,0,0,0,0,2020-12-27 19:15:00
2881,12799,Kevin Wimmer,1902,"[2015, 2016]",Tottenham Hotspur,5,4,1,401,0,0,10,9,1,768,0,0,15,13,2,1169,0,0,0.0,0.0,0.0,0,0,0,0,0,0,0,0,0,2020-12-27 19:15:002020-12-27 19:15:00
2882,6401,Kevin Wimmer,1902,[2017],Stoke City,7,6,1,577,0,0,10,8,2,744,0,0,17,14,3,1321,0,0,0.0,0.0,0.0,0,0,0,0,0,0,0,0,0,2020-12-27 19:15:00
2883,12805,Kevin-Prince Boateng,3159,"[2007, 2008]",Tottenham Hotspur,5,1,4,165,0,0,8,6,2,419,0,0,13,7,6,584,0,0,0.0,0.0,0.0,0,0,0,0,0,0,0,0,0,2020-12-27 19:15:002020-12-27 19:15:00
2884,6404,Kevin-Prince Boateng,3159,[2009],Portsmouth FC,11,11,0,961,3,0,11,9,2,883,0,0,22,20,2,1844,3,0,0.0,0.0,0.0,2,0,2,1,0,1,0,0,0,2020-12-27 19:15:00
2885,6405,Khalid Boulahrouz,2710,[2006],Chelsea FC,6,4,2,386,0,0,7,6,1,499,0,0,13,10,3,885,0,0,0.0,0.0,0.0,0,0,0,0,0,0,0,0,0,2020-12-27 19:15:00
2886,12813,Khalilou Fadiga,4105,"[2004, 2005]",Bolton Wanderers,7,2,5,84,0,0,6,3,3,347,1,0,13,5,8,431,1,0,0.0,0.0,0.0,0,1,1,0,0,0,0,0,0,2020-12-27 19:15:002020-12-27 19:15:00
2887,6408,Ki-Jana Hoever,3557,[2019],Liverpool FC,0,0,0,0,0,0,0,0,0,0,0,0,0,0,0,0,0,0,0.0,0.0,0.0,0,0,0,0,0,0,0,0,0,2020-12-27 19:15:00
2888,6409,Ki-Jana Hoever,3557,[2020],Wolverhampton Wanderers,1,0,1,12,0,0,1,0,1,17,0,0,2,0,2,29,0,0,0.0,0.0,0.0,0,0,0,0,0,0,0,0,0,2020-12-27 19:15:00
2889,6410,Ki-hyeon Seol,1563,[2006],Reading FC,15,13,2,1039,1,0,11,8,3,699,3,0,26,21,5,1738,4,0,0.0,3.0,3.0,1,2,3,0,0,0,0,0,0,2020-12-27 19:15:00
2890,19236,Ki-hyeon Seol,1563,"[2007, 2008, 2009]",Fulham FC,8,3,5,280,0,0,10,3,7,272,1,0,18,6,12,552,1,0,0.0,0.0,0.0,0,1,1,0,0,0,0,0,0,2020-12-27 19:15:002020-12-27 19:15:002020-12-27 19:15:00
2891,6414,Kieran Agard,4499,[2009],Everton FC,0,0,0,0,0,0,1,0,1,1,0,0,1,0,1,1,0,0,0.0,0.0,0.0,0,0,0,0,0,0,0,0,0,2020-12-27 19:15:00
2892,12831,Kieran Dowell,2742,"[2015, 2018]",Everton FC,2,1,1,72,0,0,0,0,0,0,0,0,2,1,1,72,0,0,0.0,0.0,0.0,0,0,0,0,0,0,0,0,0,2020-12-27 19:15:002020-12-27 19:15:00
2893,57789,Kieran Gibbs,1508,"[2008, 2009, 2010, 2011, 2012, 2013, 2014, 2015, 2016]",Arsenal FC,67,56,11,4824,2,0,70,48,22,4551,0,0,137,104,33,9375,2,0,1.0,0.0,1.0,2,0,2,0,0,0,0,0,0,2020-12-27 19:15:002020-12-27 19:15:002020-12-27 19:15:002020-12-27 19:15:002020-12-27 19:15:002020-12-27 19:15:002020-12-27 19:15:002020-12-27 19:15:002020-12-27 19:15:00
2894,12853,Kieran Gibbs,1508,"[2017, 2020]",West Bromwich Albion,18,18,0,1547,0,0,21,19,2,1778,0,0,39,37,2,3325,0,0,0.0,0.0,0.0,0,0,0,0,0,0,0,0,0,2020-12-27 19:15:002020-12-27 19:15:00
2895,6428,Kieran Lee,4360,[2006],Manchester United,0,0,0,0,0,0,1,1,0,90,0,0,1,1,0,90,0,0,0.0,0.0,0.0,0,0,0,0,0,0,0,0,0,2020-12-27 19:15:00
2896,6429,Kieran O'Hara,3279,[2016],Manchester United,0,0,0,0,0,0,0,0,0,0,0,0,0,0,0,0,0,0,0.0,0.0,0.0,0,0,0,0,0,0,0,0,0,2020-12-27 19:15:00
2897,19295,Kieran Richardson,1898,"[2002, 2005, 2006]",Manchester United,23,12,11,1272,2,0,16,8,8,709,0,0,39,20,19,1981,2,0,0.0,0.0,0.0,1,0,1,0,0,0,0,0,0,2020-12-27 19:15:002020-12-27 19:15:002020-12-27 19:15:00
2898,6431,Kieran Richardson,1898,[2004],West Bromwich Albion,6,5,1,448,2,0,5,5,0,353,1,0,11,10,1,801,3,0,0.0,0.0,0.0,1,1,2,0,0,0,0,0,0,2020-12-27 19:15:00
2899,32180,Kieran Richardson,1898,"[2007, 2008, 2009, 2010, 2011]",Sunderland AFC,65,60,5,5134,8,0,67,62,5,5328,6,0,132,122,10,10462,14,0,4.0,0.0,4.0,7,4,11,0,0,0,0,0,0,2020-12-27 19:15:002020-12-27 19:15:002020-12-27 19:15:002020-12-27 19:15:002020-12-27 19:15:00
2900,12879,Kieran Richardson,1898,"[2012, 2013]",Fulham FC,20,17,3,1444,2,0,25,23,2,1760,3,0,45,40,5,3204,5,0,0.0,0.0,0.0,1,2,3,0,0,0,0,0,0,2020-12-27 19:15:002020-12-27 19:15:00
2901,12883,Kieran Richardson,1898,"[2014, 2015]",Aston Villa,14,11,3,951,0,0,19,13,6,1184,0,0,33,24,9,2135,0,0,0.0,0.0,0.0,0,0,0,0,0,0,0,0,0,2020-12-27 19:15:002020-12-27 19:15:00
2902,12887,Kieran Tierney,2214,"[2019, 2020]",Arsenal FC,15,14,1,1251,1,0,14,12,2,992,0,0,29,26,3,2243,1,0,0.0,0.0,0.0,0,0,0,0,0,0,0,0,0,2020-12-27 19:15:002020-12-27 19:15:00
2903,6445,Kieran Trippier,1487,[2014],Burnley FC,19,19,0,1710,0,0,19,19,0,1706,0,0,38,38,0,3416,0,0,0.0,0.0,0.0,0,0,0,0,0,0,0,0,0,2020-12-27 19:15:00
2904,25790,Kieran Trippier,1487,"[2015, 2016, 2017, 2018]",Tottenham Hotspur,33,30,3,2715,2,0,36,28,8,2501,0,0,69,58,11,5216,2,0,3.0,0.0,3.0,2,0,2,0,0,0,0,0,0,2020-12-27 19:15:002020-12-27 19:15:002020-12-27 19:15:002020-12-27 19:15:00
2905,45171,Kieron Dyer,2033,"[2000, 2001, 2002, 2003, 2004, 2005, 2006]",Newcastle United,79,72,7,6330,10,0,73,62,11,5587,10,0,152,134,18,11917,20,0,3.0,0.0,3.0,6,7,13,0,1,1,0,0,0,2020-12-27 19:15:002020-12-27 19:15:002020-12-27 19:15:002020-12-27 19:15:002020-12-27 19:15:002020-12-27 19:15:002020-12-27 19:15:00
2906,25834,Kieron Dyer,2033,"[2007, 2008, 2009, 2010]",West Ham United,15,7,8,631,0,0,15,8,7,707,0,0,30,15,15,1338,0,0,0.0,0.0,0.0,0,0,0,0,0,0,0,0,0,2020-12-27 19:15:002020-12-27 19:15:002020-12-27 19:15:002020-12-27 19:15:00
2907,12923,Kieron Dyer,2033,"[2011, 2012]",Queens Park Rangers,1,1,0,7,0,0,4,1,3,196,0,0,5,2,3,203,0,0,0.0,0.0,0.0,0,0,0,0,0,0,0,0,0,2020-12-27 19:15:002020-12-27 19:15:00
2908,6463,Kieron Freeman,3474,[2019],Sheffield United,1,0,1,1,0,0,1,0,1,5,0,0,2,0,2,6,0,0,0.0,0.0,0.0,0,0,0,0,0,0,0,0,0,2020-12-27 19:15:00
2909,12929,Kiki Musampa,2917,"[2004, 2005]",Manchester City,19,17,2,1497,2,0,18,17,1,1378,1,0,37,34,3,2875,3,0,4.0,0.0,4.0,2,0,2,0,0,0,0,0,0,2020-12-27 19:15:002020-12-27 19:15:00
2910,6466,Kiko Casilla,1071,[2020],Leeds United,0,0,0,0,0,0,0,0,0,0,0,0,0,0,0,0,0,0,0.0,0.0,0.0,0,0,0,0,0,0,0,0,0,2020-12-27 19:15:00
2911,19404,Kiko Femenía,1919,"[2017, 2018, 2019]",Watford FC,40,33,7,3065,2,0,40,34,6,2936,0,0,80,67,13,6001,2,0,0.0,0.0,0.0,1,0,1,0,0,0,0,0,0,2020-12-27 19:15:002020-12-27 19:15:002020-12-27 19:15:00
2912,6470,Kim Källström,3957,[2013],Arsenal FC,3,1,2,128,0,0,0,0,0,0,0,0,3,1,2,128,0,0,0.0,0.0,0.0,0,0,0,0,0,0,0,0,0,2020-12-27 19:15:00
2913,6471,Kit Symons,3546,[2001],Fulham FC,2,1,1,165,0,0,2,1,1,116,0,0,4,2,2,281,0,0,0.0,0.0,0.0,0,0,0,0,0,0,0,0,0,2020-12-27 19:15:00
2914,12945,Kléberson,3499,"[2003, 2004]",Manchester United,12,10,2,793,2,0,8,6,2,412,0,0,20,16,4,1205,2,0,0.0,0.0,0.0,1,0,1,0,0,0,0,0,0,2020-12-27 19:15:002020-12-27 19:15:00
2915,45339,Kolo Touré,1415,"[2002, 2003, 2004, 2005, 2006, 2007, 2008]",Arsenal FC,112,100,12,8977,3,0,108,99,9,8847,6,0,220,199,21,17824,9,0,1.0,1.0,2.0,2,4,6,0,0,0,0,0,0,2020-12-27 19:15:002020-12-27 19:15:002020-12-27 19:15:002020-12-27 19:15:002020-12-27 19:15:002020-12-27 19:15:002020-12-27 19:15:00
2916,25930,Kolo Touré,1415,"[2009, 2010, 2011, 2012]",Manchester City,42,36,6,3299,2,0,39,33,6,2938,0,0,81,69,12,6237,2,0,0.0,0.0,0.0,2,0,2,0,0,0,0,0,0,2020-12-27 19:15:002020-12-27 19:15:002020-12-27 19:15:002020-12-27 19:15:00
2917,19458,Kolo Touré,1415,"[2013, 2014, 2015]",Liverpool FC,23,17,6,1675,0,0,23,14,9,1333,1,0,46,31,15,3008,1,0,0.0,0.0,0.0,0,0,0,0,0,0,0,0,0,2020-12-27 19:15:002020-12-27 19:15:002020-12-27 19:15:00
2918,6488,Konstantinos Chalkias,4232,[2004],Portsmouth FC,2,2,0,180,0,0,3,3,0,270,0,0,5,5,0,450,0,0,0.0,0.0,0.0,0,0,0,0,0,0,0,0,0,2020-12-27 19:15:00
2919,19470,Konstantinos Mavropanos,1484,"[2017, 2018, 2019]",Arsenal FC,2,2,0,136,0,0,5,4,1,284,0,0,7,6,1,420,0,0,0.0,0.0,0.0,0,0,0,0,0,0,0,0,0,2020-12-27 19:15:002020-12-27 19:15:002020-12-27 19:15:00
2920,6492,Korey Smith,4106,[2012],Norwich City,0,0,0,0,0,0,0,0,0,0,0,0,0,0,0,0,0,0,0.0,0.0,0.0,0,0,0,0,0,0,0,0,0,2020-12-27 19:15:00
2921,6493,Kortney Hause,2155,[2018],Wolverhampton Wanderers,0,0,0,0,0,0,0,0,0,0,0,0,0,0,0,0,0,0,0.0,0.0,0.0,0,0,0,0,0,0,0,0,0,2020-12-27 19:15:00
2922,12989,Kortney Hause,2155,"[2019, 2020]",Aston Villa,11,11,0,990,2,0,10,9,1,824,0,0,21,20,1,1814,2,0,0.0,0.0,0.0,1,0,1,0,0,0,0,0,0,2020-12-27 19:15:002020-12-27 19:15:00
2923,6496,Kostas Konstantinidis,4274,[2001],Bolton Wanderers,1,1,0,90,0,0,2,2,0,149,0,0,3,3,0,239,0,0,0.0,0.0,0.0,0,0,0,0,0,0,0,0,0,2020-12-27 19:15:00
2924,6497,Kostas Mitroglou,3675,[2013],Fulham FC,0,0,0,0,0,0,3,1,2,152,0,0,3,1,2,152,0,0,0.0,0.0,0.0,0,0,0,0,0,0,0,0,0,2020-12-27 19:15:00
2925,6498,Kostas Stafylidis,3643,[2017],Stoke City,1,1,0,90,0,0,3,2,1,155,0,0,4,3,1,245,0,0,0.0,0.0,0.0,0,0,0,0,0,0,0,0,0,2020-12-27 19:15:00
2926,6499,Kostas Tsimikas,1022,[2020],Liverpool FC,0,0,0,0,0,0,0,0,0,0,0,0,0,0,0,0,0,0,0.0,0.0,0.0,0,0,0,0,0,0,0,0,0,2020-12-27 19:15:00
2927,6500,Kristofer Hæstad,3445,[2006],Wigan Athletic,0,0,0,0,0,0,2,1,1,74,0,0,2,1,1,74,0,0,0.0,0.0,0.0,0,0,0,0,0,0,0,0,0,2020-12-27 19:15:00
2928,19506,Kristoffer Nordfeldt,2275,"[2015, 2016, 2017]",Swansea City,2,2,0,180,0,0,0,0,0,0,0,0,2,2,0,180,0,0,0.0,0.0,0.0,0,0,0,0,0,0,0,0,0,2020-12-27 19:15:002020-12-27 19:15:002020-12-27 19:15:00
2929,65085,Kun Agüero,1204,"[2011, 2012, 2013, 2014, 2015, 2016, 2017, 2018, 2019, 2020]",Manchester City,138,118,20,9938,104,0,129,112,17,9506,76,0,267,230,37,19444,180,0,11.0,23.0,34.0,44,45,89,18,8,26,0,0,0,2020-12-27 19:15:002020-12-27 19:15:002020-12-27 19:15:002020-12-27 19:15:002020-12-27 19:15:002020-12-27 19:15:002020-12-27 19:15:002020-12-27 19:15:002020-12-27 19:15:002020-12-27 19:15:00
2930,32584,Kurt Zouma,1903,"[2014, 2015, 2016, 2019, 2020]",Chelsea FC,44,37,7,3318,3,0,45,33,12,3092,2,0,89,70,19,6410,5,0,0.0,0.0,0.0,2,0,2,0,0,0,0,0,0,2020-12-27 19:15:002020-12-27 19:15:002020-12-27 19:15:002020-12-27 19:15:002020-12-27 19:15:00
2931,6517,Kurt Zouma,1903,[2017],Stoke City,16,14,2,1292,0,0,17,17,0,1506,1,0,33,31,2,2798,1,0,0.0,0.0,0.0,0,1,1,0,0,0,0,0,0,2020-12-27 19:15:00
2932,6518,Kurt Zouma,1903,[2018],Everton FC,16,15,1,1351,1,0,16,14,2,1262,1,0,32,29,3,2613,2,0,0.0,0.0,0.0,1,1,2,0,0,0,0,0,0,2020-12-27 19:15:00
2933,6521,Kyel Reid,4158,[2005],West Bromwich Albion,1,1,0,90,0,0,0,0,0,0,0,0,1,1,0,90,0,0,0.0,0.0,0.0,0,0,0,0,0,0,0,0,0,2020-12-27 19:15:00
2934,6522,Kyel Reid,4158,[2007],West Ham United,1,0,1,11,0,0,0,0,0,0,0,0,1,0,1,11,0,0,0.0,0.0,0.0,0,0,0,0,0,0,0,0,0,2020-12-27 19:15:00
2935,32625,Kyle Bartley,2276,"[2012, 2013, 2014, 2015, 2017]",Swansea City,9,7,2,664,0,0,12,7,5,720,0,0,21,14,7,1384,0,0,0.0,0.0,0.0,0,0,0,0,0,0,0,0,0,2020-12-27 19:15:002020-12-27 19:15:002020-12-27 19:15:002020-12-27 19:15:002020-12-27 19:15:00
2936,6528,Kyle Bartley,2276,[2020],West Bromwich Albion,5,5,0,450,1,0,3,3,0,270,0,0,8,8,0,720,1,0,0.0,0.0,0.0,0,0,0,0,0,0,0,0,0,2020-12-27 19:15:00
2937,6529,Kyle Edwards,1034,[2020],West Bromwich Albion,2,0,2,23,0,0,3,1,2,92,0,0,5,1,4,115,0,0,0.0,0.0,0.0,0,0,0,0,0,0,0,0,0,2020-12-27 19:15:00
2938,6530,Kyle Jameson,4563,[2017],West Bromwich Albion,0,0,0,0,0,0,0,0,0,0,0,0,0,0,0,0,0,0,0.0,0.0,0.0,0,0,0,0,0,0,0,0,0,2020-12-27 19:15:00
2939,6531,Kyle Knoyle,3522,[2015],West Ham United,0,0,0,0,0,0,0,0,0,0,0,0,0,0,0,0,0,0,0.0,0.0,0.0,0,0,0,0,0,0,0,0,0,2020-12-27 19:15:00
2940,6532,Kyle Lafferty,4227,[2015],Norwich City,1,0,1,13,0,0,0,0,0,0,0,0,1,0,1,13,0,0,0.0,0.0,0.0,0,0,0,0,0,0,0,0,0,2020-12-27 19:15:00
2941,32678,Kyle Naughton,2273,"[2009, 2010, 2012, 2013, 2014]",Tottenham Hotspur,19,17,2,1455,0,0,23,20,3,1745,0,0,42,37,5,3200,0,0,0.0,0.0,0.0,0,0,0,0,0,0,0,0,0,2020-12-27 19:15:002020-12-27 19:15:002020-12-27 19:15:002020-12-27 19:15:002020-12-27 19:15:00
2942,6535,Kyle Naughton,2273,[2011],Norwich City,17,14,3,1350,0,0,15,15,0,1350,0,0,32,29,3,2700,0,0,0.0,0.0,0.0,0,0,0,0,0,0,0,0,0,2020-12-27 19:15:00
2943,19620,Kyle Naughton,2273,"[2015, 2016, 2017]",Swansea City,47,41,6,3724,0,0,45,43,2,3843,1,0,92,84,8,7567,1,0,0.0,0.0,0.0,0,0,0,0,0,0,0,0,0,2020-12-27 19:15:002020-12-27 19:15:002020-12-27 19:15:00
2944,6542,Kyle Scott,3383,[2017],Chelsea FC,0,0,0,0,0,0,0,0,0,0,0,0,0,0,0,0,0,0,0.0,0.0,0.0,0,0,0,0,0,0,0,0,0,2020-12-27 19:15:00
2945,13087,Kyle Taylor,3935,"[2017, 2018]",AFC Bournemouth,0,0,0,0,0,0,0,0,0,0,0,0,0,0,0,0,0,0,0.0,0.0,0.0,0,0,0,0,0,0,0,0,0,2020-12-27 19:15:002020-12-27 19:15:00
2946,6545,Kyle Walker,1196,[2010],Aston Villa,7,7,0,618,1,0,8,8,0,720,0,0,15,15,0,1338,1,0,0.0,0.0,0.0,1,0,1,0,0,0,0,0,0,2020-12-27 19:15:00
2947,39291,Kyle Walker,1196,"[2011, 2012, 2013, 2014, 2015, 2016]",Tottenham Hotspur,90,88,2,7746,4,0,90,90,0,7898,0,0,180,178,2,15644,4,0,3.0,0.0,3.0,2,0,2,0,0,0,0,0,0,2020-12-27 19:15:002020-12-27 19:15:002020-12-27 19:15:002020-12-27 19:15:002020-12-27 19:15:002020-12-27 19:15:00
2948,26214,Kyle Walker,1196,"[2017, 2018, 2019, 2020]",Manchester City,50,46,4,4133,2,0,55,54,1,4777,1,0,105,100,5,8910,3,0,6.0,3.0,9.0,2,1,3,0,0,0,0,0,0,2020-12-27 19:15:002020-12-27 19:15:002020-12-27 19:15:002020-12-27 19:15:00
2949,26230,Kyle Walker-Peters,3113,"[2015, 2017, 2018, 2019]",Tottenham Hotspur,7,6,1,514,0,0,5,3,2,290,0,0,12,9,3,804,0,0,0.0,0.0,0.0,0,0,0,0,0,0,0,0,0,2020-12-27 19:15:002020-12-27 19:15:002020-12-27 19:15:002020-12-27 19:15:00
2950,6560,Kyle Walker-Peters,3113,[2020],Southampton FC,7,7,0,630,0,0,8,8,0,720,0,0,15,15,0,1350,0,0,0.0,0.0,0.0,0,0,0,0,0,0,0,0,0,2020-12-27 19:15:00
2951,6561,Kévin Théophile-Catherine,3457,[2013],Cardiff City,15,13,2,1186,0,0,13,13,0,1170,0,0,28,26,2,2356,0,0,0.0,0.0,0.0,0,0,0,0,0,0,0,0,0,2020-12-27 19:15:00
2952,6562,Lacina Traoré,4552,[2013],Everton FC,0,0,0,0,0,0,1,0,1,1,0,0,1,0,1,1,0,0,0.0,0.0,0.0,0,0,0,0,0,0,0,0,0,2020-12-27 19:15:00
2953,6563,Lamine Diatta,4424,[2007],Newcastle United,1,0,1,8,0,0,1,0,1,1,0,0,2,0,2,9,0,0,0.0,0.0,0.0,0,0,0,0,0,0,0,0,0,2020-12-27 19:15:00
2954,13129,Lamine Koné,3136,"[2015, 2016]",Sunderland AFC,23,22,1,1946,2,0,22,22,0,1914,1,0,45,44,1,3860,3,0,0.0,0.0,0.0,0,1,1,0,0,0,0,0,0,2020-12-27 19:15:002020-12-27 19:15:00
2955,6566,Lamine Sakho,2781,[2003],Leeds United,8,5,3,435,0,0,9,4,5,347,1,0,17,9,8,782,1,0,0.0,0.0,0.0,0,1,1,0,0,0,0,0,0,2020-12-27 19:15:00
2956,13135,Landon Donovan,3992,"[2009, 2011]",Everton FC,9,8,1,726,2,0,8,6,2,554,0,0,17,14,3,1280,2,0,0.0,0.0,0.0,0,0,0,0,0,0,0,0,0,2020-12-27 19:15:002020-12-27 19:15:00
2957,6569,Larnell Cole,4033,[2011],Manchester United,0,0,0,0,0,0,0,0,0,0,0,0,0,0,0,0,0,0,0.0,0.0,0.0,0,0,0,0,0,0,0,0,0,2020-12-27 19:15:00
2958,6570,Larnell Cole,4033,[2013],Fulham FC,0,0,0,0,0,0,1,0,1,10,0,0,1,0,1,10,0,0,0.0,0.0,0.0,0,0,0,0,0,0,0,0,0,2020-12-27 19:15:00
2959,6571,Lars Bohinen,3834,[2000],Derby County,0,0,0,0,0,0,2,1,1,81,0,0,2,1,1,81,0,0,0.0,0.0,0.0,0,0,0,0,0,0,0,0,0,2020-12-27 19:15:00
2960,6572,Lars Jacobsen,2657,[2008],Everton FC,1,1,0,90,0,0,4,3,1,271,0,0,5,4,1,361,0,0,0.0,0.0,0.0,0,0,0,0,0,0,0,0,0,2020-12-27 19:15:00
2961,6573,Lars Jacobsen,2657,[2009],Wigan Athletic,1,0,1,23,0,0,0,0,0,0,0,0,1,0,1,23,0,0,0.0,0.0,0.0,0,0,0,0,0,0,0,0,0,2020-12-27 19:15:00
2962,6574,Lars Jacobsen,2657,[2010],Blackburn Rovers,0,0,0,0,0,0,0,0,0,0,0,0,0,0,0,0,0,0,0.0,0.0,0.0,0,0,0,0,0,0,0,0,0,2020-12-27 19:15:00
2963,13151,Lassana Diarra,2975,"[2005, 2006]",Chelsea FC,6,4,2,319,0,0,7,5,2,423,0,0,13,9,4,742,0,0,0.0,0.0,0.0,0,0,0,0,0,0,0,0,0,2020-12-27 19:15:002020-12-27 19:15:00
2964,13155,Lassana Diarra,2975,"[2007, 2008]",Portsmouth FC,12,11,1,995,0,0,12,11,1,914,1,0,24,22,2,1909,1,0,0.0,3.0,3.0,0,1,1,0,0,0,0,0,0,2020-12-27 19:15:002020-12-27 19:15:00
2965,6579,Lasse Sørensen,4069,[2017],Stoke City,0,0,0,0,0,0,1,1,0,76,0,0,1,1,0,76,0,0,0.0,0.0,0.0,0,0,0,0,0,0,0,0,0,2020-12-27 19:15:00
2966,6580,Lasse Vigen,4347,[2013],Fulham FC,0,0,0,0,0,0,0,0,0,0,0,0,0,0,0,0,0,0,0.0,0.0,0.0,0,0,0,0,0,0,0,0,0,2020-12-27 19:15:00
2967,39501,Lauren,1602,"[2000, 2001, 2002, 2003, 2004, 2005]",Arsenal FC,76,73,3,6531,5,0,79,75,4,6726,2,0,155,148,7,13257,7,0,3.0,0.0,3.0,3,1,4,1,1,2,0,0,0,2020-12-27 19:15:002020-12-27 19:15:002020-12-27 19:15:002020-12-27 19:15:002020-12-27 19:15:002020-12-27 19:15:00
2968,13175,Lauren,1602,"[2006, 2007]",Portsmouth FC,13,10,3,978,0,0,12,10,2,798,0,0,25,20,5,1776,0,0,0.0,0.0,0.0,0,0,0,0,0,0,0,0,0,2020-12-27 19:15:002020-12-27 19:15:00
2969,13179,Laurent Blanc,1451,"[2001, 2002]",Manchester United,23,22,1,1950,0,0,23,20,3,1844,1,0,46,42,4,3794,1,0,0.0,0.0,0.0,0,0,0,0,0,0,0,0,0,2020-12-27 19:15:002020-12-27 19:15:00
2970,6591,Laurent Charvet,3304,[2000],Manchester City,10,7,3,649,0,0,8,7,1,613,0,0,18,14,4,1262,0,0,0.0,0.0,0.0,0,0,0,0,0,0,0,0,0,2020-12-27 19:15:00
2971,6592,Laurent Courtois,2041,[2001],West Ham United,4,4,0,280,0,0,3,1,2,114,0,0,7,5,2,394,0,0,0.0,0.0,0.0,0,0,0,0,0,0,0,0,0,2020-12-27 19:15:00
2972,13187,Laurent Depoitre,3102,"[2017, 2018]",Huddersfield Town,27,11,16,1270,3,0,29,17,12,1599,3,0,56,28,28,2869,6,0,0.0,1.0,1.0,1,2,3,0,0,0,0,0,0,2020-12-27 19:15:002020-12-27 19:15:00
2973,59391,Laurent Koscielny,1497,"[2010, 2011, 2012, 2013, 2014, 2015, 2016, 2017, 2018]",Arsenal FC,122,119,3,10448,14,0,132,125,7,11065,8,0,254,244,10,21513,22,0,6.0,11.0,17.0,8,7,15,0,0,0,0,0,0,2020-12-27 19:15:002020-12-27 19:15:002020-12-27 19:15:002020-12-27 19:15:002020-12-27 19:15:002020-12-27 19:15:002020-12-27 19:15:002020-12-27 19:15:002020-12-27 19:15:00
2974,26422,Laurent Robert,2034,"[2001, 2002, 2003, 2004]",Newcastle United,65,57,8,4994,14,0,58,48,10,4224,8,0,123,105,18,9218,22,0,11.0,0.0,11.0,11,3,14,0,0,0,0,0,0,2020-12-27 19:15:002020-12-27 19:15:002020-12-27 19:15:002020-12-27 19:15:00
2975,6608,Laurent Robert,2034,[2005],Portsmouth FC,8,7,1,657,0,0,9,6,3,500,1,0,17,13,4,1157,1,0,0.0,0.0,0.0,0,0,0,0,0,0,0,0,0,2020-12-27 19:15:00
2976,6609,Laurent Robert,2034,[2007],Derby County,2,1,1,65,0,0,2,2,0,116,0,0,4,3,1,181,0,0,0.0,0.0,0.0,0,0,0,0,0,0,0,0,0,2020-12-27 19:15:00
2977,6610,Layton Ndukwu,4066,[2017],Leicester City,0,0,0,0,0,0,0,0,0,0,0,0,0,0,0,0,0,0,0.0,0.0,0.0,0,0,0,0,0,0,0,0,0,2020-12-27 19:15:00
2978,6611,Lazar Marković,3249,[2014],Liverpool FC,10,6,4,477,1,0,9,5,4,457,1,0,19,11,8,934,2,0,0.0,3.0,3.0,1,1,2,0,0,0,0,0,0,2020-12-27 19:15:00
2979,6612,Lazar Marković,3249,[2016],Hull City,5,5,0,402,2,0,7,7,0,610,0,0,12,12,0,1012,2,0,0.0,0.0,0.0,2,0,2,0,0,0,0,0,0,2020-12-27 19:15:00
2980,6613,Lazar Marković,3249,[2018],Fulham FC,0,0,0,0,0,0,1,0,1,44,0,0,1,0,1,44,0,0,0.0,0.0,0.0,0,0,0,0,0,0,0,0,0,2020-12-27 19:15:00
2981,6614,Leam Richardson,4055,[2001],Bolton Wanderers,0,0,0,0,0,0,1,0,1,8,0,0,1,0,1,8,0,0,0.0,0.0,0.0,0,0,0,0,0,0,0,0,0,2020-12-27 19:15:00
2982,19848,Leander Dendoncker,2181,"[2018, 2019, 2020]",Wolverhampton Wanderers,35,30,5,2632,4,0,34,30,4,2580,2,0,69,60,9,5212,6,0,4.0,3.0,7.0,3,1,4,0,0,0,0,0,0,2020-12-27 19:15:002020-12-27 19:15:002020-12-27 19:15:00
2983,19857,Leandro Bacuna,1438,"[2013, 2014, 2015]",Aston Villa,46,33,13,3109,4,0,39,32,7,2885,2,0,85,65,20,5994,6,0,0.0,0.0,0.0,3,1,4,0,0,0,0,0,0,2020-12-27 19:15:002020-12-27 19:15:002020-12-27 19:15:00
2984,6621,Leandro Bacuna,1438,[2018],Cardiff City,6,2,4,302,0,0,5,2,3,252,0,0,11,4,7,554,0,0,0.0,0.0,0.0,0,0,0,0,0,0,0,0,0,2020-12-27 19:15:00
2985,13245,Leandro Trossard,2425,"[2019, 2020]",Brighton & Hove Albion,23,18,5,1678,5,0,20,14,6,1258,1,0,43,32,11,2936,6,0,1.0,3.0,4.0,4,1,5,0,0,0,0,0,0,2020-12-27 19:15:002020-12-27 19:15:00
2986,72924,Ledley King,1119,"[2000, 2001, 2002, 2003, 2004, 2005, 2007, 2008, 2009, 2010, 2011]",Tottenham Hotspur,120,119,1,10423,4,0,116,116,0,10070,6,0,236,235,1,20493,10,0,0.0,0.0,0.0,2,4,6,0,0,0,0,0,0,2020-12-27 19:15:002020-12-27 19:15:002020-12-27 19:15:002020-12-27 19:15:002020-12-27 19:15:002020-12-27 19:15:002020-12-27 19:15:002020-12-27 19:15:002020-12-27 19:15:002020-12-27 19:15:002020-12-27 19:15:00
2987,6630,Ledley King,1119,[2006],Watford FC,1,1,0,90,0,0,0,0,0,0,0,0,1,1,0,90,0,0,0.0,0.0,0.0,0,0,0,0,0,0,0,0,0,2020-12-27 19:15:00
2988,6636,Lee Barnard,4494,[2005],Tottenham Hotspur,2,0,2,56,0,0,1,0,1,12,0,0,3,0,3,68,0,0,0.0,0.0,0.0,0,0,0,0,0,0,0,0,0,2020-12-27 19:15:00
2989,13275,Lee Bowyer,1297,"[2000, 2001]",Leeds United,25,24,1,2148,7,0,29,29,0,2572,7,0,54,53,1,4720,14,0,0.0,9.0,9.0,4,5,9,0,0,0,0,0,0,2020-12-27 19:15:002020-12-27 19:15:00
2990,26571,Lee Bowyer,1297,"[2002, 2006, 2007, 2008]",West Ham United,28,23,5,1989,2,0,22,20,2,1614,2,0,50,43,7,3603,4,0,1.0,0.0,1.0,2,1,3,0,0,0,0,0,0,2020-12-27 19:15:002020-12-27 19:15:002020-12-27 19:15:002020-12-27 19:15:00
2991,19923,Lee Bowyer,1297,"[2003, 2004, 2005]",Newcastle United,38,25,13,2214,5,0,38,33,5,2896,1,0,76,58,18,5110,6,0,0.0,0.0,0.0,4,1,5,0,0,0,0,0,0,2020-12-27 19:15:002020-12-27 19:15:002020-12-27 19:15:00
2992,13293,Lee Bowyer,1297,"[2009, 2010]",Birmingham City,35,31,4,2630,4,0,29,27,2,2427,5,0,64,58,6,5057,9,0,10.0,3.0,13.0,4,3,7,0,0,0,0,0,0,2020-12-27 19:15:002020-12-27 19:15:00
2993,6648,Lee Camp,3705,[2012],Norwich City,1,0,1,75,0,0,2,1,1,147,0,0,3,1,2,222,0,0,0.0,0.0,0.0,0,0,0,0,0,0,0,0,0,2020-12-27 19:15:00
2994,6649,Lee Camp,3705,[2013],West Bromwich Albion,0,0,0,0,0,0,0,0,0,0,0,0,0,0,0,0,0,0,0.0,0.0,0.0,0,0,0,0,0,0,0,0,0,2020-12-27 19:15:00
2995,6650,Lee Carsley,1803,[2000],Leeds United,1,1,0,76,0,0,0,0,0,0,0,0,1,1,0,76,0,0,0.0,0.0,0.0,0,0,0,0,0,0,0,0,0,2020-12-27 19:15:00
2996,46578,Lee Carsley,1803,"[2001, 2002, 2003, 2004, 2005, 2006, 2007]",Everton FC,81,74,7,6536,5,0,79,75,4,6592,6,0,160,149,11,13128,11,0,3.0,4.0,7.0,4,5,9,0,0,0,0,0,0,2020-12-27 19:15:002020-12-27 19:15:002020-12-27 19:15:002020-12-27 19:15:002020-12-27 19:15:002020-12-27 19:15:002020-12-27 19:15:00
2997,6658,Lee Carsley,1803,[2009],Birmingham City,3,0,3,52,0,0,4,3,1,301,0,0,7,3,4,353,0,0,0.0,0.0,0.0,0,0,0,0,0,0,0,0,0,2020-12-27 19:15:00
2998,19980,Lee Cattermole,1687,"[2005, 2006, 2007]",Middlesbrough FC,33,17,16,1662,0,0,35,25,10,2263,3,0,68,42,26,3925,3,0,0.0,6.0,6.0,0,3,3,0,0,0,0,0,0,2020-12-27 19:15:002020-12-27 19:15:002020-12-27 19:15:00
2999,6662,Lee Cattermole,1687,[2008],Wigan Athletic,16,16,0,1394,1,0,16,16,0,1383,0,0,32,32,0,2777,1,0,0.0,0.0,0.0,0,0,0,0,0,0,0,0,0,2020-12-27 19:15:00
3000,53332,Lee Cattermole,1687,"[2009, 2010, 2011, 2012, 2013, 2014, 2015, 2016]",Sunderland AFC,86,79,7,6638,0,0,83,77,6,6567,2,0,169,156,13,13205,2,0,0.0,0.0,0.0,0,2,2,0,0,0,0,0,0,2020-12-27 19:15:002020-12-27 19:15:002020-12-27 19:15:002020-12-27 19:15:002020-12-27 19:15:002020-12-27 19:15:002020-12-27 19:15:002020-12-27 19:15:00
3001,26690,Lee Clark,2017,"[2001, 2002, 2003, 2004]",Fulham FC,32,26,6,2320,3,0,25,23,2,2024,2,0,57,49,8,4344,5,0,4.0,0.0,4.0,3,2,5,0,0,0,0,0,0,2020-12-27 19:15:002020-12-27 19:15:002020-12-27 19:15:002020-12-27 19:15:00
3002,6675,Lee Clark,2017,[2005],Newcastle United,14,3,11,414,1,0,8,5,3,471,0,0,22,8,14,885,1,0,1.0,0.0,1.0,1,0,1,0,0,0,0,0,0,2020-12-27 19:15:00
3003,13353,Lee Croft,1812,"[2004, 2005]",Manchester City,15,3,12,426,0,0,11,1,10,264,1,0,26,4,22,690,1,0,0.0,0.0,0.0,0,1,1,0,0,0,0,0,0,2020-12-27 19:15:002020-12-27 19:15:00
3004,6678,Lee Crooks,3854,[2000],Manchester City,1,0,1,13,0,0,1,0,1,70,0,0,2,0,2,83,0,0,0.0,0.0,0.0,0,0,0,0,0,0,0,0,0,2020-12-27 19:15:00
3005,13359,Lee Dixon,3258,"[2000, 2001]",Arsenal FC,22,14,8,1446,1,0,19,15,4,1434,0,0,41,29,12,2880,1,0,0.0,0.0,0.0,0,0,0,0,0,0,0,0,0,2020-12-27 19:15:002020-12-27 19:15:00
3006,13363,Lee Grant,1908,"[2016, 2017]",Stoke City,16,16,0,1440,0,0,15,15,0,1350,0,0,31,31,0,2790,0,0,0.0,0.0,0.0,0,0,0,0,0,0,0,0,0,2020-12-27 19:15:002020-12-27 19:15:00
3007,20052,Lee Grant,1908,"[2018, 2019, 2020]",Manchester United,0,0,0,0,0,0,0,0,0,0,0,0,0,0,0,0,0,0,0.0,0.0,0.0,0,0,0,0,0,0,0,0,0,2020-12-27 19:15:002020-12-27 19:15:002020-12-27 19:15:00
3008,46823,Lee Hendrie,1797,"[2000, 2001, 2002, 2003, 2004, 2005, 2006]",Aston Villa,81,72,9,5906,11,0,79,60,19,5348,9,0,160,132,28,11254,20,0,4.0,2.0,6.0,7,8,15,0,0,0,0,0,0,2020-12-27 19:15:002020-12-27 19:15:002020-12-27 19:15:002020-12-27 19:15:002020-12-27 19:15:002020-12-27 19:15:002020-12-27 19:15:00
3009,6693,Lee Hughes,3083,[2002],West Bromwich Albion,10,7,3,583,0,0,12,6,6,499,0,0,22,13,9,1082,0,0,0.0,0.0,0.0,0,0,0,0,0,0,0,0,0,2020-12-27 19:15:00
3010,13389,Lee Lucas,4323,"[2011, 2013]",Swansea City,0,0,0,0,0,0,0,0,0,0,0,0,0,0,0,0,0,0,0.0,0.0,0.0,0,0,0,0,0,0,0,0,0,2020-12-27 19:15:002020-12-27 19:15:00
3011,13393,Lee Marshall,1308,"[2000, 2001]",Leicester City,21,17,4,1520,0,0,23,19,4,1827,0,0,44,36,8,3347,0,0,0.0,0.0,0.0,0,0,0,0,0,0,0,0,0,2020-12-27 19:15:002020-12-27 19:15:00
3012,6698,Lee Marshall,1308,[2002],West Bromwich Albion,4,2,2,204,1,0,5,2,3,192,0,0,9,4,5,396,1,0,0.0,0.0,0.0,0,0,0,0,0,0,0,0,0,2020-12-27 19:15:00
3013,6699,Lee Martin,4412,[2008],Manchester United,0,0,0,0,0,0,1,1,0,90,0,0,1,1,0,90,0,0,0.0,0.0,0.0,0,0,0,0,0,0,0,0,0,2020-12-27 19:15:00
3014,13401,Lee McCulloch,1819,"[2005, 2006]",Wigan Athletic,29,27,2,2415,6,0,30,25,5,2293,3,0,59,52,7,4708,9,0,3.0,6.0,9.0,4,3,7,0,0,0,0,0,0,2020-12-27 19:15:002020-12-27 19:15:00
3015,13405,Lee Morris,3453,"[2000, 2001]",Derby County,18,8,10,758,3,0,14,4,10,506,1,0,32,12,20,1264,4,0,3.0,0.0,3.0,1,0,1,0,0,0,0,0,0,2020-12-27 19:15:002020-12-27 19:15:00
3016,6704,Lee Naylor,2903,[2003],Wolverhampton Wanderers,19,19,0,1691,0,0,19,18,1,1523,0,0,38,37,1,3214,0,0,0.0,0.0,0.0,0,0,0,0,0,0,0,0,0,2020-12-27 19:15:00
3017,6705,Lee Nicholls,4236,[2010],Wigan Athletic,0,0,0,0,0,0,0,0,0,0,0,0,0,0,0,0,0,0,0.0,0.0,0.0,0,0,0,0,0,0,0,0,0,2020-12-27 19:15:00
3018,6706,Lee Peltier,3143,[2018],Cardiff City,7,6,1,521,0,0,13,11,2,1022,0,0,20,17,3,1543,0,0,0.0,0.0,0.0,0,0,0,0,0,0,0,0,0,2020-12-27 19:15:00
3019,6707,Lee Peltier,3143,[2020],West Bromwich Albion,0,0,0,0,0,0,1,0,1,3,0,0,1,0,1,3,0,0,0.0,0.0,0.0,0,0,0,0,0,0,0,0,0,2020-12-27 19:15:00
3020,6708,Lee Roche,4282,[2002],Manchester United,1,0,1,21,0,0,0,0,0,0,0,0,1,0,1,21,0,0,0.0,0.0,0.0,0,0,0,0,0,0,0,0,0,2020-12-27 19:15:00
3021,6709,Lee Sharpe,3059,[2000],Bradford City,5,3,2,279,0,0,4,3,1,172,0,0,9,6,3,451,0,0,0.0,0.0,0.0,0,0,0,0,0,0,0,0,0,2020-12-27 19:15:00
3022,6710,Lee Tomlin,3904,[2015],AFC Bournemouth,3,2,1,172,0,0,3,1,2,117,0,0,6,3,3,289,0,0,0.0,0.0,0.0,0,0,0,0,0,0,0,0,0,2020-12-27 19:15:00
3023,6711,Lee Williamson,3702,[2006],Watford FC,2,2,0,136,0,0,3,2,1,197,0,0,5,4,1,333,0,0,0.0,0.0,0.0,0,0,0,0,0,0,0,0,0,2020-12-27 19:15:00
3024,6712,Leif Davis,1072,[2020],Leeds United,1,0,1,13,0,0,1,0,1,18,0,0,2,0,2,31,0,0,0.0,0.0,0.0,0,0,0,0,0,0,0,0,0,2020-12-27 19:15:00
3025,6713,Leigh Bromby,2581,[2006],Sheffield United,9,7,2,611,0,0,8,5,3,528,0,0,17,12,5,1139,0,0,0.0,0.0,0.0,0,0,0,0,0,0,0,0,0,2020-12-27 19:15:00
3026,6714,Leigh Griffiths,4309,[2010],Wolverhampton Wanderers,0,0,0,0,0,0,0,0,0,0,0,0,0,0,0,0,0,0,0.0,0.0,0.0,0,0,0,0,0,0,0,0,0,2020-12-27 19:15:00
3027,13431,Leighton Baines,1466,"[2005, 2006]",Wigan Athletic,35,34,1,2935,2,0,37,36,1,3285,1,0,72,70,2,6220,3,0,0.0,0.0,0.0,2,0,2,0,1,1,0,0,0,2020-12-27 19:15:002020-12-27 19:15:00
3028,87399,Leighton Baines,1466,"[2007, 2008, 2009, 2010, 2011, 2012, 2013, 2014, 2015, 2016, 2017, 2018, 2019]",Everton FC,173,163,10,14557,16,0,173,162,11,14473,13,0,346,325,21,29030,29,0,14.0,5.0,19.0,11,12,23,13,6,19,0,0,0,2020-12-27 19:15:002020-12-27 19:15:002020-12-27 19:15:002020-12-27 19:15:002020-12-27 19:15:002020-12-27 19:15:002020-12-27 19:15:002020-12-27 19:15:002020-12-27 19:15:002020-12-27 19:15:002020-12-27 19:15:002020-12-27 19:15:002020-12-27 19:15:00
3029,6730,Leighton Clarkson,1053,[2020],Liverpool FC,0,0,0,0,0,0,0,0,0,0,0,0,0,0,0,0,0,0,0.0,0.0,0.0,0,0,0,0,0,0,0,0,0,2020-12-27 19:15:00
3030,6731,Lennard Sowah,4275,[2009],Portsmouth FC,3,2,1,206,0,0,2,1,1,134,0,0,5,3,2,340,0,0,0.0,0.0,0.0,0,0,0,0,0,0,0,0,0,2020-12-27 19:15:00
3031,13465,Lenny Pidgeley,2973,"[2004, 2005]",Chelsea FC,1,0,1,8,0,0,1,1,0,90,0,0,2,1,1,98,0,0,0.0,0.0,0.0,0,0,0,0,0,0,0,0,0,2020-12-27 19:15:002020-12-27 19:15:00
3032,13469,Leo Chambers,2762,"[2012, 2013]",West Ham United,0,0,0,0,0,0,0,0,0,0,0,0,0,0,0,0,0,0,0.0,0.0,0.0,0,0,0,0,0,0,0,0,0,2020-12-27 19:15:002020-12-27 19:15:00
3033,13473,Leon Andreasen,3686,"[2007, 2008]",Fulham FC,9,4,5,359,0,0,10,5,5,463,0,0,19,9,10,822,0,0,0.0,0.0,0.0,0,0,0,0,0,0,0,0,0,2020-12-27 19:15:002020-12-27 19:15:00
3034,13477,Leon Balogun,2485,"[2018, 2019]",Brighton & Hove Albion,4,2,2,309,1,0,4,3,1,282,0,0,8,5,3,591,1,0,0.0,0.0,0.0,0,0,0,0,0,0,0,0,0,2020-12-27 19:15:002020-12-27 19:15:00
3035,6740,Leon Barnett,3041,[2008],West Bromwich Albion,6,6,0,489,0,0,5,4,1,423,0,0,11,10,1,912,0,0,0.0,0.0,0.0,0,0,0,0,0,0,0,0,0,2020-12-27 19:15:00
3036,13483,Leon Barnett,3041,"[2011, 2012]",Norwich City,13,10,3,954,1,0,12,9,3,863,0,0,25,19,6,1817,1,0,0.0,0.0,0.0,1,0,1,0,0,0,0,0,0,2020-12-27 19:15:002020-12-27 19:15:00
3037,6743,Leon Best,2399,[2004],Southampton FC,1,0,1,14,0,0,2,1,1,65,0,0,3,1,2,79,0,0,0.0,0.0,0.0,0,0,0,0,0,0,0,0,0,2020-12-27 19:15:00
3038,13489,Leon Best,2399,"[2010, 2011]",Newcastle United,17,14,3,1026,8,0,12,11,1,888,2,0,29,25,4,1914,10,0,3.0,1.0,4.0,4,1,5,0,0,0,0,0,0,2020-12-27 19:15:002020-12-27 19:15:00
3039,47243,Leon Britton,1707,"[2011, 2012, 2013, 2014, 2015, 2016, 2017]",Swansea City,80,72,8,6091,0,0,69,62,7,5029,0,0,149,134,15,11120,0,0,0.0,0.0,0.0,0,0,0,0,0,0,0,0,0,2020-12-27 19:15:002020-12-27 19:15:002020-12-27 19:15:002020-12-27 19:15:002020-12-27 19:15:002020-12-27 19:15:002020-12-27 19:15:00
3040,6753,Leon Clarke,3607,[2019],Sheffield United,1,0,1,13,0,0,1,0,1,20,0,0,2,0,2,33,0,0,0.0,0.0,0.0,0,0,0,0,0,0,0,0,0,2020-12-27 19:15:00
3041,6754,Leon Cort,1996,[2008],Stoke City,6,5,1,416,0,0,5,4,1,428,0,0,11,9,2,844,0,0,0.0,0.0,0.0,0,0,0,0,0,0,0,0,0,2020-12-27 19:15:00
3042,6755,Leon Cort,1996,[2009],Burnley FC,8,8,0,720,0,0,7,7,0,573,0,0,15,15,0,1293,0,0,0.0,0.0,0.0,0,0,0,0,0,0,0,0,0,2020-12-27 19:15:00
3043,6756,Leon McKenzie,2391,[2004],Norwich City,17,13,4,1182,5,0,19,10,9,1142,2,0,36,23,13,2324,7,0,1.0,0.0,1.0,2,1,3,0,0,0,0,0,0,2020-12-27 19:15:00
3044,94689,Leon Osman,1747,"[2002, 2003, 2004, 2005, 2006, 2007, 2008, 2009, 2010, 2011, 2012, 2013, 2014, 2015]",Everton FC,178,157,21,13595,25,0,168,132,36,11910,18,0,346,289,57,25505,43,0,23.0,1.0,24.0,20,12,32,0,0,0,0,0,0,2020-12-27 19:15:002020-12-27 19:15:002020-12-27 19:15:002020-12-27 19:15:002020-12-27 19:15:002020-12-27 19:15:002020-12-27 19:15:002020-12-27 19:15:002020-12-27 19:15:002020-12-27 19:15:002020-12-27 19:15:002020-12-27 19:15:002020-12-27 19:15:002020-12-27 19:15:00
3045,6771,Leonardo Campana,4415,[2019],Wolverhampton Wanderers,0,0,0,0,0,0,0,0,0,0,0,0,0,0,0,0,0,0,0.0,0.0,0.0,0,0,0,0,0,0,0,0,0,2020-12-27 19:15:00
3046,20319,Leonardo Ulloa,2518,"[2014, 2015, 2016]",Leicester City,41,18,23,1878,14,0,41,21,20,1932,4,0,82,39,43,3810,18,0,5.0,3.0,8.0,7,2,9,3,0,3,0,0,0,2020-12-27 19:15:002020-12-27 19:15:002020-12-27 19:15:00
3047,6775,Leonardo Ulloa,2518,[2017],Brighton & Hove Albion,4,0,4,58,0,0,6,2,4,204,1,0,10,2,8,262,1,0,0.0,0.0,0.0,0,1,1,0,0,0,0,0,0,2020-12-27 19:15:00
3048,6776,Leroy Fer,1375,[2013],Norwich City,14,14,0,1248,1,0,15,14,1,1225,2,0,29,28,1,2473,3,0,0.0,0.0,0.0,0,0,0,0,0,0,0,0,0,2020-12-27 19:15:00
3049,6777,Leroy Fer,1375,[2014],Queens Park Rangers,14,13,1,1148,4,0,15,14,1,1219,2,0,29,27,2,2367,6,0,3.0,0.0,3.0,4,2,6,0,0,0,0,0,0,2020-12-27 19:15:00
3050,20337,Leroy Fer,1375,"[2015, 2016, 2017]",Swansea City,29,23,6,2004,4,0,36,28,8,2554,3,0,65,51,14,4558,7,0,0.0,3.0,3.0,3,2,5,0,0,0,0,0,0,2020-12-27 19:15:002020-12-27 19:15:002020-12-27 19:15:00
3051,13563,Leroy Lita,2593,"[2006, 2007]",Reading FC,22,14,8,1307,3,0,23,16,7,1408,5,0,45,30,15,2715,8,0,3.0,0.0,3.0,1,2,3,0,0,0,0,0,0,2020-12-27 19:15:002020-12-27 19:15:00
3052,20352,Leroy Lita,2593,"[2011, 2012, 2013]",Swansea City,11,2,9,280,1,0,7,2,5,212,1,0,18,4,14,492,2,0,0.0,0.0,0.0,0,1,1,0,0,0,0,0,0,2020-12-27 19:15:002020-12-27 19:15:002020-12-27 19:15:00
3053,27150,Leroy Sané,1205,"[2016, 2017, 2018, 2019]",Manchester City,47,38,9,3361,12,0,42,29,13,2637,13,0,89,67,22,5998,25,0,3.0,0.0,3.0,5,6,11,0,0,0,0,0,0,2020-12-27 19:15:002020-12-27 19:15:002020-12-27 19:15:002020-12-27 19:15:00
3054,13581,Les Ferdinand,2083,"[2000, 2001]",Tottenham Hotspur,30,27,3,2133,17,0,21,18,3,1512,2,0,51,45,6,3645,19,0,9.0,3.0,12.0,10,2,12,0,0,0,0,0,0,2020-12-27 19:15:002020-12-27 19:15:00
3055,6792,Les Ferdinand,2083,[2002],West Ham United,6,5,1,305,1,0,7,6,1,480,1,0,13,11,2,785,2,0,0.0,0.0,0.0,1,1,2,0,0,0,0,0,0,2020-12-27 19:15:00
3056,6793,Les Ferdinand,2083,[2003],Leicester City,14,11,3,795,3,0,15,9,6,807,9,0,29,20,9,1602,12,0,0.0,5.0,5.0,2,6,8,0,0,0,0,0,0,2020-12-27 19:15:00
3057,6794,Les Ferdinand,2083,[2004],Bolton Wanderers,6,0,6,86,1,0,5,1,4,161,0,0,11,1,10,247,1,0,1.0,0.0,1.0,1,0,1,0,0,0,0,0,0,2020-12-27 19:15:00
3058,6795,Levi Lumeka,4535,[2017],Crystal Palace,0,0,0,0,0,0,1,0,1,25,0,0,1,0,1,25,0,0,0.0,0.0,0.0,0,0,0,0,0,0,0,0,0,2020-12-27 19:15:00
3059,6796,Lewin Nyatanga,3596,[2007],Derby County,1,1,0,90,0,0,1,1,0,90,1,0,2,2,0,180,1,0,0.0,0.0,0.0,0,1,1,0,0,0,0,0,0,2020-12-27 19:15:00
3060,13595,Lewis Baker,3693,"[2013, 2014]",Chelsea FC,0,0,0,0,0,0,0,0,0,0,0,0,0,0,0,0,0,0,0.0,0.0,0.0,0,0,0,0,0,0,0,0,0,2020-12-27 19:15:002020-12-27 19:15:00
3061,6799,Lewis Bate,4411,[2019],Chelsea FC,0,0,0,0,0,0,0,0,0,0,0,0,0,0,0,0,0,0,0.0,0.0,0.0,0,0,0,0,0,0,0,0,0,2020-12-27 19:15:00
3062,6800,Lewis Cass,4510,[2018],Newcastle United,0,0,0,0,0,0,0,0,0,0,0,0,0,0,0,0,0,0,0.0,0.0,0.0,0,0,0,0,0,0,0,0,0,2020-12-27 19:15:00
3063,27210,Lewis Cook,1038,"[2016, 2017, 2018, 2019]",AFC Bournemouth,42,28,14,2653,0,0,33,23,10,2084,0,0,75,51,24,4737,0,0,0.0,0.0,0.0,0,0,0,0,0,0,0,0,0,2020-12-27 19:15:002020-12-27 19:15:002020-12-27 19:15:002020-12-27 19:15:00
3064,27226,Lewis Dunk,2416,"[2017, 2018, 2019, 2020]",Brighton & Hove Albion,60,60,0,5321,2,0,62,62,0,5580,5,0,122,122,0,10901,7,0,0.0,0.0,0.0,2,3,5,0,0,0,0,1,1,2020-12-27 19:15:002020-12-27 19:15:002020-12-27 19:15:002020-12-27 19:15:00
3065,6809,Lewis Gibson,3902,[2019],Everton FC,0,0,0,0,0,0,0,0,0,0,0,0,0,0,0,0,0,0,0.0,0.0,0.0,0,0,0,0,0,0,0,0,0,2020-12-27 19:15:00
3066,13621,Lewis Grabban,3207,"[2015, 2016]",AFC Bournemouth,9,3,6,386,0,0,9,1,8,239,0,0,18,4,14,625,0,0,0.0,0.0,0.0,0,0,0,0,0,0,0,0,0,2020-12-27 19:15:002020-12-27 19:15:00
3067,13626,Lewis Holtby,2815,"[2012, 2014]",Tottenham Hotspur,4,2,2,242,0,0,8,2,6,293,0,0,12,4,8,535,0,0,0.0,0.0,0.0,0,0,0,0,0,0,0,0,0,2020-12-27 19:15:002020-12-27 19:15:00
3068,6813,Lewis Holtby,2815,[2013],Fulham FC,7,6,1,493,0,0,6,5,1,429,1,0,13,11,2,922,1,0,0.0,0.0,0.0,0,1,1,0,0,0,0,0,0,2020-12-27 19:15:00
3069,6815,Lewis Kinsella,3893,[2014],Aston Villa,0,0,0,0,0,0,0,0,0,0,0,0,0,0,0,0,0,0,0.0,0.0,0.0,0,0,0,0,0,0,0,0,0,2020-12-27 19:15:00
3070,6816,Lewis Price,3235,[2007],Derby County,4,4,0,360,0,0,2,2,0,180,0,0,6,6,0,540,0,0,0.0,0.0,0.0,0,0,0,0,0,0,0,0,0,2020-12-27 19:15:00
3071,6817,Lewis Price,3235,[2013],Crystal Palace,0,0,0,0,0,0,0,0,0,0,0,0,0,0,0,0,0,0,0.0,0.0,0.0,0,0,0,0,0,0,0,0,0,2020-12-27 19:15:00
3072,6818,Lewis Richardson,1055,[2020],Burnley FC,0,0,0,0,0,0,0,0,0,0,0,0,0,0,0,0,0,0,0.0,0.0,0.0,0,0,0,0,0,0,0,0,0,2020-12-27 19:15:00
3073,13639,Liam Agnew,4096,"[2013, 2014]",Sunderland AFC,0,0,0,0,0,0,0,0,0,0,0,0,0,0,0,0,0,0,0.0,0.0,0.0,0,0,0,0,0,0,0,0,0,2020-12-27 19:15:002020-12-27 19:15:00
3074,20466,Liam Bridcutt,2264,"[2013, 2014, 2015]",Sunderland AFC,15,10,5,945,0,0,15,9,6,848,0,0,30,19,11,1793,0,0,0.0,0.0,0.0,0,0,0,0,0,0,0,0,0,2020-12-27 19:15:002020-12-27 19:15:002020-12-27 19:15:00
3075,6824,Liam Cooper,4142,[2009],Hull City,1,0,1,35,0,0,1,1,0,90,0,0,2,1,1,125,0,0,0.0,0.0,0.0,0,0,0,0,0,0,0,0,0,2020-12-27 19:15:00
3076,6825,Liam Cooper,4142,[2020],Leeds United,6,6,0,540,0,0,5,5,0,432,1,0,11,11,0,972,1,0,0.0,0.0,0.0,0,0,0,0,0,0,0,0,0,2020-12-27 19:15:00
3077,6826,Liam Delap,1043,[2020],Manchester City,1,0,1,39,0,0,0,0,0,0,0,0,1,0,1,39,0,0,0.0,0.0,0.0,0,0,0,0,0,0,0,0,0,2020-12-27 19:15:00
3078,6827,Liam Fontaine,4367,[2004],Fulham FC,0,0,0,0,0,0,1,0,1,1,0,0,1,0,1,1,0,0,0.0,0.0,0.0,0,0,0,0,0,0,0,0,0,2020-12-27 19:15:00
3079,13657,Liam Gibson,3036,"[2015, 2019]",Newcastle United,0,0,0,0,0,0,0,0,0,0,0,0,0,0,0,0,0,0,0.0,0.0,0.0,0,0,0,0,0,0,0,0,0,2020-12-27 19:15:002020-12-27 19:15:00
3080,6830,Liam Lawrence,2536,[2005],Sunderland AFC,16,9,7,960,1,0,13,10,3,837,2,0,29,19,10,1797,3,0,0.0,0.0,0.0,1,2,3,0,0,0,0,0,0,2020-12-27 19:15:00
3081,13663,Liam Lawrence,2536,"[2008, 2009]",Stoke City,26,19,7,1750,3,0,19,13,6,1187,1,0,45,32,13,2937,4,0,3.0,0.0,3.0,2,0,2,1,0,1,0,0,0,2020-12-27 19:15:002020-12-27 19:15:00
3082,6833,Liam Marrs,4041,[2012],Sunderland AFC,0,0,0,0,0,0,0,0,0,0,0,0,0,0,0,0,0,0,0.0,0.0,0.0,0,0,0,0,0,0,0,0,0,2020-12-27 19:15:00
3083,13669,Liam Miller,1224,"[2004, 2005]",Manchester United,5,2,3,159,0,0,4,1,3,107,0,0,9,3,6,266,0,0,0.0,0.0,0.0,0,0,0,0,0,0,0,0,0,2020-12-27 19:15:002020-12-27 19:15:00
3084,13673,Liam Miller,1224,"[2007, 2008]",Sunderland AFC,12,7,5,723,0,0,14,9,5,903,1,0,26,16,10,1626,1,0,0.0,1.0,1.0,0,1,1,0,0,0,0,0,0,2020-12-27 19:15:002020-12-27 19:15:00
3085,6838,Liam Moore,2521,[2014],Leicester City,4,4,0,360,0,0,7,6,1,576,0,0,11,10,1,936,0,0,0.0,0.0,0.0,0,0,0,0,0,0,0,0,0,2020-12-27 19:15:00
3086,13679,Liam O'Neil,3856,"[2013, 2014]",West Bromwich Albion,1,0,1,7,0,0,2,0,2,8,0,0,3,0,3,15,0,0,0.0,0.0,0.0,0,0,0,0,0,0,0,0,0,2020-12-27 19:15:002020-12-27 19:15:00
3087,27370,Liam Ridgewell,1772,"[2003, 2004, 2005, 2006]",Aston Villa,38,32,6,2936,2,0,39,32,7,3029,5,0,77,64,13,5965,7,0,0.0,1.0,1.0,1,3,4,0,0,0,0,0,0,2020-12-27 19:15:002020-12-27 19:15:002020-12-27 19:15:002020-12-27 19:15:00
3088,20538,Liam Ridgewell,1772,"[2007, 2009, 2010]",Birmingham City,51,51,0,4566,6,0,51,50,1,4500,2,0,102,101,1,9066,8,0,3.0,1.0,4.0,6,2,8,0,0,0,0,0,0,2020-12-27 19:15:002020-12-27 19:15:002020-12-27 19:15:00
3089,20547,Liam Ridgewell,1772,"[2011, 2012, 2013]",West Bromwich Albion,37,36,1,3179,2,0,39,38,1,3347,0,0,76,74,2,6526,2,0,0.0,0.0,0.0,0,0,0,0,0,0,0,0,0,2020-12-27 19:15:002020-12-27 19:15:002020-12-27 19:15:00
3090,20556,Liam Rosenior,1756,"[2004, 2005, 2006]",Fulham FC,38,36,2,3260,0,0,36,35,1,3128,0,0,74,71,3,6388,0,0,0.0,0.0,0.0,0,0,0,0,0,0,0,0,0,2020-12-27 19:15:002020-12-27 19:15:002020-12-27 19:15:00
3091,6854,Liam Rosenior,1756,[2007],Reading FC,8,7,1,571,0,0,8,7,1,579,0,0,16,14,2,1150,0,0,0.0,0.0,0.0,0,0,0,0,0,0,0,0,0,2020-12-27 19:15:00
3092,13711,Liam Rosenior,1756,"[2013, 2014]",Hull City,23,13,10,1349,1,0,20,14,6,1251,0,0,43,27,16,2600,1,0,0.0,0.0,0.0,1,0,1,0,0,0,0,0,0,2020-12-27 19:15:002020-12-27 19:15:00
3093,6857,Liam Rosenior,1756,[2017],Brighton & Hove Albion,1,0,1,28,0,0,2,1,1,134,0,0,3,1,2,162,0,0,0.0,0.0,0.0,0,0,0,0,0,0,0,0,0,2020-12-27 19:15:00
3094,6858,Liam Shephard,3772,[2014],Swansea City,0,0,0,0,0,0,0,0,0,0,0,0,0,0,0,0,0,0,0.0,0.0,0.0,0,0,0,0,0,0,0,0,0,2020-12-27 19:15:00
3095,13719,Libor Kozák,3407,"[2013, 2015]",Aston Villa,10,6,4,563,1,0,8,5,3,476,3,0,18,11,7,1039,4,0,0.0,3.0,3.0,0,3,3,0,0,0,0,0,0,2020-12-27 19:15:002020-12-27 19:15:00
3096,6861,Lilian Laslandes,1342,[2001],Sunderland AFC,6,3,3,267,0,0,5,1,4,118,0,0,11,4,7,385,0,0,0.0,0.0,0.0,0,0,0,0,0,0,0,0,0,2020-12-27 19:15:00
3097,6862,Lilian Martin,3497,[2000],Derby County,5,4,1,323,0,0,4,3,1,224,0,0,9,7,2,547,0,0,0.0,0.0,0.0,0,0,0,0,0,0,0,0,0,2020-12-27 19:15:00
3098,6863,Lilian Nalis,3163,[2003],Leicester City,11,6,5,544,1,0,9,5,4,488,0,0,20,11,9,1032,1,0,0.0,0.0,0.0,1,0,1,0,0,0,0,0,0,2020-12-27 19:15:00
3099,34330,Linvoy Primus,1065,"[2003, 2004, 2005, 2006, 2008]",Portsmouth FC,57,52,5,4577,0,0,55,53,2,4680,3,0,112,105,7,9257,3,0,0.0,3.0,3.0,0,2,2,0,0,0,0,0,0,2020-12-27 19:15:002020-12-27 19:15:002020-12-27 19:15:002020-12-27 19:15:002020-12-27 19:15:00
3100,6869,Lionel Scaloni,2861,[2005],West Ham United,7,7,0,630,0,0,5,5,0,403,0,0,12,12,0,1033,0,0,0.0,0.0,0.0,0,0,0,0,0,0,0,0,0,2020-12-27 19:15:00
3101,6870,Llorente,1860,[2016],Swansea City,16,13,3,1105,11,0,17,15,2,1346,4,0,33,28,5,2451,15,0,12.0,0.0,12.0,8,3,11,0,0,0,0,0,0,2020-12-27 19:15:00
3102,13743,Llorente,1860,"[2017, 2018]",Tottenham Hotspur,18,5,13,586,1,0,18,2,16,323,1,0,36,7,29,909,2,0,3.0,0.0,3.0,1,1,2,0,0,0,0,0,0,2020-12-27 19:15:002020-12-27 19:15:00
3103,6873,Llorente,1860,[2020],Leeds United,0,0,0,0,0,0,1,0,1,81,0,0,1,0,1,81,0,0,0.0,0.0,0.0,0,0,0,0,0,0,0,0,0,2020-12-27 19:15:00
3104,6874,Lloyd Doyley,2115,[2006],Watford FC,9,5,4,538,0,0,10,10,0,900,0,0,19,15,4,1438,0,0,0.0,0.0,0.0,0,0,0,0,0,0,0,0,0,2020-12-27 19:15:00
3105,6875,Lloyd Dyer,3881,[2004],West Bromwich Albion,4,0,4,79,0,0,0,0,0,0,0,0,4,0,4,79,0,0,0.0,0.0,0.0,0,0,0,0,0,0,0,0,0,2020-12-27 19:15:00
3106,6876,Lloyd Dyer,3881,[2015],Watford FC,0,0,0,0,0,0,0,0,0,0,0,0,0,0,0,0,0,0,0.0,0.0,0.0,0,0,0,0,0,0,0,0,0,2020-12-27 19:15:00
3107,27514,Lloyd Isgrove,3533,"[2012, 2013, 2014, 2016]",Southampton FC,0,0,0,0,0,0,1,0,1,8,0,0,1,0,1,8,0,0,0.0,0.0,0.0,0,0,0,0,0,0,0,0,0,2020-12-27 19:15:002020-12-27 19:15:002020-12-27 19:15:002020-12-27 19:15:00
3108,6881,Lloyd Jones,4421,[2013],Liverpool FC,0,0,0,0,0,0,0,0,0,0,0,0,0,0,0,0,0,0,0.0,0.0,0.0,0,0,0,0,0,0,0,0,0,2020-12-27 19:15:00
3109,6882,Lloyd Kelly,3343,[2019],AFC Bournemouth,4,4,0,360,0,0,4,3,1,278,0,0,8,7,1,638,0,0,0.0,0.0,0.0,0,0,0,0,0,0,0,0,0,2020-12-27 19:15:00
3110,20652,Lloyd Sam,4097,"[2004, 2005, 2006]",Charlton Athletic,5,1,4,151,0,0,5,2,3,228,0,0,10,3,7,379,0,0,0.0,0.0,0.0,0,0,0,0,0,0,0,0,0,2020-12-27 19:15:002020-12-27 19:15:002020-12-27 19:15:00
3111,20661,Lomana LuaLua,1074,"[2000, 2001, 2002]",Newcastle United,25,4,21,737,4,0,27,8,19,928,1,0,52,12,40,1665,5,0,0.0,3.0,3.0,2,1,3,0,0,0,0,0,0,2020-12-27 19:15:002020-12-27 19:15:002020-12-27 19:15:00
3112,27562,Lomana LuaLua,1074,"[2003, 2004, 2005, 2006]",Portsmouth FC,49,33,16,3074,11,0,38,29,9,2676,8,0,87,62,25,5750,19,0,9.0,4.0,13.0,7,7,14,1,0,1,0,0,0,2020-12-27 19:15:002020-12-27 19:15:002020-12-27 19:15:002020-12-27 19:15:00
3113,13787,Lorenzo Amoruso,3812,"[2003, 2004]",Blackburn Rovers,11,10,1,922,2,0,7,6,1,541,1,0,18,16,2,1463,3,0,0.0,0.0,0.0,2,1,3,0,0,0,0,0,0,2020-12-27 19:15:002020-12-27 19:15:00
3114,6895,Lorik Cana,3253,[2009],Sunderland AFC,15,15,0,1350,0,0,15,13,2,1169,0,0,30,28,2,2519,0,0,0.0,0.0,0.0,0,0,0,0,0,0,0,0,0,2020-12-27 19:15:00
3115,20691,Loris Karius,1178,"[2016, 2017, 2018]",Liverpool FC,17,17,0,1530,0,0,12,12,0,1080,0,0,29,29,0,2610,0,0,0.0,0.0,0.0,0,0,0,0,0,0,0,0,0,2020-12-27 19:15:002020-12-27 19:15:002020-12-27 19:15:00
3116,13799,Louis Laing,3962,"[2010, 2011]",Sunderland AFC,1,0,1,3,0,0,0,0,0,0,0,0,1,0,1,3,0,0,0.0,0.0,0.0,0,0,0,0,0,0,0,0,0,2020-12-27 19:15:002020-12-27 19:15:00
3117,6901,Louis Moult,4239,[2009],Stoke City,0,0,0,0,0,0,1,0,1,5,0,0,1,0,1,5,0,0,0.0,0.0,0.0,0,0,0,0,0,0,0,0,0,2020-12-27 19:15:00
3118,20709,Louis Saha,1727,"[2001, 2002, 2003]",Fulham FC,37,32,5,2727,16,0,31,23,8,2237,10,0,68,55,13,4964,26,0,3.0,4.0,7.0,11,8,19,3,2,5,0,0,0,2020-12-27 19:15:002020-12-27 19:15:002020-12-27 19:15:00
3119,27626,Louis Saha,1727,"[2004, 2005, 2006, 2007]",Manchester United,36,21,15,2000,10,0,38,22,16,2175,11,0,74,43,31,4175,21,0,3.0,3.0,6.0,7,6,13,2,2,4,0,0,0,2020-12-27 19:15:002020-12-27 19:15:002020-12-27 19:15:002020-12-27 19:15:00
3120,27642,Louis Saha,1727,"[2008, 2009, 2010, 2011]",Everton FC,48,31,17,3024,18,0,48,33,15,3049,9,0,96,64,32,6073,27,0,6.0,4.0,10.0,10,6,16,2,1,3,0,0,0,2020-12-27 19:15:002020-12-27 19:15:002020-12-27 19:15:002020-12-27 19:15:00
3121,6913,Louis Saha,1727,[2012],Sunderland AFC,6,0,6,91,0,0,5,0,5,93,0,0,11,0,11,184,0,0,0.0,0.0,0.0,0,0,0,0,0,0,0,0,0,2020-12-27 19:15:00
3122,6914,Lovre Kalinić,4456,[2019],Aston Villa,0,0,0,0,0,0,0,0,0,0,0,0,0,0,0,0,0,0,0.0,0.0,0.0,0,0,0,0,0,0,0,0,0,2020-12-27 19:15:00
3123,6915,Loïc Damour,4516,[2018],Cardiff City,1,0,1,4,0,0,1,0,1,17,0,0,2,0,2,21,0,0,0.0,0.0,0.0,0,0,0,0,0,0,0,0,0,2020-12-27 19:15:00
3124,6916,Loïc Rémy,2455,[2012],Queens Park Rangers,7,6,1,557,3,0,7,7,0,630,3,0,14,13,1,1187,6,0,0.0,0.0,0.0,3,2,5,1,0,1,0,0,0,2020-12-27 19:15:00
3125,6917,Loïc Rémy,2455,[2013],Newcastle United,13,11,2,1050,8,0,13,13,0,1062,6,0,26,24,2,2112,14,0,3.0,3.0,6.0,5,2,7,0,0,0,0,0,0,2020-12-27 19:15:00
3126,13837,Loïc Rémy,2455,"[2014, 2015]",Chelsea FC,19,5,14,566,6,0,13,4,9,385,2,0,32,9,23,951,8,0,3.0,3.0,6.0,3,1,4,0,0,0,0,0,0,2020-12-27 19:15:002020-12-27 19:15:00
3127,6920,Loïc Rémy,2455,[2016],Crystal Palace,3,1,2,108,0,0,2,0,2,23,0,0,5,1,4,131,0,0,0.0,0.0,0.0,0,0,0,0,0,0,0,0,0,2020-12-27 19:15:00
3128,6921,Luc Nilis,3934,[2000],Aston Villa,1,1,0,70,1,0,2,2,0,97,0,0,3,3,0,167,1,0,0.0,0.0,0.0,1,0,1,0,0,0,0,0,0,2020-12-27 19:15:00
3129,6922,Luca de la Torre,4509,[2018],Fulham FC,0,0,0,0,0,0,0,0,0,0,0,0,0,0,0,0,0,0,0.0,0.0,0.0,0,0,0,0,0,0,0,0,0,2020-12-27 19:15:00
3130,27698,Lucas,1861,"[2017, 2018, 2019, 2020]",Tottenham Hotspur,41,29,12,2537,8,0,44,27,17,2490,7,0,85,56,29,5027,15,0,0.0,1.0,1.0,2,3,5,0,0,0,0,0,0,2020-12-27 19:15:002020-12-27 19:15:002020-12-27 19:15:002020-12-27 19:15:00
3131,20784,Lucas Digne,1458,"[2018, 2019, 2020]",Everton FC,39,39,0,3441,2,0,39,37,2,3304,2,0,78,76,2,6745,4,0,1.0,0.0,1.0,1,0,1,0,0,0,0,0,0,2020-12-27 19:15:002020-12-27 19:15:002020-12-27 19:15:00
3132,69345,Lucas Leiva,1429,"[2007, 2008, 2009, 2010, 2011, 2012, 2013, 2014, 2015, 2016]",Liverpool FC,118,88,30,7885,1,0,129,106,23,9473,0,0,247,194,53,17358,1,0,0.0,0.0,0.0,0,0,0,0,0,0,0,0,0,2020-12-27 19:15:002020-12-27 19:15:002020-12-27 19:15:002020-12-27 19:15:002020-12-27 19:15:002020-12-27 19:15:002020-12-27 19:15:002020-12-27 19:15:002020-12-27 19:15:002020-12-27 19:15:00
3133,41655,Lucas Neill,1132,"[2001, 2002, 2003, 2004, 2005, 2006]",Blackburn Rovers,94,92,2,8287,3,0,89,88,1,7822,2,0,183,180,3,16109,5,0,1.0,0.0,1.0,2,1,3,1,0,1,0,0,0,2020-12-27 19:15:002020-12-27 19:15:002020-12-27 19:15:002020-12-27 19:15:002020-12-27 19:15:002020-12-27 19:15:00
3134,13893,Lucas Neill,1132,"[2007, 2008]",West Ham United,34,34,0,3060,0,0,33,33,0,2926,1,0,67,67,0,5986,1,0,0.0,0.0,0.0,0,1,1,0,0,0,0,0,0,2020-12-27 19:15:002020-12-27 19:15:00
3135,6948,Lucas Neill,1132,[2009],Everton FC,5,4,1,364,0,0,7,6,1,554,0,0,12,10,2,918,0,0,0.0,0.0,0.0,0,0,0,0,0,0,0,0,0,2020-12-27 19:15:00
3136,13899,Lucas Piazón,3895,"[2011, 2012]",Chelsea FC,0,0,0,0,0,0,0,0,0,0,0,0,0,0,0,0,0,0,0.0,0.0,0.0,0,0,0,0,0,0,0,0,0,2020-12-27 19:15:002020-12-27 19:15:00
3137,6951,Lucas Pérez,3318,[2016],Arsenal FC,6,2,4,207,0,0,5,0,5,58,1,0,11,2,9,265,1,0,0.0,0.0,0.0,0,0,0,0,0,0,0,0,0,2020-12-27 19:15:00
3138,6952,Lucas Pérez,3318,[2018],West Ham United,10,2,8,287,3,0,5,2,3,181,0,0,15,4,11,468,3,0,0.0,0.0,0.0,2,0,2,0,0,0,0,0,0,2020-12-27 19:15:00
3139,20862,Lucas Radebe,2131,"[2000, 2002, 2003]",Leeds United,24,22,2,1928,0,0,24,19,5,1761,0,0,48,41,7,3689,0,0,0.0,0.0,0.0,0,0,0,0,0,0,0,0,0,2020-12-27 19:15:002020-12-27 19:15:002020-12-27 19:15:00
3140,13913,Lucas Torreira,1472,"[2018, 2019]",Arsenal FC,33,21,12,2030,2,0,30,20,10,1856,1,0,63,41,22,3886,3,0,3.0,0.0,3.0,1,0,1,0,0,0,0,0,0,2020-12-27 19:15:002020-12-27 19:15:00
3141,13917,Luciano Becchio,1384,"[2012, 2013]",Norwich City,8,2,6,212,0,0,5,0,5,11,0,0,13,2,11,223,0,0,0.0,0.0,0.0,0,0,0,0,0,0,0,0,0,2020-12-27 19:15:002020-12-27 19:15:00
3142,6960,Luciano Figueroa,4325,[2003],Birmingham City,1,0,1,3,0,0,0,0,0,0,0,0,1,0,1,3,0,0,0.0,0.0,0.0,0,0,0,0,0,0,0,0,0,2020-12-27 19:15:00
3143,13923,Luciano Narsingh,3190,"[2016, 2017]",Swansea City,17,6,11,623,0,0,14,2,12,402,1,0,31,8,23,1025,1,0,0.0,3.0,3.0,0,1,1,0,0,0,0,0,0,2020-12-27 19:15:002020-12-27 19:15:00
3144,6963,Luciano Vietto,3915,[2018],Fulham FC,9,6,3,549,1,0,11,4,7,434,0,0,20,10,10,983,1,0,0.0,0.0,0.0,0,0,0,0,0,0,0,0,0,2020-12-27 19:15:00
3145,6964,Luciano Zavagno,3411,[2001],Derby County,12,12,0,984,0,0,13,13,0,1083,0,0,25,25,0,2067,0,0,0.0,0.0,0.0,0,0,0,0,0,0,0,0,0,2020-12-27 19:15:00
3146,6965,Lucien Aubey,4223,[2007],Portsmouth FC,0,0,0,0,0,0,3,1,2,168,0,0,3,1,2,168,0,0,0.0,0.0,0.0,0,0,0,0,0,0,0,0,0,2020-12-27 19:15:00
3147,6966,Lucien Mettomo,3200,[2002],Manchester City,2,2,0,180,0,0,2,1,1,140,0,0,4,3,1,320,0,0,0.0,0.0,0.0,0,0,0,0,0,0,0,0,0,2020-12-27 19:15:00
3148,6967,Ludovic Sylvestre,2605,[2010],Blackpool FC,2,1,1,83,0,0,6,5,1,346,0,0,8,6,2,429,0,0,0.0,0.0,0.0,0,0,0,0,0,0,0,0,0,2020-12-27 19:15:00
3149,6968,Luis Alberto,1432,[2013],Liverpool FC,6,0,6,80,0,0,3,0,3,53,0,0,9,0,9,133,0,0,0.0,0.0,0.0,0,0,0,0,0,0,0,0,0,2020-12-27 19:15:00
3150,20910,Luis García,3230,"[2004, 2005, 2006]",Liverpool FC,41,31,10,2861,10,0,36,21,15,2076,8,0,77,52,25,4937,18,0,3.0,7.0,10.0,2,7,9,0,0,0,0,0,0,2020-12-27 19:15:002020-12-27 19:15:002020-12-27 19:15:00
3151,6972,Luis Hernández,3762,[2016],Leicester City,0,0,0,0,0,0,4,3,1,326,0,0,4,3,1,326,0,0,0.0,0.0,0.0,0,0,0,0,0,0,0,0,0,2020-12-27 19:15:00
3152,6973,Luis Jiménez,1289,[2009],West Ham United,6,3,3,331,1,0,5,3,2,324,0,0,11,6,5,655,1,0,0.0,0.0,0.0,0,0,0,1,0,1,0,0,0,2020-12-27 19:15:00
3153,27902,Luis Suárez,1427,"[2010, 2011, 2012, 2013]",Liverpool FC,56,54,2,4849,35,0,54,53,1,4727,34,0,110,107,3,9576,69,0,6.0,2.0,8.0,13,10,23,0,0,0,0,0,0,2020-12-27 19:15:002020-12-27 19:15:002020-12-27 19:15:002020-12-27 19:15:00
3154,34900,Luka Milivojević,2251,"[2016, 2017, 2018, 2019, 2020]",Crystal Palace,65,60,5,5353,14,0,65,62,3,5530,13,0,130,122,8,10883,27,0,5.0,6.0,11.0,10,5,15,12,9,21,0,0,0,2020-12-27 19:15:002020-12-27 19:15:002020-12-27 19:15:002020-12-27 19:15:002020-12-27 19:15:00
3155,27938,Luka Modrić,1272,"[2008, 2009, 2010, 2011]",Tottenham Hotspur,63,62,1,5423,7,0,61,59,2,5126,6,0,124,121,3,10549,13,0,4.0,0.0,4.0,4,3,7,0,1,1,0,0,0,2020-12-27 19:15:002020-12-27 19:15:002020-12-27 19:15:002020-12-27 19:15:00
3156,6987,Lukas Jensen,2678,[2019],Burnley FC,0,0,0,0,0,0,0,0,0,0,0,0,0,0,0,0,0,0,0.0,0.0,0.0,0,0,0,0,0,0,0,0,0,2020-12-27 19:15:00
3157,6988,Lukas Jutkiewicz,1494,[2008],Everton FC,1,0,1,4,0,0,0,0,0,0,0,0,1,0,1,4,0,0,0.0,0.0,0.0,0,0,0,0,0,0,0,0,0,2020-12-27 19:15:00
3158,13979,Lukas Jutkiewicz,1494,"[2014, 2016]",Burnley FC,14,6,8,523,0,0,13,4,9,463,0,0,27,10,17,986,0,0,0.0,0.0,0.0,0,0,0,0,0,0,0,0,0,2020-12-27 19:15:002020-12-27 19:15:00
3159,6991,Lukas Nmecha,3956,[2017],Manchester City,1,0,1,4,0,0,1,0,1,10,0,0,2,0,2,14,0,0,0.0,0.0,0.0,0,0,0,0,0,0,0,0,0,2020-12-27 19:15:00
3160,20979,Lukas Podolski,3095,"[2012, 2013, 2014]",Arsenal FC,32,20,12,1718,12,0,28,19,9,1556,7,0,60,39,21,3274,19,0,3.0,0.0,3.0,7,2,9,0,0,0,0,0,0,2020-12-27 19:15:002020-12-27 19:15:002020-12-27 19:15:00
3161,6995,Lukas Rupp,3585,[2019],Norwich City,6,2,4,211,0,0,6,6,0,488,0,0,12,8,4,699,0,0,0.0,0.0,0.0,0,0,0,0,0,0,0,0,0,2020-12-27 19:15:00
3162,6996,Luke Amos,3112,[2018],Tottenham Hotspur,0,0,0,0,0,0,1,0,1,2,0,0,1,0,1,2,0,0,0.0,0.0,0.0,0,0,0,0,0,0,0,0,0,2020-12-27 19:15:00
3163,6997,Luke Ayling,1062,[2020],Leeds United,8,8,0,700,0,0,7,7,0,630,0,0,15,15,0,1330,0,0,0.0,0.0,0.0,0,0,0,0,0,0,0,0,0,2020-12-27 19:15:00
3164,20997,Luke Chadwick,3302,"[2000, 2001, 2002]",Manchester United,13,6,7,544,0,0,11,5,6,512,2,0,24,11,13,1056,2,0,0.0,0.0,0.0,0,1,1,0,0,0,0,0,0,2020-12-27 19:15:002020-12-27 19:15:002020-12-27 19:15:00
3165,7001,Luke Croll,4566,[2015],Crystal Palace,0,0,0,0,0,0,0,0,0,0,0,0,0,0,0,0,0,0,0.0,0.0,0.0,0,0,0,0,0,0,0,0,0,2020-12-27 19:15:00
3166,19001,Luke Cundle,4470,"[2019, 2020]",Wolverhampton Wanderers,0,0,0,0,0,0,0,0,0,0,0,0,0,0,0,0,0,0,0.0,0.0,0.0,0,0,0,0,0,0,0,0,0,2020-12-27 19:15:002020-12-27 19:15:00
3167,28018,Luke Daniels,2303,"[2011, 2012, 2013, 2014]",West Bromwich Albion,0,0,0,0,0,0,1,0,1,12,0,0,1,0,1,12,0,0,0.0,0.0,0.0,0,0,0,0,0,0,0,0,0,2020-12-27 19:15:002020-12-27 19:15:002020-12-27 19:15:002020-12-27 19:15:00
3168,21024,Luke Dreher,3014,"[2015, 2016, 2018]",Crystal Palace,1,0,1,1,0,0,0,0,0,0,0,0,1,0,1,1,0,0,0.0,0.0,0.0,0,0,0,0,0,0,0,0,0,2020-12-27 19:15:002020-12-27 19:15:002020-12-27 19:15:00
3169,7010,Luke Freeman,3603,[2019],Sheffield United,4,1,3,178,0,0,7,2,5,184,0,0,11,3,8,362,0,0,0.0,0.0,0.0,0,0,0,0,0,0,0,0,0,2020-12-27 19:15:00
3170,21036,Luke Garbutt,2297,"[2013, 2014, 2017]",Everton FC,1,0,1,16,0,0,4,3,1,271,0,0,5,3,2,287,0,0,0.0,0.0,0.0,0,0,0,0,0,0,0,0,0,2020-12-27 19:15:002020-12-27 19:15:002020-12-27 19:15:00
3171,7014,Luke McGee,4322,[2016],Tottenham Hotspur,0,0,0,0,0,0,0,0,0,0,0,0,0,0,0,0,0,0,0.0,0.0,0.0,0,0,0,0,0,0,0,0,0,2020-12-27 19:15:00
3172,7015,Luke Moore,1796,[2003],Newcastle United,1,0,1,40,0,0,0,0,0,0,0,0,1,0,1,40,0,0,0.0,0.0,0.0,0,0,0,0,0,0,0,0,0,2020-12-27 19:15:00
3173,28070,Luke Moore,1796,"[2004, 2005, 2006, 2007]",Aston Villa,37,18,19,1737,6,0,41,17,24,1962,8,0,78,35,43,3699,14,0,1.0,2.0,3.0,4,6,10,0,0,0,0,0,0,2020-12-27 19:15:002020-12-27 19:15:002020-12-27 19:15:002020-12-27 19:15:00
3174,7020,Luke Moore,1796,[2008],West Bromwich Albion,12,3,9,413,1,0,9,2,7,262,0,0,21,5,16,675,1,0,0.0,0.0,0.0,1,0,1,0,0,0,0,0,0,2020-12-27 19:15:00
3175,14043,Luke Moore,1796,"[2011, 2012]",Swansea City,20,4,16,536,2,0,17,3,14,513,3,0,37,7,30,1049,5,0,6.0,1.0,7.0,2,2,4,0,0,0,0,0,0,2020-12-27 19:15:002020-12-27 19:15:00
3176,14047,Luke Shaw,2576,"[2012, 2013]",Southampton FC,28,27,1,2331,0,0,32,30,2,2616,0,0,60,57,3,4947,0,0,0.0,0.0,0.0,0,0,0,0,0,0,0,0,0,2020-12-27 19:15:002020-12-27 19:15:00
3177,49196,Luke Shaw,2576,"[2014, 2015, 2016, 2017, 2018, 2019, 2020]",Manchester United,53,48,5,4147,1,0,54,49,5,4172,0,0,107,97,10,8319,1,0,0.0,0.0,0.0,0,0,0,0,0,0,1,0,1,2020-12-27 19:15:002020-12-27 19:15:002020-12-27 19:15:002020-12-27 19:15:002020-12-27 19:15:002020-12-27 19:15:002020-12-27 19:15:00
3178,14065,Luke Thomas,4432,"[2019, 2020]",Leicester City,4,4,0,270,0,0,2,2,0,180,0,0,6,6,0,450,0,0,0.0,0.0,0.0,0,0,0,0,0,0,0,0,0,2020-12-27 19:15:002020-12-27 19:15:00
3179,7034,Luke Varney,2611,[2010],Blackpool FC,16,13,3,1041,3,0,14,11,3,1003,2,0,30,24,6,2044,5,0,0.0,0.0,0.0,2,0,2,0,0,0,0,0,0,2020-12-27 19:15:00
3180,14071,Luke Wilkshire,3429,"[2001, 2002]",Middlesbrough FC,11,6,5,499,0,0,7,4,3,358,0,0,18,10,8,857,0,0,0.0,0.0,0.0,0,0,0,0,0,0,0,0,0,2020-12-27 19:15:002020-12-27 19:15:00
3181,7037,Luke Young,1952,[2000],Tottenham Hotspur,11,9,2,781,0,0,9,8,1,739,0,0,20,17,3,1520,0,0,0.0,0.0,0.0,0,0,0,0,0,0,0,0,0,2020-12-27 19:15:00
3182,42243,Luke Young,1952,"[2001, 2002, 2003, 2004, 2005, 2006]",Charlton Athletic,91,88,3,7787,2,0,89,86,3,7638,2,0,180,174,6,15425,4,0,0.0,0.0,0.0,0,1,1,0,0,0,0,0,0,2020-12-27 19:15:002020-12-27 19:15:002020-12-27 19:15:002020-12-27 19:15:002020-12-27 19:15:002020-12-27 19:15:00
3183,7044,Luke Young,1952,[2007],Middlesbrough FC,18,18,0,1580,1,0,17,17,0,1530,0,0,35,35,0,3110,1,0,1.0,0.0,1.0,1,0,1,0,0,0,0,0,0,2020-12-27 19:15:00
3184,21138,Luke Young,1952,"[2008, 2009, 2010]",Aston Villa,33,31,2,2815,2,0,32,31,1,2689,0,0,65,62,3,5504,2,0,3.0,0.0,3.0,2,0,2,0,0,0,0,0,0,2020-12-27 19:15:002020-12-27 19:15:002020-12-27 19:15:00
3185,7048,Luke Young,1952,[2011],Queens Park Rangers,12,12,0,1055,0,0,11,11,0,977,2,0,23,23,0,2032,2,0,0.0,0.0,0.0,0,2,2,0,0,0,0,0,0,2020-12-27 19:15:00
3186,14099,Luque,2713,"[2005, 2006]",Newcastle United,11,4,7,369,0,0,9,2,7,343,1,0,20,6,14,712,1,0,0.0,0.0,0.0,0,0,0,0,0,0,0,0,0,2020-12-27 19:15:002020-12-27 19:15:00
3187,7051,Luton Shelton,4278,[2006],Sheffield United,0,0,0,0,0,0,4,2,2,201,0,0,4,2,2,201,0,0,0.0,0.0,0.0,0,0,0,0,0,0,0,0,0,2020-12-27 19:15:00
3188,7052,Luuk de Jong,3987,[2013],Newcastle United,7,5,2,343,0,0,5,3,2,326,0,0,12,8,4,669,0,0,0.0,0.0,0.0,0,0,0,0,0,0,0,0,0,2020-12-27 19:15:00
3189,14107,Lynden Gooch,3315,"[2015, 2016]",Sunderland AFC,4,2,2,154,0,0,7,2,5,210,0,0,11,4,7,364,0,0,0.0,0.0,0.0,0,0,0,0,0,0,0,0,0,2020-12-27 19:15:002020-12-27 19:15:00
3190,21168,Lys Mousset,1044,"[2016, 2017, 2018]",AFC Bournemouth,30,3,27,528,2,0,28,5,23,672,1,0,58,8,50,1200,3,0,3.0,0.0,3.0,2,0,2,0,0,0,0,0,0,2020-12-27 19:15:002020-12-27 19:15:002020-12-27 19:15:00
3191,14117,Lys Mousset,1044,"[2019, 2020]",Sheffield United,16,4,12,565,3,0,18,7,11,744,3,0,34,11,23,1309,6,0,3.0,1.0,4.0,1,2,3,0,0,0,0,0,0,2020-12-27 19:15:002020-12-27 19:15:00
3192,7060,Lárus Sigurðsson,3079,[2002],West Bromwich Albion,13,11,2,991,0,0,15,11,4,1058,0,0,28,22,6,2049,0,0,0.0,0.0,0.0,0,0,0,0,0,0,0,0,0,2020-12-27 19:15:00
3193,14123,Léandre Griffit,4198,"[2003, 2004]",Southampton FC,6,2,4,175,2,0,1,0,1,5,0,0,7,2,5,180,2,0,0.0,0.0,0.0,1,0,1,0,0,0,0,0,0,2020-12-27 19:15:002020-12-27 19:15:00
3194,7063,Léo Bonatini,2152,[2018],Wolverhampton Wanderers,4,0,4,62,0,0,3,0,3,67,0,0,7,0,7,129,0,0,0.0,0.0,0.0,0,0,0,0,0,0,0,0,0,2020-12-27 19:15:00
3195,7064,M'Baye Niang,3929,[2016],Watford FC,8,8,0,661,2,0,8,7,1,593,0,0,16,15,1,1254,2,0,0.0,0.0,0.0,1,0,1,0,0,0,0,0,0,2020-12-27 19:15:00
3196,7065,Maarten Stekelenburg,1465,[2013],Fulham FC,8,8,0,706,0,0,11,11,0,976,0,0,19,19,0,1682,0,0,0.0,0.0,0.0,0,0,0,0,0,0,0,0,0,2020-12-27 19:15:00
3197,7066,Maarten Stekelenburg,1465,[2015],Southampton FC,8,8,0,720,0,0,9,9,0,810,0,0,17,17,0,1530,0,0,0.0,0.0,0.0,0,0,0,0,0,0,0,0,0,2020-12-27 19:15:00
3198,28274,Maarten Stekelenburg,1465,"[2016, 2017, 2018, 2019]",Everton FC,9,9,0,784,0,0,10,10,0,900,0,0,19,19,0,1684,0,0,0.0,0.0,0.0,0,0,0,0,0,0,0,0,0,2020-12-27 19:15:002020-12-27 19:15:002020-12-27 19:15:002020-12-27 19:15:00
3199,14143,Mace Goodridge,3614,"[2019, 2020]",Burnley FC,0,0,0,0,0,0,0,0,0,0,0,0,0,0,0,0,0,0,0.0,0.0,0.0,0,0,0,0,0,0,0,0,0,2020-12-27 19:15:002020-12-27 19:15:00
3200,7073,Maceo Rigters,4086,[2007],Arsenal FC,1,0,1,10,0,0,0,0,0,0,0,0,1,0,1,10,0,0,0.0,0.0,0.0,0,0,0,0,0,0,0,0,0,2020-12-27 19:15:00
3201,7074,Madjid Bougherra,3537,[2006],Charlton Athletic,1,0,1,14,0,0,4,2,2,204,0,0,5,2,3,218,0,0,0.0,0.0,0.0,0,0,0,0,0,0,0,0,0,2020-12-27 19:15:00
3202,28306,Magaye Gueye,1750,"[2010, 2011, 2012, 2013]",Everton FC,12,3,9,481,1,0,12,2,10,299,0,0,24,5,19,780,1,0,0.0,0.0,0.0,1,0,1,0,0,0,0,0,0,2020-12-27 19:15:002020-12-27 19:15:002020-12-27 19:15:002020-12-27 19:15:00
3203,7079,Magnus Eikrem,3659,[2013],Cardiff City,4,1,3,183,0,0,2,0,2,17,0,0,6,1,5,200,0,0,0.0,0.0,0.0,0,0,0,0,0,0,0,0,0,2020-12-27 19:15:00
3204,7080,Magnus Hedman,2095,[2000],Leeds United,1,1,0,90,0,0,0,0,0,0,0,0,1,1,0,90,0,0,0.0,0.0,0.0,0,0,0,0,0,0,0,0,0,2020-12-27 19:15:00
3205,21246,Mahamadou Diarra,3350,"[2011, 2012, 2013]",Fulham FC,12,9,3,829,0,0,11,10,1,867,1,0,23,19,4,1696,1,0,0.0,0.0,0.0,0,0,0,0,0,0,0,0,0,2020-12-27 19:15:002020-12-27 19:15:002020-12-27 19:15:00
3206,7084,Maicon,3262,[2012],Manchester City,5,2,3,244,0,0,4,2,2,272,0,0,9,4,5,516,0,0,0.0,0.0,0.0,0,0,0,0,0,0,0,0,0,2020-12-27 19:15:00
3207,14171,Maik Taylor,2501,"[2001, 2002]",Fulham FC,9,8,1,729,0,0,9,8,1,748,0,0,18,16,2,1477,0,0,0.0,0.0,0.0,0,0,0,0,0,0,0,0,0,2020-12-27 19:15:002020-12-27 19:15:00
3208,42537,Maik Taylor,2501,"[2003, 2004, 2005, 2007, 2009, 2010]",Birmingham City,67,67,0,6030,0,0,71,71,0,6390,0,0,138,138,0,12420,0,0,0.0,0.0,0.0,0,0,0,0,0,0,0,0,0,2020-12-27 19:15:002020-12-27 19:15:002020-12-27 19:15:002020-12-27 19:15:002020-12-27 19:15:002020-12-27 19:15:00
3209,14187,Malcolm Christie,2137,"[2000, 2001]",Derby County,34,27,7,2370,13,0,29,24,5,2036,4,0,63,51,12,4406,17,0,8.0,6.0,14.0,9,3,12,0,0,0,0,0,0,2020-12-27 19:15:002020-12-27 19:15:00
3210,35485,Malcolm Christie,2137,"[2002, 2003, 2004, 2005, 2006]",Middlesbrough FC,21,13,8,1118,3,0,21,13,8,1092,4,0,42,26,16,2210,7,0,1.0,3.0,4.0,3,3,6,0,0,0,0,0,0,2020-12-27 19:15:002020-12-27 19:15:002020-12-27 19:15:002020-12-27 19:15:002020-12-27 19:15:00
3211,7100,Malik Buari,3673,[2003],Fulham FC,1,1,0,45,0,0,2,0,2,36,0,0,3,1,2,81,0,0,0.0,0.0,0.0,0,0,0,0,0,0,0,0,0,2020-12-27 19:15:00
3212,7101,Malky Mackay,2114,[2006],Watford FC,8,8,0,720,0,0,6,5,1,506,0,0,14,13,1,1226,0,0,0.0,0.0,0.0,0,0,0,0,0,0,0,0,0,2020-12-27 19:15:00
3213,21309,Mamadou Sakho,2250,"[2013, 2014, 2015]",Liverpool FC,24,24,0,2087,2,0,32,29,3,2667,0,0,56,53,3,4754,2,0,0.0,0.0,0.0,0,0,0,0,0,0,0,0,0,2020-12-27 19:15:002020-12-27 19:15:002020-12-27 19:15:00
3214,35535,Mamadou Sakho,2250,"[2016, 2017, 2018, 2019, 2020]",Crystal Palace,34,31,3,2830,1,0,38,36,2,3152,0,0,72,67,5,5982,1,0,3.0,0.0,3.0,1,0,1,0,0,0,0,0,0,2020-12-27 19:15:002020-12-27 19:15:002020-12-27 19:15:002020-12-27 19:15:002020-12-27 19:15:00
3215,28446,Mamady Sidibe,1994,"[2008, 2009, 2010, 2011]",Stoke City,25,16,9,1342,4,0,23,20,3,1609,1,0,48,36,12,2951,5,0,6.0,0.0,6.0,2,0,2,0,0,0,0,0,0,2020-12-27 19:15:002020-12-27 19:15:002020-12-27 19:15:002020-12-27 19:15:00
3216,14230,Mame Diouf,1584,"[2009, 2011]",Manchester United,3,0,3,53,1,0,2,0,2,37,0,0,5,0,5,90,1,0,0.0,0.0,0.0,0,0,0,0,0,0,0,0,0,2020-12-27 19:15:002020-12-27 19:15:00
3217,7115,Mame Diouf,1584,[2010],Blackburn Rovers,15,9,6,858,1,0,11,8,3,750,2,0,26,17,9,1608,3,0,0.0,0.0,0.0,1,1,2,0,0,0,0,0,0,2020-12-27 19:15:00
3218,28474,Mame Diouf,1584,"[2014, 2015, 2016, 2017]",Stoke City,59,39,20,3540,16,0,63,46,17,4148,8,0,122,85,37,7688,24,0,9.0,5.0,14.0,9,7,16,0,0,0,0,0,0,2020-12-27 19:15:002020-12-27 19:15:002020-12-27 19:15:002020-12-27 19:15:00
3219,7121,Maniche,2974,[2005],Chelsea FC,4,1,3,135,0,0,4,2,2,268,0,0,8,3,5,403,0,0,0.0,0.0,0.0,0,0,0,0,0,0,0,0,0,2020-12-27 19:15:00
3220,7122,Manny Onariase,4136,[2014],West Ham United,0,0,0,0,0,0,0,0,0,0,0,0,0,0,0,0,0,0,0.0,0.0,0.0,0,0,0,0,0,0,0,0,0,2020-12-27 19:15:00
3221,21372,Manolo Gabbiadini,1913,"[2016, 2017, 2018]",Southampton FC,27,14,13,1313,5,0,24,11,13,962,5,0,51,25,26,2275,10,0,1.0,4.0,5.0,5,4,9,1,0,1,0,0,0,2020-12-27 19:15:002020-12-27 19:15:002020-12-27 19:15:00
3222,7126,Manquillo,2469,[2014],Liverpool FC,6,6,0,514,0,0,4,4,0,248,0,0,10,10,0,762,0,0,0.0,0.0,0.0,0,0,0,0,0,0,0,0,0,2020-12-27 19:15:00
3223,7127,Manquillo,2469,[2016],Sunderland AFC,10,7,3,710,0,0,10,8,2,718,1,0,20,15,5,1428,1,0,0.0,0.0,0.0,0,1,1,0,0,0,0,0,0,2020-12-27 19:15:00
3224,28518,Manquillo,2469,"[2017, 2018, 2019, 2020]",Newcastle United,33,27,6,2461,0,0,32,27,5,2366,0,0,65,54,11,4827,0,0,0.0,0.0,0.0,0,0,0,0,0,0,0,0,0,2020-12-27 19:15:002020-12-27 19:15:002020-12-27 19:15:002020-12-27 19:15:00
3225,7132,Manu García,2759,[2015],Manchester City,1,0,1,10,0,0,0,0,0,0,0,0,1,0,1,10,0,0,0.0,0.0,0.0,0,0,0,0,0,0,0,0,0,2020-12-27 19:15:00
3226,7133,Manucho,2950,[2008],Hull City,6,1,5,215,0,0,7,5,2,437,2,0,13,6,7,652,2,0,0.0,3.0,3.0,0,2,2,0,0,0,0,0,0,2020-12-27 19:15:00
3227,49959,Manuel Almunia,2039,"[2004, 2006, 2007, 2008, 2009, 2010, 2011]",Arsenal FC,57,57,0,5118,0,0,50,50,0,4500,0,0,107,107,0,9618,0,0,0.0,0.0,0.0,0,0,0,0,0,0,0,0,0,2020-12-27 19:15:002020-12-27 19:15:002020-12-27 19:15:002020-12-27 19:15:002020-12-27 19:15:002020-12-27 19:15:002020-12-27 19:15:00
3228,14283,Manuel Da Costa,4013,"[2009, 2010]",West Ham United,15,14,1,1228,1,0,16,12,4,1158,2,0,31,26,5,2386,3,0,0.0,1.0,1.0,0,2,2,0,0,0,0,0,0,2020-12-27 19:15:002020-12-27 19:15:00
3229,14287,Manuel Fernandes,3644,"[2006, 2007]",Everton FC,12,11,1,982,1,0,9,6,3,605,1,0,21,17,4,1587,2,0,0.0,0.0,0.0,0,1,1,0,0,0,0,0,0,2020-12-27 19:15:002020-12-27 19:15:00
3230,42885,Manuel Lanzini,2351,"[2015, 2016, 2017, 2018, 2019, 2020]",West Ham United,69,53,16,4707,10,0,61,47,14,4279,11,0,130,100,30,8986,21,0,3.0,4.0,7.0,5,6,11,0,2,2,0,0,0,2020-12-27 19:15:002020-12-27 19:15:002020-12-27 19:15:002020-12-27 19:15:002020-12-27 19:15:002020-12-27 19:15:00
3231,14303,Mapou Yanga-Mbiwa,2452,"[2012, 2013]",Newcastle United,16,14,2,1274,0,0,21,14,7,1313,0,0,37,28,9,2587,0,0,0.0,0.0,0.0,0,0,0,0,0,0,0,0,0,2020-12-27 19:15:002020-12-27 19:15:00
3232,35775,Marc Albrighton,1448,"[2009, 2010, 2011, 2012, 2013]",Aston Villa,49,25,24,2704,3,0,36,22,14,1988,4,0,85,47,38,4692,7,0,0.0,0.0,0.0,1,4,5,0,0,0,0,0,0,2020-12-27 19:15:002020-12-27 19:15:002020-12-27 19:15:002020-12-27 19:15:002020-12-27 19:15:00
3233,50127,Marc Albrighton,1448,"[2014, 2015, 2016, 2017, 2018, 2019, 2020]",Leicester City,87,70,17,5985,7,0,93,66,27,5909,3,0,180,136,44,11894,10,0,0.0,0.0,0.0,2,2,4,0,0,0,0,0,0,2020-12-27 19:15:002020-12-27 19:15:002020-12-27 19:15:002020-12-27 19:15:002020-12-27 19:15:002020-12-27 19:15:002020-12-27 19:15:00
3234,7165,Marc Edworthy,2386,[2000],Coventry City,10,10,0,900,1,0,11,7,4,803,0,0,21,17,4,1703,1,0,1.0,0.0,1.0,1,0,1,0,0,0,0,0,0,2020-12-27 19:15:00
3235,7166,Marc Edworthy,2386,[2004],Norwich City,13,12,1,1099,0,0,14,14,0,1241,0,0,27,26,1,2340,0,0,0.0,0.0,0.0,0,0,0,0,0,0,0,0,0,2020-12-27 19:15:00
3236,7167,Marc Edworthy,2386,[2007],Derby County,7,5,2,478,0,0,2,2,0,180,0,0,9,7,2,658,0,0,0.0,0.0,0.0,0,0,0,0,0,0,0,0,0,2020-12-27 19:15:00
3237,14337,Marc Guehi,4286,"[2018, 2019]",Chelsea FC,0,0,0,0,0,0,0,0,0,0,0,0,0,0,0,0,0,0,0.0,0.0,0.0,0,0,0,0,0,0,0,0,0,2020-12-27 19:15:002020-12-27 19:15:00
3238,7170,Marc Navarro,2093,[2018],Watford FC,0,0,0,0,0,0,2,1,1,85,0,0,2,1,1,85,0,0,0.0,0.0,0.0,0,0,0,0,0,0,0,0,0,2020-12-27 19:15:00
3239,28690,Marc Pugh,1016,"[2015, 2016, 2017, 2018]",AFC Bournemouth,35,23,12,1967,2,0,32,19,13,1686,3,0,67,42,25,3653,5,0,3.0,0.0,3.0,1,3,4,0,0,0,0,0,0,2020-12-27 19:15:002020-12-27 19:15:002020-12-27 19:15:002020-12-27 19:15:00
3240,14351,Marc Tierney,3042,"[2011, 2012]",Norwich City,8,8,0,720,0,0,10,10,0,900,0,0,18,18,0,1620,0,0,0.0,0.0,0.0,0,0,0,0,0,0,0,0,0,2020-12-27 19:15:002020-12-27 19:15:00
3241,14355,Marc Wilson,1546,"[2008, 2009]",Portsmouth FC,14,14,0,1216,0,0,17,16,1,1377,0,0,31,30,1,2593,0,0,0.0,0.0,0.0,0,0,0,0,0,0,0,0,0,2020-12-27 19:15:002020-12-27 19:15:00
3242,43089,Marc Wilson,1546,"[2010, 2011, 2012, 2013, 2014, 2015]",Stoke City,70,60,10,5415,0,0,75,70,5,5877,1,0,145,130,15,11292,1,0,0.0,0.0,0.0,0,0,0,0,0,0,0,0,0,2020-12-27 19:15:002020-12-27 19:15:002020-12-27 19:15:002020-12-27 19:15:002020-12-27 19:15:002020-12-27 19:15:00
3243,7185,Marc Wilson,1546,[2016],West Bromwich Albion,1,0,1,26,0,0,3,3,0,230,0,0,4,3,1,256,0,0,0.0,0.0,0.0,0,0,0,0,0,0,0,0,0,2020-12-27 19:15:00
3244,28750,Marc-Antoine Fortuné,1742,"[2008, 2010, 2011, 2012]",West Bromwich Albion,42,26,16,2318,8,0,38,26,12,2177,2,0,80,52,28,4495,10,0,4.0,0.0,4.0,5,1,6,0,0,0,0,0,0,2020-12-27 19:15:002020-12-27 19:15:002020-12-27 19:15:002020-12-27 19:15:00
3245,7190,Marc-Vivien Foé,3202,[2002],Manchester City,19,19,0,1667,5,0,15,15,0,1350,4,0,34,34,0,3017,9,0,0.0,1.0,1.0,2,3,5,0,0,0,0,0,0,2020-12-27 19:15:00
3246,28770,Marcel Desailly,2614,"[2000, 2001, 2002, 2003]",Chelsea FC,54,54,0,4831,3,0,49,48,1,4264,2,0,103,102,1,9095,5,0,0.0,1.0,1.0,2,1,3,0,0,0,0,0,0,2020-12-27 19:15:002020-12-27 19:15:002020-12-27 19:15:002020-12-27 19:15:00
3247,7195,Marcel Gecov,3266,[2011],Fulham FC,1,0,1,1,0,0,1,0,1,5,0,0,2,0,2,6,0,0,0.0,0.0,0.0,0,0,0,0,0,0,0,0,0,2020-12-27 19:15:00
3248,7196,Marcelino,3395,[2000],Newcastle United,1,1,0,90,0,0,4,3,1,271,0,0,5,4,1,361,0,0,0.0,0.0,0.0,0,0,0,0,0,0,0,0,0,2020-12-27 19:15:00
3249,14395,Marcello Trotta,2561,"[2011, 2012]",Fulham FC,0,0,0,0,0,0,1,0,1,2,0,0,1,0,1,2,0,0,0.0,0.0,0.0,0,0,0,0,0,0,0,0,0,2020-12-27 19:15:002020-12-27 19:15:00
3250,7199,Marcelo Moreno,3489,[2009],Wigan Athletic,8,6,2,507,0,0,4,3,1,221,0,0,12,9,3,728,0,0,0.0,0.0,0.0,0,0,0,0,0,0,0,0,0,2020-12-27 19:15:00
3251,21603,Marcin Wasilewski,2515,"[2014, 2015, 2016]",Leicester City,15,15,0,1240,0,0,15,11,4,1141,1,0,30,26,4,2381,1,0,0.0,0.0,0.0,0,0,0,0,0,0,0,0,0,2020-12-27 19:15:002020-12-27 19:15:002020-12-27 19:15:00
3252,7203,Marco Ambrosio,3570,[2003],Chelsea FC,4,4,0,360,0,0,4,4,0,360,0,0,8,8,0,720,0,0,0.0,0.0,0.0,0,0,0,0,0,0,0,0,0,2020-12-27 19:15:00
3253,7204,Marco Amelia,4392,[2015],Chelsea FC,0,0,0,0,0,0,0,0,0,0,0,0,0,0,0,0,0,0,0.0,0.0,0.0,0,0,0,0,0,0,0,0,0,2020-12-27 19:15:00
3254,7205,Marco Borriello,3875,[2013],West Ham United,1,0,1,44,0,0,1,0,1,44,0,0,2,0,2,88,0,0,0.0,0.0,0.0,0,0,0,0,0,0,0,0,0,2020-12-27 19:15:00
3255,7206,Marco Stiepermann,1827,[2019],Norwich City,10,7,3,585,0,0,14,7,7,600,0,0,24,14,10,1185,0,0,0.0,0.0,0.0,0,0,0,0,0,0,0,0,0,2020-12-27 19:15:00
3256,7207,Marco van Ginkel,2757,[2013],Chelsea FC,2,0,2,12,0,0,0,0,0,0,0,0,2,0,2,12,0,0,0.0,0.0,0.0,0,0,0,0,0,0,0,0,0,2020-12-27 19:15:00
3257,7208,Marco van Ginkel,2757,[2015],Stoke City,9,4,5,422,0,0,8,4,4,329,0,0,17,8,9,751,0,0,0.0,0.0,0.0,0,0,0,0,0,0,0,0,0,2020-12-27 19:15:00
3258,14419,Marcos Alonso,1846,"[2010, 2011]",Bolton Wanderers,2,2,0,180,0,0,7,6,1,512,1,0,9,8,1,692,1,0,0.0,0.0,0.0,0,1,1,0,0,0,0,0,0,2020-12-27 19:15:002020-12-27 19:15:00
3259,7211,Marcos Alonso,1846,[2013],Sunderland AFC,8,8,0,720,0,0,8,8,0,720,0,0,16,16,0,1440,0,0,0.0,0.0,0.0,0,0,0,0,0,0,0,0,0,2020-12-27 19:15:00
3260,36070,Marcos Alonso,1846,"[2016, 2017, 2018, 2019, 2020]",Chelsea FC,57,56,1,5048,9,0,59,56,3,4924,10,0,116,112,4,9972,19,0,10.0,5.0,15.0,5,7,12,0,0,0,0,0,0,2020-12-27 19:15:002020-12-27 19:15:002020-12-27 19:15:002020-12-27 19:15:002020-12-27 19:15:00
3261,7217,Marcos Angeleri,3868,[2010],Sunderland AFC,1,0,1,5,0,0,1,0,1,1,0,0,2,0,2,6,0,0,0.0,0.0,0.0,0,0,0,0,0,0,0,0,0,2020-12-27 19:15:00
3262,7218,Marcos Painter,2775,[2005],Birmingham City,2,1,1,96,0,0,2,1,1,109,0,0,4,2,2,205,0,0,0.0,0.0,0.0,0,0,0,0,0,0,0,0,0,2020-12-27 19:15:00
3263,43329,Marcos Rojo,1651,"[2014, 2015, 2016, 2017, 2018, 2019]",Manchester United,42,36,6,3096,1,0,34,28,6,2558,0,0,76,64,12,5654,1,0,0.0,0.0,0.0,1,0,1,0,0,0,0,0,0,2020-12-27 19:15:002020-12-27 19:15:002020-12-27 19:15:002020-12-27 19:15:002020-12-27 19:15:002020-12-27 19:15:00
3264,14451,Marcus Allbäck,3270,"[2002, 2003]",Aston Villa,18,7,11,776,4,0,16,9,7,920,2,0,34,16,18,1696,6,0,3.0,0.0,3.0,3,2,5,0,0,0,0,0,0,2020-12-27 19:15:002020-12-27 19:15:00
3265,14459,Marcus Bent,1349,"[2001, 2007]",Blackburn Rovers,4,0,4,100,0,0,5,2,3,203,0,0,9,2,7,303,0,0,0.0,0.0,0.0,0,0,0,0,0,0,0,0,0,2020-12-27 19:15:002020-12-27 19:15:00
3266,7228,Marcus Bent,1349,[2003],Leicester City,16,13,3,1144,2,0,17,15,2,1350,7,0,33,28,5,2494,9,0,1.0,0.0,1.0,2,3,5,0,0,0,0,0,0,2020-12-27 19:15:00
3267,7229,Marcus Bent,1349,[2004],Everton FC,19,15,4,1318,3,0,17,16,1,1309,3,0,36,31,5,2627,6,0,7.0,1.0,8.0,3,1,4,0,0,0,0,0,0,2020-12-27 19:15:00
3268,14461,Marcus Bent,1349,"[2005, 2006]",Charlton Athletic,20,15,5,1098,0,0,23,14,9,1365,3,0,43,29,14,2463,3,0,0.0,1.0,1.0,0,1,1,0,0,0,0,0,0,2020-12-27 19:15:002020-12-27 19:15:00
3269,7233,Marcus Bent,1349,[2010],Wolverhampton Wanderers,0,0,0,0,0,0,3,0,3,13,0,0,3,0,3,13,0,0,0.0,0.0,0.0,0,0,0,0,0,0,0,0,0,2020-12-27 19:15:00
3270,14469,Marcus Bettinelli,4017,"[2013, 2018]",Fulham FC,3,3,0,270,0,0,4,4,0,360,0,0,7,7,0,630,0,0,0.0,0.0,0.0,0,0,0,0,0,0,0,0,0,2020-12-27 19:15:002020-12-27 19:15:00
3271,21711,Marcus Browne,2644,"[2015, 2016, 2017]",West Ham United,0,0,0,0,0,0,0,0,0,0,0,0,0,0,0,0,0,0,0.0,0.0,0.0,0,0,0,0,0,0,0,0,0,2020-12-27 19:15:002020-12-27 19:15:002020-12-27 19:15:00
3272,14479,Marcus Hahnemann,2588,"[2006, 2007]",Reading FC,38,38,0,3420,0,0,34,34,0,2935,0,0,72,72,0,6355,0,0,0.0,0.0,0.0,0,0,0,0,0,0,0,0,0,2020-12-27 19:15:002020-12-27 19:15:00
3273,14483,Marcus Hahnemann,2588,"[2009, 2010]",Wolverhampton Wanderers,20,20,0,1800,0,0,18,18,0,1620,0,0,38,38,0,3420,0,0,0.0,0.0,0.0,0,0,0,0,0,0,0,0,0,2020-12-27 19:15:002020-12-27 19:15:00
3274,7243,Marcus Hall,2099,[2000],Leeds United,1,1,0,90,0,0,0,0,0,0,0,0,1,1,0,90,0,0,0.0,0.0,0.0,0,0,0,0,0,0,0,0,0,2020-12-27 19:15:00
3275,7244,Marcus Olsson,3512,[2011],Blackburn Rovers,6,4,2,450,0,0,6,6,0,540,0,0,12,10,2,990,0,0,0.0,0.0,0.0,0,0,0,0,0,0,0,0,0,2020-12-27 19:15:00
3276,43485,Marcus Rashford,1648,"[2015, 2016, 2017, 2018, 2019, 2020]",Manchester United,79,64,15,5688,27,0,78,50,28,4899,23,0,157,114,43,10587,50,0,12.0,15.0,27.0,16,14,30,5,1,6,0,0,0,2020-12-27 19:15:002020-12-27 19:15:002020-12-27 19:15:002020-12-27 19:15:002020-12-27 19:15:002020-12-27 19:15:00
3277,14503,Marcus Stewart,2722,"[2000, 2001]",Ipswich Town,29,24,5,2119,9,0,31,27,4,2431,16,0,60,51,9,4550,25,0,4.0,4.0,8.0,7,9,16,1,2,3,0,0,0,2020-12-27 19:15:002020-12-27 19:15:00
3278,7253,Marcus Stewart,2722,[2002],Sunderland AFC,12,5,7,500,1,0,7,4,3,344,0,0,19,9,10,844,1,0,0.0,0.0,0.0,0,0,0,0,0,0,0,0,0,2020-12-27 19:15:00
3279,7254,Marek Matějovský,3157,[2007],Reading FC,8,6,2,542,0,0,6,4,2,352,1,0,14,10,4,894,1,0,0.0,0.0,0.0,0,1,1,0,0,0,0,0,0,2020-12-27 19:15:00
3280,7255,Marek Rodák,1011,[2020],Fulham FC,1,1,0,90,0,0,0,0,0,0,0,0,1,1,0,90,0,0,0.0,0.0,0.0,0,0,0,0,0,0,0,0,0,2020-12-27 19:15:00
3281,21771,Marek Čech,3296,"[2008, 2010, 2011]",West Bromwich Albion,13,9,4,866,0,0,10,8,2,688,0,0,23,17,6,1554,0,0,0.0,0.0,0.0,0,0,0,0,0,0,0,0,0,2020-12-27 19:15:002020-12-27 19:15:002020-12-27 19:15:00
3282,7259,Marek Štěch,3805,[2010],West Ham United,0,0,0,0,0,0,0,0,0,0,0,0,0,0,0,0,0,0,0.0,0.0,0.0,0,0,0,0,0,0,0,0,0,2020-12-27 19:15:00
3283,29046,Marians Pahars,2051,"[2000, 2001, 2002, 2003]",Southampton FC,46,40,6,3419,18,0,39,26,13,2372,8,0,85,66,19,5791,26,0,8.0,4.0,12.0,8,4,12,2,0,2,0,0,0,2020-12-27 19:15:002020-12-27 19:15:002020-12-27 19:15:002020-12-27 19:15:00
3284,21795,Mario Balotelli,1681,"[2010, 2011, 2012]",Manchester City,28,16,12,1485,13,0,26,17,9,1562,7,0,54,33,21,3047,20,0,3.0,0.0,3.0,8,4,12,5,0,5,0,0,0,2020-12-27 19:15:002020-12-27 19:15:002020-12-27 19:15:00
3285,7267,Mario Balotelli,1681,[2014],Liverpool FC,8,4,4,401,1,0,8,6,2,538,0,0,16,10,6,939,1,0,3.0,0.0,3.0,1,0,1,0,0,0,0,0,0,2020-12-27 19:15:00
3286,7268,Mario Espartero,4237,[2001],Bolton Wanderers,0,0,0,0,0,0,3,0,3,56,0,0,3,0,3,56,0,0,0.0,0.0,0.0,0,0,0,0,0,0,0,0,0,2020-12-27 19:15:00
3287,14539,Mario Lemina,1911,"[2017, 2018]",Southampton FC,20,19,1,1607,0,0,26,19,7,1731,2,0,46,38,8,3338,2,0,0.0,0.0,0.0,0,1,1,0,0,0,0,0,0,2020-12-27 19:15:002020-12-27 19:15:00
3288,7271,Mario Lemina,1911,[2020],Fulham FC,5,4,1,302,0,0,5,1,4,154,0,0,10,5,5,456,0,0,0.0,0.0,0.0,0,0,0,0,0,0,0,0,0,2020-12-27 19:15:00
3289,29094,Mario Melchiot,1512,"[2000, 2001, 2002, 2003]",Chelsea FC,63,54,9,5091,2,0,58,56,2,4869,2,0,121,110,11,9960,4,0,0.0,3.0,3.0,2,2,4,0,0,0,0,0,0,2020-12-27 19:15:002020-12-27 19:15:002020-12-27 19:15:002020-12-27 19:15:00
3290,14553,Mario Melchiot,1512,"[2004, 2005]",Birmingham City,31,29,2,2372,1,0,26,26,0,2323,1,0,57,55,2,4695,2,0,0.0,0.0,0.0,0,1,1,0,0,0,0,0,0,2020-12-27 19:15:002020-12-27 19:15:00
3291,21837,Mario Melchiot,1512,"[2007, 2008, 2009]",Wigan Athletic,46,45,1,3946,0,0,49,49,0,4288,0,0,95,94,1,8234,0,0,0.0,0.0,0.0,0,0,0,0,0,0,0,0,0,2020-12-27 19:15:002020-12-27 19:15:002020-12-27 19:15:00
3292,29130,Mario Stanić,3414,"[2000, 2001, 2002, 2003]",Chelsea FC,27,18,9,1505,3,0,30,19,11,1535,4,0,57,37,20,3040,7,0,0.0,0.0,0.0,0,2,2,0,0,0,0,0,0,2020-12-27 19:15:002020-12-27 19:15:002020-12-27 19:15:002020-12-27 19:15:00
3293,7285,Mario Suárez,3864,[2015],Watford FC,7,3,4,313,0,0,8,5,3,432,0,0,15,8,7,745,0,0,0.0,0.0,0.0,0,0,0,0,0,0,0,0,0,2020-12-27 19:15:00
3294,7286,Mario Vrančić,2179,[2019],Norwich City,12,4,8,404,1,0,8,2,6,224,0,0,20,6,14,628,1,0,0.0,0.0,0.0,1,0,1,0,0,0,0,0,0,2020-12-27 19:15:00
3295,7287,Mark Bosnich,3413,[2001],Chelsea FC,1,1,0,90,0,0,4,4,0,350,0,0,5,5,0,440,0,0,0.0,0.0,0.0,0,0,0,0,0,0,0,0,0,2020-12-27 19:15:00
3296,14577,Mark Bunn,1380,"[2010, 2011]",Blackburn Rovers,2,2,0,180,0,0,4,3,1,314,0,0,6,5,1,494,0,0,0.0,0.0,0.0,0,0,0,0,0,0,0,0,0,2020-12-27 19:15:002020-12-27 19:15:00
3297,14581,Mark Bunn,1380,"[2012, 2013]",Norwich City,12,12,0,1005,0,0,11,10,1,908,0,0,23,22,1,1913,0,0,0.0,0.0,0.0,0,0,0,0,0,0,0,0,0,2020-12-27 19:15:002020-12-27 19:15:00
3298,7292,Mark Bunn,1380,[2015],Aston Villa,5,5,0,450,0,0,5,5,0,450,0,0,10,10,0,900,0,0,0.0,0.0,0.0,0,0,0,0,0,0,0,0,0,2020-12-27 19:15:00
3299,7293,Mark Burchill,3767,[2000],Ipswich Town,2,2,0,180,1,0,5,0,5,35,0,0,7,2,5,215,1,0,0.0,0.0,0.0,0,0,0,0,0,0,0,0,0,2020-12-27 19:15:00
3300,7294,Mark Clyde,4181,[2003],Wolverhampton Wanderers,4,2,2,180,0,0,5,4,1,337,0,0,9,6,3,517,0,0,0.0,0.0,0.0,0,0,0,0,0,0,0,0,0,2020-12-27 19:15:00
3301,21888,Mark Crossley,1932,"[2000, 2001, 2002]",Middlesbrough FC,10,9,1,868,0,0,12,11,1,925,0,0,22,20,2,1793,0,0,0.0,0.0,0.0,0,0,0,0,0,0,0,0,0,2020-12-27 19:15:002020-12-27 19:15:002020-12-27 19:15:00
3302,21897,Mark Crossley,1932,"[2003, 2004, 2005]",Fulham FC,12,11,1,990,0,0,7,7,0,611,0,0,19,18,1,1601,0,0,0.0,0.0,0.0,0,0,0,0,0,0,0,0,0,2020-12-27 19:15:002020-12-27 19:15:002020-12-27 19:15:00
3303,7301,Mark Cullen,3919,[2009],Hull City,2,1,1,105,0,0,1,1,0,90,1,0,3,2,1,195,1,0,0.0,0.0,0.0,0,1,1,0,0,0,0,0,0,2020-12-27 19:15:00
3304,29214,Mark Davies,2493,"[2008, 2009, 2010, 2011]",Bolton Wanderers,42,26,16,2558,3,0,43,25,18,2475,2,0,85,51,34,5033,5,0,1.0,0.0,1.0,3,2,5,0,0,0,0,0,0,2020-12-27 19:15:002020-12-27 19:15:002020-12-27 19:15:002020-12-27 19:15:00
3305,43851,Mark Delaney,3269,"[2000, 2001, 2002, 2003, 2004, 2005]",Aston Villa,61,56,5,5089,1,0,64,60,4,5315,0,0,125,116,9,10404,1,0,0.0,0.0,0.0,0,0,0,0,0,0,0,0,0,2020-12-27 19:15:002020-12-27 19:15:002020-12-27 19:15:002020-12-27 19:15:002020-12-27 19:15:002020-12-27 19:15:00
3306,14625,Mark Draper,2049,"[2000, 2001]",Southampton FC,9,4,5,476,0,0,15,13,2,1190,1,0,24,17,7,1666,1,0,0.0,3.0,3.0,0,1,1,0,0,0,0,0,0,2020-12-27 19:15:002020-12-27 19:15:00
3307,36580,Mark Fish,1671,"[2000, 2001, 2002, 2003, 2004]",Charlton Athletic,53,52,1,4405,1,0,47,47,0,3889,1,0,100,99,1,8294,2,0,0.0,0.0,0.0,1,1,2,0,0,0,0,0,0,2020-12-27 19:15:002020-12-27 19:15:002020-12-27 19:15:002020-12-27 19:15:002020-12-27 19:15:00
3308,7319,Mark Gillespie,1024,[2020],Newcastle United,0,0,0,0,0,0,0,0,0,0,0,0,0,0,0,0,0,0,0.0,0.0,0.0,0,0,0,0,0,0,0,0,0,2020-12-27 19:15:00
3309,7320,Mark González,3554,[2006],Liverpool FC,13,6,7,561,2,0,12,8,4,656,0,0,25,14,11,1217,2,0,0.0,0.0,0.0,1,0,1,0,0,0,0,0,0,2020-12-27 19:15:00
3310,14643,Mark Gower,2810,"[2011, 2012]",Swansea City,10,7,3,638,0,0,11,7,4,499,0,0,21,14,7,1137,0,0,0.0,0.0,0.0,0,0,0,0,0,0,0,0,0,2020-12-27 19:15:002020-12-27 19:15:00
3311,7323,Mark Halstead,3918,[2010],Blackpool FC,1,0,1,23,0,0,0,0,0,0,0,0,1,0,1,23,0,0,0.0,0.0,0.0,0,0,0,0,0,0,0,0,0,2020-12-27 19:15:00
3312,14649,Mark Hudson,2970,"[2000, 2001]",Middlesbrough FC,4,0,4,47,0,0,1,0,1,4,0,0,5,0,5,51,0,0,0.0,0.0,0.0,0,0,0,0,0,0,0,0,0,2020-12-27 19:15:002020-12-27 19:15:00
3313,7326,Mark Hudson,2970,[2004],Crystal Palace,4,4,0,360,1,0,3,3,0,270,0,0,7,7,0,630,1,0,0.0,0.0,0.0,1,0,1,0,0,0,0,0,0,2020-12-27 19:15:00
3314,7327,Mark Hudson,2970,[2013],Cardiff City,1,1,0,78,0,0,1,1,0,69,0,0,2,2,0,147,0,0,0.0,0.0,0.0,0,0,0,0,0,0,0,0,0,2020-12-27 19:15:00
3315,14658,Mark Hughes,1353,"[2000, 2006]",Everton FC,6,3,3,220,0,0,4,3,1,231,0,0,10,6,4,451,0,0,0.0,0.0,0.0,0,0,0,0,0,0,0,0,0,2020-12-27 19:15:002020-12-27 19:15:00
3316,7329,Mark Hughes,1353,[2001],Blackburn Rovers,8,0,8,169,0,0,12,3,9,437,1,0,20,3,17,606,1,0,0.0,0.0,0.0,0,1,1,0,0,0,0,0,0,2020-12-27 19:15:00
3317,7331,Mark Kennedy,2907,[2000],Manchester City,12,8,4,794,0,0,10,5,5,489,0,0,22,13,9,1283,0,0,0.0,0.0,0.0,0,0,0,0,0,0,0,0,0,2020-12-27 19:15:00
3318,7332,Mark Kennedy,2907,[2003],Wolverhampton Wanderers,14,14,0,1227,0,0,17,14,3,1308,2,0,31,28,3,2535,2,0,0.0,0.0,0.0,0,1,1,0,0,0,0,0,0,2020-12-27 19:15:00
3319,14667,Mark Kinsella,1677,"[2000, 2001]",Charlton Athletic,24,20,4,1844,2,0,23,19,4,1743,0,0,47,39,8,3587,2,0,0.0,0.0,0.0,1,0,1,0,0,0,0,0,0,2020-12-27 19:15:002020-12-27 19:15:00
3320,14671,Mark Kinsella,1677,"[2002, 2003]",Aston Villa,11,8,3,681,0,0,10,9,1,804,0,0,21,17,4,1485,0,0,0.0,0.0,0.0,0,0,0,0,0,0,0,0,0,2020-12-27 19:15:002020-12-27 19:15:00
3321,110160,Mark Noble,2204,"[2005, 2006, 2007, 2008, 2009, 2010, 2012, 2013, 2014, 2015, 2016, 2017, 2018, 2019, 2020]",West Ham United,194,181,13,15772,27,0,196,184,12,15603,19,0,390,365,25,31375,46,0,13.0,5.0,18.0,18,11,29,20,7,27,0,0,0,2020-12-27 19:15:002020-12-27 19:15:002020-12-27 19:15:002020-12-27 19:15:002020-12-27 19:15:002020-12-27 19:15:002020-12-27 19:15:002020-12-27 19:15:002020-12-27 19:15:002020-12-27 19:15:002020-12-27 19:15:002020-12-27 19:15:002020-12-27 19:15:002020-12-27 19:15:002020-12-27 19:15:00
3322,22059,Mark Pembridge,1933,"[2000, 2001, 2002]",Everton FC,24,19,5,1722,2,0,31,29,2,2388,0,0,55,48,7,4110,2,0,0.0,0.0,0.0,1,0,1,0,0,0,0,0,0,2020-12-27 19:15:002020-12-27 19:15:002020-12-27 19:15:00
3323,22068,Mark Pembridge,1933,"[2003, 2004, 2005]",Fulham FC,22,19,3,1627,0,0,20,18,2,1565,1,0,42,37,5,3192,1,0,0.0,0.0,0.0,0,1,1,0,0,0,0,0,0,2020-12-27 19:15:002020-12-27 19:15:002020-12-27 19:15:00
3324,14717,Mark Randall,1239,"[2007, 2008]",Arsenal FC,0,0,0,0,0,0,2,0,2,17,0,0,2,0,2,17,0,0,0.0,0.0,0.0,0,0,0,0,0,0,0,0,0,2020-12-27 19:15:002020-12-27 19:15:00
3325,58908,Mark Schwarzer,1328,"[2000, 2001, 2002, 2003, 2004, 2005, 2006, 2007]",Middlesbrough FC,130,130,0,11700,0,0,120,120,0,10800,0,0,250,250,0,22500,0,0,0.0,0.0,0.0,0,0,0,0,0,0,0,0,0,2020-12-27 19:15:002020-12-27 19:15:002020-12-27 19:15:002020-12-27 19:15:002020-12-27 19:15:002020-12-27 19:15:002020-12-27 19:15:002020-12-27 19:15:00
3326,36850,Mark Schwarzer,1328,"[2008, 2009, 2010, 2011, 2012]",Fulham FC,81,81,0,7290,0,0,84,84,0,7560,0,0,165,165,0,14850,0,0,0.0,0.0,0.0,0,0,0,0,0,0,0,0,0,2020-12-27 19:15:002020-12-27 19:15:002020-12-27 19:15:002020-12-27 19:15:002020-12-27 19:15:00
3327,7373,Mark Schwarzer,1328,[2013],Chelsea FC,2,2,0,180,0,0,2,2,0,180,0,0,4,4,0,360,0,0,0.0,0.0,0.0,0,0,0,0,0,0,0,0,0,2020-12-27 19:15:00
3328,14749,Mark Schwarzer,1328,"[2014, 2015]",Leicester City,2,2,0,180,0,0,4,4,0,360,0,0,6,6,0,540,0,0,0.0,0.0,0.0,0,0,0,0,0,0,0,0,0,2020-12-27 19:15:002020-12-27 19:15:00
3329,7376,Mark Summerbell,2067,[2000],Middlesbrough FC,3,3,0,270,1,0,4,2,2,213,0,0,7,5,2,483,1,0,1.0,0.0,1.0,1,0,1,0,0,0,0,0,0,2020-12-27 19:15:00
3330,14755,Mark Travers,4102,"[2018, 2019]",AFC Bournemouth,2,2,0,180,0,0,1,1,0,90,0,0,3,3,0,270,0,0,0.0,0.0,0.0,0,0,0,0,0,0,0,0,0,2020-12-27 19:15:002020-12-27 19:15:00
3331,14759,Mark Venus,3766,"[2000, 2001]",Ipswich Town,29,28,1,2504,2,0,24,23,1,2023,2,0,53,51,2,4527,4,0,0.0,0.0,0.0,0,1,1,0,0,0,0,0,0,2020-12-27 19:15:002020-12-27 19:15:00
3332,29530,Mark Viduka,1299,"[2000, 2001, 2002, 2003]",Leeds United,57,55,2,4827,34,0,60,58,2,5169,25,0,117,113,4,9996,59,0,8.0,13.0,21.0,19,15,34,2,3,5,0,0,0,2020-12-27 19:15:002020-12-27 19:15:002020-12-27 19:15:002020-12-27 19:15:00
3333,22158,Mark Viduka,1299,"[2004, 2005, 2006]",Middlesbrough FC,37,30,7,2611,17,0,35,26,9,2246,8,0,72,56,16,4857,25,0,9.0,4.0,13.0,11,6,17,0,0,0,0,0,0,2020-12-27 19:15:002020-12-27 19:15:002020-12-27 19:15:00
3334,14777,Mark Viduka,1299,"[2007, 2008]",Newcastle United,18,13,5,1147,6,0,20,12,8,1118,1,0,38,25,13,2265,7,0,1.0,0.0,1.0,5,1,6,0,0,0,0,0,0,2020-12-27 19:15:002020-12-27 19:15:00
3335,14781,Mark Wilson,3684,"[2001, 2002]",Middlesbrough FC,8,2,6,230,0,0,8,4,4,453,0,0,16,6,10,683,0,0,0.0,0.0,0.0,0,0,0,0,0,0,0,0,0,2020-12-27 19:15:002020-12-27 19:15:00
3336,14785,Mark Yeates,4144,"[2003, 2004]",Tottenham Hotspur,1,0,1,12,0,0,2,1,1,108,0,0,3,1,2,120,0,0,0.0,0.0,0.0,0,0,0,0,0,0,0,0,0,2020-12-27 19:15:002020-12-27 19:15:00
3337,29582,Marko Arnautović,1552,"[2013, 2014, 2015, 2016]",Stoke City,67,62,5,5441,13,0,58,50,8,4345,9,0,125,112,13,9786,22,0,3.0,7.0,10.0,7,6,13,1,3,4,0,0,0,2020-12-27 19:15:002020-12-27 19:15:002020-12-27 19:15:002020-12-27 19:15:00
3338,14797,Marko Arnautović,1552,"[2017, 2018]",West Ham United,32,29,3,2454,13,0,28,24,4,2017,8,0,60,53,7,4471,21,0,4.0,0.0,4.0,6,5,11,1,0,1,0,0,0,2020-12-27 19:15:002020-12-27 19:15:00
3339,14801,Marko Grujić,2754,"[2016, 2017]",Liverpool FC,4,0,4,31,0,0,4,0,4,21,0,0,8,0,8,52,0,0,0.0,0.0,0.0,0,0,0,0,0,0,0,0,0,2020-12-27 19:15:002020-12-27 19:15:00
3340,7402,Marko Marin,2748,[2012],Chelsea FC,4,1,3,71,1,0,2,1,1,72,0,0,6,2,4,143,1,0,0.0,0.0,0.0,0,0,0,0,0,0,0,0,0,2020-12-27 19:15:00
3341,22212,Markus Babbel,2688,"[2000, 2001, 2002]",Liverpool FC,21,21,0,1788,2,0,19,19,0,1612,1,0,40,40,0,3400,3,0,3.0,0.0,3.0,1,1,2,0,0,0,0,0,0,2020-12-27 19:15:002020-12-27 19:15:002020-12-27 19:15:00
3342,7406,Markus Babbel,2688,[2003],Blackburn Rovers,12,11,1,933,3,0,12,11,1,1012,0,0,24,22,2,1945,3,0,1.0,0.0,1.0,3,0,3,0,0,0,0,0,0,2020-12-27 19:15:00
3343,7407,Markus Henriksen,2784,[2016],Hull City,7,3,4,279,0,0,8,3,5,355,0,0,15,6,9,634,0,0,0.0,0.0,0.0,0,0,0,0,0,0,0,0,0,2020-12-27 19:15:00
3344,14817,Markus Rosenberg,2562,"[2012, 2013]",West Bromwich Albion,13,2,11,263,0,0,15,4,11,372,0,0,28,6,22,635,0,0,0.0,0.0,0.0,0,0,0,0,0,0,0,0,0,2020-12-27 19:15:002020-12-27 19:15:00
3345,14821,Markus Suttner,2661,"[2017, 2018]",Brighton & Hove Albion,8,8,0,720,0,0,6,5,1,458,0,0,14,13,1,1178,0,0,0.0,0.0,0.0,0,0,0,0,0,0,0,0,0,2020-12-27 19:15:002020-12-27 19:15:00
3346,14825,Marlon Beresford,4574,"[2000, 2001]",Middlesbrough FC,1,0,1,66,0,0,1,0,1,72,0,0,2,0,2,138,0,0,0.0,0.0,0.0,0,0,0,0,0,0,0,0,0,2020-12-27 19:15:002020-12-27 19:15:00
3347,14829,Marlon Harewood,1942,"[2005, 2006]",West Ham United,34,23,11,2189,10,0,33,26,7,2304,7,0,67,49,18,4493,17,0,3.0,6.0,9.0,6,5,11,1,1,2,0,0,0,2020-12-27 19:15:002020-12-27 19:15:00
3348,14833,Marlon Harewood,1942,"[2007, 2008]",Aston Villa,14,0,14,265,1,0,15,1,14,298,4,0,29,1,28,563,5,0,0.0,0.0,0.0,0,1,1,0,0,0,0,0,0,2020-12-27 19:15:002020-12-27 19:15:00
3349,7418,Marlon Harewood,1942,[2010],Blackpool FC,8,3,5,311,2,0,8,4,4,350,3,0,16,7,9,661,5,0,0.0,0.0,0.0,1,1,2,0,0,0,0,0,0,2020-12-27 19:15:00
3350,7419,Marlon King,2119,[2006],Watford FC,6,6,0,540,3,0,7,6,1,581,1,0,13,12,1,1121,4,0,1.0,0.0,1.0,3,0,3,1,0,1,0,0,0,2020-12-27 19:15:00
3351,14842,Marlon King,2119,"[2007, 2009]",Wigan Athletic,9,4,5,354,0,0,9,4,5,326,1,0,18,8,10,680,1,0,0.0,0.0,0.0,0,1,1,0,1,1,0,0,0,2020-12-27 19:15:002020-12-27 19:15:00
3352,7421,Marlon King,2119,[2008],Hull City,9,8,1,706,1,0,11,11,0,929,4,0,20,19,1,1635,5,0,3.0,0.0,3.0,1,2,3,1,1,2,0,0,0,2020-12-27 19:15:00
3353,7423,Marnick Vermijl,4078,[2014],Manchester United,0,0,0,0,0,0,0,0,0,0,0,0,0,0,0,0,0,0,0.0,0.0,0.0,0,0,0,0,0,0,0,0,0,2020-12-27 19:15:00
3354,22275,Marouane Chamakh,1031,"[2010, 2011, 2012]",Arsenal FC,21,9,12,902,4,0,18,10,8,1107,4,0,39,19,20,2009,8,0,3.0,0.0,3.0,2,1,3,0,0,0,0,0,0,2020-12-27 19:15:002020-12-27 19:15:002020-12-27 19:15:00
3355,22284,Marouane Chamakh,1031,"[2013, 2014, 2015]",Crystal Palace,32,23,9,1988,5,0,28,20,8,1728,2,0,60,43,17,3716,7,0,6.0,0.0,6.0,2,2,4,1,0,1,0,0,0,2020-12-27 19:15:002020-12-27 19:15:002020-12-27 19:15:00
3356,37160,Marouane Fellaini,2189,"[2008, 2009, 2010, 2011, 2012]",Everton FC,70,66,4,5775,13,0,65,60,5,5412,12,0,135,126,9,11187,25,0,7.0,4.0,11.0,8,8,16,0,0,0,0,0,0,2020-12-27 19:15:002020-12-27 19:15:002020-12-27 19:15:002020-12-27 19:15:002020-12-27 19:15:00
3357,44625,Marouane Fellaini,2189,"[2013, 2014, 2015, 2016, 2017, 2018]",Manchester United,60,32,28,3157,7,0,59,40,19,3841,5,0,119,72,47,6998,12,0,3.0,3.0,6.0,4,5,9,0,0,0,0,0,0,2020-12-27 19:15:002020-12-27 19:15:002020-12-27 19:15:002020-12-27 19:15:002020-12-27 19:15:002020-12-27 19:15:00
3358,14883,Mart Poom,3370,"[2000, 2001]",Derby County,22,22,0,1980,0,0,21,20,1,1880,0,0,43,42,1,3860,0,0,0.0,0.0,0.0,0,0,0,0,0,0,0,0,0,2020-12-27 19:15:002020-12-27 19:15:00
3359,7443,Mart Poom,3370,[2002],Sunderland AFC,1,1,0,90,0,0,3,3,0,270,0,0,4,4,0,360,0,0,0.0,0.0,0.0,0,0,0,0,0,0,0,0,0,2020-12-27 19:15:00
3360,7444,Marten de Roon,3010,[2016],Middlesbrough FC,17,16,1,1392,2,0,16,16,0,1385,2,0,33,32,1,2777,4,0,3.0,1.0,4.0,1,1,2,0,0,0,0,0,0,2020-12-27 19:15:00
3361,14891,Martijn Reuser,2721,"[2000, 2001]",Ipswich Town,28,18,10,1617,4,0,21,13,8,1262,3,0,49,31,18,2879,7,0,3.0,3.0,6.0,4,2,6,0,0,0,0,0,0,2020-12-27 19:15:002020-12-27 19:15:00
3362,14895,Martin Albrechtsen,1599,"[2004, 2005]",West Bromwich Albion,26,22,4,2089,0,0,28,23,5,2141,1,0,54,45,9,4230,1,0,0.0,3.0,3.0,0,1,1,0,0,0,0,0,0,2020-12-27 19:15:002020-12-27 19:15:00
3363,7449,Martin Andresen,1137,[2003],Blackburn Rovers,6,6,0,454,0,0,5,5,0,407,0,0,11,11,0,861,0,0,0.0,0.0,0.0,0,0,0,0,0,0,0,0,0,2020-12-27 19:15:00
3364,7450,Martin Brittain,4431,[2003],Newcastle United,0,0,0,0,0,0,1,0,1,16,0,0,1,0,1,16,0,0,0.0,0.0,0.0,0,0,0,0,0,0,0,0,0,2020-12-27 19:15:00
3365,14903,Martin Cranie,3103,"[2003, 2004]",Southampton FC,1,1,0,90,0,0,3,3,0,270,0,0,4,4,0,360,0,0,0.0,0.0,0.0,0,0,0,0,0,0,0,0,0,2020-12-27 19:15:002020-12-27 19:15:00
3366,7453,Martin Cranie,3103,[2007],Portsmouth FC,2,1,1,54,0,0,0,0,0,0,0,0,2,1,1,54,0,0,0.0,0.0,0.0,0,0,0,0,0,0,0,0,0,2020-12-27 19:15:00
3367,7454,Martin Cranie,3103,[2017],Huddersfield Town,1,0,1,29,0,0,2,2,0,151,0,0,3,2,1,180,0,0,0.0,0.0,0.0,0,0,0,0,0,0,0,0,0,2020-12-27 19:15:00
3368,14911,Martin Djetou,1079,"[2002, 2003]",Fulham FC,25,20,5,1849,1,0,21,16,5,1332,0,0,46,36,10,3181,1,0,3.0,0.0,3.0,1,0,1,0,0,0,0,0,0,2020-12-27 19:15:002020-12-27 19:15:00
3369,7457,Martin Djetou,1079,[2005],Bolton Wanderers,0,0,0,0,0,0,3,1,2,94,0,0,3,1,2,94,0,0,0.0,0.0,0.0,0,0,0,0,0,0,0,0,0,2020-12-27 19:15:00
3370,22377,Martin Dúbravka,2466,"[2017, 2018, 2019]",Newcastle United,44,44,0,3960,0,0,44,44,0,3960,0,0,88,88,0,7920,0,0,0.0,0.0,0.0,0,0,0,0,0,0,0,0,0,2020-12-27 19:15:002020-12-27 19:15:002020-12-27 19:15:00
3371,14923,Martin Grainger,4088,"[2002, 2003]",Birmingham City,6,4,2,450,1,0,7,7,0,514,0,0,13,11,2,964,1,0,0.0,0.0,0.0,1,0,1,0,0,0,0,0,0,2020-12-27 19:15:002020-12-27 19:15:00
3372,7463,Martin Hansen,4260,[2010],Liverpool FC,0,0,0,0,0,0,0,0,0,0,0,0,0,0,0,0,0,0,0.0,0.0,0.0,0,0,0,0,0,0,0,0,0,2020-12-27 19:15:00
3373,7464,Martin Jiránek,2543,[2010],Birmingham City,5,5,0,410,0,0,5,5,0,374,0,0,10,10,0,784,0,0,0.0,0.0,0.0,0,0,0,0,0,0,0,0,0,2020-12-27 19:15:00
3374,37335,Martin Kelly,1034,"[2009, 2010, 2011, 2012, 2013]",Liverpool FC,20,14,6,1295,0,0,13,12,1,993,0,0,33,26,7,2288,0,0,0.0,0.0,0.0,0,0,0,0,0,0,0,0,0,2020-12-27 19:15:002020-12-27 19:15:002020-12-27 19:15:002020-12-27 19:15:002020-12-27 19:15:00
3375,52311,Martin Kelly,1034,"[2014, 2015, 2016, 2017, 2018, 2019, 2020]",Crystal Palace,58,49,9,4450,0,0,62,55,7,5075,0,0,120,104,16,9525,0,0,0.0,0.0,0.0,0,0,0,0,0,0,0,0,0,2020-12-27 19:15:002020-12-27 19:15:002020-12-27 19:15:002020-12-27 19:15:002020-12-27 19:15:002020-12-27 19:15:002020-12-27 19:15:00
3376,29914,Martin Keown,2355,"[2000, 2001, 2002, 2003]",Arsenal FC,39,33,6,3104,0,0,41,37,4,3264,0,0,80,70,10,6368,0,0,0.0,0.0,0.0,0,0,0,0,0,0,0,0,0,2020-12-27 19:15:002020-12-27 19:15:002020-12-27 19:15:002020-12-27 19:15:00
3377,7481,Martin Latka,3571,[2005],Birmingham City,3,3,0,270,0,0,3,3,0,251,0,0,6,6,0,521,0,0,0.0,0.0,0.0,0,0,0,0,0,0,0,0,0,2020-12-27 19:15:00
3378,29934,Martin Laursen,2124,"[2004, 2006, 2007, 2008]",Aston Villa,37,37,0,3284,4,0,42,40,2,3522,4,0,79,77,2,6806,8,0,3.0,0.0,3.0,3,4,7,0,0,0,0,0,0,2020-12-27 19:15:002020-12-27 19:15:002020-12-27 19:15:002020-12-27 19:15:00
3379,37440,Martin Olsson,1372,"[2007, 2008, 2009, 2010, 2011]",Blackburn Rovers,42,36,6,3352,2,0,46,37,9,3553,0,0,88,73,15,6905,2,0,3.0,0.0,3.0,2,0,2,0,0,0,0,0,0,2020-12-27 19:15:002020-12-27 19:15:002020-12-27 19:15:002020-12-27 19:15:002020-12-27 19:15:00
3380,14983,Martin Olsson,1372,"[2013, 2015]",Norwich City,29,25,4,2299,1,0,28,28,0,2434,0,0,57,53,4,4733,1,0,3.0,0.0,3.0,1,0,1,0,0,0,0,0,0,2020-12-27 19:15:002020-12-27 19:15:00
3381,14987,Martin Olsson,1372,"[2016, 2017]",Swansea City,25,25,0,2168,2,0,26,25,1,2239,0,0,51,50,1,4407,2,0,0.0,0.0,0.0,1,0,1,0,0,0,0,0,0,2020-12-27 19:15:002020-12-27 19:15:00
3382,7495,Martin Paterson,3331,[2009],Burnley FC,12,9,3,756,2,0,11,8,3,679,2,0,23,17,6,1435,4,0,0.0,0.0,0.0,2,1,3,0,0,0,0,0,0,2020-12-27 19:15:00
3383,22491,Martin Petrov,2492,"[2007, 2008, 2009]",Manchester City,30,24,6,2115,6,0,28,22,6,1918,3,0,58,46,12,4033,9,0,0.0,1.0,1.0,4,3,7,0,0,0,0,0,0,2020-12-27 19:15:002020-12-27 19:15:002020-12-27 19:15:00
3384,14999,Martin Petrov,2492,"[2010, 2011]",Bolton Wanderers,28,24,4,1950,5,0,31,24,7,2092,2,0,59,48,11,4042,7,0,0.0,0.0,0.0,2,2,4,2,2,4,0,0,0,2020-12-27 19:15:002020-12-27 19:15:00
3385,7501,Martin Pringle,3863,[2000],Charlton Athletic,3,0,3,54,1,0,4,1,3,156,0,0,7,1,6,210,1,0,0.0,0.0,0.0,0,0,0,0,0,0,0,0,0,2020-12-27 19:15:00
3386,7502,Martin Reeves,3831,[2001],Leicester City,2,0,2,22,0,0,3,1,2,100,0,0,5,1,4,122,0,0,0.0,0.0,0.0,0,0,0,0,0,0,0,0,0,2020-12-27 19:15:00
3387,7503,Martin Samuelsen,3523,[2015],West Ham United,0,0,0,0,0,0,0,0,0,0,0,0,0,0,0,0,0,0,0.0,0.0,0.0,0,0,0,0,0,0,0,0,0,2020-12-27 19:15:00
3388,22515,Martin Taylor,1345,"[2001, 2002, 2003]",Blackburn Rovers,31,24,7,2316,2,0,29,24,5,2235,0,0,60,48,12,4551,2,0,0.0,0.0,0.0,1,0,1,0,0,0,0,0,0,2020-12-27 19:15:002020-12-27 19:15:002020-12-27 19:15:00
3389,22524,Martin Taylor,1345,"[2004, 2005, 2007]",Birmingham City,19,18,1,1616,0,0,14,13,1,1152,0,0,33,31,2,2768,0,0,0.0,0.0,0.0,0,0,0,0,0,0,0,0,0,2020-12-27 19:15:002020-12-27 19:15:002020-12-27 19:15:00
3390,7510,Martin Woods,4121,[2005],Sunderland AFC,1,0,1,30,0,0,6,1,5,139,0,0,7,1,6,169,0,0,0.0,0.0,0.0,0,0,0,0,0,0,0,0,0,2020-12-27 19:15:00
3391,67635,Martin Škrtel,1423,"[2007, 2008, 2009, 2010, 2011, 2012, 2013, 2014, 2015]",Liverpool FC,120,115,5,10410,9,0,122,118,4,10600,7,0,242,233,9,21010,16,0,1.0,0.0,1.0,5,5,10,0,0,0,0,0,0,2020-12-27 19:15:002020-12-27 19:15:002020-12-27 19:15:002020-12-27 19:15:002020-12-27 19:15:002020-12-27 19:15:002020-12-27 19:15:002020-12-27 19:15:002020-12-27 19:15:00
3392,22563,Martyn Waghorn,4094,"[2007, 2008, 2010]",Sunderland AFC,2,1,1,91,0,0,4,1,3,67,0,0,6,2,4,158,0,0,0.0,0.0,0.0,0,0,0,0,0,0,0,0,0,2020-12-27 19:15:002020-12-27 19:15:002020-12-27 19:15:00
3393,7523,Martín Cáceres,3251,[2016],Southampton FC,0,0,0,0,0,0,1,1,0,90,0,0,1,1,0,90,0,0,0.0,0.0,0.0,0,0,0,0,0,0,0,0,0,2020-12-27 19:15:00
3394,22575,Martín Demichelis,1356,"[2013, 2014, 2015]",Manchester City,40,35,5,3206,2,0,38,30,8,2796,1,0,78,65,13,6002,3,0,0.0,1.0,1.0,0,1,1,0,0,0,0,0,0,2020-12-27 19:15:002020-12-27 19:15:002020-12-27 19:15:00
3395,7527,Martín Herrera,4404,[2002],Fulham FC,1,1,0,90,0,0,1,0,1,51,0,0,2,1,1,141,0,0,0.0,0.0,0.0,0,0,0,0,0,0,0,0,0,2020-12-27 19:15:00
3396,15057,Martín Montoya,2418,"[2018, 2019]",Brighton & Hove Albion,28,25,3,2183,0,0,24,22,2,1885,0,0,52,47,5,4068,0,0,0.0,0.0,0.0,0,0,0,0,0,0,0,0,0,2020-12-27 19:15:002020-12-27 19:15:00
3397,15061,Marvelous Nakamba,2852,"[2019, 2020]",Aston Villa,18,9,9,967,0,0,15,11,4,972,0,0,33,20,13,1939,0,0,0.0,0.0,0.0,0,0,0,0,0,0,0,0,0,2020-12-27 19:15:002020-12-27 19:15:00
3398,7532,Marvin Emnes,1709,[2008],Middlesbrough FC,7,1,6,157,0,0,8,2,6,224,0,0,15,3,12,381,0,0,0.0,0.0,0.0,0,0,0,0,0,0,0,0,0,2020-12-27 19:15:00
3399,22602,Marvin Emnes,1709,"[2013, 2014, 2015]",Swansea City,14,2,12,369,0,0,12,4,8,338,1,0,26,6,20,707,1,0,0.0,0.0,0.0,0,0,0,0,0,0,0,0,0,2020-12-27 19:15:002020-12-27 19:15:002020-12-27 19:15:00
3400,7536,Marvin Robinson,4382,[2001],Derby County,1,0,1,14,0,0,1,0,1,32,1,0,2,0,2,46,1,0,0.0,1.0,1.0,0,1,1,0,0,0,0,0,0,2020-12-27 19:15:00
3401,7537,Marvin Sordell,2498,[2011],Bolton Wanderers,0,0,0,0,0,0,3,0,3,40,0,0,3,0,3,40,0,0,0.0,0.0,0.0,0,0,0,0,0,0,0,0,0,2020-12-27 19:15:00
3402,7538,Marvin Sordell,2498,[2014],Burnley FC,6,1,5,103,0,0,8,1,7,178,0,0,14,2,12,281,0,0,0.0,0.0,0.0,0,0,0,0,0,0,0,0,0,2020-12-27 19:15:00
3403,7539,Marvin Zeegelaar,3227,[2017],Watford FC,7,7,0,630,0,0,5,5,0,416,0,0,12,12,0,1046,0,0,0.0,0.0,0.0,0,0,0,0,0,0,0,0,0,2020-12-27 19:15:00
3404,7540,Marçal,1041,[2020],Wolverhampton Wanderers,5,4,1,285,0,0,5,3,2,285,0,0,10,7,3,570,0,0,0.0,0.0,0.0,0,0,0,0,0,0,0,0,0,2020-12-27 19:15:00
3405,22626,Mason Greenwood,2912,"[2018, 2019, 2020]",Manchester United,23,11,12,1121,7,0,20,9,11,866,4,0,43,20,23,1987,11,0,2.0,0.0,2.0,4,3,7,0,0,0,0,0,0,2020-12-27 19:15:002020-12-27 19:15:002020-12-27 19:15:00
3406,45279,Mason Holgate,1062,"[2015, 2016, 2017, 2018, 2019, 2020]",Everton FC,37,31,6,2731,0,0,34,32,2,2818,1,0,71,63,8,5549,1,0,0.0,0.0,0.0,0,0,0,0,0,0,0,0,0,2020-12-27 19:15:002020-12-27 19:15:002020-12-27 19:15:002020-12-27 19:15:002020-12-27 19:15:002020-12-27 19:15:00
3407,15101,Mason Mount,2956,"[2019, 2020]",Chelsea FC,24,21,3,1937,4,0,27,24,3,2107,4,0,51,45,6,4044,8,0,3.0,0.0,3.0,4,1,5,0,0,0,0,0,0,2020-12-27 19:15:002020-12-27 19:15:00
3408,15105,Mason Springthorpe,3998,"[2012, 2013]",Everton FC,0,0,0,0,0,0,0,0,0,0,0,0,0,0,0,0,0,0,0.0,0.0,0.0,0,0,0,0,0,0,0,0,0,2020-12-27 19:15:002020-12-27 19:15:00
3409,37780,Massadio Haïdara,2280,"[2012, 2013, 2014, 2015, 2017]",Newcastle United,20,10,10,1046,0,0,19,14,5,1388,0,0,39,24,15,2434,0,0,0.0,0.0,0.0,0,0,0,0,0,0,0,0,0,2020-12-27 19:15:002020-12-27 19:15:002020-12-27 19:15:002020-12-27 19:15:002020-12-27 19:15:00
3410,7559,Massimo Luongo,4299,[2011],Tottenham Hotspur,0,0,0,0,0,0,0,0,0,0,0,0,0,0,0,0,0,0,0.0,0.0,0.0,0,0,0,0,0,0,0,0,0,2020-12-27 19:15:00
3411,30246,Massimo Maccarone,1888,"[2002, 2003, 2005, 2006]",Middlesbrough FC,46,24,22,2366,15,0,33,20,13,1767,3,0,79,44,35,4133,18,0,4.0,0.0,4.0,4,2,6,2,2,4,0,0,0,2020-12-27 19:15:002020-12-27 19:15:002020-12-27 19:15:002020-12-27 19:15:00
3412,22695,Mat Sadler,3634,"[2002, 2005, 2007]",Birmingham City,7,6,1,551,0,0,8,7,1,570,0,0,15,13,2,1121,0,0,0.0,0.0,0.0,0,0,0,0,0,0,0,0,0,2020-12-27 19:15:002020-12-27 19:15:002020-12-27 19:15:00
3413,15135,Mata,1643,"[2011, 2012]",Chelsea FC,35,29,6,2644,9,0,33,30,3,2552,8,0,68,59,9,5196,17,0,3.0,6.0,9.0,5,7,12,0,0,0,0,0,0,2020-12-27 19:15:002020-12-27 19:15:00
3414,60580,Mata,1643,"[2013, 2014, 2015, 2016, 2017, 2018, 2019, 2020]",Manchester United,97,78,19,6720,18,0,89,67,22,5725,15,0,186,145,41,12445,33,0,9.0,4.0,13.0,7,11,18,1,1,2,0,0,0,2020-12-27 19:15:002020-12-27 19:15:002020-12-27 19:15:002020-12-27 19:15:002020-12-27 19:15:002020-12-27 19:15:002020-12-27 19:15:002020-12-27 19:15:00
3415,7577,Mateja Kežman,3580,[2004],Chelsea FC,15,2,13,330,3,0,10,4,6,408,1,0,25,6,19,738,4,0,0.0,0.0,0.0,0,1,1,1,0,1,0,0,0,2020-12-27 19:15:00
3416,22737,Mateo Kovačić,1849,"[2018, 2019, 2020]",Chelsea FC,38,25,13,2256,0,0,36,26,10,2137,1,0,74,51,23,4393,1,0,0.0,0.0,0.0,0,0,0,0,0,0,0,0,0,2020-12-27 19:15:002020-12-27 19:15:002020-12-27 19:15:00
3417,7581,Mateusz Bogusz,1077,[2020],Leeds United,0,0,0,0,0,0,0,0,0,0,0,0,0,0,0,0,0,0,0.0,0.0,0.0,0,0,0,0,0,0,0,0,0,2020-12-27 19:15:00
3418,7582,Mateusz Hewelt,3110,[2016],Everton FC,0,0,0,0,0,0,0,0,0,0,0,0,0,0,0,0,0,0,0.0,0.0,0.0,0,0,0,0,0,0,0,0,0,2020-12-27 19:15:00
3419,7583,Mateusz Klich,1067,[2020],Leeds United,8,8,0,682,2,0,7,7,0,577,1,0,15,15,0,1259,3,0,0.0,0.0,0.0,2,1,3,2,0,2,0,0,0,2020-12-27 19:15:00
3420,7584,Matheus Pereira,1030,[2020],West Bromwich Albion,5,5,0,448,0,0,6,5,1,414,1,0,11,10,1,862,1,0,0.0,0.0,0.0,0,1,1,0,0,0,0,0,0,2020-12-27 19:15:00
3421,7585,Mathew Birley,4577,[2005],Birmingham City,0,0,0,0,0,0,1,0,1,25,0,0,1,0,1,25,0,0,0.0,0.0,0.0,0,0,0,0,0,0,0,0,0,2020-12-27 19:15:00
3422,30350,Mathew Ryan,2415,"[2017, 2018, 2019, 2020]",Brighton & Hove Albion,61,61,0,5490,0,0,60,60,0,5400,0,0,121,121,0,10890,0,0,0.0,0.0,0.0,0,0,0,0,0,0,0,0,0,2020-12-27 19:15:002020-12-27 19:15:002020-12-27 19:15:002020-12-27 19:15:00
3423,30366,Mathias Svensson,2335,"[2000, 2001, 2002, 2003]",Charlton Athletic,27,12,15,1067,5,0,23,16,7,1405,1,0,50,28,22,2472,6,0,6.0,0.0,6.0,5,1,6,0,0,0,0,0,0,2020-12-27 19:15:002020-12-27 19:15:002020-12-27 19:15:002020-12-27 19:15:00
3424,7594,Mathias Svensson,2335,[2004],Norwich City,11,4,7,422,4,0,10,5,5,417,0,0,21,9,12,839,4,0,6.0,0.0,6.0,4,0,4,0,0,0,0,0,0,2020-12-27 19:15:00
3425,7595,Mathieu Berson,3622,[2004],Aston Villa,5,3,2,299,0,0,6,4,2,331,0,0,11,7,4,630,0,0,0.0,0.0,0.0,0,0,0,0,0,0,0,0,0,2020-12-27 19:15:00
3426,15193,Mathieu Debuchy,2453,"[2012, 2013]",Newcastle United,21,20,1,1865,0,0,22,22,0,1840,1,0,43,42,1,3705,1,0,0.0,0.0,0.0,0,1,1,0,0,0,0,0,0,2020-12-27 19:15:002020-12-27 19:15:00
3427,30398,Mathieu Debuchy,2453,"[2014, 2015, 2016, 2017]",Arsenal FC,8,8,0,524,0,0,5,5,0,444,1,0,13,13,0,968,1,0,0.0,0.0,0.0,0,1,1,0,0,0,0,0,0,2020-12-27 19:15:002020-12-27 19:15:002020-12-27 19:15:002020-12-27 19:15:00
3428,53235,Mathieu Flamini,1510,"[2004, 2005, 2006, 2007, 2013, 2014, 2015]",Arsenal FC,82,50,32,4977,6,0,82,58,24,5231,4,0,164,108,56,10208,10,0,1.0,0.0,1.0,2,3,5,0,0,0,0,0,0,2020-12-27 19:15:002020-12-27 19:15:002020-12-27 19:15:002020-12-27 19:15:002020-12-27 19:15:002020-12-27 19:15:002020-12-27 19:15:00
3429,7609,Mathieu Flamini,1510,[2016],Crystal Palace,4,1,3,67,0,0,6,2,4,203,0,0,10,3,7,270,0,0,0.0,0.0,0.0,0,0,0,0,0,0,0,0,0,2020-12-27 19:15:00
3430,15221,Matija Nastasić,1357,"[2012, 2013]",Manchester City,15,14,1,1204,1,0,19,18,1,1646,0,0,34,32,2,2850,1,0,0.0,0.0,0.0,0,0,0,0,0,0,0,0,0,2020-12-27 19:15:002020-12-27 19:15:00
3431,7612,Mats Møller Dæhli,3660,[2013],Cardiff City,7,3,4,337,0,0,6,2,4,287,1,0,13,5,8,624,1,0,0.0,1.0,1.0,0,1,1,0,0,0,0,0,0,2020-12-27 19:15:00
3432,22842,Matt Butcher,2828,"[2015, 2017, 2018]",AFC Bournemouth,0,0,0,0,0,0,0,0,0,0,0,0,0,0,0,0,0,0,0.0,0.0,0.0,0,0,0,0,0,0,0,0,0,2020-12-27 19:15:002020-12-27 19:15:002020-12-27 19:15:00
3433,7616,Matt Clarke,3254,[2000],Bradford City,9,9,0,810,0,0,6,6,0,540,0,0,15,15,0,1350,0,0,0.0,0.0,0.0,0,0,0,0,0,0,0,0,0,2020-12-27 19:15:00
3434,30474,Matt Derbyshire,2247,"[2004, 2006, 2007, 2008]",Blackburn Rovers,33,10,23,1124,4,0,29,7,22,965,6,0,62,17,45,2089,10,0,4.0,6.0,10.0,3,3,6,0,0,0,0,0,0,2020-12-27 19:15:002020-12-27 19:15:002020-12-27 19:15:002020-12-27 19:15:00
3435,7621,Matt Derbyshire,2247,[2010],Birmingham City,6,2,4,215,0,0,7,2,5,248,0,0,13,4,9,463,0,0,0.0,0.0,0.0,0,0,0,0,0,0,0,0,0,2020-12-27 19:15:00
3436,30494,Matt Doherty,2142,"[2010, 2011, 2018, 2019]",Wolverhampton Wanderers,38,34,4,3089,4,0,37,33,4,2943,4,0,75,67,8,6032,8,0,4.0,6.0,10.0,3,4,7,0,0,0,0,0,0,2020-12-27 19:15:002020-12-27 19:15:002020-12-27 19:15:002020-12-27 19:15:00
3437,7626,Matt Doherty,2142,[2020],Tottenham Hotspur,3,3,0,256,0,0,4,4,0,360,0,0,7,7,0,616,0,0,0.0,0.0,0.0,0,0,0,0,0,0,0,0,0,2020-12-27 19:15:00
3438,15255,Matt Duke,1605,"[2008, 2009]",Hull City,11,11,0,990,0,0,10,10,0,900,0,0,21,21,0,1890,0,0,0.0,0.0,0.0,0,0,0,0,0,0,0,0,0,2020-12-27 19:15:002020-12-27 19:15:00
3439,22890,Matt Elliott,2716,"[2000, 2001, 2003]",Leicester City,38,35,3,3180,2,0,33,32,1,2919,0,0,71,67,4,6099,2,0,0.0,0.0,0.0,1,0,1,0,0,0,0,0,0,2020-12-27 19:15:002020-12-27 19:15:002020-12-27 19:15:00
3440,7632,Matt Gilks,1492,[2010],Blackpool FC,9,9,0,810,0,0,9,9,0,766,0,0,18,18,0,1576,0,0,0.0,0.0,0.0,0,0,0,0,0,0,0,0,0,2020-12-27 19:15:00
3441,7633,Matt Gilks,1492,[2014],Burnley FC,0,0,0,0,0,0,0,0,0,0,0,0,0,0,0,0,0,0,0.0,0.0,0.0,0,0,0,0,0,0,0,0,0,2020-12-27 19:15:00
3442,15269,Matt Grimes,1708,"[2014, 2015]",Swansea City,1,0,1,1,0,0,3,1,2,131,0,0,4,1,3,132,0,0,0.0,0.0,0.0,0,0,0,0,0,0,0,0,0,2020-12-27 19:15:002020-12-27 19:15:00
3443,15273,Matt Heath,3809,"[2001, 2003]",Leicester City,8,7,1,631,0,0,10,9,1,812,0,0,18,16,2,1443,0,0,0.0,0.0,0.0,0,0,0,0,0,0,0,0,0,2020-12-27 19:15:002020-12-27 19:15:00
3444,7638,Matt Hill,4214,[2009],Wolverhampton Wanderers,0,0,0,0,0,0,2,2,0,180,0,0,2,2,0,180,0,0,0.0,0.0,0.0,0,0,0,0,0,0,0,0,0,2020-12-27 19:15:00
3445,15279,Matt Holland,1955,"[2000, 2001]",Ipswich Town,38,38,0,3379,5,0,36,36,0,3240,1,0,74,74,0,6619,6,0,0.0,3.0,3.0,4,1,5,0,0,0,0,0,0,2020-12-27 19:15:002020-12-27 19:15:00
3446,30570,Matt Holland,1955,"[2003, 2004, 2005, 2006]",Charlton Athletic,64,58,6,5163,3,0,59,55,4,4852,8,0,123,113,10,10015,11,0,4.0,6.0,10.0,3,7,10,0,0,0,0,0,0,2020-12-27 19:15:002020-12-27 19:15:002020-12-27 19:15:002020-12-27 19:15:00
3447,15291,Matt Jackson,3444,"[2005, 2006]",Wigan Athletic,15,13,2,1128,1,0,21,15,6,1473,0,0,36,28,8,2601,1,0,0.0,0.0,0.0,0,0,0,0,0,0,0,0,0,2020-12-27 19:15:002020-12-27 19:15:00
3448,38245,Matt Jansen,1350,"[2001, 2002, 2003, 2004, 2005]",Blackburn Rovers,36,22,14,2100,8,0,32,21,11,1822,6,0,68,43,25,3922,14,0,4.0,2.0,6.0,5,5,10,0,0,0,0,0,0,2020-12-27 19:15:002020-12-27 19:15:002020-12-27 19:15:002020-12-27 19:15:002020-12-27 19:15:00
3449,15305,Matt Kilgallon,1400,"[2002, 2003]",Leeds United,6,4,2,366,1,0,4,3,1,271,1,0,10,7,3,637,2,0,0.0,0.0,0.0,1,0,1,0,0,0,0,0,0,2020-12-27 19:15:002020-12-27 19:15:00
3450,7654,Matt Kilgallon,1400,[2006],Sheffield United,2,2,0,180,0,0,4,4,0,360,0,0,6,6,0,540,0,0,0.0,0.0,0.0,0,0,0,0,0,0,0,0,0,2020-12-27 19:15:00
3451,22968,Matt Kilgallon,1400,"[2009, 2011, 2012]",Sunderland AFC,10,8,2,820,0,0,13,13,0,1097,0,0,23,21,2,1917,0,0,0.0,0.0,0.0,0,0,0,0,0,0,0,0,0,2020-12-27 19:15:002020-12-27 19:15:002020-12-27 19:15:00
3452,15317,Matt Le Tissier,4034,"[2000, 2001]",Southampton FC,9,2,7,241,1,0,3,0,3,37,0,0,12,2,10,278,1,0,3.0,0.0,3.0,1,0,1,0,0,0,0,0,0,2020-12-27 19:15:002020-12-27 19:15:00
3453,45975,Matt Macey,2858,"[2014, 2015, 2016, 2017, 2019, 2020]",Arsenal FC,0,0,0,0,0,0,0,0,0,0,0,0,0,0,0,0,0,0,0.0,0.0,0.0,0,0,0,0,0,0,0,0,0,2020-12-27 19:15:002020-12-27 19:15:002020-12-27 19:15:002020-12-27 19:15:002020-12-27 19:15:002020-12-27 19:15:00
3454,7666,Matt Miazga,4249,[2015],Chelsea FC,0,0,0,0,0,0,2,2,0,136,0,0,2,2,0,136,0,0,0.0,0.0,0.0,0,0,0,0,0,0,0,0,0,2020-12-27 19:15:00
3455,15335,Matt Mills,4246,"[2005, 2006]",Manchester City,0,0,0,0,0,0,2,1,1,66,0,0,2,1,1,66,0,0,0.0,0.0,0.0,0,0,0,0,0,0,0,0,0,2020-12-27 19:15:002020-12-27 19:15:00
3456,7669,Matt Murray,4150,[2003],Wolverhampton Wanderers,0,0,0,0,0,0,1,1,0,90,0,0,1,1,0,90,0,0,0.0,0.0,0.0,0,0,0,0,0,0,0,0,0,2020-12-27 19:15:00
3457,38360,Matt Oakley,1573,"[2000, 2001, 2002, 2003, 2004]",Southampton FC,49,46,3,4053,3,0,53,51,2,4253,0,0,102,97,5,8306,3,0,0.0,0.0,0.0,3,0,3,0,0,0,0,0,0,2020-12-27 19:15:002020-12-27 19:15:002020-12-27 19:15:002020-12-27 19:15:002020-12-27 19:15:00
3458,7675,Matt Oakley,1573,[2007],Derby County,9,9,0,802,3,0,10,10,0,866,0,0,19,19,0,1668,3,0,0.0,0.0,0.0,3,0,3,0,0,0,0,0,0,2020-12-27 19:15:00
3459,7676,Matt Phillips,1660,[2010],Blackpool FC,16,5,11,615,1,0,11,1,10,414,0,0,27,6,21,1029,1,0,0.0,0.0,0.0,1,0,1,0,0,0,0,0,0,2020-12-27 19:15:00
3460,7677,Matt Phillips,1660,[2014],Queens Park Rangers,13,8,5,858,1,0,12,12,0,962,2,0,25,20,5,1820,3,0,0.0,0.0,0.0,1,1,2,0,0,0,0,0,0,2020-12-27 19:15:00
3461,23037,Matt Phillips,1660,"[2016, 2017, 2020]",West Bromwich Albion,36,30,6,2556,3,0,33,24,9,2251,3,0,69,54,15,4807,6,0,0.0,6.0,6.0,1,3,4,0,0,0,0,0,0,2020-12-27 19:15:002020-12-27 19:15:002020-12-27 19:15:00
3462,7681,Matt Ritchie,1008,[2009],Portsmouth FC,1,0,1,2,0,0,1,1,0,80,0,0,2,1,1,82,0,0,0.0,0.0,0.0,0,0,0,0,0,0,0,0,0,2020-12-27 19:15:00
3463,7682,Matt Ritchie,1008,[2015],AFC Bournemouth,18,15,3,1345,4,0,19,18,1,1633,0,0,37,33,4,2978,4,0,1.0,0.0,1.0,2,0,2,0,0,0,0,0,0,2020-12-27 19:15:00
3464,30738,Matt Ritchie,1008,"[2017, 2018, 2019, 2020]",Newcastle United,48,45,3,3883,6,0,46,40,6,3522,1,0,94,85,9,7405,7,0,9.0,1.0,10.0,4,1,5,1,0,1,0,1,1,2020-12-27 19:15:002020-12-27 19:15:002020-12-27 19:15:002020-12-27 19:15:00
3465,7687,Matt Smith,2859,[2019],Arsenal FC,0,0,0,0,0,0,0,0,0,0,0,0,0,0,0,0,0,0,0.0,0.0,0.0,0,0,0,0,0,0,0,0,0,2020-12-27 19:15:00
3466,46143,Matt Targett,1158,"[2013, 2014, 2015, 2016, 2017, 2018]",Southampton FC,22,18,4,1543,1,0,21,18,3,1479,0,0,43,36,7,3022,1,0,0.0,0.0,0.0,1,0,1,0,0,0,0,0,0,2020-12-27 19:15:002020-12-27 19:15:002020-12-27 19:15:002020-12-27 19:15:002020-12-27 19:15:002020-12-27 19:15:00
3467,15389,Matt Targett,1158,"[2019, 2020]",Aston Villa,21,20,1,1734,1,0,20,20,0,1731,0,0,41,40,1,3465,1,0,3.0,0.0,3.0,1,0,1,0,0,0,0,0,0,2020-12-27 19:15:002020-12-27 19:15:00
3468,7696,Matt Worthington,4248,[2016],AFC Bournemouth,0,0,0,0,0,0,1,0,1,16,0,0,1,0,1,16,0,0,0.0,0.0,0.0,0,0,0,0,0,0,0,0,0,2020-12-27 19:15:00
3469,30794,Matteo Darmian,2187,"[2015, 2016, 2017, 2018]",Manchester United,28,21,7,1876,1,0,32,28,4,2277,0,0,60,49,11,4153,1,0,0.0,0.0,0.0,0,0,0,0,0,0,0,0,0,2020-12-27 19:15:002020-12-27 19:15:002020-12-27 19:15:002020-12-27 19:15:00
3470,7701,Matteo Ferrari,3299,[2005],Everton FC,4,2,2,197,0,0,4,4,0,335,0,0,8,6,2,532,0,0,0.0,0.0,0.0,0,0,0,0,0,0,0,0,0,2020-12-27 19:15:00
3471,7702,Matteo Sereni,2717,[2001],Ipswich Town,12,12,0,1080,0,0,13,13,0,1170,0,0,25,25,0,2250,0,0,0.0,0.0,0.0,0,0,0,0,0,0,0,0,0,2020-12-27 19:15:00
3472,38525,Matthew Bates,1887,"[2003, 2004, 2005, 2006, 2008]",Middlesbrough FC,16,11,5,985,1,0,20,16,4,1528,0,0,36,27,9,2513,1,0,0.0,0.0,0.0,1,0,1,0,0,0,0,0,0,2020-12-27 19:15:002020-12-27 19:15:002020-12-27 19:15:002020-12-27 19:15:002020-12-27 19:15:00
3473,38550,Matthew Briggs,2559,"[2006, 2010, 2011, 2012, 2013]",Fulham FC,2,2,0,180,0,0,11,5,6,504,0,0,13,7,6,684,0,0,0.0,0.0,0.0,0,0,0,0,0,0,0,0,0,2020-12-27 19:15:002020-12-27 19:15:002020-12-27 19:15:002020-12-27 19:15:002020-12-27 19:15:00
3474,7713,Matthew Connolly,2170,[2011],Queens Park Rangers,3,2,1,219,0,0,3,3,0,270,0,0,6,5,1,489,0,0,0.0,0.0,0.0,0,0,0,0,0,0,0,0,0,2020-12-27 19:15:00
3475,15429,Matthew Connolly,2170,"[2013, 2018]",Cardiff City,2,2,0,180,0,0,1,1,0,90,0,0,3,3,0,270,0,0,0.0,0.0,0.0,0,0,0,0,0,0,0,0,0,2020-12-27 19:15:002020-12-27 19:15:00
3476,23151,Matthew Etherington,1557,"[2000, 2001, 2002]",Tottenham Hotspur,21,11,10,1049,0,0,19,8,11,810,1,0,40,19,21,1859,1,0,0.0,0.0,0.0,0,1,1,0,0,0,0,0,0,2020-12-27 19:15:002020-12-27 19:15:002020-12-27 19:15:00
3477,30882,Matthew Etherington,1557,"[2005, 2006, 2007, 2008]",West Ham United,46,40,6,3492,2,0,43,38,5,3177,5,0,89,78,11,6669,7,0,0.0,0.0,0.0,0,0,0,0,0,0,0,0,0,2020-12-27 19:15:002020-12-27 19:15:002020-12-27 19:15:002020-12-27 19:15:00
3478,38625,Matthew Etherington,1557,"[2009, 2010, 2011, 2012, 2013]",Stoke City,72,64,8,5348,8,0,66,55,11,4605,5,0,138,119,19,9953,13,0,4.0,3.0,7.0,4,4,8,2,1,3,0,0,0,2020-12-27 19:15:002020-12-27 19:15:002020-12-27 19:15:002020-12-27 19:15:002020-12-27 19:15:00
3479,23187,Matthew Jarvis,2627,"[2009, 2010, 2011]",Wolverhampton Wanderers,53,46,7,4196,5,0,54,48,6,4253,10,0,107,94,13,8449,15,0,0.0,5.0,5.0,3,7,10,0,0,0,0,0,0,2020-12-27 19:15:002020-12-27 19:15:002020-12-27 19:15:00
3480,23196,Matthew Jarvis,2627,"[2012, 2013, 2014]",West Ham United,38,29,9,2424,2,0,37,27,10,2503,2,0,75,56,19,4927,4,0,0.0,0.0,0.0,2,2,4,0,0,0,0,0,0,2020-12-27 19:15:002020-12-27 19:15:002020-12-27 19:15:00
3481,7734,Matthew Jarvis,2627,[2015],Norwich City,9,7,2,546,1,0,10,6,4,475,0,0,19,13,6,1021,1,0,0.0,0.0,0.0,0,0,0,0,0,0,0,0,0,2020-12-27 19:15:00
3482,15471,Matthew Jones,1310,"[2000, 2001]",Leicester City,8,6,2,499,1,0,13,10,3,798,0,0,21,16,5,1297,1,0,0.0,0.0,0.0,1,0,1,0,0,0,0,0,0,2020-12-27 19:15:002020-12-27 19:15:00
3483,7737,Matthew Kennedy,4353,[2012],Everton FC,0,0,0,0,0,0,0,0,0,0,0,0,0,0,0,0,0,0,0.0,0.0,0.0,0,0,0,0,0,0,0,0,0,2020-12-27 19:15:00
3484,15477,Matthew Longstaff,3035,"[2019, 2020]",Newcastle United,4,2,2,189,1,0,7,5,2,503,1,0,11,7,4,692,2,0,3.0,0.0,3.0,1,1,2,0,0,0,0,0,0,2020-12-27 19:15:002020-12-27 19:15:00
3485,23223,Matthew Lowton,1250,"[2012, 2013, 2014]",Aston Villa,33,31,2,2737,1,0,38,31,7,2854,1,0,71,62,9,5591,2,0,0.0,0.0,0.0,1,1,2,0,0,0,0,0,0,2020-12-27 19:15:002020-12-27 19:15:002020-12-27 19:15:00
3486,38725,Matthew Lowton,1250,"[2016, 2017, 2018, 2019, 2020]",Burnley FC,53,52,1,4724,0,0,57,55,2,4988,0,0,110,107,3,9712,0,0,0.0,0.0,0.0,0,0,0,0,0,0,0,0,0,2020-12-27 19:15:002020-12-27 19:15:002020-12-27 19:15:002020-12-27 19:15:002020-12-27 19:15:00
3487,15497,Matthew Pennington,3647,"[2015, 2016]",Everton FC,3,3,0,209,0,0,4,3,1,270,1,0,7,6,1,479,1,0,0.0,0.0,0.0,0,1,1,0,0,0,0,0,0,2020-12-27 19:15:002020-12-27 19:15:00
3488,7750,Matthew Piper,2683,[2001],Leicester City,9,8,1,705,1,0,6,5,1,461,0,0,15,13,2,1166,1,0,3.0,0.0,3.0,1,0,1,0,0,0,0,0,0,2020-12-27 19:15:00
3489,7751,Matthew Piper,2683,[2002],Sunderland AFC,6,4,2,385,0,0,7,4,3,398,0,0,13,8,5,783,0,0,0.0,0.0,0.0,0,0,0,0,0,0,0,0,0,2020-12-27 19:15:00
3490,7752,Matthew Spring,3728,[2006],Watford FC,4,1,3,164,0,0,2,1,1,96,0,0,6,2,4,260,0,0,0.0,0.0,0.0,0,0,0,0,0,0,0,0,0,2020-12-27 19:15:00
3491,38775,Matthew Taylor,1069,"[2003, 2004, 2005, 2006, 2007]",Portsmouth FC,69,54,15,5065,9,0,74,50,24,4896,7,0,143,104,39,9961,16,0,3.0,3.0,6.0,6,5,11,3,1,4,0,0,0,2020-12-27 19:15:002020-12-27 19:15:002020-12-27 19:15:002020-12-27 19:15:002020-12-27 19:15:00
3492,23277,Matthew Taylor,1069,"[2008, 2009, 2010]",Bolton Wanderers,51,42,9,3664,6,0,55,41,14,3600,14,0,106,83,23,7264,20,0,1.0,6.0,7.0,4,9,13,1,2,3,0,0,0,2020-12-27 19:15:002020-12-27 19:15:002020-12-27 19:15:00
3493,15523,Matthew Taylor,1069,"[2012, 2013]",West Ham United,25,15,10,1468,1,0,23,15,8,1315,0,0,48,30,18,2783,1,0,0.0,0.0,0.0,0,0,0,0,0,0,0,0,0,2020-12-27 19:15:002020-12-27 19:15:00
3494,7763,Matthew Taylor,1069,[2014],Burnley FC,5,4,1,309,0,0,5,3,2,260,0,0,10,7,3,569,0,0,0.0,0.0,0.0,0,0,0,0,0,0,0,0,0,2020-12-27 19:15:00
3495,15529,Matthew Upson,1279,"[2000, 2001]",Arsenal FC,6,5,1,464,0,0,10,5,5,436,0,0,16,10,6,900,0,0,0.0,0.0,0.0,0,0,0,0,0,0,0,0,0,2020-12-27 19:15:002020-12-27 19:15:00
3496,31070,Matthew Upson,1279,"[2002, 2003, 2004, 2005]",Birmingham City,53,53,0,4768,3,0,50,50,0,4407,0,0,103,103,0,9175,3,0,0.0,0.0,0.0,2,0,2,0,0,0,0,0,0,2020-12-27 19:15:002020-12-27 19:15:002020-12-27 19:15:002020-12-27 19:15:00
3497,38860,Matthew Upson,1279,"[2006, 2007, 2008, 2009, 2010]",West Ham United,68,68,0,5726,1,0,61,61,0,5295,3,0,129,129,0,11021,4,0,3.0,0.0,3.0,1,2,3,0,0,0,0,0,0,2020-12-27 19:15:002020-12-27 19:15:002020-12-27 19:15:002020-12-27 19:15:002020-12-27 19:15:00
3498,15551,Matthew Upson,1279,"[2011, 2012]",Stoke City,8,6,2,619,2,0,7,5,2,490,0,0,15,11,4,1109,2,0,0.0,0.0,0.0,1,0,1,0,0,0,0,0,0,2020-12-27 19:15:002020-12-27 19:15:00
3499,7777,Matthew Upson,1279,[2014],Leicester City,1,1,0,90,0,0,4,4,0,285,0,0,5,5,0,375,0,0,0.0,0.0,0.0,0,0,0,0,0,0,0,0,0,2020-12-27 19:15:00
3500,7778,Matthias Fanimo,4512,[2012],West Ham United,0,0,0,0,0,0,0,0,0,0,0,0,0,0,0,0,0,0,0.0,0.0,0.0,0,0,0,0,0,0,0,0,0,2020-12-27 19:15:00
3501,7779,Mattias Jonson,2390,[2004],Norwich City,15,11,4,802,0,0,13,8,5,739,0,0,28,19,9,1541,0,0,0.0,0.0,0.0,0,0,0,0,0,0,0,0,0,2020-12-27 19:15:00
3502,7780,Matty Cash,1047,[2020],Aston Villa,6,6,0,507,0,0,6,6,0,538,0,0,12,12,0,1045,0,0,0.0,0.0,0.0,0,0,0,0,0,0,0,0,0,2020-12-27 19:15:00
3503,7781,Matty Daly,3219,[2018],Huddersfield Town,1,0,1,49,0,0,1,0,1,24,0,0,2,0,2,73,0,0,0.0,0.0,0.0,0,0,0,0,0,0,0,0,0,2020-12-27 19:15:00
3504,7782,Matty Fryatt,2318,[2013],Hull City,5,0,5,124,1,0,4,0,4,90,1,0,9,0,9,214,2,0,0.0,0.0,0.0,0,0,0,0,0,0,0,0,0,2020-12-27 19:15:00
3505,31138,Matty James,2516,"[2014, 2016, 2017, 2019]",Leicester City,22,15,7,1427,0,0,20,16,4,1464,0,0,42,31,11,2891,0,0,0.0,0.0,0.0,0,0,0,0,0,0,0,0,0,2020-12-27 19:15:002020-12-27 19:15:002020-12-27 19:15:002020-12-27 19:15:00
3506,15575,Matty Pattison,3510,"[2005, 2006]",Newcastle United,2,1,1,83,0,0,6,2,4,273,0,0,8,3,5,356,0,0,0.0,0.0,0.0,0,0,0,0,0,0,0,0,0,2020-12-27 19:15:002020-12-27 19:15:00
3507,7789,Matty Willock,3212,[2016],Manchester United,0,0,0,0,0,0,0,0,0,0,0,0,0,0,0,0,0,0,0.0,0.0,0.0,0,0,0,0,0,0,0,0,0,2020-12-27 19:15:00
3508,15581,Mattéo Guendouzi,1485,"[2018, 2019]",Arsenal FC,25,19,6,1797,0,0,32,23,9,2093,0,0,57,42,15,3890,0,0,0.0,0.0,0.0,0,0,0,0,0,0,0,0,0,2020-12-27 19:15:002020-12-27 19:15:00
3509,7792,Matěj Vydra,2302,[2013],West Bromwich Albion,13,4,9,367,3,0,10,3,7,301,0,0,23,7,16,668,3,0,2.0,0.0,2.0,3,0,3,0,0,0,0,0,0,2020-12-27 19:15:00
3510,15587,Matěj Vydra,2302,"[2015, 2016]",Watford FC,1,0,1,2,0,0,0,0,0,0,0,0,1,0,1,2,0,0,0.0,0.0,0.0,0,0,0,0,0,0,0,0,0,2020-12-27 19:15:002020-12-27 19:15:00
3511,23388,Matěj Vydra,2302,"[2018, 2019, 2020]",Burnley FC,15,5,10,525,2,0,25,6,19,768,1,0,40,11,29,1293,3,0,0.0,3.0,3.0,2,1,3,0,0,0,0,0,0,2020-12-27 19:15:002020-12-27 19:15:002020-12-27 19:15:00
3512,7798,Maurice Edu,4240,[2012],Stoke City,0,0,0,0,0,0,1,0,1,10,0,0,1,0,1,10,0,0,0.0,0.0,0.0,0,0,0,0,0,0,0,0,0,2020-12-27 19:15:00
3513,7799,Mauricio Isla,3446,[2014],Queens Park Rangers,15,13,2,1184,0,0,11,11,0,947,0,0,26,24,2,2131,0,0,0.0,0.0,0.0,0,0,0,0,0,0,0,0,0,2020-12-27 19:15:00
3514,7800,Mauricio Pellegrino,3559,[2004],Liverpool FC,7,7,0,586,0,0,5,4,1,327,0,0,12,11,1,913,0,0,0.0,0.0,0.0,0,0,0,0,0,0,0,0,0,2020-12-27 19:15:00
3515,31210,Mauricio Taricco,1118,"[2000, 2001, 2002, 2003]",Tottenham Hotspur,44,42,2,3413,2,0,43,41,2,3511,0,0,87,83,4,6924,2,0,0.0,0.0,0.0,2,0,2,0,0,0,0,0,0,2020-12-27 19:15:002020-12-27 19:15:002020-12-27 19:15:002020-12-27 19:15:00
3516,15611,Mauro Boselli,3632,"[2010, 2012]",Wigan Athletic,9,4,5,427,0,0,6,2,4,198,0,0,15,6,9,625,0,0,0.0,0.0,0.0,0,0,0,0,0,0,0,0,0,2020-12-27 19:15:002020-12-27 19:15:00
3517,15615,Mauro Fórmica,3422,"[2010, 2011]",Blackburn Rovers,17,13,4,1126,4,0,17,12,5,1043,0,0,34,25,9,2169,4,0,0.0,0.0,0.0,3,0,3,0,0,0,0,0,0,2020-12-27 19:15:002020-12-27 19:15:00
3518,7809,Mauro Zárate,2504,[2007],Birmingham City,8,2,6,252,3,0,6,4,2,354,1,0,14,6,8,606,4,0,1.0,0.0,1.0,2,1,3,0,0,0,0,0,0,2020-12-27 19:15:00
3519,15621,Mauro Zárate,2504,"[2014, 2015]",West Ham United,10,7,3,549,2,0,12,7,5,654,3,0,22,14,8,1203,5,0,0.0,0.0,0.0,2,2,4,0,0,0,0,0,0,2020-12-27 19:15:002020-12-27 19:15:00
3520,7812,Mauro Zárate,2504,[2016],Watford FC,2,2,0,132,0,0,1,1,0,74,0,0,3,3,0,206,0,0,0.0,0.0,0.0,0,0,0,0,0,0,0,0,0,2020-12-27 19:15:00
3521,7813,Max Aarons,2176,[2019],Norwich City,18,18,0,1620,0,0,18,18,0,1620,0,0,36,36,0,3240,0,0,0.0,0.0,0.0,0,0,0,0,0,0,0,0,0,2020-12-27 19:15:00
3522,7814,Max Ehmer,3478,[2012],Queens Park Rangers,0,0,0,0,0,0,0,0,0,0,0,0,0,0,0,0,0,0,0.0,0.0,0.0,0,0,0,0,0,0,0,0,0,2020-12-27 19:15:00
3523,15631,Max Gradel,2771,"[2015, 2016]",AFC Bournemouth,14,6,8,552,1,0,11,5,6,472,0,0,25,11,14,1024,1,0,0.0,0.0,0.0,1,0,1,0,0,0,0,0,0,2020-12-27 19:15:002020-12-27 19:15:00
3524,23454,Max Kilman,2185,"[2018, 2019, 2020]",Wolverhampton Wanderers,6,5,1,451,0,0,6,4,2,376,0,0,12,9,3,827,0,0,0.0,0.0,0.0,0,0,0,0,0,0,0,0,0,2020-12-27 19:15:002020-12-27 19:15:002020-12-27 19:15:00
3525,7820,Max Lowe,1020,[2020],Sheffield United,4,4,0,236,0,0,2,2,0,180,0,0,6,6,0,416,0,0,0.0,0.0,0.0,0,0,0,0,0,0,0,0,0,2020-12-27 19:15:00
3526,7821,Max Melbourne,2248,[2017],West Bromwich Albion,0,0,0,0,0,0,0,0,0,0,0,0,0,0,0,0,0,0,0.0,0.0,0.0,0,0,0,0,0,0,0,0,0,2020-12-27 19:15:00
3527,23469,Max Meyer,2312,"[2018, 2019, 2020]",Crystal Palace,28,10,18,1043,0,0,18,11,7,1021,1,0,46,21,25,2064,1,0,0.0,0.0,0.0,0,0,0,0,0,0,0,0,0,2020-12-27 19:15:002020-12-27 19:15:002020-12-27 19:15:00
3528,7825,Max Sanders,4328,[2018],Brighton & Hove Albion,0,0,0,0,0,0,0,0,0,0,0,0,0,0,0,0,0,0,0.0,0.0,0.0,0,0,0,0,0,0,0,0,0,2020-12-27 19:15:00
3529,7826,Max Stryjek,4545,[2016],Sunderland AFC,0,0,0,0,0,0,0,0,0,0,0,0,0,0,0,0,0,0,0.0,0.0,0.0,0,0,0,0,0,0,0,0,0,2020-12-27 19:15:00
3530,15655,Max Thompson,2676,"[2019, 2020]",Burnley FC,0,0,0,0,0,0,1,0,1,2,0,0,1,0,1,2,0,0,0.0,0.0,0.0,0,0,0,0,0,0,0,0,0,2020-12-27 19:15:002020-12-27 19:15:00
3531,23490,Maxi Rodríguez,2993,"[2009, 2010, 2011]",Liverpool FC,30,24,6,2113,7,0,27,24,3,1937,8,0,57,48,9,4050,15,0,1.0,3.0,4.0,3,4,7,0,0,0,0,0,0,2020-12-27 19:15:002020-12-27 19:15:002020-12-27 19:15:00
3532,15665,Maxime Le Marchand,3906,"[2018, 2020]",Fulham FC,15,13,2,1203,0,0,13,13,0,1170,0,0,28,26,2,2373,0,0,0.0,0.0,0.0,0,0,0,0,0,0,0,0,0,2020-12-27 19:15:002020-12-27 19:15:00
3533,62700,Maya Yoshida,1145,"[2012, 2013, 2014, 2015, 2016, 2017, 2018, 2019]",Southampton FC,79,69,10,6364,4,0,75,66,9,6027,2,0,154,135,19,12391,6,0,3.0,0.0,3.0,2,2,4,0,0,0,0,0,0,2020-12-27 19:15:002020-12-27 19:15:002020-12-27 19:15:002020-12-27 19:15:002020-12-27 19:15:002020-12-27 19:15:002020-12-27 19:15:002020-12-27 19:15:00
3534,47067,Maynor Figueroa,2057,"[2007, 2008, 2009, 2010, 2011, 2012]",Wigan Athletic,89,86,3,7651,2,0,88,88,0,7753,2,0,177,174,3,15404,4,0,6.0,0.0,6.0,2,1,3,0,0,0,0,0,0,2020-12-27 19:15:002020-12-27 19:15:002020-12-27 19:15:002020-12-27 19:15:002020-12-27 19:15:002020-12-27 19:15:00
3535,15697,Maynor Figueroa,2057,"[2013, 2014]",Hull City,17,17,0,1411,0,0,18,16,2,1513,0,0,35,33,2,2924,0,0,0.0,0.0,0.0,0,0,0,0,0,0,0,0,0,2020-12-27 19:15:002020-12-27 19:15:00
3536,15701,Mbulelo Mabizela,3479,"[2003, 2004]",Tottenham Hotspur,3,1,2,73,0,0,4,0,4,95,1,0,7,1,6,168,1,0,0.0,0.0,0.0,0,1,1,0,0,0,0,0,0,2020-12-27 19:15:002020-12-27 19:15:00
3537,7852,Mbwana Samatta,2849,[2019],Aston Villa,7,5,2,438,0,0,7,6,1,508,1,0,14,11,3,946,1,0,0.0,0.0,0.0,0,0,0,0,0,0,0,0,0,2020-12-27 19:15:00
3538,23562,Mehdi Abeid,2928,"[2011, 2012, 2014]",Newcastle United,7,4,3,350,0,0,6,3,3,312,0,0,13,7,6,662,0,0,0.0,0.0,0.0,0,0,0,0,0,0,0,0,0,2020-12-27 19:15:002020-12-27 19:15:002020-12-27 19:15:00
3539,23571,Mehdi Nafti,1517,"[2004, 2005, 2007]",Birmingham City,19,12,7,1127,0,0,18,15,3,1315,0,0,37,27,10,2442,0,0,0.0,0.0,0.0,0,0,0,0,0,0,0,0,0,2020-12-27 19:15:002020-12-27 19:15:002020-12-27 19:15:00
3540,15719,Memphis Depay,2191,"[2015, 2016]",Manchester United,16,8,8,741,1,0,17,8,9,756,1,0,33,16,17,1497,2,0,0.0,0.0,0.0,1,1,2,0,0,0,0,0,0,2020-12-27 19:15:002020-12-27 19:15:00
3541,31450,Mendieta,2296,"[2003, 2004, 2005, 2006]",Middlesbrough FC,31,28,3,2357,4,0,31,28,3,2371,0,0,62,56,6,4728,4,0,0.0,0.0,0.0,3,0,3,0,0,0,0,0,0,2020-12-27 19:15:002020-12-27 19:15:002020-12-27 19:15:002020-12-27 19:15:00
3542,7865,Meritan Shabani,1082,[2020],Wolverhampton Wanderers,0,0,0,0,0,0,0,0,0,0,0,0,0,0,0,0,0,0,0.0,0.0,0.0,0,0,0,0,0,0,0,0,0,2020-12-27 19:15:00
3543,7866,Mesca,3982,[2013],Fulham FC,0,0,0,0,0,0,1,0,1,18,0,0,1,0,1,18,0,0,0.0,0.0,0.0,0,0,0,0,0,0,0,0,0,2020-12-27 19:15:00
3544,55090,Mesut Özil,1500,"[2013, 2014, 2015, 2016, 2017, 2018, 2019]",Arsenal FC,99,96,3,8428,21,0,85,79,6,6833,12,0,184,175,9,15261,33,0,3.0,3.0,6.0,8,8,16,0,0,0,0,0,0,2020-12-27 19:15:002020-12-27 19:15:002020-12-27 19:15:002020-12-27 19:15:002020-12-27 19:15:002020-12-27 19:15:002020-12-27 19:15:00
3545,70902,Micah Richards,1364,"[2005, 2006, 2007, 2008, 2009, 2010, 2011, 2012, 2013]",Manchester City,89,84,5,7232,3,0,87,78,9,6763,3,0,176,162,14,13995,6,0,3.0,1.0,4.0,1,3,4,0,0,0,0,0,0,2020-12-27 19:15:002020-12-27 19:15:002020-12-27 19:15:002020-12-27 19:15:002020-12-27 19:15:002020-12-27 19:15:002020-12-27 19:15:002020-12-27 19:15:002020-12-27 19:15:00
3546,7883,Micah Richards,1364,[2015],Aston Villa,12,12,0,1031,1,0,12,11,1,1015,0,0,24,23,1,2046,1,0,0.0,0.0,0.0,1,0,1,0,0,0,0,0,0,2020-12-27 19:15:00
3547,7884,Michael Ball,2823,[2000],Everton FC,14,14,0,1260,3,0,14,14,0,1224,0,0,28,28,0,2484,3,0,1.0,0.0,1.0,3,0,3,2,0,2,0,0,0,2020-12-27 19:15:00
3548,23658,Michael Ball,2823,"[2006, 2007, 2008]",Manchester City,26,20,6,1866,0,0,21,18,3,1701,0,0,47,38,9,3567,0,0,0.0,0.0,0.0,0,0,0,0,0,0,0,0,0,2020-12-27 19:15:002020-12-27 19:15:002020-12-27 19:15:00
3549,31558,Michael Ballack,2271,"[2006, 2007, 2008, 2009]",Chelsea FC,56,49,7,4360,10,0,48,37,11,3422,7,0,104,86,18,7782,17,0,6.0,6.0,12.0,5,5,10,1,1,2,0,0,0,2020-12-27 19:15:002020-12-27 19:15:002020-12-27 19:15:002020-12-27 19:15:00
3550,7892,Michael Bradley,4219,[2010],Aston Villa,1,0,1,1,0,0,2,0,2,27,0,0,3,0,3,28,0,0,0.0,0.0,0.0,0,0,0,0,0,0,0,0,0,2020-12-27 19:15:00
3551,23682,Michael Bridges,2294,"[2000, 2002, 2003]",Leeds United,10,3,7,368,0,0,10,3,7,409,0,0,20,6,14,777,0,0,0.0,0.0,0.0,0,0,0,0,0,0,0,0,0,2020-12-27 19:15:002020-12-27 19:15:002020-12-27 19:15:00
3552,15793,Michael Brown,1122,"[2003, 2004]",Tottenham Hotspur,19,18,1,1542,1,0,22,19,3,1646,1,0,41,37,4,3188,2,0,0.0,0.0,0.0,1,0,1,0,0,0,0,0,0,2020-12-27 19:15:002020-12-27 19:15:00
3553,15797,Michael Brown,1122,"[2005, 2006]",Fulham FC,20,20,0,1733,0,0,19,18,1,1540,0,0,39,38,1,3273,0,0,0.0,0.0,0.0,0,0,0,0,0,0,0,0,0,2020-12-27 19:15:002020-12-27 19:15:00
3554,7900,Michael Brown,1122,[2007],Blackburn Rovers,0,0,0,0,0,0,1,1,0,90,0,0,1,1,0,90,0,0,0.0,0.0,0.0,0,0,0,0,0,0,0,0,0,2020-12-27 19:15:00
3555,7901,Michael Brown,1122,[2008],Wigan Athletic,14,11,3,915,0,0,11,7,4,613,0,0,25,18,7,1528,0,0,0.0,0.0,0.0,0,0,0,0,0,0,0,0,0,2020-12-27 19:15:00
3556,7902,Michael Brown,1122,[2009],Portsmouth FC,13,12,1,1048,2,0,11,10,1,882,0,0,24,22,2,1930,2,0,0.0,0.0,0.0,1,0,1,0,0,0,0,0,0,2020-12-27 19:15:00
3557,23712,Michael Carrick,1627,"[2000, 2001, 2002]",West Ham United,36,35,1,3151,3,0,42,40,2,3637,1,0,78,75,3,6788,4,0,0.0,0.0,0.0,2,0,2,0,0,0,0,0,0,2020-12-27 19:15:002020-12-27 19:15:002020-12-27 19:15:00
3558,15813,Michael Carrick,1627,"[2004, 2005]",Tottenham Hotspur,32,31,1,2818,2,0,31,29,2,2588,0,0,63,60,3,5406,2,0,3.0,0.0,3.0,1,0,1,0,0,0,0,0,0,2020-12-27 19:15:002020-12-27 19:15:00
3559,94962,Michael Carrick,1627,"[2006, 2007, 2008, 2009, 2010, 2011, 2012, 2013, 2014, 2015, 2016, 2017]",Manchester United,155,131,24,11485,13,0,159,134,25,12374,3,0,314,265,49,23859,16,0,0.0,3.0,3.0,4,2,6,0,0,0,0,0,0,2020-12-27 19:15:002020-12-27 19:15:002020-12-27 19:15:002020-12-27 19:15:002020-12-27 19:15:002020-12-27 19:15:002020-12-27 19:15:002020-12-27 19:15:002020-12-27 19:15:002020-12-27 19:15:002020-12-27 19:15:002020-12-27 19:15:00
3560,31686,Michael Chopra,1226,"[2002, 2003, 2004, 2005]",Newcastle United,13,5,8,562,0,0,8,2,6,187,1,0,21,7,14,749,1,0,0.0,0.0,0.0,0,1,1,0,0,0,0,0,0,2020-12-27 19:15:002020-12-27 19:15:002020-12-27 19:15:002020-12-27 19:15:00
3561,15849,Michael Chopra,1226,"[2007, 2008]",Sunderland AFC,19,11,8,1008,4,0,19,10,9,1129,4,0,38,21,17,2137,8,0,3.0,3.0,6.0,3,3,6,0,1,1,0,0,0,2020-12-27 19:15:002020-12-27 19:15:00
3562,79305,Michael Dawson,1267,"[2004, 2005, 2006, 2007, 2008, 2009, 2010, 2011, 2012, 2013]",Tottenham Hotspur,117,113,4,10087,3,0,114,103,11,9229,4,0,231,216,15,19316,7,0,0.0,2.0,2.0,2,3,5,0,0,0,0,0,0,2020-12-27 19:15:002020-12-27 19:15:002020-12-27 19:15:002020-12-27 19:15:002020-12-27 19:15:002020-12-27 19:15:002020-12-27 19:15:002020-12-27 19:15:002020-12-27 19:15:002020-12-27 19:15:00
3563,15873,Michael Dawson,1267,"[2014, 2016]",Hull City,24,22,2,1990,4,0,26,25,1,2165,0,0,50,47,3,4155,4,0,7.0,0.0,7.0,4,0,4,0,0,0,0,0,0,2020-12-27 19:15:002020-12-27 19:15:00
3564,7938,Michael Doughty,2925,[2014],Queens Park Rangers,0,0,0,0,0,0,3,0,3,51,0,0,3,0,3,51,0,0,0.0,0.0,0.0,0,0,0,0,0,0,0,0,0,2020-12-27 19:15:00
3565,31762,Michael Duberry,2291,"[2000, 2001, 2002, 2003]",Leeds United,16,15,1,1359,2,0,16,15,1,1382,1,0,32,30,2,2741,3,0,0.0,0.0,0.0,2,1,3,0,0,0,0,0,0,2020-12-27 19:15:002020-12-27 19:15:002020-12-27 19:15:002020-12-27 19:15:00
3566,15887,Michael Duberry,2291,"[2006, 2007]",Reading FC,10,10,0,795,0,0,10,9,1,827,0,0,20,19,1,1622,0,0,0.0,0.0,0.0,0,0,0,0,0,0,0,0,0,2020-12-27 19:15:002020-12-27 19:15:00
3567,15891,Michael Duff,1488,"[2009, 2014]",Burnley FC,15,15,0,1350,0,0,17,16,1,1477,0,0,32,31,1,2827,0,0,0.0,0.0,0.0,0,0,0,0,0,0,0,0,0,2020-12-27 19:15:002020-12-27 19:15:00
3568,71559,Michael Essien,1763,"[2005, 2006, 2007, 2008, 2009, 2010, 2011, 2012, 2013]",Chelsea FC,83,77,6,6856,12,0,83,71,12,6322,5,0,166,148,18,13178,17,0,10.0,4.0,14.0,8,4,12,0,0,0,0,0,0,2020-12-27 19:15:002020-12-27 19:15:002020-12-27 19:15:002020-12-27 19:15:002020-12-27 19:15:002020-12-27 19:15:002020-12-27 19:15:002020-12-27 19:15:002020-12-27 19:15:00
3569,15913,Michael Folivi,4031,"[2016, 2017]",Watford FC,0,0,0,0,0,0,1,0,1,9,0,0,1,0,1,9,0,0,0.0,0.0,0.0,0,0,0,0,0,0,0,0,0,2020-12-27 19:15:002020-12-27 19:15:00
3570,23877,Michael Gray,1092,"[2000, 2001, 2002]",Sunderland AFC,48,48,0,4268,1,0,45,45,0,3936,1,0,93,93,0,8204,2,0,3.0,0.0,3.0,1,1,2,0,0,0,0,0,0,2020-12-27 19:15:002020-12-27 19:15:002020-12-27 19:15:00
3571,23888,Michael Gray,1092,"[2003, 2005, 2006]",Blackburn Rovers,27,27,0,2333,0,0,28,27,1,2350,0,0,55,54,1,4683,0,0,0.0,0.0,0.0,0,0,0,0,0,0,0,0,0,2020-12-27 19:15:002020-12-27 19:15:002020-12-27 19:15:00
3572,7962,Michael Gray,1092,[2004],Southampton FC,1,1,0,89,0,0,0,0,0,0,0,0,1,1,0,89,0,0,0.0,0.0,0.0,0,0,0,0,0,0,0,0,0,2020-12-27 19:15:00
3573,15931,Michael Harriman,3669,"[2011, 2012]",Queens Park Rangers,0,0,0,0,0,0,2,1,1,119,0,0,2,1,1,119,0,0,0.0,0.0,0.0,0,0,0,0,0,0,0,0,0,2020-12-27 19:15:002020-12-27 19:15:00
3574,7967,Michael Hector,1012,[2020],Fulham FC,2,2,0,148,0,0,2,1,1,115,0,0,4,3,1,263,0,0,0.0,0.0,0.0,0,0,0,0,0,0,0,0,0,2020-12-27 19:15:00
3575,7968,Michael Hefele,3800,[2017],Huddersfield Town,1,0,1,1,0,0,1,0,1,31,0,0,2,0,2,32,0,0,0.0,0.0,0.0,0,0,0,0,0,0,0,0,0,2020-12-27 19:15:00
3576,7969,Michael Hughes,2027,[2004],Crystal Palace,18,17,1,1532,1,0,17,16,1,1396,1,0,35,33,2,2928,2,0,0.0,0.0,0.0,0,1,1,0,0,0,0,0,0,2020-12-27 19:15:00
3577,7970,Michael Johnson,3030,[2002],Birmingham City,2,2,0,180,0,0,4,3,1,263,0,0,6,5,1,443,0,0,0.0,0.0,0.0,0,0,0,0,0,0,0,0,0,2020-12-27 19:15:00
3578,31890,Michael Johnson,3030,"[2006, 2007, 2008, 2009]",Manchester City,18,17,1,1453,2,0,18,18,0,1552,0,0,36,35,1,3005,2,0,6.0,0.0,6.0,2,0,2,0,0,0,0,0,0,2020-12-27 19:15:002020-12-27 19:15:002020-12-27 19:15:002020-12-27 19:15:00
3579,7975,Michael Jordan Williams,4180,[2014],Liverpool FC,0,0,0,0,0,0,0,0,0,0,0,0,0,0,0,0,0,0,0.0,0.0,0.0,0,0,0,0,0,0,0,0,0,2020-12-27 19:15:00
3580,7976,Michael Keane,1047,[2013],Manchester United,0,0,0,0,0,0,0,0,0,0,0,0,0,0,0,0,0,0,0.0,0.0,0.0,0,0,0,0,0,0,0,0,0,2020-12-27 19:15:00
3581,15955,Michael Keane,1047,"[2014, 2016]",Burnley FC,25,25,0,2250,1,0,31,27,4,2494,1,0,56,52,4,4744,2,0,0.0,1.0,1.0,0,1,1,0,0,0,0,0,0,2020-12-27 19:15:002020-12-27 19:15:00
3582,31922,Michael Keane,1047,"[2017, 2018, 2019, 2020]",Everton FC,52,50,2,4528,2,0,57,55,2,4885,3,0,109,105,4,9413,5,0,0.0,3.0,3.0,2,1,3,0,0,0,0,0,0,2020-12-27 19:15:002020-12-27 19:15:002020-12-27 19:15:002020-12-27 19:15:00
3583,23952,Michael Kightly,1259,"[2009, 2010, 2011]",Wolverhampton Wanderers,18,9,9,943,2,0,13,9,4,857,1,0,31,18,13,1800,3,0,0.0,0.0,0.0,2,1,3,0,0,0,0,0,0,2020-12-27 19:15:002020-12-27 19:15:002020-12-27 19:15:00
3584,7986,Michael Kightly,1259,[2012],Stoke City,14,8,6,729,1,0,8,6,2,467,2,0,22,14,8,1196,3,0,0.0,0.0,0.0,1,1,2,0,0,0,0,0,0,2020-12-27 19:15:00
3585,15975,Michael Kightly,1259,"[2014, 2016]",Burnley FC,11,5,6,511,0,0,11,6,5,544,1,0,22,11,11,1055,1,0,0.0,0.0,0.0,0,1,1,0,0,0,0,0,0,2020-12-27 19:15:002020-12-27 19:15:00
3586,7989,Michael Ledger,4485,[2016],Sunderland AFC,0,0,0,0,0,0,0,0,0,0,0,0,0,0,0,0,0,0,0.0,0.0,0.0,0,0,0,0,0,0,0,0,0,2020-12-27 19:15:00
3587,7990,Michael Mancienne,2886,[2008],Chelsea FC,1,1,0,81,0,0,3,1,2,95,0,0,4,2,2,176,0,0,0.0,0.0,0.0,0,0,0,0,0,0,0,0,0,2020-12-27 19:15:00
3588,15983,Michael Mancienne,2886,"[2009, 2010]",Wolverhampton Wanderers,22,16,6,1358,0,0,23,18,5,1664,0,0,45,34,11,3022,0,0,0.0,0.0,0.0,0,0,0,0,0,0,0,0,0,2020-12-27 19:15:002020-12-27 19:15:00
3589,7993,Michael McGovern,1836,[2019],Norwich City,1,1,0,90,0,0,1,0,1,68,0,0,2,1,1,158,0,0,0.0,0.0,0.0,0,0,0,0,0,0,0,0,0,2020-12-27 19:15:00
3590,7994,Michael Oakes,2902,[2003],Wolverhampton Wanderers,11,11,0,990,0,0,10,10,0,900,0,0,21,21,0,1890,0,0,0.0,0.0,0.0,0,0,0,0,0,0,0,0,0,2020-12-27 19:15:00
3591,31986,Michael Obafemi,2328,"[2017, 2018, 2019, 2020]",Southampton FC,13,4,9,294,0,0,16,5,11,550,4,0,29,9,20,844,4,0,0.0,1.0,1.0,0,3,3,0,0,0,0,0,0,2020-12-27 19:15:002020-12-27 19:15:002020-12-27 19:15:002020-12-27 19:15:00
3592,24002,Michael Owen,1949,"[2000, 2002, 2003]",Liverpool FC,47,44,3,3847,30,0,40,32,8,2812,21,0,87,76,11,6659,51,0,9.0,0.0,9.0,18,12,30,4,2,6,0,0,0,2020-12-27 19:15:002020-12-27 19:15:002020-12-27 19:15:00
3593,8000,Michael Owen,1949,[2001],West Ham United,1,0,1,31,0,0,0,0,0,0,0,0,1,0,1,31,0,0,0.0,0.0,0.0,0,0,0,0,0,0,0,0,0,2020-12-27 19:15:00
3594,32018,Michael Owen,1949,"[2005, 2006, 2007, 2008]",Newcastle United,33,26,7,2430,14,0,38,32,6,2773,12,0,71,58,13,5203,26,0,9.0,1.0,10.0,8,7,15,2,1,3,0,0,0,2020-12-27 19:15:002020-12-27 19:15:002020-12-27 19:15:002020-12-27 19:15:00
3595,24024,Michael Owen,1949,"[2009, 2010, 2011]",Manchester United,16,3,13,516,3,0,14,3,11,386,2,0,30,6,24,902,5,0,3.0,1.0,4.0,1,1,2,0,0,0,0,0,0,2020-12-27 19:15:002020-12-27 19:15:002020-12-27 19:15:00
3596,8010,Michael Owen,1949,[2012],Stoke City,3,0,3,26,0,0,5,0,5,69,1,0,8,0,8,95,1,0,0.0,0.0,0.0,0,0,0,0,0,0,0,0,0,2020-12-27 19:15:00
3597,8011,Michael O’Halloran,3899,[2011],Bolton Wanderers,0,0,0,0,0,0,0,0,0,0,0,0,0,0,0,0,0,0,0.0,0.0,0.0,0,0,0,0,0,0,0,0,0,2020-12-27 19:15:00
3598,8012,Michael Petrasso,4402,[2014],Queens Park Rangers,0,0,0,0,0,0,0,0,0,0,0,0,0,0,0,0,0,0,0.0,0.0,0.0,0,0,0,0,0,0,0,0,0,2020-12-27 19:15:00
3599,8013,Michael Phillips,2786,[2016],Crystal Palace,0,0,0,0,0,0,0,0,0,0,0,0,0,0,0,0,0,0,0.0,0.0,0.0,0,0,0,0,0,0,0,0,0,2020-12-27 19:15:00
3600,8014,Michael Proctor,3483,[2002],Sunderland AFC,12,9,3,724,2,0,9,2,7,293,0,0,21,11,10,1017,2,0,3.0,0.0,3.0,2,0,2,0,0,0,0,0,0,2020-12-27 19:15:00
3601,8015,Michael Reddy,4194,[2000],Manchester City,1,0,1,5,0,0,0,0,0,0,0,0,1,0,1,5,0,0,0.0,0.0,0.0,0,0,0,0,0,0,0,0,0,2020-12-27 19:15:00
3602,16033,Michael Reiziger,3838,"[2004, 2005]",Middlesbrough FC,11,10,1,914,1,0,11,9,2,816,0,0,22,19,3,1730,1,0,0.0,0.0,0.0,0,0,0,0,0,0,0,0,0,2020-12-27 19:15:002020-12-27 19:15:00
3603,8018,Michael Richardson,2726,[2010],Newcastle United,0,0,0,0,0,0,0,0,0,0,0,0,0,0,0,0,0,0,0.0,0.0,0.0,0,0,0,0,0,0,0,0,0,2020-12-27 19:15:00
3604,8019,Michael Ricketts,2140,[2001],Bolton Wanderers,18,11,7,1138,5,0,19,15,4,1323,7,0,37,26,11,2461,12,0,5.0,4.0,9.0,5,4,9,0,0,0,0,0,0,2020-12-27 19:15:00
3605,16041,Michael Ricketts,2140,"[2002, 2003]",Middlesbrough FC,14,6,8,612,0,0,18,7,11,780,3,0,32,13,19,1392,3,0,0.0,0.0,0.0,0,0,0,0,2,2,0,0,0,2020-12-27 19:15:002020-12-27 19:15:00
3606,24069,Michael Stewart,4038,"[2000, 2001, 2002]",Manchester United,2,2,0,123,0,0,5,3,2,245,0,0,7,5,2,368,0,0,0.0,0.0,0.0,0,0,0,0,0,0,0,0,0,2020-12-27 19:15:002020-12-27 19:15:002020-12-27 19:15:00
3607,16051,Michael Svensson,2914,"[2002, 2003]",Southampton FC,30,30,0,2700,1,0,27,26,1,2386,3,0,57,56,1,5086,4,0,0.0,4.0,4.0,1,2,3,0,0,0,0,0,0,2020-12-27 19:15:002020-12-27 19:15:00
3608,8027,Michael Tarnat,3720,[2003],Manchester City,17,17,0,1511,1,0,13,13,0,1170,2,0,30,30,0,2681,3,0,0.0,0.0,0.0,1,2,3,0,0,0,0,0,0,2020-12-27 19:15:00
3609,8028,Michael Tonge,1997,[2006],Sheffield United,12,9,3,787,2,0,13,12,1,1047,0,0,25,21,4,1834,2,0,0.0,0.0,0.0,1,0,1,0,0,0,0,0,0,2020-12-27 19:15:00
3610,16059,Michael Tonge,1997,"[2008, 2010]",Stoke City,8,0,8,161,0,0,4,1,3,131,0,0,12,1,11,292,0,0,0.0,0.0,0.0,0,0,0,0,0,0,0,0,0,2020-12-27 19:15:002020-12-27 19:15:00
3611,8031,Michael Turner,1371,[2008],Hull City,19,19,0,1710,3,0,19,19,0,1710,1,0,38,38,0,3420,4,0,3.0,0.0,3.0,3,1,4,0,0,0,0,0,0,2020-12-27 19:15:00
3612,24099,Michael Turner,1371,"[2009, 2010, 2011]",Sunderland AFC,35,35,0,3098,1,0,33,32,1,2881,0,0,68,67,1,5979,1,0,0.0,0.0,0.0,0,0,0,0,0,0,0,0,0,2020-12-27 19:15:002020-12-27 19:15:002020-12-27 19:15:00
3613,16071,Michael Turner,1371,"[2012, 2013]",Norwich City,24,24,0,2053,1,0,24,23,1,2116,2,0,48,47,1,4169,3,0,0.0,1.0,1.0,1,2,3,0,0,0,0,0,0,2020-12-27 19:15:002020-12-27 19:15:00
3614,16075,Michael Verrips,3473,"[2019, 2020]",Sheffield United,0,0,0,0,0,0,0,0,0,0,0,0,0,0,0,0,0,0,0.0,0.0,0.0,0,0,0,0,0,0,0,0,0,2020-12-27 19:15:002020-12-27 19:15:00
3615,48249,Michail Antonio,2208,"[2015, 2016, 2017, 2018, 2019, 2020]",West Ham United,68,60,8,4999,18,0,72,56,16,5264,21,0,140,116,24,10263,39,0,10.0,3.0,13.0,13,11,24,0,1,1,0,0,0,2020-12-27 19:15:002020-12-27 19:15:002020-12-27 19:15:002020-12-27 19:15:002020-12-27 19:15:002020-12-27 19:15:00
3616,24138,Michel Vorm,1174,"[2011, 2012, 2013]",Swansea City,47,47,0,4230,0,0,42,42,0,3749,0,0,89,89,0,7979,0,0,0.0,0.0,0.0,0,0,0,0,0,0,0,0,0,2020-12-27 19:15:002020-12-27 19:15:002020-12-27 19:15:00
3617,48303,Michel Vorm,1174,"[2014, 2015, 2016, 2017, 2018, 2019]",Tottenham Hotspur,5,4,1,446,0,0,8,7,1,685,0,0,13,11,2,1131,0,0,0.0,0.0,0.0,0,0,0,0,0,0,0,0,0,2020-12-27 19:15:002020-12-27 19:15:002020-12-27 19:15:002020-12-27 19:15:002020-12-27 19:15:002020-12-27 19:15:00
3618,16109,Michu,2939,"[2012, 2013]",Swansea City,27,26,1,2277,12,0,25,24,1,2025,8,0,52,50,2,4302,20,0,3.0,0.0,3.0,5,6,11,0,0,0,0,0,0,2020-12-27 19:15:002020-12-27 19:15:00
3619,24172,Michy Batshuayi,2732,"[2016, 2017, 2019]",Chelsea FC,23,3,20,454,5,0,25,2,23,363,3,0,48,5,43,817,8,0,0.0,3.0,3.0,1,2,3,0,0,0,0,0,0,2020-12-27 19:15:002020-12-27 19:15:002020-12-27 19:15:00
3620,16118,Michy Batshuayi,2732,"[2018, 2020]",Crystal Palace,10,5,5,495,2,0,11,8,3,685,3,0,21,13,8,1180,5,0,0.0,0.0,0.0,1,2,3,0,0,0,0,0,0,2020-12-27 19:15:002020-12-27 19:15:00
3621,8061,Mickaël Debève,3896,[2001],Middlesbrough FC,2,0,2,90,0,0,2,1,1,104,0,0,4,1,3,194,0,0,0.0,0.0,0.0,0,0,0,0,0,0,0,0,0,2020-12-27 19:15:00
3622,8062,Mickaël Tavares,4472,[2012],Fulham FC,0,0,0,0,0,0,0,0,0,0,0,0,0,0,0,0,0,0,0.0,0.0,0.0,0,0,0,0,0,0,0,0,0,2020-12-27 19:15:00
3623,24192,Mido,2636,"[2004, 2005, 2006]",Tottenham Hotspur,24,20,4,1805,11,0,23,14,9,1310,3,0,47,34,13,3115,14,0,6.0,1.0,7.0,9,3,12,1,0,1,0,0,0,2020-12-27 19:15:002020-12-27 19:15:002020-12-27 19:15:00
3624,8066,Mido,2636,[2007],Middlesbrough FC,6,4,2,403,1,0,6,4,2,345,1,0,12,8,4,748,2,0,0.0,0.0,0.0,1,1,2,0,0,0,0,0,0,2020-12-27 19:15:00
3625,8067,Mido,2636,[2008],Wigan Athletic,7,6,1,433,2,0,5,4,1,327,0,0,12,10,2,760,2,0,1.0,0.0,1.0,2,0,2,1,0,1,0,0,0,2020-12-27 19:15:00
3626,8068,Mido,2636,[2009],West Ham United,4,2,2,184,0,0,5,3,2,308,0,0,9,5,4,492,0,0,0.0,0.0,0.0,0,0,0,0,0,0,0,0,0,2020-12-27 19:15:00
3627,24210,Miguel Almirón,2471,"[2018, 2019, 2020]",Newcastle United,30,27,3,2394,3,0,29,25,4,2160,2,0,59,52,7,4554,5,0,3.0,0.0,3.0,3,1,4,0,0,0,0,0,0,2020-12-27 19:15:002020-12-27 19:15:002020-12-27 19:15:00
3628,32294,Miguel Britos,1930,"[2015, 2016, 2017, 2018]",Watford FC,32,30,2,2613,2,0,34,33,1,2822,0,0,66,63,3,5435,2,0,4.0,0.0,4.0,2,0,2,0,0,0,0,0,0,2020-12-27 19:15:002020-12-27 19:15:002020-12-27 19:15:002020-12-27 19:15:00
3629,8076,Miguel Layún,3814,[2015],Watford FC,1,1,0,55,0,0,2,1,1,77,1,0,3,2,1,132,1,0,0.0,0.0,0.0,0,1,1,0,0,0,0,0,0,2020-12-27 19:15:00
3630,8077,Mika,3138,[2016],Sunderland AFC,0,0,0,0,0,0,0,0,0,0,0,0,0,0,0,0,0,0,0.0,0.0,0.0,0,0,0,0,0,0,0,0,0,2020-12-27 19:15:00
3631,16158,Mikael Forssell,1965,"[2001, 2004]",Chelsea FC,11,1,10,200,3,0,11,1,10,258,1,0,22,2,20,458,4,0,3.0,0.0,3.0,1,1,2,0,0,0,0,0,0,2020-12-27 19:15:002020-12-27 19:15:00
3632,24242,Mikael Forssell,1965,"[2003, 2005, 2007]",Birmingham City,46,36,10,3247,19,0,43,27,16,2543,10,0,89,63,26,5790,29,0,7.0,3.0,10.0,11,4,15,3,0,3,0,0,0,2020-12-27 19:15:002020-12-27 19:15:002020-12-27 19:15:00
3633,32338,Mikael Mandron,4024,"[2012, 2013, 2014, 2015]",Sunderland AFC,1,0,1,4,0,0,2,0,2,20,0,0,3,0,3,24,0,0,0.0,0.0,0.0,0,0,0,0,0,0,0,0,0,2020-12-27 19:15:002020-12-27 19:15:002020-12-27 19:15:002020-12-27 19:15:00
3634,8087,Mikael Nilsson,3367,[2004],Southampton FC,7,6,1,534,0,0,8,6,2,477,0,0,15,12,3,1011,0,0,0.0,0.0,0.0,0,0,0,0,0,0,0,0,0,2020-12-27 19:15:00
3635,64732,Mikaël Silvestre,1106,"[2000, 2001, 2002, 2003, 2004, 2005, 2006, 2007]",Manchester United,110,98,12,8687,5,0,102,91,11,8004,1,0,212,189,23,16691,6,0,6.0,0.0,6.0,4,1,5,0,0,0,0,0,0,2020-12-27 19:15:002020-12-27 19:15:002020-12-27 19:15:002020-12-27 19:15:002020-12-27 19:15:002020-12-27 19:15:002020-12-27 19:15:002020-12-27 19:15:00
3636,16193,Mikaël Silvestre,1106,"[2008, 2009]",Arsenal FC,15,13,2,1101,1,0,10,7,3,758,2,0,25,20,5,1859,3,0,0.0,0.0,0.0,1,1,2,0,0,0,0,0,0,2020-12-27 19:15:002020-12-27 19:15:00
3637,64812,Mike Pollitt,2880,"[2005, 2006, 2007, 2008, 2009, 2010, 2011, 2012]",Wigan Athletic,16,14,2,1372,0,0,20,17,3,1646,0,0,36,31,5,3018,0,0,0.0,0.0,0.0,0,0,0,0,0,0,0,0,0,2020-12-27 19:15:002020-12-27 19:15:002020-12-27 19:15:002020-12-27 19:15:002020-12-27 19:15:002020-12-27 19:15:002020-12-27 19:15:002020-12-27 19:15:00
3638,16213,Mike Whitlow,3066,"[2001, 2002]",Bolton Wanderers,24,22,2,1978,0,0,22,20,2,1832,0,0,46,42,4,3810,0,0,0.0,0.0,0.0,0,0,0,0,0,0,0,0,0,2020-12-27 19:15:002020-12-27 19:15:00
3639,48663,Mike Williamson,2287,"[2010, 2011, 2012, 2013, 2014, 2015]",Newcastle United,64,60,4,5491,1,0,69,66,3,5944,0,0,133,126,7,11435,1,0,0.0,0.0,0.0,1,0,1,0,0,0,0,0,0,2020-12-27 19:15:002020-12-27 19:15:002020-12-27 19:15:002020-12-27 19:15:002020-12-27 19:15:002020-12-27 19:15:00
3640,16229,Mike van der Hoorn,3191,"[2016, 2017]",Swansea City,17,16,1,1427,2,0,15,15,0,1186,0,0,32,31,1,2613,2,0,0.0,0.0,0.0,0,0,0,0,0,0,0,0,0,2020-12-27 19:15:002020-12-27 19:15:00
3641,8116,Mikel Alonso,3751,[2007],Bolton Wanderers,4,2,2,201,0,0,3,2,1,158,0,0,7,4,3,359,0,0,0.0,0.0,0.0,0,0,0,0,0,0,0,0,0,2020-12-27 19:15:00
3642,56840,Mikel Arteta,1802,"[2004, 2005, 2006, 2007, 2008, 2009, 2010]",Everton FC,91,86,5,7569,19,0,73,72,1,6276,8,0,164,158,6,13845,27,0,7.0,2.0,9.0,15,5,20,6,3,9,0,0,0,2020-12-27 19:15:002020-12-27 19:15:002020-12-27 19:15:002020-12-27 19:15:002020-12-27 19:15:002020-12-27 19:15:002020-12-27 19:15:00
3643,40630,Mikel Arteta,1802,"[2011, 2012, 2013, 2014, 2015]",Arsenal FC,55,49,6,4231,9,0,55,47,8,4311,5,0,110,96,14,8542,14,0,6.0,3.0,9.0,4,4,8,4,3,7,0,0,0,2020-12-27 19:15:002020-12-27 19:15:002020-12-27 19:15:002020-12-27 19:15:002020-12-27 19:15:00
3644,8129,Mikel Merino,2933,[2017],Newcastle United,13,7,6,693,1,0,11,7,4,650,0,0,24,14,10,1343,1,0,3.0,0.0,3.0,1,0,1,0,0,0,0,0,0,2020-12-27 19:15:00
3645,8130,Mikele Leigertwood,1980,[2004],Crystal Palace,10,8,2,759,1,0,10,8,2,804,0,0,20,16,4,1563,1,0,0.0,0.0,0.0,1,0,1,0,0,0,0,0,0,2020-12-27 19:15:00
3646,8131,Mikele Leigertwood,1980,[2006],Sheffield United,9,8,1,638,0,0,10,8,2,781,0,0,19,16,3,1419,0,0,0.0,0.0,0.0,0,0,0,0,0,0,0,0,0,2020-12-27 19:15:00
3647,8132,Mikele Leigertwood,1980,[2012],Reading FC,15,14,1,1295,1,0,15,15,0,1350,0,0,30,29,1,2645,1,0,0.0,0.0,0.0,1,0,1,0,0,0,0,0,0,2020-12-27 19:15:00
3648,8133,Mikkel Bischoff,4370,[2002],Manchester City,1,1,0,61,0,0,0,0,0,0,0,0,1,1,0,61,0,0,0.0,0.0,0.0,0,0,0,0,0,0,0,0,0,2020-12-27 19:15:00
3649,24405,Milan Baroš,1961,"[2002, 2003, 2004]",Liverpool FC,30,16,14,1717,9,0,36,29,7,2305,10,0,66,45,21,4022,19,0,3.0,2.0,5.0,6,7,13,3,0,3,0,0,0,2020-12-27 19:15:002020-12-27 19:15:002020-12-27 19:15:00
3650,16275,Milan Baroš,1961,"[2005, 2006]",Aston Villa,23,18,5,1531,6,0,19,16,3,1384,3,0,42,34,8,2915,9,0,6.0,4.0,10.0,4,2,6,0,1,1,0,0,0,2020-12-27 19:15:002020-12-27 19:15:00
3651,8139,Milan Baroš,1961,[2007],Portsmouth FC,7,5,2,405,0,0,5,3,2,214,0,0,12,8,4,619,0,0,0.0,0.0,0.0,0,0,0,0,0,0,0,0,0,2020-12-27 19:15:00
3652,8140,Milan Jovanović,3169,[2010],Liverpool FC,4,2,2,172,0,0,6,3,3,288,0,0,10,5,5,460,0,0,0.0,0.0,0.0,0,0,0,0,0,0,0,0,0,2020-12-27 19:15:00
3653,32570,Mile Jedinak,1030,"[2013, 2014, 2015, 2016]",Crystal Palace,47,41,6,3680,2,0,43,38,5,3414,4,0,90,79,11,7094,6,0,0.0,4.0,4.0,0,3,3,0,4,4,0,0,0,2020-12-27 19:15:002020-12-27 19:15:002020-12-27 19:15:002020-12-27 19:15:00
3654,8145,Mile Sterjovski,3597,[2007],Derby County,6,5,1,370,0,0,6,4,2,321,0,0,12,9,3,691,0,0,0.0,0.0,0.0,0,0,0,0,0,0,0,0,0,2020-12-27 19:15:00
3655,8146,Milenko Ačimovič,3736,[2002],Tottenham Hotspur,7,2,5,293,0,0,10,2,8,207,0,0,17,4,13,500,0,0,0.0,0.0,0.0,0,0,0,0,0,0,0,0,0,2020-12-27 19:15:00
3656,8147,Miles Addison,4528,[2007],Derby County,0,0,0,0,0,0,1,1,0,90,0,0,1,1,0,90,0,0,0.0,0.0,0.0,0,0,0,0,0,0,0,0,0,2020-12-27 19:15:00
3657,8148,Miloš Veljković,4357,[2013],Tottenham Hotspur,2,0,2,29,0,0,0,0,0,0,0,0,2,0,2,29,0,0,0.0,0.0,0.0,0,0,0,0,0,0,0,0,0,2020-12-27 19:15:00
3658,8149,Mineiro,4518,[2008],Chelsea FC,1,0,1,15,0,0,0,0,0,0,0,0,1,0,1,15,0,0,0.0,0.0,0.0,0,0,0,0,0,0,0,0,0,2020-12-27 19:15:00
3659,8150,Miroslav Stoch,4291,[2008],Chelsea FC,3,0,3,19,0,0,1,0,1,5,0,0,4,0,4,24,0,0,0.0,0.0,0.0,0,0,0,0,0,0,0,0,0,2020-12-27 19:15:00
3660,8151,Mitchell Beeney,4394,[2014],Chelsea FC,0,0,0,0,0,0,0,0,0,0,0,0,0,0,0,0,0,0,0.0,0.0,0.0,0,0,0,0,0,0,0,0,0,2020-12-27 19:15:00
3661,8152,Mladen Petrić,3640,[2012],Fulham FC,14,6,8,520,4,0,9,3,6,361,1,0,23,9,14,881,5,0,0.0,0.0,0.0,2,0,2,1,0,1,0,0,0,2020-12-27 19:15:00
3662,8153,Mladen Petrić,3640,[2013],West Ham United,2,0,2,35,0,0,1,0,1,31,0,0,3,0,3,66,0,0,0.0,0.0,0.0,0,0,0,0,0,0,0,0,0,2020-12-27 19:15:00
3663,8154,Mo Camara,4521,[2007],Derby County,0,0,0,0,0,0,1,1,0,63,0,0,1,1,0,63,0,0,0.0,0.0,0.0,0,0,0,0,0,0,0,0,0,2020-12-27 19:15:00
3664,8155,Modibo Diakité,4111,[2013],Sunderland AFC,2,2,0,180,0,0,5,5,0,450,0,0,7,7,0,630,0,0,0.0,0.0,0.0,0,0,0,0,0,0,0,0,0,2020-12-27 19:15:00
3665,24471,Modibo Maïga,2763,"[2012, 2013, 2015]",West Ham United,18,6,12,704,4,0,16,7,9,735,0,0,34,13,21,1439,4,0,0.0,0.0,0.0,1,0,1,0,0,0,0,0,0,2020-12-27 19:15:002020-12-27 19:15:002020-12-27 19:15:00
3666,24480,Modou Barrow,1705,"[2014, 2015, 2016]",Swansea City,30,8,22,1127,0,0,21,11,10,1081,1,0,51,19,32,2208,1,0,0.0,0.0,0.0,0,1,1,0,0,0,0,0,0,2020-12-27 19:15:002020-12-27 19:15:002020-12-27 19:15:00
3667,8162,Mohamed El Ouriachi,4154,[2015],Stoke City,0,0,0,0,0,0,0,0,0,0,0,0,0,0,0,0,0,0,0.0,0.0,0.0,0,0,0,0,0,0,0,0,0,2020-12-27 19:15:00
3668,40825,Mohamed Elneny,1865,"[2015, 2016, 2017, 2018, 2020]",Arsenal FC,28,23,5,1932,0,0,26,18,8,1524,0,0,54,41,13,3456,0,0,0.0,0.0,0.0,0,0,0,0,0,0,0,0,0,2020-12-27 19:15:002020-12-27 19:15:002020-12-27 19:15:002020-12-27 19:15:002020-12-27 19:15:00
3669,8168,Mohamed Elyounoussi,2157,[2018],Southampton FC,8,4,4,393,0,0,8,4,4,397,0,0,16,8,8,790,0,0,0.0,0.0,0.0,0,0,0,0,0,0,0,0,0,2020-12-27 19:15:00
3670,16339,Mohamed Salah,1187,"[2013, 2014]",Chelsea FC,6,3,3,245,2,0,7,3,4,285,0,0,13,6,7,530,2,0,0.0,0.0,0.0,1,0,1,0,0,0,0,0,0,2020-12-27 19:15:002020-12-27 19:15:00
3671,32690,Mohamed Salah,1187,"[2017, 2018, 2019, 2020]",Liverpool FC,63,62,1,5458,53,0,59,55,4,4785,33,0,122,117,5,10243,86,0,13.0,10.0,23.0,28,16,44,7,5,12,0,0,0,2020-12-27 19:15:002020-12-27 19:15:002020-12-27 19:15:002020-12-27 19:15:00
3672,16351,Mohamed Shawky,2635,"[2007, 2008]",Middlesbrough FC,6,4,2,302,0,0,12,10,2,800,0,0,18,14,4,1102,0,0,0.0,0.0,0.0,0,0,0,0,0,0,0,0,0,2020-12-27 19:15:002020-12-27 19:15:00
3673,24534,Mohamed Sissoko,2745,"[2005, 2006, 2007]",Liverpool FC,18,12,6,1128,0,0,33,30,3,2633,1,0,51,42,9,3761,1,0,0.0,0.0,0.0,0,1,1,0,0,0,0,0,0,2020-12-27 19:15:002020-12-27 19:15:002020-12-27 19:15:00
3674,16361,Moise Kean,1464,"[2019, 2020]",Everton FC,14,4,10,428,2,0,17,2,15,422,0,0,31,6,25,850,2,0,0.0,0.0,0.0,2,0,2,0,0,0,0,0,0,2020-12-27 19:15:002020-12-27 19:15:00
3675,8182,Molla Wagué,3226,[2017],Watford FC,3,3,0,244,1,0,3,2,1,195,0,0,6,5,1,439,1,0,0.0,0.0,0.0,1,0,1,0,0,0,0,0,0,2020-12-27 19:15:00
3676,24552,Momo Diamé,2060,"[2009, 2010, 2011]",Wigan Athletic,49,40,9,3476,2,0,47,42,5,3622,3,0,96,82,14,7098,5,0,0.0,0.0,0.0,1,3,4,0,0,0,0,0,0,2020-12-27 19:15:002020-12-27 19:15:002020-12-27 19:15:00
3677,24561,Momo Diamé,2060,"[2012, 2013, 2014]",West Ham United,37,30,7,2707,5,0,34,30,4,2439,2,0,71,60,11,5146,7,0,0.0,0.0,0.0,4,1,5,0,0,0,0,0,0,2020-12-27 19:15:002020-12-27 19:15:002020-12-27 19:15:00
3678,16379,Momo Diamé,2060,"[2017, 2018]",Newcastle United,28,22,6,1930,0,0,32,25,7,2278,2,0,60,47,13,4208,2,0,0.0,0.0,0.0,0,2,2,0,0,0,0,0,0,2020-12-27 19:15:002020-12-27 19:15:00
3679,16383,Morata,3786,"[2017, 2018]",Chelsea FC,25,19,6,1657,9,0,22,16,6,1353,7,0,47,35,12,3010,16,0,3.0,0.0,3.0,6,4,10,0,0,0,0,0,0,2020-12-27 19:15:002020-12-27 19:15:00
3680,8193,Moreira,4292,[2011],Swansea City,0,0,0,0,0,0,0,0,0,0,0,0,0,0,0,0,0,0,0.0,0.0,0.0,0,0,0,0,0,0,0,0,0,2020-12-27 19:15:00
3681,8194,Morgan Amalfitano,2301,[2013],West Bromwich Albion,14,14,0,1139,2,0,14,12,2,1014,2,0,28,26,2,2153,4,0,0.0,3.0,3.0,1,2,3,0,0,0,0,0,0,2020-12-27 19:15:00
3682,8195,Morgan Amalfitano,2301,[2014],West Ham United,10,6,4,542,3,0,14,8,6,640,0,0,24,14,10,1182,3,0,0.0,0.0,0.0,1,0,1,0,0,0,0,0,0,2020-12-27 19:15:00
3683,16393,Morgan Gibbs-White,2705,"[2018, 2019]",Wolverhampton Wanderers,19,5,14,552,0,0,14,1,13,223,0,0,33,6,27,775,0,0,0.0,0.0,0.0,0,0,0,0,0,0,0,0,0,2020-12-27 19:15:002020-12-27 19:15:00
3684,24597,Morgan Schneiderlin,1051,"[2012, 2013, 2014]",Southampton FC,48,46,2,4086,6,0,47,45,2,4070,5,0,95,91,4,8156,11,0,0.0,0.0,0.0,5,5,10,0,0,0,0,0,0,2020-12-27 19:15:002020-12-27 19:15:002020-12-27 19:15:00
3685,8201,Morgan Schneiderlin,1051,[2015],Manchester United,14,13,1,1142,0,0,15,12,3,1063,1,0,29,25,4,2205,1,0,0.0,0.0,0.0,0,1,1,0,0,0,0,0,0,2020-12-27 19:15:00
3686,32814,Morgan Schneiderlin,1051,"[2016, 2017, 2018, 2019]",Everton FC,38,31,7,2543,1,0,35,27,8,2499,0,0,73,58,15,5042,1,0,0.0,0.0,0.0,0,0,0,0,0,0,0,0,0,2020-12-27 19:15:002020-12-27 19:15:002020-12-27 19:15:002020-12-27 19:15:00
3687,16413,Morientes,3231,"[2004, 2005]",Liverpool FC,22,17,5,1563,6,0,19,15,4,1277,2,0,41,32,9,2840,8,0,0.0,0.0,0.0,3,2,5,0,0,0,0,0,0,2020-12-27 19:15:002020-12-27 19:15:00
3688,8208,Moritz Bauer,3321,[2017],Stoke City,6,6,0,519,0,0,8,8,0,700,0,0,14,14,0,1219,0,0,0.0,0.0,0.0,0,0,0,0,0,0,0,0,0,2020-12-27 19:15:00
3689,8209,Moritz Leitner,3034,[2019],Norwich City,4,4,0,307,0,0,5,3,2,379,0,0,9,7,2,686,0,0,0.0,0.0,0.0,0,0,0,0,0,0,0,0,0,2020-12-27 19:15:00
3690,41060,Moritz Volz,1078,"[2003, 2004, 2005, 2006, 2007]",Fulham FC,60,55,5,4881,0,0,59,54,5,4836,2,0,119,109,10,9717,2,0,0.0,1.0,1.0,0,2,2,0,0,0,0,0,0,2020-12-27 19:15:002020-12-27 19:15:002020-12-27 19:15:002020-12-27 19:15:002020-12-27 19:15:00
3691,57528,Morten Gamst Pedersen,2009,"[2004, 2005, 2006, 2007, 2008, 2010, 2011]",Blackburn Rovers,118,110,8,9440,20,0,106,100,6,8583,11,0,224,210,14,18023,31,0,10.0,9.0,19.0,16,9,25,0,0,0,0,0,0,2020-12-27 19:15:002020-12-27 19:15:002020-12-27 19:15:002020-12-27 19:15:002020-12-27 19:15:002020-12-27 19:15:002020-12-27 19:15:00
3692,8220,Morten Gamst Pedersen,2009,[2009],Wigan Athletic,1,0,1,14,0,0,0,0,0,0,0,0,1,0,1,14,0,0,0.0,0.0,0.0,0,0,0,0,0,0,0,0,0,2020-12-27 19:15:00
3693,8223,Moses Ashikodi,3824,[2006],Watford FC,0,0,0,0,0,0,2,0,2,21,0,0,2,0,2,21,0,0,0.0,0.0,0.0,0,0,0,0,0,0,0,0,0,2020-12-27 19:15:00
3694,16449,Moses Makasi,4482,"[2016, 2017]",West Ham United,0,0,0,0,0,0,0,0,0,0,0,0,0,0,0,0,0,0,0.0,0.0,0.0,0,0,0,0,0,0,0,0,0,2020-12-27 19:15:002020-12-27 19:15:00
3695,8226,Mouez Hassen,3140,[2016],Southampton FC,0,0,0,0,0,0,0,0,0,0,0,0,0,0,0,0,0,0,0.0,0.0,0.0,0,0,0,0,0,0,0,0,0,2020-12-27 19:15:00
3696,16455,Mousa Dembélé,1172,"[2010, 2011]",Fulham FC,29,26,3,2338,4,0,31,29,2,2522,1,0,60,55,5,4860,5,0,6.0,0.0,6.0,3,0,3,0,0,0,0,0,0,2020-12-27 19:15:002020-12-27 19:15:00
3697,57624,Mousa Dembélé,1172,"[2012, 2013, 2014, 2015, 2016, 2017, 2018]",Tottenham Hotspur,89,68,21,5938,5,0,92,69,23,5971,2,0,181,137,44,11909,7,0,0.0,0.0,0.0,4,2,6,0,0,0,0,0,0,2020-12-27 19:15:002020-12-27 19:15:002020-12-27 19:15:002020-12-27 19:15:002020-12-27 19:15:002020-12-27 19:15:002020-12-27 19:15:00
3698,8236,Moussa Dembélé,4226,[2013],Fulham FC,1,1,0,81,0,0,1,0,1,7,0,0,2,1,1,88,0,0,0.0,0.0,0.0,0,0,0,0,0,0,0,0,0,2020-12-27 19:15:00
3699,16475,Moussa Djénépo,2479,"[2019, 2020]",Southampton FC,16,12,4,1040,1,0,13,6,7,541,2,0,29,18,11,1581,3,0,0.0,3.0,3.0,1,2,3,0,0,0,0,0,0,2020-12-27 19:15:002020-12-27 19:15:00
3700,32962,Moussa Sissoko,1858,"[2012, 2013, 2014, 2015]",Newcastle United,59,59,0,5213,9,0,59,59,0,5167,2,0,118,118,0,10380,11,0,9.0,0.0,9.0,7,1,8,0,0,0,0,0,0,2020-12-27 19:15:002020-12-27 19:15:002020-12-27 19:15:002020-12-27 19:15:00
3701,41225,Moussa Sissoko,1858,"[2016, 2017, 2018, 2019, 2020]",Tottenham Hotspur,64,43,21,4013,2,0,65,46,19,4120,1,0,129,89,40,8133,3,0,0.0,0.0,0.0,0,0,0,0,0,0,0,0,0,2020-12-27 19:15:002020-12-27 19:15:002020-12-27 19:15:002020-12-27 19:15:002020-12-27 19:15:00
3702,8248,Moustapha Salifou,3126,[2007],Aston Villa,1,0,1,1,0,0,3,0,3,43,0,0,4,0,4,44,0,0,0.0,0.0,0.0,0,0,0,0,0,0,0,0,0,2020-12-27 19:15:00
3703,8249,Muamer Tanković,3687,[2013],Fulham FC,1,0,1,7,0,0,2,1,1,53,0,0,3,1,2,60,0,0,0.0,0.0,0.0,0,0,0,0,0,0,0,0,0,2020-12-27 19:15:00
3704,33006,Muhamed Bešić,2236,"[2014, 2015, 2016, 2017]",Everton FC,20,11,9,894,0,0,17,11,6,993,0,0,37,22,15,1887,0,0,0.0,0.0,0.0,0,0,0,0,0,0,0,0,0,2020-12-27 19:15:002020-12-27 19:15:002020-12-27 19:15:002020-12-27 19:15:00
3705,8254,Muhamed Bešić,2236,[2019],Sheffield United,3,1,2,102,0,0,6,1,5,143,0,0,9,2,7,245,0,0,0.0,0.0,0.0,0,0,0,0,0,0,0,0,0,2020-12-27 19:15:00
3706,8255,Muhamed Konjić,3985,[2000],Coventry City,4,4,0,296,0,0,3,3,0,193,0,0,7,7,0,489,0,0,0.0,0.0,0.0,0,0,0,0,0,0,0,0,0,2020-12-27 19:15:00
3707,33030,Muniesa,1556,"[2013, 2014, 2015, 2016]",Stoke City,27,19,8,1923,1,0,30,21,9,2049,0,0,57,40,17,3972,1,0,0.0,0.0,0.0,0,0,0,0,0,0,0,0,0,2020-12-27 19:15:002020-12-27 19:15:002020-12-27 19:15:002020-12-27 19:15:00
3708,8260,Mustapha Hadji,2103,[2000],Leeds United,1,1,0,90,0,0,0,0,0,0,0,0,1,1,0,90,0,0,0.0,0.0,0.0,0,0,0,0,0,0,0,0,0,2020-12-27 19:15:00
3709,24786,Mustapha Hadji,2103,"[2001, 2002, 2003]",Aston Villa,18,11,7,1065,0,0,17,13,4,1135,2,0,35,24,11,2200,2,0,0.0,0.0,0.0,0,0,0,0,0,0,0,0,0,2020-12-27 19:15:002020-12-27 19:15:002020-12-27 19:15:00
3710,24795,Muzzy Izzet,2682,"[2000, 2001, 2003]",Leicester City,46,45,1,3908,8,0,42,41,1,3574,5,0,88,86,2,7482,13,0,0.0,3.0,3.0,5,4,9,2,2,4,0,0,0,2020-12-27 19:15:002020-12-27 19:15:002020-12-27 19:15:00
3711,16535,Muzzy Izzet,2682,"[2004, 2005]",Birmingham City,14,10,4,856,0,0,12,10,2,933,1,0,26,20,6,1789,1,0,0.0,1.0,1.0,0,1,1,0,0,0,0,0,0,2020-12-27 19:15:002020-12-27 19:15:00
3712,8269,Myles Anderson,4146,[2011],Blackburn Rovers,0,0,0,0,0,0,0,0,0,0,0,0,0,0,0,0,0,0,0.0,0.0,0.0,0,0,0,0,0,0,0,0,0,2020-12-27 19:15:00
3713,24813,Márton Fülöp,1213,"[2007, 2008, 2009]",Sunderland AFC,19,19,0,1710,0,0,20,19,1,1733,0,0,39,38,1,3443,0,0,0.0,0.0,0.0,0,0,0,0,0,0,0,0,0,2020-12-27 19:15:002020-12-27 19:15:002020-12-27 19:15:00
3714,8273,Márton Fülöp,1213,[2011],West Bromwich Albion,1,1,0,90,0,0,0,0,0,0,0,0,1,1,0,90,0,0,0.0,0.0,0.0,0,0,0,0,0,0,0,0,0,2020-12-27 19:15:00
3715,16549,Míchel,3338,"[2009, 2010]",Birmingham City,3,0,3,50,0,0,6,3,3,255,0,0,9,3,6,305,0,0,0.0,0.0,0.0,0,0,0,0,0,0,0,0,0,2020-12-27 19:15:002020-12-27 19:15:00
3716,8276,Míchel Salgado,2655,[2009],Wigan Athletic,1,1,0,76,0,0,0,0,0,0,0,0,1,1,0,76,0,0,0.0,0.0,0.0,0,0,0,0,0,0,0,0,0,2020-12-27 19:15:00
3717,16555,Míchel Salgado,2655,"[2010, 2011]",Blackburn Rovers,22,22,0,1854,0,0,23,23,0,1834,0,0,45,45,0,3688,0,0,0.0,0.0,0.0,0,0,0,0,0,0,0,0,0,2020-12-27 19:15:002020-12-27 19:15:00
3718,8279,N'Golo Kanté,1848,[2015],Leicester City,18,15,3,1376,1,0,19,18,1,1644,0,0,37,33,4,3020,1,0,0.0,0.0,0.0,1,0,1,0,0,0,0,0,0,2020-12-27 19:15:00
3719,41410,N'Golo Kanté,1848,"[2016, 2017, 2018, 2019, 2020]",Chelsea FC,72,71,1,6138,4,0,70,69,1,6155,5,0,142,140,2,12293,9,0,0.0,3.0,3.0,2,3,5,0,0,0,0,0,0,2020-12-27 19:15:002020-12-27 19:15:002020-12-27 19:15:002020-12-27 19:15:002020-12-27 19:15:00
3720,8285,Nabil Abidallah,3768,[2000],Ipswich Town,2,0,2,14,0,0,0,0,0,0,0,0,2,0,2,14,0,0,0.0,0.0,0.0,0,0,0,0,0,0,0,0,0,2020-12-27 19:15:00
3721,24861,Nabil Bentaleb,1167,"[2013, 2014, 2015]",Tottenham Hotspur,22,19,3,1712,0,0,24,19,5,1730,0,0,46,38,8,3442,0,0,0.0,0.0,0.0,0,0,0,0,0,0,0,0,0,2020-12-27 19:15:002020-12-27 19:15:002020-12-27 19:15:00
3722,8289,Nabil Bentaleb,1167,[2019],Newcastle United,6,3,3,287,0,0,6,5,1,462,0,0,12,8,4,749,0,0,0.0,0.0,0.0,0,0,0,0,0,0,0,0,0,2020-12-27 19:15:00
3723,24873,Nabil El Zhar,1896,"[2006, 2008, 2009]",Liverpool FC,11,0,11,141,0,0,10,2,8,235,0,0,21,2,19,376,0,0,0.0,0.0,0.0,0,0,0,0,0,0,0,0,0,2020-12-27 19:15:002020-12-27 19:15:002020-12-27 19:15:00
3724,24882,Naby Keïta,2087,"[2018, 2019, 2020]",Liverpool FC,25,14,11,1215,2,0,25,17,8,1403,2,0,50,31,19,2618,4,0,0.0,0.0,0.0,2,1,3,0,0,0,0,0,0,2020-12-27 19:15:002020-12-27 19:15:002020-12-27 19:15:00
3725,24891,Nacer Chadli,1170,"[2013, 2014, 2015]",Tottenham Hotspur,43,28,15,2432,8,0,45,25,20,2364,7,0,88,53,35,4796,15,0,0.0,1.0,1.0,4,5,9,0,0,0,0,0,0,2020-12-27 19:15:002020-12-27 19:15:002020-12-27 19:15:00
3726,16599,Nacer Chadli,1170,"[2016, 2017]",West Bromwich Albion,17,14,3,1151,3,0,19,15,4,1242,3,0,36,29,7,2393,6,0,0.0,0.0,0.0,2,3,5,1,0,1,0,0,0,2020-12-27 19:15:002020-12-27 19:15:00
3727,66436,Nacho Monreal,1498,"[2012, 2013, 2014, 2015, 2016, 2017, 2018, 2019]",Arsenal FC,90,81,9,7165,4,0,96,87,9,7806,3,0,186,168,18,14971,7,0,0.0,0.0,0.0,4,3,7,0,0,0,0,0,0,2020-12-27 19:15:002020-12-27 19:15:002020-12-27 19:15:002020-12-27 19:15:002020-12-27 19:15:002020-12-27 19:15:002020-12-27 19:15:002020-12-27 19:15:00
3728,16619,Nadir Belhadj,2811,"[2008, 2009]",Portsmouth FC,26,19,7,1839,3,0,22,18,4,1576,2,0,48,37,11,3415,5,0,0.0,0.0,0.0,2,1,3,0,0,0,0,0,0,2020-12-27 19:15:002020-12-27 19:15:00
3729,8311,Nahki Wells,2376,[2017],Burnley FC,5,0,5,22,0,0,4,0,4,24,0,0,9,0,9,46,0,0,0.0,0.0,0.0,0,0,0,0,0,0,0,0,0,2020-12-27 19:15:00
3730,33254,Nampalys Mendy,2945,"[2016, 2018, 2019, 2020]",Leicester City,28,21,7,1759,0,0,27,22,5,1912,0,0,55,43,12,3671,0,0,0.0,0.0,0.0,0,0,0,0,0,0,0,0,0,2020-12-27 19:15:002020-12-27 19:15:002020-12-27 19:15:002020-12-27 19:15:00
3731,66556,Nani,2258,"[2007, 2008, 2009, 2010, 2011, 2012, 2013, 2014]",Manchester United,73,59,14,5047,19,0,73,51,22,4718,6,0,146,110,36,9765,25,0,6.0,3.0,9.0,6,4,10,0,0,0,0,0,0,2020-12-27 19:15:002020-12-27 19:15:002020-12-27 19:15:002020-12-27 19:15:002020-12-27 19:15:002020-12-27 19:15:002020-12-27 19:15:002020-12-27 19:15:00
3732,33303,Nathan Aké,1037,"[2012, 2013, 2014, 2016]",Chelsea FC,2,2,0,180,0,0,5,0,5,38,0,0,7,2,5,218,0,0,0.0,0.0,0.0,0,0,0,0,0,0,0,0,0,2020-12-27 19:15:002020-12-27 19:15:002020-12-27 19:15:002020-12-27 19:15:00
3733,8327,Nathan Aké,1037,[2015],Watford FC,12,10,2,945,1,0,12,10,2,954,0,0,24,20,4,1899,1,0,0.0,0.0,0.0,1,0,1,0,0,0,0,0,0,2020-12-27 19:15:00
3734,24990,Nathan Aké,1037,"[2017, 2018, 2019]",AFC Bournemouth,54,54,0,4755,5,0,51,50,1,4515,3,0,105,104,1,9270,8,0,4.0,0.0,4.0,3,1,4,0,0,0,0,0,0,2020-12-27 19:15:002020-12-27 19:15:002020-12-27 19:15:00
3735,8332,Nathan Aké,1037,[2020],Manchester City,4,4,0,360,1,0,2,1,1,109,0,0,6,5,1,469,1,0,0.0,0.0,0.0,0,0,0,0,0,0,0,0,0,2020-12-27 19:15:00
3736,8333,Nathan Ashton,4508,[2007],Fulham FC,1,1,0,90,0,0,0,0,0,0,0,0,1,1,0,90,0,0,0.0,0.0,0.0,0,0,0,0,0,0,0,0,0,2020-12-27 19:15:00
3737,50019,Nathan Baker,1973,"[2010, 2011, 2012, 2013, 2014, 2015]",Aston Villa,41,38,3,3146,0,0,37,33,4,2808,0,0,78,71,7,5954,0,0,0.0,0.0,0.0,0,0,0,0,0,0,0,0,0,2020-12-27 19:15:002020-12-27 19:15:002020-12-27 19:15:002020-12-27 19:15:002020-12-27 19:15:002020-12-27 19:15:00
3738,8340,Nathan Blake,2908,[2001],Blackburn Rovers,2,0,2,88,0,0,1,0,1,27,1,0,3,0,3,115,1,0,0.0,0.0,0.0,0,0,0,0,0,0,0,0,0,2020-12-27 19:15:00
3739,8341,Nathan Blake,2908,[2003],Wolverhampton Wanderers,6,5,1,508,1,0,7,5,2,494,0,0,13,10,3,1002,1,0,0.0,0.0,0.0,1,0,1,0,0,0,0,0,0,2020-12-27 19:15:00
3740,41720,Nathan Delfouneso,2175,"[2008, 2009, 2010, 2011, 2012]",Aston Villa,21,3,18,559,1,0,10,1,9,308,1,0,31,4,27,867,2,0,0.0,3.0,3.0,1,1,2,0,0,0,0,0,0,2020-12-27 19:15:002020-12-27 19:15:002020-12-27 19:15:002020-12-27 19:15:002020-12-27 19:15:00
3741,8347,Nathan Doyle,3049,[2008],Hull City,2,2,0,157,0,0,1,0,1,56,0,0,3,2,1,213,0,0,0.0,0.0,0.0,0,0,0,0,0,0,0,0,0,2020-12-27 19:15:00
3742,58457,Nathan Dyer,1702,"[2011, 2012, 2013, 2014, 2015, 2016, 2017]",Swansea City,84,59,25,5238,10,0,79,56,23,4664,7,0,163,115,48,9902,17,0,3.0,1.0,4.0,5,4,9,0,0,0,0,0,0,2020-12-27 19:15:002020-12-27 19:15:002020-12-27 19:15:002020-12-27 19:15:002020-12-27 19:15:002020-12-27 19:15:002020-12-27 19:15:00
3743,25068,Nathan Eccleston,4296,"[2009, 2010, 2011]",Liverpool FC,0,0,0,0,0,0,2,0,2,22,0,0,2,0,2,22,0,0,0.0,0.0,0.0,0,0,0,0,0,0,0,0,0,2020-12-27 19:15:002020-12-27 19:15:002020-12-27 19:15:00
3744,8358,Nathan Ellington,3857,[2005],West Bromwich Albion,16,8,8,795,3,0,14,6,8,648,2,0,30,14,16,1443,5,0,0.0,1.0,1.0,1,2,3,1,0,1,0,0,0,2020-12-27 19:15:00
3745,8359,Nathan Ferguson,4550,[2017],West Bromwich Albion,0,0,0,0,0,0,0,0,0,0,0,0,0,0,0,0,0,0,0.0,0.0,0.0,0,0,0,0,0,0,0,0,0,2020-12-27 19:15:00
3746,25083,Nathan Holland,2211,"[2016, 2018, 2019]",West Ham United,1,0,1,12,0,0,1,0,1,19,0,0,2,0,2,31,0,0,0.0,0.0,0.0,0,0,0,0,0,0,0,0,0,2020-12-27 19:15:002020-12-27 19:15:002020-12-27 19:15:00
3747,8363,Nathan Ofoborh,3939,[2018],AFC Bournemouth,0,0,0,0,0,0,0,0,0,0,0,0,0,0,0,0,0,0,0.0,0.0,0.0,0,0,0,0,0,0,0,0,0,2020-12-27 19:15:00
3748,8364,Nathan Redmond,1244,[2010],Birmingham City,0,0,0,0,0,0,0,0,0,0,0,0,0,0,0,0,0,0,0.0,0.0,0.0,0,0,0,0,0,0,0,0,0,2020-12-27 19:15:00
3749,16731,Nathan Redmond,1244,"[2013, 2015]",Norwich City,35,24,11,2288,4,0,34,23,11,2205,3,0,69,47,22,4493,7,0,3.0,0.0,3.0,2,1,3,0,0,0,0,0,0,2020-12-27 19:15:002020-12-27 19:15:00
3750,41845,Nathan Redmond,1244,"[2016, 2017, 2018, 2019, 2020]",Southampton FC,71,61,10,5492,8,0,76,64,12,5834,11,0,147,125,22,11326,19,0,1.0,0.0,1.0,6,6,12,0,0,0,0,0,0,2020-12-27 19:15:002020-12-27 19:15:002020-12-27 19:15:002020-12-27 19:15:002020-12-27 19:15:00
3751,8372,Nathan Rooney,4436,[2010],Wolverhampton Wanderers,0,0,0,0,0,0,0,0,0,0,0,0,0,0,0,0,0,0,0.0,0.0,0.0,0,0,0,0,0,0,0,0,0,2020-12-27 19:15:00
3752,16747,Nathan Tella,4230,"[2019, 2020]",Southampton FC,2,0,2,71,0,0,3,0,3,28,0,0,5,0,5,99,0,0,0.0,0.0,0.0,0,0,0,0,0,0,0,0,0,2020-12-27 19:15:002020-12-27 19:15:00
3753,8375,Nathan Trott,3955,[2017],West Ham United,0,0,0,0,0,0,0,0,0,0,0,0,0,0,0,0,0,0,0.0,0.0,0.0,0,0,0,0,0,0,0,0,0,2020-12-27 19:15:00
3754,16754,Nathaniel Chalobah,2330,"[2011, 2016]",Chelsea FC,6,1,5,142,0,0,4,0,4,17,0,0,10,1,9,159,0,0,0.0,0.0,0.0,0,0,0,0,0,0,0,0,0,2020-12-27 19:15:002020-12-27 19:15:00
3755,8377,Nathaniel Chalobah,2330,[2014],Burnley FC,2,0,2,11,0,0,2,0,2,54,0,0,4,0,4,65,0,0,0.0,0.0,0.0,0,0,0,0,0,0,0,0,0,2020-12-27 19:15:00
3756,25140,Nathaniel Chalobah,2330,"[2017, 2018, 2019]",Watford FC,18,9,9,770,0,0,19,9,10,900,0,0,37,18,19,1670,0,0,0.0,0.0,0.0,0,0,0,0,0,0,0,0,0,2020-12-27 19:15:002020-12-27 19:15:002020-12-27 19:15:00
3757,25149,Nathaniel Clyne,1144,"[2012, 2013, 2014]",Southampton FC,47,44,3,4029,1,0,47,45,2,3997,2,0,94,89,5,8026,3,0,0.0,1.0,1.0,1,2,3,0,0,0,0,0,0,2020-12-27 19:15:002020-12-27 19:15:002020-12-27 19:15:00
3758,25158,Nathaniel Clyne,1144,"[2015, 2016, 2017]",Liverpool FC,37,36,1,3259,0,0,35,35,0,3119,1,0,72,71,1,6378,1,0,0.0,0.0,0.0,0,0,0,0,0,0,0,0,0,2020-12-27 19:15:002020-12-27 19:15:002020-12-27 19:15:00
3759,8388,Nathaniel Clyne,1144,[2018],AFC Bournemouth,7,7,0,579,0,0,7,6,1,567,0,0,14,13,1,1146,0,0,0.0,0.0,0.0,0,0,0,0,0,0,0,0,0,2020-12-27 19:15:00
3760,8389,Nathaniel Clyne,1144,[2020],Crystal Palace,4,4,0,360,0,0,4,4,0,342,0,0,8,8,0,702,0,0,0.0,0.0,0.0,0,0,0,0,0,0,0,0,0,2020-12-27 19:15:00
3761,8390,Nathaniel Mendez-Laing,3153,[2018],Cardiff City,9,5,4,443,0,0,11,6,5,542,4,0,20,11,9,985,4,0,0.0,0.0,0.0,0,2,2,0,1,1,0,0,0,2020-12-27 19:15:00
3762,16783,Nathaniel Phillips,4012,"[2019, 2020]",Liverpool FC,1,1,0,90,0,0,1,1,0,90,0,0,2,2,0,180,0,0,0.0,0.0,0.0,0,0,0,0,0,0,0,0,0,2020-12-27 19:15:002020-12-27 19:15:00
3763,33578,Nayron Nosworthy,1214,"[2005, 2007, 2008, 2009]",Sunderland AFC,42,38,4,3367,0,0,41,36,5,3369,0,0,83,74,9,6736,0,0,0.0,0.0,0.0,0,0,0,0,0,0,0,0,0,2020-12-27 19:15:002020-12-27 19:15:002020-12-27 19:15:002020-12-27 19:15:00
3764,8397,Neal Eardley,2609,[2010],Blackpool FC,17,16,1,1413,1,0,14,14,0,1149,0,0,31,30,1,2562,1,0,0.0,0.0,0.0,1,0,1,0,0,0,0,0,0,2020-12-27 19:15:00
3765,16797,Neal Maupay,2424,"[2019, 2020]",Brighton & Hove Albion,26,21,5,1920,6,0,24,21,3,1857,9,0,50,42,8,3777,15,0,3.0,4.0,7.0,6,7,13,2,1,3,0,0,0,2020-12-27 19:15:002020-12-27 19:15:00
3766,16801,Neco Williams,2306,"[2019, 2020]",Liverpool FC,5,2,3,191,0,0,5,3,2,213,0,0,10,5,5,404,0,0,0.0,0.0,0.0,0,0,0,0,0,0,0,0,0,2020-12-27 19:15:002020-12-27 19:15:00
3767,50427,Nedum Onuoha,2533,"[2004, 2005, 2006, 2007, 2008, 2009]",Manchester City,48,34,14,3262,3,0,44,36,8,3332,0,0,92,70,22,6594,3,0,3.0,0.0,3.0,1,0,1,0,0,0,0,0,0,2020-12-27 19:15:002020-12-27 19:15:002020-12-27 19:15:002020-12-27 19:15:002020-12-27 19:15:002020-12-27 19:15:00
3768,8408,Nedum Onuoha,2533,[2010],Sunderland AFC,16,16,0,1345,0,0,15,15,0,1324,1,0,31,31,0,2669,1,0,0.0,0.0,0.0,0,1,1,0,0,0,0,0,0,2020-12-27 19:15:00
3769,25230,Nedum Onuoha,2533,"[2011, 2012, 2014]",Queens Park Rangers,31,27,4,2472,0,0,31,26,5,2511,0,0,62,53,9,4983,0,0,0.0,0.0,0.0,0,0,0,0,0,0,0,0,0,2020-12-27 19:15:002020-12-27 19:15:002020-12-27 19:15:00
3770,16825,Neeskens Kebano,3914,"[2018, 2020]",Fulham FC,8,1,7,150,0,0,4,0,4,68,0,0,12,1,11,218,0,0,0.0,0.0,0.0,0,0,0,0,0,0,0,0,0,2020-12-27 19:15:002020-12-27 19:15:00
3771,8414,Neil Alexander,3132,[2013],Crystal Palace,0,0,0,0,0,0,0,0,0,0,0,0,0,0,0,0,0,0,0.0,0.0,0.0,0,0,0,0,0,0,0,0,0,2020-12-27 19:15:00
3772,25248,Neil Clement,1320,"[2002, 2004, 2005]",West Bromwich Albion,50,48,2,4339,5,0,51,49,2,4502,2,0,101,97,4,8841,7,0,1.0,0.0,1.0,4,2,6,0,0,0,0,0,0,2020-12-27 19:15:002020-12-27 19:15:002020-12-27 19:15:00
3773,16837,Neil Danns,4186,"[2002, 2003]",Blackburn Rovers,3,1,2,62,0,0,0,0,0,0,0,0,3,1,2,62,0,0,0.0,0.0,0.0,0,0,0,0,0,0,0,0,0,2020-12-27 19:15:002020-12-27 19:15:00
3774,8420,Neil Danns,4186,[2007],Birmingham City,0,0,0,0,0,0,2,0,2,21,0,0,2,0,2,21,0,0,0.0,0.0,0.0,0,0,0,0,0,0,0,0,0,2020-12-27 19:15:00
3775,33690,Neil Etheridge,3142,"[2010, 2011, 2012, 2013]",Fulham FC,0,0,0,0,0,0,0,0,0,0,0,0,0,0,0,0,0,0,0.0,0.0,0.0,0,0,0,0,0,0,0,0,0,2020-12-27 19:15:002020-12-27 19:15:002020-12-27 19:15:002020-12-27 19:15:00
3776,8425,Neil Etheridge,3142,[2018],Cardiff City,19,19,0,1710,0,0,19,19,0,1710,0,0,38,38,0,3420,0,0,0.0,0.0,0.0,0,0,0,0,0,0,0,0,0,2020-12-27 19:15:00
3777,8426,Neil Kilkenny,2776,[2005],Birmingham City,9,1,8,248,0,0,9,5,4,427,0,0,18,6,12,675,0,0,0.0,0.0,0.0,0,0,0,0,0,0,0,0,0,2020-12-27 19:15:00
3778,8427,Neil Lennon,3696,[2000],Leicester City,7,7,0,586,0,0,8,8,0,720,0,0,15,15,0,1306,0,0,0.0,0.0,0.0,0,0,0,0,0,0,0,0,0,2020-12-27 19:15:00
3779,16857,Neil McCann,2916,"[2003, 2004]",Southampton FC,14,5,9,581,0,0,13,8,5,745,0,0,27,13,14,1326,0,0,0.0,0.0,0.0,0,0,0,0,0,0,0,0,0,2020-12-27 19:15:002020-12-27 19:15:00
3780,16861,Neil Mellor,3391,"[2002, 2004]",Liverpool FC,7,4,3,326,2,0,5,3,2,254,0,0,12,7,5,580,2,0,3.0,0.0,3.0,2,0,2,0,0,0,0,0,0,2020-12-27 19:15:002020-12-27 19:15:00
3781,8432,Neil Mellor,3391,[2005],Wigan Athletic,1,1,0,90,0,0,2,2,0,155,1,0,3,3,0,245,1,0,0.0,3.0,3.0,0,1,1,0,0,0,0,0,0,2020-12-27 19:15:00
3782,16867,Neil Moss,4068,"[2000, 2001]",Southampton FC,2,2,0,180,0,0,3,3,0,270,0,0,5,5,0,450,0,0,0.0,0.0,0.0,0,0,0,0,0,0,0,0,0,2020-12-27 19:15:002020-12-27 19:15:00
3783,8435,Neil Shipperley,3828,[2004],Crystal Palace,0,0,0,0,0,0,1,0,1,13,0,0,1,0,1,13,0,0,0.0,0.0,0.0,0,0,0,0,0,0,0,0,0,2020-12-27 19:15:00
3784,16873,Neil Sullivan,2076,"[2000, 2001]",Tottenham Hotspur,32,32,0,2880,0,0,30,30,0,2700,0,0,62,62,0,5580,0,0,0.0,0.0,0.0,0,0,0,0,0,0,0,0,0,2020-12-27 19:15:002020-12-27 19:15:00
3785,8438,Neil Sullivan,2076,[2003],Chelsea FC,2,2,0,180,0,0,1,1,0,90,0,0,3,3,0,270,0,0,0.0,0.0,0.0,0,0,0,0,0,0,0,0,0,2020-12-27 19:15:00
3786,50649,Neil Taylor,1695,"[2011, 2012, 2013, 2014, 2015, 2016]",Swansea City,66,60,6,5368,0,0,65,63,2,5452,0,0,131,123,8,10820,0,0,0.0,0.0,0.0,0,0,0,0,0,0,0,0,0,2020-12-27 19:15:002020-12-27 19:15:002020-12-27 19:15:002020-12-27 19:15:002020-12-27 19:15:002020-12-27 19:15:00
3787,16891,Neil Taylor,1695,"[2019, 2020]",Aston Villa,8,6,2,594,0,0,6,5,1,495,0,0,14,11,3,1089,0,0,0.0,0.0,0.0,0,0,0,0,0,0,0,0,0,2020-12-27 19:15:002020-12-27 19:15:00
3788,8447,Nelson Vivas,4122,[2000],Arsenal FC,6,1,5,201,0,0,6,2,4,220,0,0,12,3,9,421,0,0,0.0,0.0,0.0,0,0,0,0,0,0,0,0,0,2020-12-27 19:15:00
3789,42250,Nemanja Matić,1537,"[2009, 2013, 2014, 2015, 2016]",Chelsea FC,63,52,11,4772,1,0,60,56,4,4955,3,0,123,108,15,9727,4,0,0.0,0.0,0.0,0,1,1,0,0,0,0,0,0,2020-12-27 19:15:002020-12-27 19:15:002020-12-27 19:15:002020-12-27 19:15:002020-12-27 19:15:00
3790,33818,Nemanja Matić,1537,"[2017, 2018, 2019, 2020]",Manchester United,42,41,1,3599,1,0,50,45,5,3979,1,0,92,86,6,7578,2,0,0.0,3.0,3.0,1,1,2,0,0,0,0,0,0,2020-12-27 19:15:002020-12-27 19:15:002020-12-27 19:15:002020-12-27 19:15:00
3791,76149,Nemanja Vidić,1725,"[2005, 2006, 2007, 2008, 2009, 2010, 2011, 2012, 2013]",Manchester United,106,101,5,8924,9,0,104,103,1,9093,6,0,210,204,6,18017,15,0,3.0,4.0,7.0,3,4,7,0,0,0,0,0,0,2020-12-27 19:15:002020-12-27 19:15:002020-12-27 19:15:002020-12-27 19:15:002020-12-27 19:15:002020-12-27 19:15:002020-12-27 19:15:002020-12-27 19:15:002020-12-27 19:15:00
3792,25401,Nenad Milijaš,2890,"[2009, 2010, 2011]",Wolverhampton Wanderers,34,19,15,1833,3,0,27,19,8,1588,1,0,61,38,23,3421,4,0,0.0,0.0,0.0,2,1,3,0,0,0,0,0,0,2020-12-27 19:15:002020-12-27 19:15:002020-12-27 19:15:00
3793,8469,Nenê,3448,[2014],West Ham United,5,0,5,73,0,0,3,0,3,54,0,0,8,0,8,127,0,0,0.0,0.0,0.0,0,0,0,0,0,0,0,0,0,2020-12-27 19:15:00
3794,8470,Nery Castillo,4183,[2007],Manchester City,3,1,2,113,0,0,4,1,3,180,0,0,7,2,5,293,0,0,0.0,0.0,0.0,0,0,0,0,0,0,0,0,0,2020-12-27 19:15:00
3795,8471,Niall Mason,4457,[2015],Aston Villa,0,0,0,0,0,0,0,0,0,0,0,0,0,0,0,0,0,0,0.0,0.0,0.0,0,0,0,0,0,0,0,0,0,2020-12-27 19:15:00
3796,25419,Niall Quinn,1099,"[2000, 2001, 2002]",Sunderland AFC,35,24,11,2031,7,0,35,22,13,2064,6,0,70,46,24,4095,13,0,7.0,6.0,13.0,5,4,9,0,0,0,0,0,0,2020-12-27 19:15:002020-12-27 19:15:002020-12-27 19:15:00
3797,16951,Nick Barmby,2133,"[2000, 2001]",Liverpool FC,19,13,6,1210,2,0,12,9,3,788,0,0,31,22,9,1998,2,0,0.0,0.0,0.0,1,0,1,0,0,0,0,0,0,2020-12-27 19:15:002020-12-27 19:15:00
3798,16955,Nick Barmby,2133,"[2002, 2003]",Leeds United,12,8,4,665,2,0,13,9,4,833,2,0,25,17,8,1498,4,0,0.0,0.0,0.0,2,1,3,0,0,0,0,0,0,2020-12-27 19:15:002020-12-27 19:15:00
3799,16959,Nick Barmby,2133,"[2008, 2009]",Hull City,20,10,10,958,1,0,21,9,12,893,0,0,41,19,22,1851,1,0,0.0,0.0,0.0,1,0,1,0,0,0,0,0,0,2020-12-27 19:15:002020-12-27 19:15:00
3800,8481,Nick Blackman,3744,[2011],Blackburn Rovers,1,0,1,6,0,0,0,0,0,0,0,0,1,0,1,6,0,0,0.0,0.0,0.0,0,0,0,0,0,0,0,0,0,2020-12-27 19:15:00
3801,8482,Nick Blackman,3744,[2012],Reading FC,5,1,4,144,0,0,6,2,4,245,0,0,11,3,8,389,0,0,0.0,0.0,0.0,0,0,0,0,0,0,0,0,0,2020-12-27 19:15:00
3802,25452,Nick Chadwick,4174,"[2001, 2002, 2003]",Everton FC,6,1,5,178,3,0,7,2,5,185,0,0,13,3,10,363,3,0,0.0,0.0,0.0,1,0,1,0,0,0,0,0,0,2020-12-27 19:15:002020-12-27 19:15:002020-12-27 19:15:00
3803,8486,Nick Montgomery,3664,[2006],Sheffield United,11,10,1,942,0,0,13,10,3,867,0,0,24,20,4,1809,0,0,0.0,0.0,0.0,0,0,0,0,0,0,0,0,0,2020-12-27 19:15:00
3804,33954,Nick Pope,2346,"[2016, 2017, 2019, 2020]",Burnley FC,43,42,1,3834,0,0,43,43,0,3870,0,0,86,85,1,7704,0,0,0.0,0.0,0.0,0,0,0,0,0,0,0,0,0,2020-12-27 19:15:002020-12-27 19:15:002020-12-27 19:15:002020-12-27 19:15:00
3805,16984,Nick Powell,2876,"[2012, 2015]",Manchester United,2,0,2,30,1,0,1,0,1,16,0,0,3,0,3,46,1,0,0.0,0.0,0.0,0,0,0,0,0,0,0,0,0,2020-12-27 19:15:002020-12-27 19:15:00
3806,8492,Nick Powell,2876,[2014],Leicester City,2,0,2,26,0,0,1,0,1,14,0,0,3,0,3,40,0,0,0.0,0.0,0.0,0,0,0,0,0,0,0,0,0,2020-12-27 19:15:00
3807,8494,Nick Proschwitz,3796,[2013],Hull City,1,0,1,20,0,0,1,0,1,3,0,0,2,0,2,23,0,0,0.0,0.0,0.0,0,0,0,0,0,0,0,0,0,2020-12-27 19:15:00
3808,42486,Nicklas Bendtner,1236,"[2007, 2008, 2009, 2010, 2013]",Arsenal FC,51,18,33,2036,11,0,56,23,33,2548,13,0,107,41,66,4584,24,0,14.0,3.0,17.0,9,8,17,0,1,1,0,0,0,2020-12-27 19:15:002020-12-27 19:15:002020-12-27 19:15:002020-12-27 19:15:002020-12-27 19:15:00
3809,8499,Nicklas Bendtner,1236,[2011],Sunderland AFC,14,14,0,1151,4,0,14,11,3,1080,4,0,28,25,3,2231,8,0,3.0,0.0,3.0,3,3,6,0,1,1,0,0,0,2020-12-27 19:15:00
3810,8501,Nicklas Helenius,1450,[2013],Aston Villa,2,0,2,20,0,0,1,0,1,30,0,0,3,0,3,50,0,0,0.0,0.0,0.0,0,0,0,0,0,0,0,0,0,2020-12-27 19:15:00
3811,34014,Nicky Butt,1115,"[2000, 2001, 2002, 2003]",Manchester United,49,37,12,3235,2,0,40,30,10,2571,3,0,89,67,22,5806,5,0,0.0,0.0,0.0,2,2,4,0,0,0,0,0,0,2020-12-27 19:15:002020-12-27 19:15:002020-12-27 19:15:002020-12-27 19:15:00
3812,34033,Nicky Butt,1115,"[2004, 2006, 2007, 2008]",Newcastle United,57,54,3,4582,1,0,57,55,2,4842,4,0,114,109,5,9424,5,0,0.0,4.0,4.0,1,4,5,0,0,0,0,0,0,2020-12-27 19:15:002020-12-27 19:15:002020-12-27 19:15:002020-12-27 19:15:00
3813,8507,Nicky Butt,1115,[2005],Birmingham City,14,12,2,1069,3,0,10,10,0,900,0,0,24,22,2,1969,3,0,3.0,0.0,3.0,3,0,3,0,0,0,0,0,0,2020-12-27 19:15:00
3814,42565,Nicky Hunt,1711,"[2003, 2004, 2005, 2006, 2007]",Bolton Wanderers,65,56,9,4968,1,0,61,56,5,4903,0,0,126,112,14,9871,1,0,0.0,0.0,0.0,1,0,1,0,0,0,0,0,0,2020-12-27 19:15:002020-12-27 19:15:002020-12-27 19:15:002020-12-27 19:15:002020-12-27 19:15:00
3815,8516,Nicky Law,3988,[2006],Sheffield United,2,1,1,120,0,0,2,1,1,91,0,0,4,2,2,211,0,0,0.0,0.0,0.0,0,0,0,0,0,0,0,0,0,2020-12-27 19:15:00
3816,8517,Nicky Maynard,3460,[2012],West Ham United,0,0,0,0,0,0,0,0,0,0,0,0,0,0,0,0,0,0,0.0,0.0,0.0,0,0,0,0,0,0,0,0,0,2020-12-27 19:15:00
3817,8518,Nicky Maynard,3460,[2013],Cardiff City,3,0,3,25,0,0,5,0,5,95,0,0,8,0,8,120,0,0,0.0,0.0,0.0,0,0,0,0,0,0,0,0,0,2020-12-27 19:15:00
3818,25564,Nicky Shorey,1731,"[2006, 2007, 2012]",Reading FC,43,43,0,3850,3,0,43,42,1,3783,1,0,86,85,1,7633,4,0,0.0,0.0,0.0,1,0,1,0,0,0,0,0,0,2020-12-27 19:15:002020-12-27 19:15:002020-12-27 19:15:00
3819,8521,Nicky Shorey,1731,[2008],Aston Villa,9,8,1,672,0,0,11,10,1,830,0,0,20,18,2,1502,0,0,0.0,0.0,0.0,0,0,0,0,0,0,0,0,0,2020-12-27 19:15:00
3820,8522,Nicky Shorey,1731,[2009],Fulham FC,3,3,0,270,0,0,6,6,0,540,0,0,9,9,0,810,0,0,0.0,0.0,0.0,0,0,0,0,0,0,0,0,0,2020-12-27 19:15:00
3821,17047,Nicky Shorey,1731,"[2010, 2011]",West Bromwich Albion,27,23,4,2093,0,0,26,24,2,2234,0,0,53,47,6,4327,0,0,0.0,0.0,0.0,0,0,0,0,0,0,0,0,0,2020-12-27 19:15:002020-12-27 19:15:00
3822,8526,Nicky Southall,3073,[2001],Bolton Wanderers,11,5,6,541,0,0,7,5,2,464,1,0,18,10,8,1005,1,0,0.0,0.0,0.0,0,1,1,0,0,0,0,0,0,2020-12-27 19:15:00
3823,25584,Nicky Weaver,1875,"[2000, 2004, 2006]",Manchester City,28,27,1,2377,0,0,26,26,0,2296,0,0,54,53,1,4673,0,0,0.0,0.0,0.0,0,0,0,0,0,0,0,0,0,2020-12-27 19:15:002020-12-27 19:15:002020-12-27 19:15:00
3824,25593,Niclas Alexandersson,3386,"[2000, 2001, 2002]",Everton FC,27,22,5,1834,1,0,30,26,4,2112,3,0,57,48,9,3946,4,0,3.0,0.0,3.0,1,1,2,0,0,0,0,0,0,2020-12-27 19:15:002020-12-27 19:15:002020-12-27 19:15:00
3825,8533,Niclas Jensen,3201,[2002],Manchester City,17,16,1,1470,1,0,15,15,0,1305,0,0,32,31,1,2775,1,0,0.0,0.0,0.0,0,0,0,0,0,0,0,0,0,2020-12-27 19:15:00
3826,8534,Niclas Jensen,3201,[2005],Fulham FC,8,6,2,588,0,0,7,7,0,630,0,0,15,13,2,1218,0,0,0.0,0.0,0.0,0,0,0,0,0,0,0,0,0,2020-12-27 19:15:00
3827,17071,Nico Vaesen,2619,"[2002, 2005]",Birmingham City,16,16,0,1440,0,0,15,15,0,1350,0,0,31,31,0,2790,0,0,0.0,0.0,0.0,0,0,0,0,0,0,0,0,0,2020-12-27 19:15:002020-12-27 19:15:00
3828,8537,Nicola Ventola,4287,[2004],Crystal Palace,2,0,2,56,1,0,1,0,1,20,0,0,3,0,3,76,1,0,0.0,0.0,0.0,1,0,1,0,0,0,0,0,0,2020-12-27 19:15:00
3829,8538,Nicolas Anelka,1720,[2001],West Ham United,1,1,0,90,0,0,0,0,0,0,0,0,1,1,0,90,0,0,0.0,0.0,0.0,0,0,0,0,0,0,0,0,0,2020-12-27 19:15:00
3830,25620,Nicolas Anelka,1720,"[2002, 2003, 2004]",Manchester City,45,44,1,3902,20,0,37,36,1,3099,18,0,82,80,2,7001,38,0,3.0,9.0,12.0,8,14,22,4,3,7,0,0,0,2020-12-27 19:15:002020-12-27 19:15:002020-12-27 19:15:00
3831,8542,Nicolas Anelka,1720,[2006],Bolton Wanderers,18,18,0,1492,6,0,17,17,0,1524,5,0,35,35,0,3016,11,0,3.0,3.0,6.0,1,4,5,0,0,0,0,0,0,2020-12-27 19:15:00
3832,42725,Nicolas Anelka,1720,"[2007, 2008, 2009, 2010, 2011]",Chelsea FC,65,54,11,4775,19,0,58,48,10,4415,19,0,123,102,21,9190,38,0,4.0,3.0,7.0,10,7,17,0,0,0,0,0,0,2020-12-27 19:15:002020-12-27 19:15:002020-12-27 19:15:002020-12-27 19:15:002020-12-27 19:15:00
3833,8548,Nicolas Anelka,1720,[2013],West Bromwich Albion,6,6,0,476,0,0,6,5,1,379,2,0,12,11,1,855,2,0,0.0,0.0,0.0,0,2,2,0,0,0,0,0,0,2020-12-27 19:15:00
3834,17099,Nicolas Pépé,1486,"[2019, 2020]",Arsenal FC,23,13,10,1342,4,0,19,13,6,1162,3,0,42,26,16,2504,7,0,0.0,0.0,0.0,2,3,5,1,1,2,0,0,0,2020-12-27 19:15:002020-12-27 19:15:00
3835,51321,Nicolás Otamendi,1199,"[2015, 2016, 2017, 2018, 2019, 2020]",Manchester City,67,63,4,5554,6,0,68,60,8,5533,2,0,135,123,12,11087,8,0,0.0,3.0,3.0,2,1,3,0,0,0,0,0,0,2020-12-27 19:15:002020-12-27 19:15:002020-12-27 19:15:002020-12-27 19:15:002020-12-27 19:15:002020-12-27 19:15:00
3836,8557,Niels Nkounkou,1015,[2020],Everton FC,0,0,0,0,0,0,1,1,0,69,0,0,1,1,0,69,0,0,0.0,0.0,0.0,0,0,0,0,0,0,0,0,0,2020-12-27 19:15:00
3837,25677,Nigel Martyn,1290,"[2000, 2001, 2002]",Leeds United,25,25,0,2231,0,0,26,26,0,2340,0,0,51,51,0,4571,0,0,0.0,0.0,0.0,0,0,0,0,0,0,0,0,0,2020-12-27 19:15:002020-12-27 19:15:002020-12-27 19:15:00
3838,25686,Nigel Martyn,1290,"[2003, 2004, 2005]",Everton FC,43,42,1,3845,0,0,38,38,0,3330,0,0,81,80,1,7175,0,0,0.0,0.0,0.0,0,0,0,0,0,0,0,0,0,2020-12-27 19:15:002020-12-27 19:15:002020-12-27 19:15:00
3839,17129,Nigel Quashie,1068,"[2003, 2004]",Portsmouth FC,22,19,3,1741,0,0,18,17,1,1554,1,0,40,36,4,3295,1,0,0.0,0.0,0.0,0,0,0,0,0,0,0,0,0,2020-12-27 19:15:002020-12-27 19:15:00
3840,8566,Nigel Quashie,1068,[2005],West Bromwich Albion,3,3,0,258,0,0,5,5,0,450,1,0,8,8,0,708,1,0,0.0,0.0,0.0,0,1,1,0,0,0,0,0,0,2020-12-27 19:15:00
3841,8567,Nigel Quashie,1068,[2006],West Ham United,4,4,0,340,0,0,3,3,0,270,0,0,7,7,0,610,0,0,0.0,0.0,0.0,0,0,0,0,0,0,0,0,0,2020-12-27 19:15:00
3842,17137,Nigel Reo-Coker,2494,"[2005, 2006]",West Ham United,34,34,0,2953,3,0,30,30,0,2687,3,0,64,64,0,5640,6,0,3.0,6.0,9.0,3,3,6,0,0,0,0,0,0,2020-12-27 19:15:002020-12-27 19:15:00
3843,34286,Nigel Reo-Coker,2494,"[2007, 2008, 2009, 2010]",Aston Villa,47,39,8,3434,0,0,52,44,8,3887,1,0,99,83,16,7321,1,0,0.0,0.0,0.0,0,1,1,0,0,0,0,0,0,2020-12-27 19:15:002020-12-27 19:15:002020-12-27 19:15:002020-12-27 19:15:00
3844,8574,Nigel Reo-Coker,2494,[2011],Bolton Wanderers,18,18,0,1574,2,0,19,19,0,1691,2,0,37,37,0,3265,4,0,0.0,0.0,0.0,1,1,2,0,0,0,0,0,0,2020-12-27 19:15:00
3845,25728,Nigel Winterburn,1623,"[2000, 2001, 2002]",West Ham United,35,35,0,2999,0,0,33,29,4,2623,1,0,68,64,4,5622,1,0,0.0,3.0,3.0,0,1,1,0,0,0,0,0,0,2020-12-27 19:15:002020-12-27 19:15:002020-12-27 19:15:00
3846,42900,Nigel de Jong,1680,"[2008, 2009, 2010, 2011, 2012]",Manchester City,52,45,7,3961,1,0,51,42,9,3709,0,0,103,87,16,7670,1,0,0.0,0.0,0.0,1,0,1,0,0,0,0,0,0,2020-12-27 19:15:002020-12-27 19:15:002020-12-27 19:15:002020-12-27 19:15:002020-12-27 19:15:00
3847,8583,Niki Mäenpää,3017,[2017],Brighton & Hove Albion,0,0,0,0,0,0,0,0,0,0,0,0,0,0,0,0,0,0,0.0,0.0,0.0,0,0,0,0,0,0,0,0,0,2020-12-27 19:15:00
3848,25755,Nikica Jelavić,2228,"[2011, 2012, 2013]",Everton FC,29,21,8,1825,9,0,30,20,10,1940,7,0,59,41,18,3765,16,0,9.0,0.0,9.0,5,4,9,1,0,1,0,0,0,2020-12-27 19:15:002020-12-27 19:15:002020-12-27 19:15:00
3849,8587,Nikica Jelavić,2228,[2014],Hull City,16,12,4,1121,5,0,10,9,1,689,3,0,26,21,5,1810,8,0,0.0,0.0,0.0,3,1,4,0,0,0,0,0,0,2020-12-27 19:15:00
3850,8588,Nikica Jelavić,2228,[2015],West Ham United,5,0,5,30,0,0,8,1,7,308,1,0,13,1,12,338,1,0,0.0,0.0,0.0,0,0,0,0,0,0,0,0,0,2020-12-27 19:15:00
3851,25770,Niko Kranjčar,1276,"[2006, 2007, 2008]",Portsmouth FC,37,23,14,2454,4,0,41,34,7,3137,5,0,78,57,21,5591,9,0,1.0,3.0,4.0,2,3,5,0,0,0,0,0,0,2020-12-27 19:15:002020-12-27 19:15:002020-12-27 19:15:00
3852,25779,Niko Kranjčar,1276,"[2009, 2010, 2011]",Tottenham Hotspur,23,14,9,1232,6,0,25,15,10,1368,3,0,48,29,19,2600,9,0,3.0,6.0,9.0,2,3,5,0,0,0,0,0,0,2020-12-27 19:15:002020-12-27 19:15:002020-12-27 19:15:00
3853,8595,Niko Kranjčar,1276,[2014],Queens Park Rangers,8,2,6,268,1,0,14,9,5,846,1,0,22,11,11,1114,2,0,1.0,0.0,1.0,1,0,1,0,0,0,0,0,0,2020-12-27 19:15:00
3854,17193,Nikola Kalinić,3588,"[2009, 2010]",Blackburn Rovers,21,15,6,1239,3,0,23,14,9,1309,4,0,44,29,15,2548,7,0,6.0,0.0,6.0,3,3,6,0,0,0,0,0,0,2020-12-27 19:15:002020-12-27 19:15:00
3855,8598,Nikola Tavares,2315,[2019],Crystal Palace,0,0,0,0,0,0,0,0,0,0,0,0,0,0,0,0,0,0,0.0,0.0,0.0,0,0,0,0,0,0,0,0,0,2020-12-27 19:15:00
3856,8599,Nikola Vlašić,4143,[2017],Everton FC,7,5,2,364,0,0,5,2,3,212,0,0,12,7,5,576,0,0,0.0,0.0,0.0,0,0,0,0,0,0,0,0,0,2020-12-27 19:15:00
3857,8600,Nikola Žigić,3337,[2010],Birmingham City,15,7,8,726,3,0,10,6,4,583,2,0,25,13,12,1309,5,0,3.0,3.0,6.0,2,2,4,0,0,0,0,0,0,2020-12-27 19:15:00
3858,25806,Nikolaos Dabizas,2161,"[2000, 2001, 2002]",Newcastle United,29,25,4,2283,1,0,29,28,1,2460,2,0,58,53,5,4743,3,0,0.0,3.0,3.0,0,2,2,0,0,0,0,0,0,2020-12-27 19:15:002020-12-27 19:15:002020-12-27 19:15:00
3859,8604,Nikolaos Dabizas,2161,[2003],Leicester City,9,9,0,800,0,0,9,9,0,810,0,0,18,18,0,1610,0,0,0.0,0.0,0.0,0,0,0,0,0,0,0,0,0,2020-12-27 19:15:00
3860,17211,Nile Ranger,2402,"[2010, 2012]",Newcastle United,15,0,15,260,0,0,11,1,10,307,0,0,26,1,25,567,0,0,0.0,0.0,0.0,0,0,0,0,0,0,0,0,0,2020-12-27 19:15:002020-12-27 19:15:00
3861,34434,Nils-Eric Johansson,1134,"[2001, 2002, 2003, 2004]",Blackburn Rovers,42,29,13,2952,0,0,40,27,13,2647,0,0,82,56,26,5599,0,0,0.0,0.0,0.0,0,0,0,0,0,0,0,0,0,2020-12-27 19:15:002020-12-27 19:15:002020-12-27 19:15:002020-12-27 19:15:00
3862,8611,Noel Hunt,1985,[2012],Reading FC,12,5,7,445,1,0,12,5,7,506,1,0,24,10,14,951,2,0,0.0,0.0,0.0,1,0,1,0,0,0,0,0,0,2020-12-27 19:15:00
3863,25839,Noel Whelan,2075,"[2000, 2001, 2002]",Middlesbrough FC,30,17,13,1548,2,0,30,15,15,1496,3,0,60,32,28,3044,5,0,0.0,4.0,4.0,1,3,4,0,0,0,0,0,0,2020-12-27 19:15:002020-12-27 19:15:002020-12-27 19:15:00
3864,43089,Nolberto Solano,1791,"[2000, 2001, 2002, 2005, 2006]",Newcastle United,82,81,1,6770,18,0,70,62,8,5251,10,0,152,143,9,12021,28,0,10.0,10.0,20.0,13,8,21,3,2,5,0,0,0,2020-12-27 19:15:002020-12-27 19:15:002020-12-27 19:15:002020-12-27 19:15:002020-12-27 19:15:00
3865,17237,Nolberto Solano,1791,"[2003, 2004]",Aston Villa,22,21,1,1781,7,0,23,20,3,1750,1,0,45,41,4,3531,8,0,7.0,0.0,7.0,5,1,6,0,0,0,0,0,0,2020-12-27 19:15:002020-12-27 19:15:00
3866,8622,Nolberto Solano,1791,[2007],West Ham United,12,8,4,646,2,0,11,6,5,606,2,0,23,14,9,1252,4,0,0.0,3.0,3.0,2,1,3,0,0,0,0,0,0,2020-12-27 19:15:00
3867,8623,Nolito,1589,[2016],Manchester City,8,4,4,364,1,0,11,5,6,418,3,0,19,9,10,782,4,0,1.0,0.0,1.0,1,0,1,0,0,0,0,0,0,2020-12-27 19:15:00
3868,8624,Noor Husin,2802,[2016],Crystal Palace,0,0,0,0,0,0,0,0,0,0,0,0,0,0,0,0,0,0,0.0,0.0,0.0,0,0,0,0,0,0,0,0,0,2020-12-27 19:15:00
3869,25878,Nordin Amrabat,3015,"[2015, 2016, 2017]",Watford FC,24,18,6,1518,0,0,20,14,6,1284,0,0,44,32,12,2802,0,0,0.0,0.0,0.0,0,0,0,0,0,0,0,0,0,2020-12-27 19:15:002020-12-27 19:15:002020-12-27 19:15:00
3870,17257,Noureddine Naybet,1936,"[2004, 2005]",Tottenham Hotspur,15,15,0,1309,1,0,15,14,1,1248,0,0,30,29,1,2557,1,0,0.0,0.0,0.0,1,0,1,0,0,0,0,0,0,2020-12-27 19:15:002020-12-27 19:15:00
3871,8630,Noé Pamarot,1387,[2004],Tottenham Hotspur,11,11,0,971,0,0,12,12,0,981,1,0,23,23,0,1952,1,0,0.0,3.0,3.0,0,1,1,0,0,0,0,0,0,2020-12-27 19:15:00
3872,34530,Noé Pamarot,1387,"[2005, 2006, 2007, 2008]",Portsmouth FC,28,23,5,2024,1,0,37,27,10,2421,2,0,65,50,15,4445,3,0,0.0,0.0,0.0,0,2,2,0,0,0,0,0,0,2020-12-27 19:15:002020-12-27 19:15:002020-12-27 19:15:002020-12-27 19:15:00
3873,17271,Nuno Morais,4074,"[2004, 2006]",Chelsea FC,2,0,2,19,0,0,2,0,2,6,0,0,4,0,4,25,0,0,0.0,0.0,0.0,0,0,0,0,0,0,0,0,0,2020-12-27 19:15:002020-12-27 19:15:00
3874,34554,Nuno Valente,2106,"[2005, 2006, 2007, 2008]",Everton FC,25,21,4,1819,0,0,20,18,2,1625,0,0,45,39,6,3444,0,0,0.0,0.0,0.0,0,0,0,0,0,0,0,0,0,2020-12-27 19:15:002020-12-27 19:15:002020-12-27 19:15:002020-12-27 19:15:00
3875,8641,Nuri Şahin,3844,[2012],Liverpool FC,4,4,0,283,0,0,3,3,0,172,1,0,7,7,0,455,1,0,0.0,0.0,0.0,0,0,0,0,0,0,0,0,0,2020-12-27 19:15:00
3876,34574,Nwankwo Kanu,1324,"[2000, 2001, 2002, 2003]",Arsenal FC,37,18,19,1682,6,0,38,16,22,1843,6,0,75,34,41,3525,12,0,3.0,0.0,3.0,2,4,6,0,0,0,0,0,0,2020-12-27 19:15:002020-12-27 19:15:002020-12-27 19:15:002020-12-27 19:15:00
3877,17293,Nwankwo Kanu,1324,"[2004, 2005]",West Bromwich Albion,24,17,7,1573,6,0,27,20,7,1857,1,0,51,37,14,3430,7,0,1.0,0.0,1.0,4,1,5,0,0,0,0,0,0,2020-12-27 19:15:002020-12-27 19:15:00
3878,34598,Nwankwo Kanu,1324,"[2006, 2007, 2008, 2009]",Portsmouth FC,56,29,27,2925,12,0,45,25,20,2434,5,0,101,54,47,5359,17,0,9.0,3.0,12.0,6,2,8,0,0,0,0,0,0,2020-12-27 19:15:002020-12-27 19:15:002020-12-27 19:15:002020-12-27 19:15:00
3879,17305,Nya Kirby,4228,"[2017, 2019]",Crystal Palace,0,0,0,0,0,0,0,0,0,0,0,0,0,0,0,0,0,0,0.0,0.0,0.0,0,0,0,0,0,0,0,0,0,2020-12-27 19:15:002020-12-27 19:15:00
3880,8654,Nélson Oliveira,3345,[2014],Swansea City,4,2,2,134,0,0,6,2,4,255,1,0,10,4,6,389,1,0,0.0,0.0,0.0,0,1,1,0,0,0,0,0,0,2020-12-27 19:15:00
3881,8655,Nélson Semedo,1006,[2020],Wolverhampton Wanderers,7,7,0,618,0,0,6,6,0,523,0,0,13,13,0,1141,0,0,0.0,0.0,0.0,0,0,0,0,0,0,1,0,1,2020-12-27 19:15:00
3882,8656,Núñez,3560,[2004],Liverpool FC,12,5,7,623,0,0,6,3,3,278,0,0,18,8,10,901,0,0,0.0,0.0,0.0,0,0,0,0,0,0,0,0,0,2020-12-27 19:15:00
3883,25974,Obafemi Martins,3121,"[2006, 2007, 2008]",Newcastle United,45,39,6,3436,14,0,40,34,6,3001,14,0,85,73,12,6437,28,0,3.0,0.0,3.0,11,6,17,2,0,2,0,0,0,2020-12-27 19:15:002020-12-27 19:15:002020-12-27 19:15:00
3884,8660,Obafemi Martins,3121,[2010],Birmingham City,3,3,0,224,0,0,1,0,1,26,0,0,4,3,1,250,0,0,0.0,0.0,0.0,0,0,0,0,0,0,0,0,0,2020-12-27 19:15:00
3885,8661,Obbi Oularé,3182,[2015],Watford FC,1,0,1,2,0,0,1,0,1,3,0,0,2,0,2,5,0,0,0.0,0.0,0.0,0,0,0,0,0,0,0,0,0,2020-12-27 19:15:00
3886,17325,Odion Ighalo,2990,"[2015, 2016]",Watford FC,27,26,1,2317,8,0,28,24,4,2127,9,0,55,50,5,4444,17,0,3.0,4.0,7.0,4,6,10,0,0,0,0,0,0,2020-12-27 19:15:002020-12-27 19:15:00
3887,17329,Odion Ighalo,2990,"[2019, 2020]",Manchester United,6,0,6,46,0,0,6,0,6,55,0,0,12,0,12,101,0,0,0.0,0.0,0.0,0,0,0,0,0,0,0,0,0,2020-12-27 19:15:002020-12-27 19:15:00
3888,17333,Ognjen Koroman,3858,"[2005, 2006]",Portsmouth FC,1,0,1,28,1,0,3,1,2,107,0,0,4,1,3,135,1,0,0.0,0.0,0.0,0,0,0,0,0,0,0,0,0,2020-12-27 19:15:002020-12-27 19:15:00
3889,8668,Oguchi Onyewu,4285,[2006],Newcastle United,5,4,1,377,0,0,6,3,3,367,0,0,11,7,4,744,0,0,0.0,0.0,0.0,0,0,0,0,0,0,0,0,0,2020-12-27 19:15:00
3890,17339,Ola Aina,3281,"[2015, 2016]",Chelsea FC,3,0,3,24,0,0,0,0,0,0,0,0,3,0,3,24,0,0,0.0,0.0,0.0,0,0,0,0,0,0,0,0,0,2020-12-27 19:15:002020-12-27 19:15:00
3891,8671,Ola Aina,3281,[2020],Fulham FC,6,6,0,540,1,0,6,6,0,540,0,0,12,12,0,1080,1,0,0.0,0.0,0.0,0,0,0,0,0,0,0,0,0,2020-12-27 19:15:00
3892,8672,Ola Toivonen,2817,[2015],Sunderland AFC,7,5,2,351,0,0,5,4,1,312,0,0,12,9,3,663,0,0,0.0,0.0,0.0,0,0,0,0,0,0,0,0,0,2020-12-27 19:15:00
3893,52053,Ole Gunnar Solskjær,1116,"[2000, 2001, 2002, 2003, 2005, 2006]",Manchester United,66,38,28,3564,22,0,62,44,18,4029,22,0,128,82,46,7593,44,0,7.0,8.0,15.0,10,10,20,0,0,0,0,0,0,2020-12-27 19:15:002020-12-27 19:15:002020-12-27 19:15:002020-12-27 19:15:002020-12-27 19:15:002020-12-27 19:15:00
3894,17359,Ole Söderberg,3587,"[2010, 2011]",Newcastle United,0,0,0,0,0,0,0,0,0,0,0,0,0,0,0,0,0,0,0.0,0.0,0.0,0,0,0,0,0,0,0,0,0,2020-12-27 19:15:002020-12-27 19:15:00
3895,26046,Oleg Luzhniy,3244,"[2000, 2001, 2002]",Arsenal FC,26,22,4,1919,0,0,25,17,8,1663,0,0,51,39,12,3582,0,0,0.0,0.0,0.0,0,0,0,0,0,0,0,0,0,2020-12-27 19:15:002020-12-27 19:15:002020-12-27 19:15:00
3896,8684,Oleg Luzhniy,3244,[2003],Wolverhampton Wanderers,1,1,0,90,0,0,5,3,2,303,0,0,6,4,2,393,0,0,0.0,0.0,0.0,0,0,0,0,0,0,0,0,0,2020-12-27 19:15:00
3897,34746,Oleksandr Zinchenko,1210,"[2017, 2018, 2019, 2020]",Manchester City,20,18,2,1528,0,0,21,14,7,1382,0,0,41,32,9,2910,0,0,0.0,0.0,0.0,0,0,0,0,0,0,0,0,0,2020-12-27 19:15:002020-12-27 19:15:002020-12-27 19:15:002020-12-27 19:15:00
3898,8689,Oliver Burke,1666,[2017],West Bromwich Albion,9,2,7,237,0,0,6,0,6,120,0,0,15,2,13,357,0,0,0.0,0.0,0.0,0,0,0,0,0,0,0,0,0,2020-12-27 19:15:00
3899,8690,Oliver Burke,1666,[2020],Sheffield United,4,4,0,275,0,0,5,3,2,313,0,0,9,7,2,588,0,0,0.0,0.0,0.0,0,0,0,0,0,0,0,0,0,2020-12-27 19:15:00
3900,8691,Oliver Casey,1080,[2020],Leeds United,0,0,0,0,0,0,0,0,0,0,0,0,0,0,0,0,0,0,0.0,0.0,0.0,0,0,0,0,0,0,0,0,0,2020-12-27 19:15:00
3901,8692,Oliver Gill,4153,[2010],Manchester United,0,0,0,0,0,0,0,0,0,0,0,0,0,0,0,0,0,0,0.0,0.0,0.0,0,0,0,0,0,0,0,0,0,2020-12-27 19:15:00
3902,17387,Oliver McBurnie,3197,"[2016, 2017]",Swansea City,7,0,7,112,0,0,9,2,7,234,0,0,16,2,14,346,0,0,0.0,0.0,0.0,0,0,0,0,0,0,0,0,0,2020-12-27 19:15:002020-12-27 19:15:00
3903,17391,Oliver McBurnie,3197,"[2019, 2020]",Sheffield United,26,18,8,1665,6,0,23,14,9,1274,1,0,49,32,17,2939,7,0,4.0,3.0,7.0,4,1,5,0,0,0,0,0,0,2020-12-27 19:15:002020-12-27 19:15:00
3904,17395,Oliver Norwood,3469,"[2019, 2020]",Sheffield United,26,22,4,1985,1,0,21,20,1,1568,0,0,47,42,5,3553,1,0,1.0,0.0,1.0,1,0,1,1,0,1,0,0,0,2020-12-27 19:15:002020-12-27 19:15:00
3905,17399,Oliver Shenton,2383,"[2014, 2015]",Stoke City,1,0,1,1,0,0,0,0,0,0,0,0,1,0,1,1,0,0,0.0,0.0,0.0,0,0,0,0,0,0,0,0,0,2020-12-27 19:15:002020-12-27 19:15:00
3906,17403,Oliver Skipp,2985,"[2018, 2019]",Tottenham Hotspur,10,2,8,209,0,0,5,1,4,82,0,0,15,3,12,291,0,0,0.0,0.0,0.0,0,0,0,0,0,0,0,0,0,2020-12-27 19:15:002020-12-27 19:15:00
3907,34818,Olivier Bernard,2032,"[2001, 2002, 2003, 2004]",Newcastle United,48,40,8,3641,4,0,50,38,12,3531,2,0,98,78,20,7172,6,0,3.0,0.0,3.0,2,2,4,0,0,0,0,0,0,2020-12-27 19:15:002020-12-27 19:15:002020-12-27 19:15:002020-12-27 19:15:00
3908,26124,Olivier Dacourt,1295,"[2000, 2001, 2002]",Leeds United,24,22,2,1780,1,0,29,27,2,2213,2,0,53,49,4,3993,3,0,3.0,1.0,4.0,1,2,3,0,0,0,0,0,0,2020-12-27 19:15:002020-12-27 19:15:002020-12-27 19:15:00
3909,8710,Olivier Dacourt,1295,[2008],Fulham FC,5,0,5,62,0,0,4,0,4,83,0,0,9,0,9,145,0,0,0.0,0.0,0.0,0,0,0,0,0,0,0,0,0,2020-12-27 19:15:00
3910,52281,Olivier Giroud,1504,"[2012, 2013, 2014, 2015, 2016, 2017]",Arsenal FC,90,58,32,5519,40,0,90,61,29,5784,33,0,180,119,61,11303,73,0,13.0,7.0,20.0,21,22,43,1,1,2,0,0,0,2020-12-27 19:15:002020-12-27 19:15:002020-12-27 19:15:002020-12-27 19:15:002020-12-27 19:15:002020-12-27 19:15:00
3911,26154,Olivier Giroud,1504,"[2018, 2019, 2020]",Chelsea FC,26,13,13,1153,7,0,27,9,18,966,5,0,53,22,31,2119,12,0,3.0,3.0,6.0,5,3,8,0,0,0,0,0,0,2020-12-27 19:15:002020-12-27 19:15:002020-12-27 19:15:00
3912,8720,Olivier Kapo,1963,[2007],Birmingham City,12,12,0,1032,3,0,14,10,4,986,2,0,26,22,4,2018,5,0,6.0,0.0,6.0,3,2,5,1,0,1,0,0,0,2020-12-27 19:15:00
3913,17443,Olivier Kapo,1963,"[2008, 2009]",Wigan Athletic,8,4,4,330,0,0,12,6,6,593,1,0,20,10,10,923,1,0,0.0,0.0,0.0,0,1,1,0,0,0,0,0,0,2020-12-27 19:15:002020-12-27 19:15:00
3914,8723,Olivier Kemen,4207,[2014],Newcastle United,0,0,0,0,0,0,0,0,0,0,0,0,0,0,0,0,0,0,0.0,0.0,0.0,0,0,0,0,0,0,0,0,0,2020-12-27 19:15:00
3915,34902,Olivier Tebily,1520,"[2002, 2003, 2004, 2005]",Birmingham City,35,24,11,2214,0,0,34,25,9,2038,0,0,69,49,20,4252,0,0,0.0,0.0,0.0,0,0,0,0,0,0,0,0,0,2020-12-27 19:15:002020-12-27 19:15:002020-12-27 19:15:002020-12-27 19:15:00
3916,8728,Ollie Watkins,1048,[2020],Aston Villa,7,7,0,630,4,0,6,6,0,540,2,0,13,13,0,1170,6,0,0.0,0.0,0.0,1,0,1,1,0,1,0,0,0,2020-12-27 19:15:00
3917,61124,Olof Mellberg,1790,"[2001, 2002, 2003, 2004, 2005, 2006, 2007]",Aston Villa,110,109,1,9760,2,0,116,116,0,10286,6,0,226,225,1,20046,8,0,0.0,1.0,1.0,2,4,6,0,0,0,0,0,0,2020-12-27 19:15:002020-12-27 19:15:002020-12-27 19:15:002020-12-27 19:15:002020-12-27 19:15:002020-12-27 19:15:002020-12-27 19:15:00
3918,17473,Olufela Olomola,4312,"[2015, 2016]",Southampton FC,0,0,0,0,0,0,0,0,0,0,0,0,0,0,0,0,0,0,0.0,0.0,0.0,0,0,0,0,0,0,0,0,0,2020-12-27 19:15:002020-12-27 19:15:00
3919,8738,Omar Elabdellaoui,2733,[2016],Hull City,4,4,0,352,0,0,4,3,1,264,0,0,8,7,1,616,0,0,0.0,0.0,0.0,0,0,0,0,0,0,0,0,0,2020-12-27 19:15:00
3920,8739,Omar Pouso,3916,[2006],Charlton Athletic,1,1,0,57,0,0,0,0,0,0,0,0,1,1,0,57,0,0,0.0,0.0,0.0,0,0,0,0,0,0,0,0,0,2020-12-27 19:15:00
3921,8740,Ondrej Duda,3584,[2019],Norwich City,6,5,1,403,0,0,4,4,0,326,0,0,10,9,1,729,0,0,0.0,0.0,0.0,0,0,0,0,0,0,0,0,0,2020-12-27 19:15:00
3922,8741,Ondřej Čelůstka,3187,[2013],Sunderland AFC,11,7,4,712,0,0,10,7,3,621,0,0,21,14,7,1333,0,0,0.0,0.0,0.0,0,0,0,0,0,0,0,0,0,2020-12-27 19:15:00
3923,8742,Onel Hernandez,2180,[2019],Norwich City,12,8,4,732,1,0,14,6,8,648,0,0,26,14,12,1380,1,0,0.0,0.0,0.0,0,0,0,0,0,0,0,0,0,2020-12-27 19:15:00
3924,8743,Orestis Karnezis,1916,[2017],Watford FC,7,7,0,630,0,0,8,7,1,661,0,0,15,14,1,1291,0,0,0.0,0.0,0.0,0,0,0,0,0,0,0,0,0,2020-12-27 19:15:00
3925,17489,Oriol Romeu,1243,"[2011, 2012]",Chelsea FC,10,6,4,558,0,0,12,9,3,632,0,0,22,15,7,1190,0,0,0.0,0.0,0.0,0,0,0,0,0,0,0,0,0,2020-12-27 19:15:002020-12-27 19:15:00
3926,52491,Oriol Romeu,1243,"[2015, 2016, 2017, 2018, 2019, 2020]",Southampton FC,88,71,17,6289,3,0,85,74,11,6512,2,0,173,145,28,12801,5,0,1.0,0.0,1.0,2,2,4,0,0,0,0,0,0,2020-12-27 19:15:002020-12-27 19:15:002020-12-27 19:15:002020-12-27 19:15:002020-12-27 19:15:002020-12-27 19:15:00
3927,8752,Orlandi,3946,[2011],Swansea City,1,1,0,46,1,0,2,1,1,74,0,0,3,2,1,120,1,0,0.0,0.0,0.0,1,0,1,0,0,0,0,0,0,2020-12-27 19:15:00
3928,8753,Orlando Sá,3120,[2011],Fulham FC,2,0,2,13,0,0,5,3,2,268,1,0,7,3,4,281,1,0,0.0,0.0,0.0,0,1,1,0,0,0,0,0,0,2020-12-27 19:15:00
3929,43780,Oscar,1543,"[2012, 2013, 2014, 2015, 2016]",Chelsea FC,68,58,10,4818,13,0,62,41,21,3854,8,0,130,99,31,8672,21,0,0.0,0.0,0.0,8,5,13,2,0,2,0,0,0,2020-12-27 19:15:002020-12-27 19:15:002020-12-27 19:15:002020-12-27 19:15:002020-12-27 19:15:00
3930,26280,Osei Sankofa,3498,"[2002, 2005, 2006]",Charlton Athletic,5,4,1,412,0,0,9,8,1,717,0,0,14,12,2,1129,0,0,0.0,0.0,0.0,0,0,0,0,0,0,0,0,0,2020-12-27 19:15:002020-12-27 19:15:002020-12-27 19:15:00
3931,17525,Oskar Buur,3347,"[2019, 2020]",Wolverhampton Wanderers,0,0,0,0,0,0,1,0,1,21,0,0,1,0,1,21,0,0,0.0,0.0,0.0,0,0,0,0,0,0,0,0,0,2020-12-27 19:15:002020-12-27 19:15:00
3932,8764,Oubiña,4349,[2007],Birmingham City,1,0,1,5,0,0,1,1,0,13,0,0,2,1,1,18,0,0,0.0,0.0,0.0,0,0,0,0,0,0,0,0,0,2020-12-27 19:15:00
3933,35069,Oumar Niasse,1059,"[2015, 2017, 2018, 2019]",Everton FC,17,6,11,665,6,0,18,6,12,635,2,0,35,12,23,1300,8,0,4.0,1.0,5.0,3,1,4,0,0,0,0,0,0,2020-12-27 19:15:002020-12-27 19:15:002020-12-27 19:15:002020-12-27 19:15:00
3934,8766,Oumar Niasse,1059,[2016],Hull City,9,5,4,532,4,0,8,7,1,628,0,0,17,12,5,1160,4,0,0.0,0.0,0.0,2,0,2,0,0,0,0,0,0,2020-12-27 19:15:00
3935,8770,Ousmane Dabo,3849,[2006],Manchester City,7,4,3,383,0,0,6,6,0,507,0,0,13,10,3,890,0,0,0.0,0.0,0.0,0,0,0,0,0,0,0,0,0,2020-12-27 19:15:00
3936,8771,Oussama Assaidi,2382,[2012],Liverpool FC,2,0,2,30,0,0,2,0,2,43,0,0,4,0,4,73,0,0,0.0,0.0,0.0,0,0,0,0,0,0,0,0,0,2020-12-27 19:15:00
3937,17545,Oussama Assaidi,2382,"[2013, 2014]",Stoke City,15,5,10,578,3,0,13,8,5,758,1,0,28,13,15,1336,4,0,3.0,0.0,3.0,2,1,3,0,0,0,0,0,0,2020-12-27 19:15:002020-12-27 19:15:00
3938,8774,Ovie Ejaria,3847,[2016],Liverpool FC,1,0,1,3,0,0,1,0,1,3,0,0,2,0,2,6,0,0,0.0,0.0,0.0,0,0,0,0,0,0,0,0,0,2020-12-27 19:15:00
3939,8775,Owen Garvan,3879,[2013],Crystal Palace,1,1,0,65,0,0,1,0,1,26,0,0,2,1,1,91,0,0,0.0,0.0,0.0,0,0,0,0,0,0,0,0,0,2020-12-27 19:15:00
3940,35110,Owen Hargreaves,3313,"[2007, 2008, 2009, 2010]",Manchester United,14,10,4,859,1,0,14,9,5,882,1,0,28,19,9,1741,2,0,3.0,0.0,3.0,1,1,2,0,0,0,0,0,0,2020-12-27 19:15:002020-12-27 19:15:002020-12-27 19:15:002020-12-27 19:15:00
3941,8780,Owen Hargreaves,3313,[2011],Manchester City,1,0,1,13,0,0,0,0,0,0,0,0,1,0,1,13,0,0,0.0,0.0,0.0,0,0,0,0,0,0,0,0,0,2020-12-27 19:15:00
3942,17563,Owen Otasowie,4383,"[2019, 2020]",Wolverhampton Wanderers,2,0,2,51,0,0,1,1,0,60,0,0,3,1,2,111,0,0,0.0,0.0,0.0,0,0,0,0,0,0,0,0,0,2020-12-27 19:15:002020-12-27 19:15:00
3943,8783,Pablo Armero,3534,[2013],West Ham United,2,2,0,180,0,0,3,1,2,141,0,0,5,3,2,321,0,0,0.0,0.0,0.0,0,0,0,0,0,0,0,0,0,2020-12-27 19:15:00
3944,8784,Pablo Barrera,3802,[2010],West Ham United,9,5,4,567,0,0,5,1,4,175,0,0,14,6,8,742,0,0,0.0,0.0,0.0,0,0,0,0,0,0,0,0,0,2020-12-27 19:15:00
3945,17571,Pablo Fornals,2205,"[2019, 2020]",West Ham United,25,18,7,1576,1,0,25,20,5,1709,3,0,50,38,12,3285,4,0,0.0,0.0,0.0,1,2,3,0,0,0,0,0,0,2020-12-27 19:15:002020-12-27 19:15:00
3946,17575,Pablo Hernández,3492,"[2012, 2013]",Swansea City,29,23,6,1779,4,0,28,21,7,1846,1,0,57,44,13,3625,5,0,1.0,0.0,1.0,2,0,2,0,0,0,0,0,0,2020-12-27 19:15:002020-12-27 19:15:00
3947,8789,Pablo Hernández,3492,[2020],Leeds United,4,1,3,121,0,0,2,1,1,73,0,0,6,2,4,194,0,0,0.0,0.0,0.0,0,0,0,0,0,0,0,0,0,2020-12-27 19:15:00
3948,8790,Pablo Ibáñez,3172,[2010],West Bromwich Albion,4,3,1,286,0,0,6,5,1,494,1,0,10,8,2,780,1,0,0.0,1.0,1.0,0,1,1,0,0,0,0,0,0,2020-12-27 19:15:00
3949,17583,Pablo Maffeo,1591,"[2015, 2016]",Manchester City,0,0,0,0,0,0,0,0,0,0,0,0,0,0,0,0,0,0,0.0,0.0,0.0,0,0,0,0,0,0,0,0,0,2020-12-27 19:15:002020-12-27 19:15:00
3950,20795,Pablo Marí,4399,"[2019, 2020]",Arsenal FC,2,2,0,180,0,0,1,1,0,24,0,0,3,3,0,204,0,0,0.0,0.0,0.0,0,0,0,0,0,0,0,0,0,2020-12-27 19:15:002020-12-27 19:15:00
3951,79182,Pablo Zabaleta,1355,"[2008, 2009, 2010, 2011, 2012, 2013, 2014, 2015, 2016]",Manchester City,117,104,13,9440,7,0,112,98,14,8947,2,0,229,202,27,18387,9,0,3.0,0.0,3.0,6,0,6,0,0,0,0,0,0,2020-12-27 19:15:002020-12-27 19:15:002020-12-27 19:15:002020-12-27 19:15:002020-12-27 19:15:002020-12-27 19:15:002020-12-27 19:15:002020-12-27 19:15:002020-12-27 19:15:00
3952,26412,Pablo Zabaleta,1355,"[2017, 2018, 2019]",West Ham United,38,36,2,3194,0,0,36,31,5,2868,0,0,74,67,7,6062,0,0,0.0,0.0,0.0,0,0,0,0,0,0,0,0,0,2020-12-27 19:15:002020-12-27 19:15:002020-12-27 19:15:00
3953,8806,Paddy Kenny,2163,[2006],Sheffield United,16,16,0,1411,0,0,16,16,0,1440,0,0,32,32,0,2851,0,0,0.0,0.0,0.0,0,0,0,0,0,0,0,0,0,2020-12-27 19:15:00
3954,8807,Paddy Kenny,2163,[2011],Queens Park Rangers,17,17,0,1530,0,0,16,16,0,1440,0,0,33,33,0,2970,0,0,0.0,0.0,0.0,0,0,0,0,0,0,0,0,0,2020-12-27 19:15:00
3955,17617,Paddy McCarthy,3410,"[2013, 2014]",Crystal Palace,1,0,1,26,0,0,0,0,0,0,0,0,1,0,1,26,0,0,0.0,0.0,0.0,0,0,0,0,0,0,0,0,0,2020-12-27 19:15:002020-12-27 19:15:00
3956,17621,Paddy McNair,2194,"[2014, 2015]",Manchester United,12,7,5,646,0,0,12,8,4,693,0,0,24,15,9,1339,0,0,0.0,0.0,0.0,0,0,0,0,0,0,0,0,0,2020-12-27 19:15:002020-12-27 19:15:00
3957,8812,Paddy McNair,2194,[2016],Sunderland AFC,4,3,1,210,0,0,5,2,3,145,0,0,9,5,4,355,0,0,0.0,0.0,0.0,0,0,0,0,0,0,0,0,0,2020-12-27 19:15:00
3958,26442,Pajtim Kasami,2557,"[2011, 2012, 2013]",Fulham FC,19,11,8,1048,0,0,19,12,7,1046,3,0,38,23,15,2094,3,0,0.0,3.0,3.0,0,3,3,0,0,0,0,0,0,2020-12-27 19:15:002020-12-27 19:15:002020-12-27 19:15:00
3959,8816,Panagiotis Retsos,3583,[2019],Sheffield United,0,0,0,0,0,0,0,0,0,0,0,0,0,0,0,0,0,0,0.0,0.0,0.0,0,0,0,0,0,0,0,0,0,2020-12-27 19:15:00
3960,26454,Paolo Di Canio,2042,"[2000, 2001, 2002]",West Ham United,34,33,1,2931,14,0,27,26,1,2239,13,0,61,59,2,5170,27,0,10.0,10.0,20.0,8,12,20,6,4,10,0,0,0,2020-12-27 19:15:002020-12-27 19:15:002020-12-27 19:15:00
3961,8820,Paolo Di Canio,2042,[2003],Charlton Athletic,15,11,4,924,2,0,15,11,4,1003,2,0,30,22,8,1927,4,0,0.0,2.0,2.0,2,2,4,2,1,3,0,0,0,2020-12-27 19:15:00
3962,8821,Paolo Vernazza,3780,[2000],Arsenal FC,1,0,1,23,1,0,1,0,1,20,0,0,2,0,2,43,1,0,0.0,0.0,0.0,0,0,0,0,0,0,0,0,0,2020-12-27 19:15:00
3963,26469,Papa Bouba Diop,1757,"[2004, 2005, 2006]",Fulham FC,37,35,2,2994,5,0,34,32,2,2816,3,0,71,67,4,5810,8,0,4.0,3.0,7.0,4,3,7,0,0,0,0,0,0,2020-12-27 19:15:002020-12-27 19:15:002020-12-27 19:15:00
3964,26478,Papa Bouba Diop,1757,"[2007, 2008, 2009]",Portsmouth FC,23,22,1,1891,0,0,29,26,3,2223,0,0,52,48,4,4114,0,0,0.0,0.0,0.0,0,0,0,0,0,0,0,0,0,2020-12-27 19:15:002020-12-27 19:15:002020-12-27 19:15:00
3965,44150,Pape Souaré,1021,"[2014, 2015, 2016, 2017, 2018]",Crystal Palace,27,24,3,2174,0,0,21,20,1,1726,0,0,48,44,4,3900,0,0,0.0,0.0,0.0,0,0,0,0,0,0,0,0,0,2020-12-27 19:15:002020-12-27 19:15:002020-12-27 19:15:002020-12-27 19:15:002020-12-27 19:15:00
3966,44175,Papiss Demba Cissé,2282,"[2011, 2012, 2013, 2014, 2015]",Newcastle United,64,46,18,3948,21,0,53,42,11,3770,16,0,117,88,29,7718,37,0,22.0,2.0,24.0,15,11,26,0,1,1,0,0,0,2020-12-27 19:15:002020-12-27 19:15:002020-12-27 19:15:002020-12-27 19:15:002020-12-27 19:15:00
3967,8838,Papy Djilobodji,3314,[2015],Chelsea FC,0,0,0,0,0,0,0,0,0,0,0,0,0,0,0,0,0,0,0.0,0.0,0.0,0,0,0,0,0,0,0,0,0,2020-12-27 19:15:00
3968,8839,Papy Djilobodji,3314,[2016],Sunderland AFC,10,9,1,858,0,0,8,8,0,720,0,0,18,17,1,1578,0,0,0.0,0.0,0.0,0,0,0,0,0,0,0,0,0,2020-12-27 19:15:00
3969,8840,Paris Simmons,3600,[2007],Derby County,1,0,1,27,0,0,0,0,0,0,0,0,1,0,1,27,0,0,0.0,0.0,0.0,0,0,0,0,0,0,0,0,0,2020-12-27 19:15:00
3970,17686,Pascal Chimbonda,1392,"[2005, 2009]",Wigan Athletic,19,19,0,1620,1,0,19,19,0,1710,1,0,38,38,0,3330,2,0,3.0,0.0,3.0,1,1,2,0,0,0,0,0,0,2020-12-27 19:15:002020-12-27 19:15:00
3971,17685,Pascal Chimbonda,1392,"[2006, 2007]",Tottenham Hotspur,32,31,1,2720,2,0,31,31,0,2769,1,0,63,62,1,5489,3,0,0.0,1.0,1.0,1,1,2,0,0,0,0,0,0,2020-12-27 19:15:002020-12-27 19:15:00
3972,8844,Pascal Chimbonda,1392,[2008],Sunderland AFC,7,7,0,630,0,0,6,6,0,540,0,0,13,13,0,1170,0,0,0.0,0.0,0.0,0,0,0,0,0,0,0,0,0,2020-12-27 19:15:00
3973,8846,Pascal Chimbonda,1392,[2010],Blackburn Rovers,2,0,2,48,0,0,4,3,1,314,0,0,6,3,3,362,0,0,0.0,0.0,0.0,0,0,0,0,0,0,0,0,0,2020-12-27 19:15:00
3974,35394,Pascal Cygan,3439,"[2002, 2003, 2004, 2005]",Arsenal FC,31,24,7,2126,3,0,30,26,4,2331,0,0,61,50,11,4457,3,0,0.0,0.0,0.0,2,0,2,0,0,0,0,0,0,2020-12-27 19:15:002020-12-27 19:15:002020-12-27 19:15:002020-12-27 19:15:00
3975,35410,Pascal Groß,2426,"[2017, 2018, 2019, 2020]",Brighton & Hove Albion,52,47,5,3777,12,0,53,40,13,3475,2,0,105,87,18,7252,14,0,9.0,0.0,9.0,9,0,9,4,0,4,0,0,0,2020-12-27 19:15:002020-12-27 19:15:002020-12-27 19:15:002020-12-27 19:15:00
3976,8855,Pascal Struijk,1065,[2020],Leeds United,2,2,0,165,0,0,4,3,1,226,0,0,6,5,1,391,0,0,0.0,0.0,0.0,0,0,0,0,0,0,0,0,0,2020-12-27 19:15:00
3977,8856,Pascal Zuberbühler,3562,[2010],Fulham FC,0,0,0,0,0,0,0,0,0,0,0,0,0,0,0,0,0,0,0.0,0.0,0.0,0,0,0,0,0,0,0,0,0,2020-12-27 19:15:00
3978,8857,Patrice Carteron,4001,[2000],Sunderland AFC,3,3,0,270,1,0,4,4,0,360,0,0,7,7,0,630,1,0,0.0,0.0,0.0,1,0,1,0,0,0,0,0,0,2020-12-27 19:15:00
3979,79758,Patrice Evra,1724,"[2005, 2006, 2007, 2008, 2009, 2010, 2011, 2012, 2013]",Manchester United,138,133,5,11649,4,0,133,130,3,11267,3,0,271,263,8,22916,7,0,0.0,0.0,0.0,2,2,4,0,0,0,0,0,0,2020-12-27 19:15:002020-12-27 19:15:002020-12-27 19:15:002020-12-27 19:15:002020-12-27 19:15:002020-12-27 19:15:002020-12-27 19:15:002020-12-27 19:15:002020-12-27 19:15:00
3980,8867,Patrice Evra,1724,[2017],West Ham United,1,1,0,66,0,0,4,2,2,163,0,0,5,3,2,229,0,0,0.0,0.0,0.0,0,0,0,0,0,0,0,0,0,2020-12-27 19:15:00
3981,8868,Patrice Luzi,4376,[2003],Liverpool FC,0,0,0,0,0,0,1,0,1,13,0,0,1,0,1,13,0,0,0.0,0.0,0.0,0,0,0,0,0,0,0,0,0,2020-12-27 19:15:00
3982,8869,Patrick Agyemang,3668,[2011],Queens Park Rangers,0,0,0,0,0,0,2,2,0,147,0,0,2,2,0,147,0,0,0.0,0.0,0.0,0,0,0,0,0,0,0,0,0,2020-12-27 19:15:00
3983,8870,Patrick Bamford,1261,[2015],Norwich City,2,1,1,79,0,0,5,1,4,157,0,0,7,2,5,236,0,0,0.0,0.0,0.0,0,0,0,0,0,0,0,0,0,2020-12-27 19:15:00
3984,8871,Patrick Bamford,1261,[2016],Burnley FC,2,0,2,11,0,0,4,0,4,23,0,0,6,0,6,34,0,0,0.0,0.0,0.0,0,0,0,0,0,0,0,0,0,2020-12-27 19:15:00
3985,8872,Patrick Bamford,1261,[2020],Leeds United,8,8,0,678,3,0,7,7,0,602,7,0,15,15,0,1280,10,0,3.0,3.0,6.0,2,4,6,1,0,1,0,0,0,2020-12-27 19:15:00
3986,8873,Patrick Cutrone,2183,[2019],Wolverhampton Wanderers,6,1,5,124,2,0,6,2,4,170,0,0,12,3,9,294,2,0,0.0,0.0,0.0,0,0,0,0,0,0,0,0,0,2020-12-27 19:15:00
3987,8874,Patrick Foletti,4398,[2001],Derby County,1,1,0,90,0,0,1,0,1,58,0,0,2,1,1,148,0,0,0.0,0.0,0.0,0,0,0,0,0,0,0,0,0,2020-12-27 19:15:00
3988,8875,Patrick Kluivert,2035,[2004],Newcastle United,10,5,5,502,1,0,14,9,5,698,5,0,24,14,10,1200,6,0,0.0,0.0,0.0,1,4,5,0,0,0,0,0,0,2020-12-27 19:15:00
3989,8876,Patrick M'Boma,3246,[2001],Sunderland AFC,4,2,2,236,0,0,5,3,2,236,1,0,9,5,4,472,1,0,0.0,0.0,0.0,0,1,1,0,0,0,0,0,0,2020-12-27 19:15:00
3990,8877,Patrick Roberts,3352,[2013],Fulham FC,1,0,1,9,0,0,1,0,1,35,0,0,2,0,2,44,0,0,0.0,0.0,0.0,0,0,0,0,0,0,0,0,0,2020-12-27 19:15:00
3991,8878,Patrick Roberts,3352,[2015],Manchester City,0,0,0,0,0,0,1,0,1,4,0,0,1,0,1,4,0,0,0.0,0.0,0.0,0,0,0,0,0,0,0,0,0,2020-12-27 19:15:00
3992,8879,Patrick Roberts,3352,[2019],Norwich City,1,0,1,14,0,0,2,0,2,10,0,0,3,0,3,24,0,0,0.0,0.0,0.0,0,0,0,0,0,0,0,0,0,2020-12-27 19:15:00
3993,44410,Patrick Vieira,1524,"[2000, 2001, 2002, 2003, 2004]",Arsenal FC,76,75,1,6501,13,0,71,69,2,6243,7,0,147,144,3,12744,20,0,9.0,4.0,13.0,9,5,14,0,0,0,0,0,0,2020-12-27 19:15:002020-12-27 19:15:002020-12-27 19:15:002020-12-27 19:15:002020-12-27 19:15:00
3994,17771,Patrick Vieira,1524,"[2009, 2010]",Manchester City,15,6,9,680,2,0,13,6,7,619,1,0,28,12,16,1299,3,0,1.0,0.0,1.0,1,0,1,0,0,0,0,0,0,2020-12-27 19:15:002020-12-27 19:15:00
3995,17775,Patrick van Aanholt,2254,"[2009, 2010]",Chelsea FC,1,0,1,13,0,0,1,0,1,19,0,0,2,0,2,32,0,0,0.0,0.0,0.0,0,0,0,0,0,0,0,0,0,2020-12-27 19:15:002020-12-27 19:15:00
3996,8889,Patrick van Aanholt,2254,[2011],Wigan Athletic,1,1,0,90,0,0,2,2,0,180,0,0,3,3,0,270,0,0,0.0,0.0,0.0,0,0,0,0,0,0,0,0,0,2020-12-27 19:15:00
3997,17781,Patrick van Aanholt,2254,"[2014, 2015]",Sunderland AFC,30,29,1,2612,4,0,31,30,1,2664,2,0,61,59,2,5276,6,0,1.0,0.0,1.0,4,2,6,0,0,0,0,0,0,2020-12-27 19:15:002020-12-27 19:15:00
3998,44470,Patrick van Aanholt,2254,"[2016, 2017, 2018, 2019, 2020]",Crystal Palace,57,54,3,4686,8,0,57,53,4,4750,5,0,114,107,7,9436,13,0,6.0,6.0,12.0,2,4,6,0,1,1,0,0,0,2020-12-27 19:15:002020-12-27 19:15:002020-12-27 19:15:002020-12-27 19:15:002020-12-27 19:15:00
3999,17796,Patrik Berger,2689,"[2000, 2002]",Liverpool FC,9,6,3,483,1,0,6,5,1,444,1,0,15,11,4,927,2,0,0.0,0.0,0.0,0,0,0,1,0,1,0,0,0,2020-12-27 19:15:002020-12-27 19:15:00
4000,8898,Patrik Berger,2689,[2001],West Ham United,1,1,0,90,0,0,0,0,0,0,0,0,1,1,0,90,0,0,0.0,0.0,0.0,0,0,0,0,0,0,0,0,0,2020-12-27 19:15:00
4001,17801,Patrik Berger,2689,"[2003, 2004]",Portsmouth FC,27,26,1,2162,6,0,24,23,1,1947,2,0,51,49,2,4109,8,0,3.0,0.0,3.0,3,2,5,0,0,0,0,0,0,2020-12-27 19:15:002020-12-27 19:15:00
4002,26709,Patrik Berger,2689,"[2005, 2006, 2007]",Aston Villa,18,5,13,685,1,0,11,3,8,427,1,0,29,8,21,1112,2,0,0.0,0.0,0.0,0,1,1,0,0,0,0,0,0,2020-12-27 19:15:002020-12-27 19:15:002020-12-27 19:15:00
4003,8905,Pau López,3959,[2016],Tottenham Hotspur,0,0,0,0,0,0,0,0,0,0,0,0,0,0,0,0,0,0,0.0,0.0,0.0,0,0,0,0,0,0,0,0,0,2020-12-27 19:15:00
4004,17813,Paul Boertien,3358,"[2000, 2001]",Derby County,21,15,6,1469,1,0,17,13,4,1190,0,0,38,28,10,2659,1,0,0.0,0.0,0.0,1,0,1,0,0,0,0,0,0,2020-12-27 19:15:002020-12-27 19:15:00
4005,17817,Paul Bosvelt,3124,"[2003, 2004]",Manchester City,25,23,2,2017,1,0,21,20,1,1731,1,0,46,43,3,3748,2,0,0.0,0.0,0.0,1,0,1,0,0,0,0,0,0,2020-12-27 19:15:002020-12-27 19:15:00
4006,8910,Paul Brooker,3810,[2003],Leicester City,1,0,1,22,0,0,2,0,2,32,0,0,3,0,3,54,0,0,0.0,0.0,0.0,0,0,0,0,0,0,0,0,0,2020-12-27 19:15:00
4007,8911,Paul Butler,2904,[2000],Sunderland AFC,1,1,0,90,0,0,1,1,0,90,0,0,2,2,0,180,0,0,0.0,0.0,0.0,0,0,0,0,0,0,0,0,0,2020-12-27 19:15:00
4008,8912,Paul Butler,2904,[2003],Wolverhampton Wanderers,19,19,0,1710,1,0,18,18,0,1620,0,0,37,37,0,3330,1,0,0.0,0.0,0.0,1,0,1,0,0,0,0,0,0,2020-12-27 19:15:00
4009,17827,Paul Devlin,2623,"[2002, 2003]",Birmingham City,19,10,9,971,2,0,15,10,5,945,1,0,34,20,14,1916,3,0,1.0,0.0,1.0,2,1,3,1,1,2,0,0,0,2020-12-27 19:15:002020-12-27 19:15:00
4010,17835,Paul Dickov,1878,"[2000, 2006]",Manchester City,22,14,8,1299,2,0,15,10,5,953,2,0,37,24,13,2252,4,0,0.0,0.0,0.0,1,1,2,0,0,0,0,0,0,2020-12-27 19:15:002020-12-27 19:15:00
4011,17833,Paul Dickov,1878,"[2001, 2003]",Leicester City,25,21,4,1906,9,0,22,18,4,1577,6,0,47,39,8,3483,15,0,3.0,0.0,3.0,6,4,10,1,1,2,0,0,0,2020-12-27 19:15:002020-12-27 19:15:00
4012,17837,Paul Dickov,1878,"[2004, 2005]",Blackburn Rovers,25,23,2,1915,9,0,24,21,3,1663,5,0,49,44,5,3578,14,0,3.0,5.0,8.0,6,4,10,2,1,3,0,0,0,2020-12-27 19:15:002020-12-27 19:15:00
4013,62468,Paul Dummett,2467,"[2013, 2014, 2015, 2017, 2018, 2019, 2020]",Newcastle United,65,58,7,5169,2,0,64,55,9,4878,0,0,129,113,16,10047,2,0,1.0,0.0,1.0,2,0,2,0,0,0,0,0,0,2020-12-27 19:15:002020-12-27 19:15:002020-12-27 19:15:002020-12-27 19:15:002020-12-27 19:15:002020-12-27 19:15:002020-12-27 19:15:00
4014,8928,Paul Gallacher,4195,[2004],Norwich City,0,0,0,0,0,0,0,0,0,0,0,0,0,0,0,0,0,0,0.0,0.0,0.0,0,0,0,0,0,0,0,0,0,2020-12-27 19:15:00
4015,53589,Paul Gallagher,1142,"[2002, 2003, 2004, 2005, 2006, 2009]",Blackburn Rovers,29,8,21,882,3,0,32,11,21,1123,3,0,61,19,42,2005,6,0,1.0,3.0,4.0,2,2,4,0,0,0,0,0,0,2020-12-27 19:15:002020-12-27 19:15:002020-12-27 19:15:002020-12-27 19:15:002020-12-27 19:15:002020-12-27 19:15:00
4016,17871,Paul Gascoigne,2826,"[2000, 2001]",Everton FC,18,8,10,787,0,0,14,10,4,980,1,0,32,18,14,1767,1,0,0.0,0.0,0.0,0,1,1,0,0,0,0,0,0,2020-12-27 19:15:002020-12-27 19:15:00
4017,26814,Paul Gerrard,2822,"[2000, 2001, 2002]",Everton FC,25,25,0,2249,0,0,21,21,0,1890,0,0,46,46,0,4139,0,0,0.0,0.0,0.0,0,0,0,0,0,0,0,0,0,2020-12-27 19:15:002020-12-27 19:15:002020-12-27 19:15:00
4018,8940,Paul Gerrard,2822,[2006],Sheffield United,1,1,0,90,0,0,1,1,0,90,0,0,2,2,0,180,0,0,0.0,0.0,0.0,0,0,0,0,0,0,0,0,0,2020-12-27 19:15:00
4019,8941,Paul Huntington,3509,[2006],Newcastle United,5,5,0,450,0,0,5,4,1,361,1,0,10,9,1,811,1,0,0.0,0.0,0.0,0,1,1,0,0,0,0,0,0,2020-12-27 19:15:00
4020,8942,Paul Ifill,2585,[2006],Sheffield United,3,3,0,169,0,0,0,0,0,0,0,0,3,3,0,169,0,0,0.0,0.0,0.0,0,0,0,0,0,0,0,0,0,2020-12-27 19:15:00
4021,17887,Paul Ince,2905,"[2000, 2001]",Middlesbrough FC,30,30,0,2685,2,0,29,29,0,2610,2,0,59,59,0,5295,4,0,1.0,0.0,1.0,2,1,3,0,0,0,0,0,0,2020-12-27 19:15:002020-12-27 19:15:00
4022,8945,Paul Ince,2905,[2003],Wolverhampton Wanderers,15,15,0,1350,1,0,17,17,0,1530,1,0,32,32,0,2880,2,0,0.0,0.0,0.0,1,1,2,0,0,0,0,0,0,2020-12-27 19:15:00
4023,26841,Paul Jones,2044,"[2000, 2001, 2002]",Southampton FC,41,40,1,3604,0,0,38,38,0,3420,0,0,79,78,1,7024,0,0,0.0,0.0,0.0,0,0,0,0,0,0,0,0,0,2020-12-27 19:15:002020-12-27 19:15:002020-12-27 19:15:00
4024,8949,Paul Jones,2044,[2003],Wolverhampton Wanderers,8,8,0,720,0,0,8,8,0,720,0,0,16,16,0,1440,0,0,0.0,0.0,0.0,0,0,0,0,0,0,0,0,0,2020-12-27 19:15:00
4025,17901,Paul Kitson,3884,"[2000, 2001]",West Ham United,4,1,3,136,0,0,5,2,3,193,3,0,9,3,6,329,3,0,0.0,0.0,0.0,0,3,3,0,0,0,0,0,0,2020-12-27 19:15:002020-12-27 19:15:00
4026,44770,Paul Konchesky,1560,"[2000, 2001, 2002, 2003, 2004]",Charlton Athletic,68,36,32,3473,4,0,63,41,22,3986,1,0,131,77,54,7459,5,0,0.0,0.0,0.0,2,0,2,0,0,0,0,0,0,2020-12-27 19:15:002020-12-27 19:15:002020-12-27 19:15:002020-12-27 19:15:002020-12-27 19:15:00
4027,17915,Paul Konchesky,1560,"[2005, 2006]",West Ham United,28,28,0,2520,1,0,29,29,0,2601,0,0,57,57,0,5121,1,0,0.0,0.0,0.0,0,0,0,0,0,0,0,0,0,2020-12-27 19:15:002020-12-27 19:15:00
4028,26880,Paul Konchesky,1560,"[2007, 2008, 2009]",Fulham FC,45,45,0,4042,1,0,44,44,0,3897,1,0,89,89,0,7939,2,0,0.0,0.0,0.0,1,1,2,0,0,0,0,0,0,2020-12-27 19:15:002020-12-27 19:15:002020-12-27 19:15:00
4029,8962,Paul Konchesky,1560,[2010],Liverpool FC,6,6,0,462,0,0,9,9,0,790,0,0,15,15,0,1252,0,0,0.0,0.0,0.0,0,0,0,0,0,0,0,0,0,2020-12-27 19:15:00
4030,8963,Paul Konchesky,1560,[2014],Leicester City,13,13,0,1153,1,0,13,13,0,1108,0,0,26,26,0,2261,1,0,3.0,0.0,3.0,1,0,1,0,0,0,0,0,0,2020-12-27 19:15:00
4031,17929,Paul McShane,1607,"[2007, 2008]",Sunderland AFC,13,9,4,888,0,0,11,11,0,942,0,0,24,20,4,1830,0,0,0.0,0.0,0.0,0,0,0,0,0,0,0,0,0,2020-12-27 19:15:002020-12-27 19:15:00
4032,26901,Paul McShane,1607,"[2009, 2013, 2014]",Hull City,28,26,2,2167,0,0,29,28,1,2510,1,0,57,54,3,4677,1,0,0.0,0.0,0.0,0,0,0,0,0,0,0,0,0,2020-12-27 19:15:002020-12-27 19:15:002020-12-27 19:15:00
4033,8969,Paul McVeigh,2393,[2004],Norwich City,10,1,9,260,0,0,7,2,5,211,1,0,17,3,14,471,1,0,0.0,0.0,0.0,0,0,0,0,0,0,0,0,0,2020-12-27 19:15:00
4034,17941,Paul Merson,2769,"[2000, 2001]",Aston Villa,31,29,2,2567,5,0,24,23,1,2039,3,0,55,52,3,4606,8,0,3.0,3.0,6.0,3,3,6,0,0,0,0,0,0,2020-12-27 19:15:002020-12-27 19:15:00
4035,8972,Paul Murray,4560,[2001],Southampton FC,0,0,0,0,0,0,1,0,1,8,0,0,1,0,1,8,0,0,0.0,0.0,0.0,0,0,0,0,0,0,0,0,0,2020-12-27 19:15:00
4036,17947,Paul Okon,2070,"[2000, 2001]",Middlesbrough FC,14,13,1,1113,0,0,14,11,3,958,0,0,28,24,4,2071,0,0,0.0,0.0,0.0,0,0,0,0,0,0,0,0,0,2020-12-27 19:15:002020-12-27 19:15:00
4037,8975,Paul Okon,2070,[2002],Leeds United,7,7,0,599,0,0,7,7,0,596,0,0,14,14,0,1195,0,0,0.0,0.0,0.0,0,0,0,0,0,0,0,0,0,2020-12-27 19:15:00
4038,53871,Paul Pogba,1642,"[2011, 2016, 2017, 2018, 2019, 2020]",Manchester United,63,55,8,4964,16,0,60,54,6,4862,10,0,123,109,14,9826,26,0,6.0,0.0,6.0,8,5,13,5,2,7,0,0,0,2020-12-27 19:15:002020-12-27 19:15:002020-12-27 19:15:002020-12-27 19:15:002020-12-27 19:15:002020-12-27 19:15:00
4039,8982,Paul Rachubka,3843,[2000],Manchester United,1,1,0,90,0,0,0,0,0,0,0,0,1,1,0,90,0,0,0.0,0.0,0.0,0,0,0,0,0,0,0,0,0,2020-12-27 19:15:00
4040,8983,Paul Rachubka,3843,[2010],Blackpool FC,1,0,1,34,0,0,1,1,0,90,0,0,2,1,1,124,0,0,0.0,0.0,0.0,0,0,0,0,0,0,0,0,0,2020-12-27 19:15:00
4041,17969,Paul Ritchie,3853,"[2000, 2002]",Manchester City,5,4,1,342,0,0,6,6,0,530,0,0,11,10,1,872,0,0,0.0,0.0,0.0,0,0,0,0,0,0,0,0,0,2020-12-27 19:15:002020-12-27 19:15:00
4042,26961,Paul Robinson,1262,"[2000, 2002, 2003]",Leeds United,41,40,1,3619,0,0,41,41,0,3690,0,0,82,81,1,7309,0,0,0.0,0.0,0.0,0,0,0,0,0,0,0,0,0,2020-12-27 19:15:002020-12-27 19:15:002020-12-27 19:15:00
4043,17982,Paul Robinson,1262,"[2004, 2008]",West Bromwich Albion,31,29,2,2561,0,0,34,34,0,3002,1,0,65,63,2,5563,1,0,0.0,1.0,1.0,0,1,1,0,0,0,0,0,0,2020-12-27 19:15:002020-12-27 19:15:00
4044,26973,Paul Robinson,1262,"[2005, 2006, 2007]",Tottenham Hotspur,50,50,0,4500,1,0,48,48,0,4320,0,0,98,98,0,8820,1,0,0.0,0.0,0.0,0,0,0,0,0,0,0,0,0,2020-12-27 19:15:002020-12-27 19:15:002020-12-27 19:15:00
4045,8994,Paul Robinson,1262,[2009],Wigan Athletic,1,1,0,90,0,0,0,0,0,0,0,0,1,1,0,90,0,0,0.0,0.0,0.0,0,0,0,0,0,0,0,0,0,2020-12-27 19:15:00
4046,8995,Paul Robinson,1262,[2010],Bolton Wanderers,18,18,0,1620,0,0,17,17,0,1530,0,0,35,35,0,3150,0,0,0.0,0.0,0.0,0,0,0,0,0,0,0,0,0,2020-12-27 19:15:00
4047,8996,Paul Robinson,1262,[2011],Blackburn Rovers,18,18,0,1620,0,0,16,16,0,1440,0,0,34,34,0,3060,0,0,0.0,0.0,0.0,0,0,0,0,0,0,0,0,0,2020-12-27 19:15:00
4048,8997,Paul Robinson,1262,[2016],Burnley FC,1,1,0,90,0,0,2,2,0,180,0,0,3,3,0,270,0,0,0.0,0.0,0.0,0,0,0,0,0,0,0,0,0,2020-12-27 19:15:00
4049,45005,Paul Scharner,1734,"[2005, 2006, 2008, 2009, 2012]",Wigan Athletic,58,48,10,4348,4,0,62,57,5,4998,6,0,120,105,15,9346,10,0,1.0,1.0,2.0,3,5,8,0,0,0,0,0,0,2020-12-27 19:15:002020-12-27 19:15:002020-12-27 19:15:002020-12-27 19:15:002020-12-27 19:15:00
4050,9000,Paul Scharner,1734,[2007],Blackburn Rovers,0,0,0,0,0,0,1,1,0,90,0,0,1,1,0,90,0,0,0.0,0.0,0.0,0,0,0,0,0,0,0,0,0,2020-12-27 19:15:00
4051,18007,Paul Scharner,1734,"[2010, 2011]",West Bromwich Albion,31,25,6,2156,0,0,31,26,5,2215,7,0,62,51,11,4371,7,0,0.0,10.0,10.0,0,5,5,0,0,0,0,0,0,2020-12-27 19:15:002020-12-27 19:15:00
4052,117156,Paul Scholes,1112,"[2000, 2001, 2002, 2003, 2004, 2005, 2006, 2007, 2008, 2009, 2010, 2011, 2012]",Manchester United,164,136,28,12085,37,0,168,144,24,12881,29,0,332,280,52,24966,66,0,3.0,9.0,12.0,20,23,43,0,0,0,0,0,0,2020-12-27 19:15:002020-12-27 19:15:002020-12-27 19:15:002020-12-27 19:15:002020-12-27 19:15:002020-12-27 19:15:002020-12-27 19:15:002020-12-27 19:15:002020-12-27 19:15:002020-12-27 19:15:002020-12-27 19:15:002020-12-27 19:15:002020-12-27 19:15:00
4053,9019,Paul Smith,3586,[2004],Southampton FC,2,2,0,180,0,0,2,1,1,174,0,0,4,3,1,354,0,0,0.0,0.0,0.0,0,0,0,0,0,0,0,0,0,2020-12-27 19:15:00
4054,18041,Paul Stalteri,2955,"[2005, 2006]",Tottenham Hotspur,20,17,3,1549,1,0,18,16,2,1511,1,0,38,33,5,3060,2,0,0.0,3.0,3.0,1,1,2,0,0,0,0,0,0,2020-12-27 19:15:002020-12-27 19:15:00
4055,9022,Paul Stalteri,2955,[2007],Fulham FC,6,6,0,512,0,0,7,7,0,624,0,0,13,13,0,1136,0,0,0.0,0.0,0.0,0,0,0,0,0,0,0,0,0,2020-12-27 19:15:00
4056,9023,Paul Telfer,2105,[2000],Leeds United,1,0,1,39,0,0,0,0,0,0,0,0,1,0,1,39,0,0,0.0,0.0,0.0,0,0,0,0,0,0,0,0,0,2020-12-27 19:15:00
4057,36102,Paul Telfer,2105,"[2001, 2002, 2003, 2004]",Southampton FC,62,51,11,4710,1,0,59,55,4,5008,0,0,121,106,15,9718,1,0,0.0,0.0,0.0,0,0,0,0,0,0,0,0,0,2020-12-27 19:15:002020-12-27 19:15:002020-12-27 19:15:002020-12-27 19:15:00
4058,27087,Paul Thirlwell,1635,"[2000, 2001, 2002]",Sunderland AFC,17,9,8,969,0,0,20,16,4,1367,0,0,37,25,12,2336,0,0,0.0,0.0,0.0,0,0,0,0,0,0,0,0,0,2020-12-27 19:15:002020-12-27 19:15:002020-12-27 19:15:00
4059,18063,Paul Warhurst,3069,"[2001, 2002]",Bolton Wanderers,18,18,0,1357,0,0,14,12,2,980,0,0,32,30,2,2337,0,0,0.0,0.0,0.0,0,0,0,0,0,0,0,0,0,2020-12-27 19:15:002020-12-27 19:15:00
4060,9033,Paul Williams,2097,[2000],Leeds United,1,1,0,90,0,0,0,0,0,0,0,0,1,1,0,90,0,0,0.0,0.0,0.0,0,0,0,0,0,0,0,0,0,2020-12-27 19:15:00
4061,18069,Paul Williams,2097,"[2001, 2002]",Southampton FC,18,18,0,1606,0,0,20,17,3,1557,0,0,38,35,3,3163,0,0,0.0,0.0,0.0,0,0,0,0,0,0,0,0,0,2020-12-27 19:15:002020-12-27 19:15:00
4062,18073,Paulinho,3536,"[2013, 2014]",Tottenham Hotspur,23,14,9,1338,2,0,22,17,5,1548,4,0,45,31,14,2886,6,0,0.0,4.0,4.0,2,3,5,0,0,0,0,0,0,2020-12-27 19:15:002020-12-27 19:15:00
4063,81378,Paulo Ferreira,1761,"[2004, 2005, 2006, 2007, 2008, 2009, 2010, 2011, 2012]",Chelsea FC,64,50,14,4564,0,0,75,55,20,5035,0,0,139,105,34,9599,0,0,0.0,0.0,0.0,0,0,0,0,0,0,0,0,0,2020-12-27 19:15:002020-12-27 19:15:002020-12-27 19:15:002020-12-27 19:15:002020-12-27 19:15:002020-12-27 19:15:002020-12-27 19:15:002020-12-27 19:15:002020-12-27 19:15:00
4064,36194,Paulo Gazzaniga,1156,"[2012, 2013, 2014, 2015]",Southampton FC,11,11,0,990,0,0,10,9,1,842,0,0,21,20,1,1832,0,0,0.0,0.0,0.0,0,0,0,0,0,0,0,0,0,2020-12-27 19:15:002020-12-27 19:15:002020-12-27 19:15:002020-12-27 19:15:00
4065,27156,Paulo Gazzaniga,1156,"[2017, 2018, 2019]",Tottenham Hotspur,9,9,0,810,0,0,13,12,1,1162,0,0,22,21,1,1972,0,0,0.0,0.0,0.0,0,0,0,0,0,0,0,0,0,2020-12-27 19:15:002020-12-27 19:15:002020-12-27 19:15:00
4066,18109,Paulo Wanchope,3310,"[2000, 2003]",Manchester City,23,16,7,1548,9,0,24,19,5,1684,6,0,47,35,12,3232,15,0,4.0,4.0,8.0,6,4,10,0,0,0,0,0,0,2020-12-27 19:15:002020-12-27 19:15:00
4067,18113,Paulo da Silva,2951,"[2009, 2010]",Sunderland AFC,8,7,1,624,0,0,8,5,3,536,0,0,16,12,4,1160,0,0,0.0,0.0,0.0,0,0,0,0,0,0,0,0,0,2020-12-27 19:15:002020-12-27 19:15:00
4068,9058,Pavel Pogrebnyak,1989,[2011],Fulham FC,6,6,0,444,5,0,6,6,0,506,1,0,12,12,0,950,6,0,0.0,3.0,3.0,3,1,4,0,0,0,0,0,0,2020-12-27 19:15:00
4069,9059,Pavel Pogrebnyak,1989,[2012],Reading FC,16,14,2,1151,2,0,13,12,1,919,3,0,29,26,3,2070,5,0,6.0,0.0,6.0,2,3,5,0,0,0,0,0,0,2020-12-27 19:15:00
4070,9060,Pavel Srníček,3784,[2003],Portsmouth FC,1,1,0,90,0,0,2,2,0,180,0,0,3,3,0,270,0,0,0.0,0.0,0.0,0,0,0,0,0,0,0,0,0,2020-12-27 19:15:00
4071,9061,Pavel Srníček,3784,[2006],Newcastle United,1,0,1,3,0,0,1,1,0,90,0,0,2,1,1,93,0,0,0.0,0.0,0.0,0,0,0,0,0,0,0,0,0,2020-12-27 19:15:00
4072,45320,Pedro,1851,"[2015, 2016, 2017, 2018, 2019]",Chelsea FC,71,49,22,4172,19,0,66,47,19,3988,11,0,137,96,41,8160,30,0,0.0,0.0,0.0,10,5,15,0,0,0,0,0,0,2020-12-27 19:15:002020-12-27 19:15:002020-12-27 19:15:002020-12-27 19:15:002020-12-27 19:15:00
4073,9067,Pedro Chirivella,3627,[2015],Liverpool FC,0,0,0,0,0,0,1,1,0,46,0,0,1,1,0,46,0,0,0.0,0.0,0.0,0,0,0,0,0,0,0,0,0,2020-12-27 19:15:00
4074,9068,Pedro Mendes,1390,[2004],Tottenham Hotspur,12,10,2,935,1,0,12,12,0,1015,0,0,24,22,2,1950,1,0,0.0,0.0,0.0,0,0,0,0,0,0,0,0,0,2020-12-27 19:15:00
4075,27210,Pedro Mendes,1390,"[2005, 2006, 2007]",Portsmouth FC,29,28,1,2355,4,0,29,25,4,2175,1,0,58,53,5,4530,5,0,3.0,0.0,3.0,3,0,3,0,0,0,0,0,0,2020-12-27 19:15:002020-12-27 19:15:002020-12-27 19:15:00
4076,18145,Pedro Neto,2182,"[2019, 2020]",Wolverhampton Wanderers,22,12,10,1099,3,0,22,11,11,1031,4,0,44,23,21,2130,7,0,7.0,0.0,7.0,3,1,4,0,0,0,0,0,0,2020-12-27 19:15:002020-12-27 19:15:00
4077,36302,Pedro Obiang,2639,"[2015, 2016, 2017, 2018]",West Ham United,49,31,18,2807,1,0,42,31,11,2726,2,0,91,62,29,5533,3,0,0.0,0.0,0.0,1,2,3,0,0,0,0,0,0,2020-12-27 19:15:002020-12-27 19:15:002020-12-27 19:15:002020-12-27 19:15:00
4078,9078,Pegguy Arphexad,4447,[2001],Liverpool FC,1,1,0,90,0,0,1,0,1,35,0,0,2,1,1,125,0,0,0.0,0.0,0.0,0,0,0,0,0,0,0,0,0,2020-12-27 19:15:00
4079,9079,Pelé,3327,[2008],West Bromwich Albion,2,1,1,141,0,0,1,0,1,2,0,0,3,1,2,143,0,0,0.0,0.0,0.0,0,0,0,0,0,0,0,0,0,2020-12-27 19:15:00
4080,72668,Pepe Reina,1775,"[2005, 2006, 2007, 2008, 2009, 2010, 2011, 2012]",Liverpool FC,143,143,0,12870,0,0,142,142,0,12780,0,0,285,285,0,25650,0,0,0.0,0.0,0.0,0,0,0,0,0,0,0,0,0,2020-12-27 19:15:002020-12-27 19:15:002020-12-27 19:15:002020-12-27 19:15:002020-12-27 19:15:002020-12-27 19:15:002020-12-27 19:15:002020-12-27 19:15:00
4081,9088,Pepe Reina,1775,[2019],Aston Villa,5,5,0,450,0,0,7,7,0,630,0,0,12,12,0,1080,0,0,0.0,0.0,0.0,0,0,0,0,0,0,0,0,0,2020-12-27 19:15:00
4082,27270,Per Frandsen,3070,"[2001, 2002, 2003]",Bolton Wanderers,47,39,8,3439,4,0,49,42,7,3498,2,0,96,81,15,6937,6,0,1.0,0.0,1.0,4,0,4,0,0,0,0,0,0,2020-12-27 19:15:002020-12-27 19:15:002020-12-27 19:15:00
4083,9092,Per Krøldrup,3651,[2005],Everton FC,0,0,0,0,0,0,1,1,0,90,0,0,1,1,0,90,0,0,0.0,0.0,0.0,0,0,0,0,0,0,0,0,0,2020-12-27 19:15:00
4084,63672,Per Mertesacker,1496,"[2011, 2012, 2013, 2014, 2015, 2016, 2017]",Arsenal FC,77,74,3,6728,2,0,79,78,1,6973,4,0,156,152,4,13701,6,0,0.0,3.0,3.0,2,2,4,0,0,0,0,0,0,2020-12-27 19:15:002020-12-27 19:15:002020-12-27 19:15:002020-12-27 19:15:002020-12-27 19:15:002020-12-27 19:15:002020-12-27 19:15:00
4085,9100,Peter Atherton,2836,[2000],Bradford City,12,12,0,1057,0,0,11,11,0,974,0,0,23,23,0,2031,0,0,0.0,0.0,0.0,0,0,0,0,0,0,0,0,0,2020-12-27 19:15:00
4086,9101,Peter Beagrie,3061,[2000],Bradford City,7,5,2,482,1,0,9,3,6,317,0,0,16,8,8,799,1,0,3.0,0.0,3.0,1,0,1,0,0,0,0,0,0,2020-12-27 19:15:00
4087,9102,Peter Canero,4307,[2003],Leicester City,3,1,2,133,0,0,4,1,3,108,0,0,7,2,5,241,0,0,0.0,0.0,0.0,0,0,0,0,0,0,0,0,0,2020-12-27 19:15:00
4088,27312,Peter Clarke,4359,"[2000, 2001, 2003]",Everton FC,2,2,0,131,0,0,7,4,3,455,0,0,9,6,3,586,0,0,0.0,0.0,0.0,0,0,0,0,0,0,0,0,0,2020-12-27 19:15:002020-12-27 19:15:002020-12-27 19:15:00
4089,27321,Peter Crouch,1273,"[2001, 2002, 2003]",Aston Villa,18,10,8,830,1,0,18,10,8,905,5,0,36,20,16,1735,6,0,1.0,3.0,4.0,1,3,4,0,0,0,0,0,0,2020-12-27 19:15:002020-12-27 19:15:002020-12-27 19:15:00
4090,9109,Peter Crouch,1273,[2004],Southampton FC,13,9,4,903,7,0,11,7,4,725,5,0,24,16,8,1628,12,0,1.0,0.0,1.0,3,2,5,0,0,0,0,0,0,2020-12-27 19:15:00
4091,27333,Peter Crouch,1273,"[2005, 2006, 2007]",Liverpool FC,48,31,17,2534,13,0,37,24,13,2038,9,0,85,55,30,4572,22,0,7.0,0.0,7.0,7,4,11,0,0,0,0,0,0,2020-12-27 19:15:002020-12-27 19:15:002020-12-27 19:15:00
4092,9113,Peter Crouch,1273,[2008],Portsmouth FC,19,19,0,1686,7,0,19,19,0,1674,3,0,38,38,0,3360,10,0,3.0,1.0,4.0,6,2,8,0,0,0,0,0,0,2020-12-27 19:15:00
4093,18229,Peter Crouch,1273,"[2009, 2010]",Tottenham Hotspur,36,20,16,2002,7,0,34,19,15,1967,5,0,70,39,31,3969,12,0,0.0,6.0,6.0,5,3,8,0,0,0,0,0,0,2020-12-27 19:15:002020-12-27 19:15:00
4094,63833,Peter Crouch,1273,"[2011, 2012, 2013, 2014, 2015, 2016, 2017]",Stoke City,102,69,33,6407,25,0,99,68,31,6259,19,0,201,137,64,12666,44,0,17.0,14.0,31.0,17,17,34,0,0,0,0,0,0,2020-12-27 19:15:002020-12-27 19:15:002020-12-27 19:15:002020-12-27 19:15:002020-12-27 19:15:002020-12-27 19:15:002020-12-27 19:15:00
4095,9123,Peter Crouch,1273,[2018],Burnley FC,4,0,4,56,0,0,2,0,2,30,0,0,6,0,6,86,0,0,0.0,0.0,0.0,0,0,0,0,0,0,0,0,0,2020-12-27 19:15:00
4096,18249,Peter Enckelman,1131,"[2001, 2002]",Aston Villa,19,19,0,1710,0,0,21,21,0,1890,0,0,40,40,0,3600,0,0,0.0,0.0,0.0,0,0,0,0,0,0,0,0,0,2020-12-27 19:15:002020-12-27 19:15:00
4097,9126,Peter Enckelman,1131,[2003],Blackburn Rovers,1,1,0,90,0,0,1,1,0,90,0,0,2,2,0,180,0,0,0.0,0.0,0.0,0,0,0,0,0,0,0,0,0,2020-12-27 19:15:00
4098,27384,Peter Løvenkrands,2401,"[2008, 2010, 2011]",Newcastle United,23,16,7,1266,5,0,23,12,11,1040,4,0,46,28,18,2306,9,0,0.0,0.0,0.0,1,3,4,0,0,0,0,0,0,2020-12-27 19:15:002020-12-27 19:15:002020-12-27 19:15:00
4099,27393,Peter Odemwingie,1551,"[2010, 2011, 2012]",West Bromwich Albion,47,37,10,3437,18,0,40,30,10,2856,12,0,87,67,20,6293,30,0,10.0,9.0,19.0,11,9,20,1,2,3,0,0,0,2020-12-27 19:15:002020-12-27 19:15:002020-12-27 19:15:00
4100,27402,Peter Odemwingie,1551,"[2013, 2014, 2015]",Stoke City,14,7,7,735,4,0,13,9,4,874,2,0,27,16,11,1609,6,0,3.0,0.0,3.0,3,2,5,0,0,0,0,0,0,2020-12-27 19:15:002020-12-27 19:15:002020-12-27 19:15:00
4101,36550,Peter Ramage,1947,"[2004, 2005, 2006, 2007]",Newcastle United,23,21,2,1894,0,0,27,23,4,2099,0,0,50,44,6,3993,0,0,0.0,0.0,0.0,0,0,0,0,0,0,0,0,0,2020-12-27 19:15:002020-12-27 19:15:002020-12-27 19:15:002020-12-27 19:15:00
4102,9140,Peter Ramage,1947,[2011],Queens Park Rangers,0,0,0,0,0,0,0,0,0,0,0,0,0,0,0,0,0,0,0.0,0.0,0.0,0,0,0,0,0,0,0,0,0,2020-12-27 19:15:00
4103,9141,Peter Ramage,1947,[2013],Crystal Palace,0,0,0,0,0,0,0,0,0,0,0,0,0,0,0,0,0,0,0.0,0.0,0.0,0,0,0,0,0,0,0,0,0,2020-12-27 19:15:00
4104,9142,Peter Schmeichel,3198,[2001],Aston Villa,15,15,0,1350,0,0,13,13,0,1170,1,0,28,28,0,2520,1,0,0.0,0.0,0.0,0,0,0,0,0,0,0,0,0,2020-12-27 19:15:00
4105,9143,Peter Schmeichel,3198,[2002],Manchester City,16,16,0,1440,0,0,11,11,0,990,0,0,27,27,0,2430,0,0,0.0,0.0,0.0,0,0,0,0,0,0,0,0,0,2020-12-27 19:15:00
4106,45730,Peter Whittingham,2969,"[2002, 2003, 2004, 2005, 2006]",Aston Villa,25,14,11,1494,1,0,28,16,12,1564,0,0,53,30,23,3058,1,0,0.0,0.0,0.0,1,0,1,0,0,0,0,0,0,2020-12-27 19:15:002020-12-27 19:15:002020-12-27 19:15:002020-12-27 19:15:002020-12-27 19:15:00
4107,9149,Peter Whittingham,2969,[2013],Cardiff City,14,14,0,1209,2,0,18,16,2,1455,1,0,32,30,2,2664,3,0,4.0,1.0,5.0,2,1,3,1,0,1,0,0,0,2020-12-27 19:15:00
4108,100705,Petr Čech,1531,"[2004, 2005, 2006, 2007, 2008, 2009, 2010, 2011, 2012, 2013, 2014]",Chelsea FC,163,162,1,14602,0,0,167,167,0,14875,0,0,330,329,1,29477,0,0,0.0,0.0,0.0,0,0,0,0,0,0,0,0,0,2020-12-27 19:15:002020-12-27 19:15:002020-12-27 19:15:002020-12-27 19:15:002020-12-27 19:15:002020-12-27 19:15:002020-12-27 19:15:002020-12-27 19:15:002020-12-27 19:15:002020-12-27 19:15:002020-12-27 19:15:00
4109,36650,Petr Čech,1531,"[2015, 2016, 2017, 2018]",Arsenal FC,55,55,0,4885,0,0,54,54,0,4808,0,0,109,109,0,9693,0,0,0.0,0.0,0.0,0,0,0,0,0,0,0,0,0,2020-12-27 19:15:002020-12-27 19:15:002020-12-27 19:15:002020-12-27 19:15:00
4110,9165,Petri Pasanen,3161,[2003],Portsmouth FC,7,6,1,535,0,0,5,5,0,405,0,0,12,11,1,940,0,0,0.0,0.0,0.0,0,0,0,0,0,0,0,0,0,2020-12-27 19:15:00
4111,9166,Petter Vaagan Moen,4564,[2011],Queens Park Rangers,0,0,0,0,0,0,0,0,0,0,0,0,0,0,0,0,0,0,0.0,0.0,0.0,0,0,0,0,0,0,0,0,0,2020-12-27 19:15:00
4112,9167,Phil Babb,3481,[2002],Sunderland AFC,13,13,0,1144,0,0,13,13,0,1170,0,0,26,26,0,2314,0,0,0.0,0.0,0.0,0,0,0,0,0,0,0,0,0,2020-12-27 19:15:00
4113,9168,Phil Bardsley,1409,[2005],Manchester United,4,1,3,148,0,0,4,2,2,155,0,0,8,3,5,303,0,0,0.0,0.0,0.0,0,0,0,0,0,0,0,0,0,2020-12-27 19:15:00
4114,9169,Phil Bardsley,1409,[2006],Aston Villa,7,7,0,617,0,0,6,6,0,530,0,0,13,13,0,1147,0,0,0.0,0.0,0.0,0,0,0,0,0,0,0,0,0,2020-12-27 19:15:00
4115,64211,Phil Bardsley,1409,"[2007, 2008, 2009, 2010, 2011, 2012, 2013]",Sunderland AFC,88,77,11,6797,5,0,85,76,9,6803,2,0,173,153,20,13600,7,0,3.0,3.0,6.0,4,2,6,0,0,0,0,0,0,2020-12-27 19:15:002020-12-27 19:15:002020-12-27 19:15:002020-12-27 19:15:002020-12-27 19:15:002020-12-27 19:15:002020-12-27 19:15:00
4116,27534,Phil Bardsley,1409,"[2014, 2015, 2016]",Stoke City,24,22,2,1839,0,0,27,25,2,2230,0,0,51,47,4,4069,0,0,0.0,0.0,0.0,0,0,0,0,0,0,0,0,0,2020-12-27 19:15:002020-12-27 19:15:002020-12-27 19:15:00
4117,36726,Phil Bardsley,1409,"[2017, 2018, 2019, 2020]",Burnley FC,29,29,0,2566,0,0,27,27,0,2392,0,0,56,56,0,4958,0,0,0.0,0.0,0.0,0,0,0,0,0,0,0,0,0,2020-12-27 19:15:002020-12-27 19:15:002020-12-27 19:15:002020-12-27 19:15:00
4118,36742,Phil Foden,1844,"[2017, 2018, 2019, 2020]",Manchester City,32,12,20,1103,5,0,19,5,14,668,3,0,51,17,34,1771,8,0,3.0,1.0,4.0,2,1,3,0,0,0,0,0,0,2020-12-27 19:15:002020-12-27 19:15:002020-12-27 19:15:002020-12-27 19:15:00
4119,9188,Phil Gilchrist,2829,[2000],Leicester City,5,2,3,246,0,0,6,4,2,384,0,0,11,6,5,630,0,0,0.0,0.0,0.0,0,0,0,0,0,0,0,0,0,2020-12-27 19:15:00
4120,9189,Phil Gilchrist,2829,[2002],West Bromwich Albion,11,11,0,958,0,0,11,11,0,990,0,0,22,22,0,1948,0,0,0.0,0.0,0.0,0,0,0,0,0,0,0,0,0,2020-12-27 19:15:00
4121,18381,Phil Ifil,4449,"[2004, 2006]",Tottenham Hotspur,1,1,0,90,0,0,2,2,0,180,0,0,3,3,0,270,0,0,0.0,0.0,0.0,0,0,0,0,0,0,0,0,0,2020-12-27 19:15:002020-12-27 19:15:00
4122,27603,Phil Jagielka,1048,"[2006, 2019, 2020]",Sheffield United,23,19,4,1822,3,0,21,20,1,1826,1,0,44,39,5,3648,4,0,6.0,0.0,6.0,2,1,3,1,1,2,0,0,0,2020-12-27 19:15:002020-12-27 19:15:002020-12-27 19:15:00
4123,110382,Phil Jagielka,1048,"[2007, 2008, 2009, 2010, 2011, 2012, 2013, 2014, 2015, 2016, 2017, 2018]",Everton FC,157,147,10,13244,9,0,161,152,9,13723,5,0,318,299,19,26967,14,0,9.0,4.0,13.0,8,4,12,0,0,0,0,0,0,2020-12-27 19:15:002020-12-27 19:15:002020-12-27 19:15:002020-12-27 19:15:002020-12-27 19:15:002020-12-27 19:15:002020-12-27 19:15:002020-12-27 19:15:002020-12-27 19:15:002020-12-27 19:15:002020-12-27 19:15:002020-12-27 19:15:00
4124,9207,Phil Jevons,3771,[2000],Everton FC,0,0,0,0,0,0,4,0,4,105,0,0,4,0,4,105,0,0,0.0,0.0,0.0,0,0,0,0,0,0,0,0,0,2020-12-27 19:15:00
4125,18417,Phil Jones,1650,"[2009, 2010]",Blackburn Rovers,19,16,3,1509,0,0,16,15,1,1351,0,0,35,31,4,2860,0,0,0.0,0.0,0.0,0,0,0,0,0,0,0,0,0,2020-12-27 19:15:002020-12-27 19:15:00
4126,82926,Phil Jones,1650,"[2011, 2012, 2013, 2014, 2015, 2016, 2017, 2018, 2019]",Manchester United,77,68,9,5888,0,0,88,82,6,6988,2,0,165,150,15,12876,2,0,0.0,3.0,3.0,0,2,2,0,0,0,0,0,0,2020-12-27 19:15:002020-12-27 19:15:002020-12-27 19:15:002020-12-27 19:15:002020-12-27 19:15:002020-12-27 19:15:002020-12-27 19:15:002020-12-27 19:15:002020-12-27 19:15:00
4127,9219,Phil Mulryne,4020,[2004],Norwich City,4,3,1,238,0,0,5,4,1,312,0,0,9,7,2,550,0,0,0.0,0.0,0.0,0,0,0,0,0,0,0,0,0,2020-12-27 19:15:00
4128,46110,Phil Neville,1114,"[2000, 2001, 2002, 2003, 2004]",Manchester United,65,54,11,4693,3,0,65,49,16,4589,1,0,130,103,27,9282,4,0,0.0,0.0,0.0,2,1,3,0,0,0,0,0,0,2020-12-27 19:15:002020-12-27 19:15:002020-12-27 19:15:002020-12-27 19:15:002020-12-27 19:15:00
4129,73828,Phil Neville,1114,"[2005, 2006, 2007, 2008, 2009, 2010, 2011, 2012]",Everton FC,115,113,2,10069,3,0,120,117,3,10179,1,0,235,230,5,20248,4,0,0.0,0.0,0.0,2,0,2,0,0,0,0,0,0,2020-12-27 19:15:002020-12-27 19:15:002020-12-27 19:15:002020-12-27 19:15:002020-12-27 19:15:002020-12-27 19:15:002020-12-27 19:15:002020-12-27 19:15:00
4130,18467,Philip Billing,3192,"[2017, 2018]",Huddersfield Town,21,16,5,1445,1,0,22,17,5,1507,1,0,43,33,10,2952,2,0,0.0,0.0,0.0,0,1,1,0,0,0,0,0,0,2020-12-27 19:15:002020-12-27 19:15:00
4131,9235,Philip Billing,3192,[2019],AFC Bournemouth,17,14,3,1227,1,0,17,15,2,1308,0,0,34,29,5,2535,1,0,0.0,0.0,0.0,1,0,1,0,0,0,0,0,0,2020-12-27 19:15:00
4132,9236,Philip Heise,1838,[2019],Norwich City,0,0,0,0,0,0,0,0,0,0,0,0,0,0,0,0,0,0,0.0,0.0,0.0,0,0,0,0,0,0,0,0,0,2020-12-27 19:15:00
4133,9237,Philip Stamp,3601,[2000],Sunderland AFC,1,1,0,14,0,0,0,0,0,0,0,0,1,1,0,14,0,0,0.0,0.0,0.0,0,0,0,0,0,0,0,0,0,2020-12-27 19:15:00
4134,9238,Philip Stamp,3601,[2001],Middlesbrough FC,3,2,1,162,0,0,3,1,2,131,0,0,6,3,3,293,0,0,0.0,0.0,0.0,0,0,0,0,0,0,0,0,0,2020-12-27 19:15:00
4135,9239,Philipp Degen,3996,[2009],Liverpool FC,4,1,3,136,0,0,3,2,1,203,0,0,7,3,4,339,0,0,0.0,0.0,0.0,0,0,0,0,0,0,0,0,0,2020-12-27 19:15:00
4136,27723,Philipp Wollscheid,1582,"[2014, 2015, 2016]",Stoke City,23,22,1,1951,0,0,22,22,0,1920,0,0,45,44,1,3871,0,0,0.0,0.0,0.0,0,0,0,0,0,0,0,0,0,2020-12-27 19:15:002020-12-27 19:15:002020-12-27 19:15:00
4137,27732,Philippe Christanval,3247,"[2005, 2006, 2007]",Fulham FC,19,14,5,1345,0,0,15,10,5,994,1,0,34,24,10,2339,1,0,0.0,1.0,1.0,0,1,1,0,0,0,0,0,0,2020-12-27 19:15:002020-12-27 19:15:002020-12-27 19:15:00
4138,9246,Philippe Sandler,4559,[2018],Manchester City,0,0,0,0,0,0,0,0,0,0,0,0,0,0,0,0,0,0,0.0,0.0,0.0,0,0,0,0,0,0,0,0,0,2020-12-27 19:15:00
4139,36994,Philippe Senderos,1228,"[2004, 2005, 2006, 2007]",Arsenal FC,28,24,4,2121,3,0,33,27,6,2520,1,0,61,51,10,4641,4,0,0.0,0.0,0.0,1,1,2,0,0,0,0,0,0,2020-12-27 19:15:002020-12-27 19:15:002020-12-27 19:15:002020-12-27 19:15:00
4140,9251,Philippe Senderos,1228,[2009],Everton FC,1,0,1,1,0,0,1,1,0,90,0,0,2,1,1,91,0,0,0.0,0.0,0.0,0,0,0,0,0,0,0,0,0,2020-12-27 19:15:00
4141,37014,Philippe Senderos,1228,"[2010, 2011, 2012, 2013]",Fulham FC,31,29,2,2618,1,0,26,25,1,2190,1,0,57,54,3,4808,2,0,3.0,0.0,3.0,1,0,1,0,0,0,0,0,0,2020-12-27 19:15:002020-12-27 19:15:002020-12-27 19:15:002020-12-27 19:15:00
4142,9256,Philippe Senderos,1228,[2014],Aston Villa,4,4,0,360,0,0,4,3,1,272,0,0,8,7,1,632,0,0,0.0,0.0,0.0,0,0,0,0,0,0,0,0,0,2020-12-27 19:15:00
4143,9257,Pierre Ducrocq,3356,[2001],Derby County,9,9,0,752,0,0,9,9,0,724,0,0,18,18,0,1476,0,0,0.0,0.0,0.0,0,0,0,0,0,0,0,0,0,2020-12-27 19:15:00
4144,9258,Pierre Womé,3645,[2002],Fulham FC,8,7,1,555,1,0,4,4,0,327,0,0,12,11,1,882,1,0,0.0,0.0,0.0,0,0,0,0,0,0,0,0,0,2020-12-27 19:15:00
4145,37042,Pierre-Emerick Aubameyang,1476,"[2017, 2018, 2019, 2020]",Arsenal FC,51,46,5,4143,34,0,47,44,3,3975,23,0,98,90,8,8118,57,0,11.0,18.0,29.0,21,16,37,6,2,8,0,1,1,2020-12-27 19:15:002020-12-27 19:15:002020-12-27 19:15:002020-12-27 19:15:00
4146,37058,Pierre-Emile Højbjerg,1248,"[2016, 2017, 2018, 2019]",Southampton FC,53,46,7,4159,2,0,56,48,8,4342,2,0,109,94,15,8501,4,0,0.0,3.0,3.0,2,1,3,0,0,0,0,0,0,2020-12-27 19:15:002020-12-27 19:15:002020-12-27 19:15:002020-12-27 19:15:00
4147,9267,Pierre-Emile Højbjerg,1248,[2020],Tottenham Hotspur,7,7,0,630,0,0,8,8,0,720,0,0,15,15,0,1350,0,0,0.0,0.0,0.0,0,0,0,0,0,0,0,0,0,2020-12-27 19:15:00
4148,9268,Pierre-Yves André,3501,[2002],Bolton Wanderers,4,0,4,61,0,0,5,0,5,119,0,0,9,0,9,180,0,0,0.0,0.0,0.0,0,0,0,0,0,0,0,0,0,2020-12-27 19:15:00
4149,9269,Piotr Świerczewski,4434,[2002],Birmingham City,1,0,1,38,0,0,0,0,0,0,0,0,1,0,1,38,0,0,0.0,0.0,0.0,0,0,0,0,0,0,0,0,0,2020-12-27 19:15:00
4150,18541,Piqué,4084,"[2005, 2007]",Manchester United,6,4,2,381,0,0,6,2,4,192,0,0,12,6,6,573,0,0,0.0,0.0,0.0,0,0,0,0,0,0,0,0,0,2020-12-27 19:15:002020-12-27 19:15:00
4151,27819,Piscu,3666,"[2010, 2011, 2012]",Wigan Athletic,6,5,1,483,0,0,5,4,1,383,0,0,11,9,2,866,0,0,0.0,0.0,0.0,0,0,0,0,0,0,0,0,0,2020-12-27 19:15:002020-12-27 19:15:002020-12-27 19:15:00
4152,9275,Pozuelo,2940,[2013],Swansea City,10,3,7,372,0,0,12,4,8,500,0,0,22,7,15,872,0,0,0.0,0.0,0.0,0,0,0,0,0,0,0,0,0,2020-12-27 19:15:00
4153,18553,Péter Gulácsi,3527,"[2010, 2012]",Liverpool FC,0,0,0,0,0,0,0,0,0,0,0,0,0,0,0,0,0,0,0.0,0.0,0.0,0,0,0,0,0,0,0,0,0,2020-12-27 19:15:002020-12-27 19:15:00
4154,9278,Péter Halmosi,2325,[2008],Hull City,9,3,6,325,0,0,9,1,8,225,0,0,18,4,14,550,0,0,0.0,0.0,0.0,0,0,0,0,0,0,0,0,0,2020-12-27 19:15:00
4155,9279,Péter Kurucz,4527,[2009],West Ham United,1,0,1,16,0,0,0,0,0,0,0,0,1,0,1,16,0,0,0.0,0.0,0.0,0,0,0,0,0,0,0,0,0,2020-12-27 19:15:00
4156,18561,Quincy Owusu-Abeyie,3336,"[2004, 2005]",Arsenal FC,2,1,1,82,0,0,3,0,3,35,0,0,5,1,4,117,0,0,0.0,0.0,0.0,0,0,0,0,0,0,0,0,0,2020-12-27 19:15:002020-12-27 19:15:00
4157,9282,Quincy Owusu-Abeyie,3336,[2009],Portsmouth FC,4,2,2,260,0,0,6,1,5,95,0,0,10,3,7,355,0,0,0.0,0.0,0.0,0,0,0,0,0,0,0,0,0,2020-12-27 19:15:00
4158,46425,Quinton Fortune,2782,"[2000, 2001, 2002, 2003, 2004]",Manchester United,37,26,11,2478,3,0,32,22,10,1835,0,0,69,48,21,4313,3,0,0.0,0.0,0.0,0,0,0,0,0,0,0,0,0,2020-12-27 19:15:002020-12-27 19:15:002020-12-27 19:15:002020-12-27 19:15:002020-12-27 19:15:00
4159,9288,Quinton Fortune,2782,[2006],Bolton Wanderers,4,4,0,313,0,0,2,1,1,110,0,0,6,5,1,423,0,0,0.0,0.0,0.0,0,0,0,0,0,0,0,0,0,2020-12-27 19:15:00
4160,9289,Rachid Ghezzal,3961,[2018],Leicester City,12,5,7,455,1,0,7,3,4,283,0,0,19,8,11,738,1,0,0.0,0.0,0.0,0,0,0,0,0,0,0,0,0,2020-12-27 19:15:00
4161,9290,Radamel Falcao,2379,[2014],Manchester United,15,7,8,585,2,0,11,7,4,698,2,0,26,14,12,1283,4,0,3.0,2.0,5.0,1,2,3,0,0,0,0,0,0,2020-12-27 19:15:00
4162,9291,Radamel Falcao,2379,[2015],Chelsea FC,4,1,3,134,1,0,6,0,6,94,0,0,10,1,9,228,1,0,0.0,0.0,0.0,1,0,1,0,0,0,0,0,0,2020-12-27 19:15:00
4163,9292,Rade Prica,3889,[2007],Sunderland AFC,4,0,4,151,1,0,2,0,2,89,0,0,6,0,6,240,1,0,0.0,0.0,0.0,0,0,0,0,0,0,0,0,0,2020-12-27 19:15:00
4164,18587,Radek Černý,2805,"[2004, 2007]",Tottenham Hotspur,8,7,1,656,0,0,8,8,0,720,0,0,16,15,1,1376,0,0,0.0,0.0,0.0,0,0,0,0,0,0,0,0,0,2020-12-27 19:15:002020-12-27 19:15:00
4165,9295,Radek Černý,2805,[2011],Queens Park Rangers,2,2,0,180,0,0,3,3,0,270,0,0,5,5,0,450,0,0,0.0,0.0,0.0,0,0,0,0,0,0,0,0,0,2020-12-27 19:15:00
4166,18593,Radhi Jaïdi,2502,"[2004, 2005]",Bolton Wanderers,20,16,4,1357,3,0,22,19,3,1708,5,0,42,35,7,3065,8,0,0.0,1.0,1.0,3,4,7,0,0,0,0,0,0,2020-12-27 19:15:002020-12-27 19:15:00
4167,9298,Radhi Jaïdi,2502,[2007],Birmingham City,9,9,0,810,0,0,9,9,0,810,0,0,18,18,0,1620,0,0,0.0,0.0,0.0,0,0,0,0,0,0,0,0,0,2020-12-27 19:15:00
4168,9299,Radosav Petrović,3425,[2011],Blackburn Rovers,10,5,5,484,0,0,9,5,4,498,0,0,19,10,9,982,0,0,0.0,0.0,0.0,0,0,0,0,0,0,0,0,0,2020-12-27 19:15:00
4169,27903,Radoslav Kováč,1278,"[2008, 2009, 2010]",West Ham United,26,19,7,1738,2,0,27,23,4,1885,1,0,53,42,11,3623,3,0,0.0,0.0,0.0,1,1,2,0,0,0,0,0,0,2020-12-27 19:15:002020-12-27 19:15:002020-12-27 19:15:00
4170,65142,Radostin Kishishev,1668,"[2000, 2001, 2002, 2003, 2004, 2005, 2006]",Charlton Athletic,86,72,14,6057,2,0,88,73,15,6241,0,0,174,145,29,12298,2,0,0.0,0.0,0.0,1,0,1,0,0,0,0,0,0,2020-12-27 19:15:002020-12-27 19:15:002020-12-27 19:15:002020-12-27 19:15:002020-12-27 19:15:002020-12-27 19:15:002020-12-27 19:15:00
4171,65191,Rafael,1787,"[2008, 2009, 2010, 2011, 2012, 2013, 2014]",Manchester United,60,53,7,4513,2,0,49,43,6,3697,3,0,109,96,13,8210,5,0,0.0,0.0,0.0,0,2,2,0,0,0,0,0,0,2020-12-27 19:15:002020-12-27 19:15:002020-12-27 19:15:002020-12-27 19:15:002020-12-27 19:15:002020-12-27 19:15:002020-12-27 19:15:00
4172,9317,Rafael Camacho,2088,[2018],Liverpool FC,1,0,1,1,0,0,0,0,0,0,0,0,1,0,1,1,0,0,0.0,0.0,0.0,0,0,0,0,0,0,0,0,0,2020-12-27 19:15:00
4173,9318,Rafael Schmitz,3241,[2007],Birmingham City,7,5,2,465,0,0,8,7,1,611,0,0,15,12,3,1076,0,0,0.0,0.0,0.0,0,0,0,0,0,0,0,0,0,2020-12-27 19:15:00
4174,27960,Rafael van der Vaart,2405,"[2010, 2011, 2012]",Tottenham Hotspur,33,30,3,2389,13,0,30,27,3,2265,11,0,63,57,6,4654,24,0,6.0,3.0,9.0,12,10,22,3,2,5,0,0,0,2020-12-27 19:15:002020-12-27 19:15:002020-12-27 19:15:00
4175,27969,Rafik Halliche,2652,"[2010, 2011, 2012]",Fulham FC,1,0,1,15,0,0,0,0,0,0,0,0,1,0,1,15,0,0,0.0,0.0,0.0,0,0,0,0,0,0,0,0,0,2020-12-27 19:15:002020-12-27 19:15:002020-12-27 19:15:00
4176,18651,Ragnar Klavan,1188,"[2016, 2017]",Liverpool FC,21,15,6,1412,0,0,16,14,2,1264,1,0,37,29,8,2676,1,0,0.0,3.0,3.0,0,1,1,0,0,0,0,0,0,2020-12-27 19:15:002020-12-27 19:15:00
4177,18655,Ragnvald Soma,4446,"[2000, 2001]",West Ham United,1,1,0,90,0,0,6,2,4,225,0,0,7,3,4,315,0,0,0.0,0.0,0.0,0,0,0,0,0,0,0,0,0,2020-12-27 19:15:002020-12-27 19:15:00
4178,9329,Raheem Hanley,4384,[2014],Swansea City,0,0,0,0,0,0,0,0,0,0,0,0,0,0,0,0,0,0,0.0,0.0,0.0,0,0,0,0,0,0,0,0,0,2020-12-27 19:15:00
4179,37326,Raheem Sterling,1203,"[2011, 2012, 2013, 2014]",Liverpool FC,51,40,11,3691,10,0,44,37,7,3356,8,0,95,77,18,7047,18,0,3.0,3.0,6.0,6,3,9,0,0,0,0,0,0,2020-12-27 19:15:002020-12-27 19:15:002020-12-27 19:15:002020-12-27 19:15:00
4180,56019,Raheem Sterling,1203,"[2015, 2016, 2017, 2018, 2019, 2020]",Manchester City,84,75,9,6607,42,0,92,78,14,6870,30,0,176,153,23,13477,72,0,10.0,12.0,22.0,19,12,31,0,1,1,0,0,0,2020-12-27 19:15:002020-12-27 19:15:002020-12-27 19:15:002020-12-27 19:15:002020-12-27 19:15:002020-12-27 19:15:00
4181,18681,Raimond van der Gouw,3788,"[2000, 2001]",Manchester United,4,1,3,130,0,0,6,3,3,324,0,0,10,4,6,454,0,0,0.0,0.0,0.0,0,0,0,0,0,0,0,0,0,2020-12-27 19:15:002020-12-27 19:15:00
4182,9342,Raimond van der Gouw,3788,[2002],West Ham United,0,0,0,0,0,0,0,0,0,0,0,0,0,0,0,0,0,0,0.0,0.0,0.0,0,0,0,0,0,0,0,0,0,2020-12-27 19:15:00
4183,18687,Rajiv van La Parra,3100,"[2017, 2018]",Huddersfield Town,18,14,4,1189,2,0,20,17,3,1364,1,0,38,31,7,2553,3,0,3.0,0.0,3.0,1,1,2,1,0,1,0,0,0,2020-12-27 19:15:002020-12-27 19:15:00
4184,9345,Ralf Fährmann,1835,[2019],Norwich City,0,0,0,0,0,0,1,1,0,22,0,0,1,1,0,22,0,0,0.0,0.0,0.0,0,0,0,0,0,0,0,0,0,2020-12-27 19:15:00
4185,18693,Ramadan Sobhi,1586,"[2016, 2017]",Stoke City,18,8,10,811,1,0,22,12,10,1270,1,0,40,20,20,2081,2,0,0.0,1.0,1.0,0,1,1,0,0,0,0,0,0,2020-12-27 19:15:002020-12-27 19:15:00
4186,9348,Ramadan Sobhi,1586,[2018],Huddersfield Town,1,0,1,30,0,0,3,0,3,45,0,0,4,0,4,75,0,0,0.0,0.0,0.0,0,0,0,0,0,0,0,0,0,2020-12-27 19:15:00
4187,9349,Rami Shaaban,4152,[2002],Manchester United,1,1,0,43,0,0,0,0,0,0,0,0,1,1,0,43,0,0,0.0,0.0,0.0,0,0,0,0,0,0,0,0,0,2020-12-27 19:15:00
4188,56115,Ramires,2460,"[2010, 2011, 2012, 2013, 2014, 2015]",Chelsea FC,79,57,22,5240,11,0,79,68,11,6031,6,0,158,125,33,11271,17,0,3.0,0.0,3.0,5,1,6,0,0,0,0,0,0,2020-12-27 19:15:002020-12-27 19:15:002020-12-27 19:15:002020-12-27 19:15:002020-12-27 19:15:002020-12-27 19:15:00
4189,28071,Ramiro Funes Mori,3109,"[2015, 2016, 2017]",Everton FC,28,21,7,2041,1,0,27,20,7,1847,3,0,55,41,14,3888,4,0,0.0,0.0,0.0,1,3,4,0,0,0,0,0,0,2020-12-27 19:15:002020-12-27 19:15:002020-12-27 19:15:00
4190,9359,Ramon Vega,3852,[2000],Tottenham Hotspur,4,3,1,310,0,0,5,5,0,450,0,0,9,8,1,760,0,0,0.0,0.0,0.0,0,0,0,0,0,0,0,0,0,2020-12-27 19:15:00
4191,28083,Raphael Spiegel,2761,"[2012, 2015, 2016]",West Ham United,0,0,0,0,0,0,0,0,0,0,0,0,0,0,0,0,0,0,0.0,0.0,0.0,0,0,0,0,0,0,0,0,0,2020-12-27 19:15:002020-12-27 19:15:002020-12-27 19:15:00
4192,9363,Raphinha,1070,[2020],Leeds United,5,4,1,348,0,0,5,3,2,316,1,0,10,7,3,664,1,0,0.0,3.0,3.0,0,1,1,0,0,0,0,0,0,2020-12-27 19:15:00
4193,9364,Rati Aleksidze,3833,[2000],Chelsea FC,1,0,1,7,0,0,1,0,1,11,0,0,2,0,2,18,0,0,0.0,0.0,0.0,0,0,0,0,0,0,0,0,0,2020-12-27 19:15:00
4194,18731,Ravel Morrison,3419,"[2013, 2014]",West Ham United,9,5,4,566,1,0,8,7,1,620,2,0,17,12,5,1186,3,0,0.0,0.0,0.0,1,1,2,0,0,0,0,0,0,2020-12-27 19:15:002020-12-27 19:15:00
4195,9367,Ravel Morrison,3419,[2019],Sheffield United,1,0,1,12,0,0,0,0,0,0,0,0,1,0,1,12,0,0,0.0,0.0,0.0,0,0,0,0,0,0,0,0,0,2020-12-27 19:15:00
4196,37478,Ray Parlour,1334,"[2000, 2001, 2002, 2003]",Arsenal FC,48,36,12,3223,4,0,54,45,9,4000,0,0,102,81,21,7223,4,0,0.0,0.0,0.0,1,0,1,0,0,0,0,0,0,2020-12-27 19:15:002020-12-27 19:15:002020-12-27 19:15:002020-12-27 19:15:00
4197,18745,Ray Parlour,1334,"[2004, 2005]",Middlesbrough FC,23,21,2,1881,0,0,23,22,1,1884,0,0,46,43,3,3765,0,0,0.0,0.0,0.0,0,0,0,0,0,0,0,0,0,2020-12-27 19:15:002020-12-27 19:15:00
4198,9374,Rayan Aït Nouri,1079,[2020],Wolverhampton Wanderers,3,2,1,195,1,0,3,2,1,155,0,0,6,4,2,350,1,0,0.0,0.0,0.0,1,0,1,0,0,0,0,0,0,2020-12-27 19:15:00
4199,9375,Rayhaan Tulloch,4397,[2017],West Bromwich Albion,0,0,0,0,0,0,0,0,0,0,0,0,0,0,0,0,0,0,0.0,0.0,0.0,0,0,0,0,0,0,0,0,0,2020-12-27 19:15:00
4200,9376,Raúl Bravo,2130,[2002],Leeds United,3,3,0,270,0,0,2,2,0,130,0,0,5,5,0,400,0,0,0.0,0.0,0.0,0,0,0,0,0,0,0,0,0,2020-12-27 19:15:00
4201,28134,Raúl Jiménez,2148,"[2018, 2019, 2020]",Wolverhampton Wanderers,43,43,0,3742,18,0,43,40,3,3460,16,0,86,83,3,7202,34,0,9.0,14.0,23.0,11,15,26,4,2,6,1,0,1,2020-12-27 19:15:002020-12-27 19:15:002020-12-27 19:15:00
4202,9380,Raúl Meireles,2992,[2010],Liverpool FC,16,16,0,1264,3,0,17,16,1,1280,2,0,33,32,1,2544,5,0,0.0,3.0,3.0,3,1,4,0,0,0,0,0,0,2020-12-27 19:15:00
4203,18763,Raúl Meireles,2992,"[2011, 2012]",Chelsea FC,15,12,3,994,2,0,16,12,4,1040,0,0,31,24,7,2034,2,0,0.0,0.0,0.0,1,0,1,0,0,0,0,0,0,2020-12-27 19:15:002020-12-27 19:15:00
4204,28152,Reece Burke,3447,"[2014, 2016, 2017]",West Ham United,2,1,1,166,0,0,3,3,0,249,0,0,5,4,1,415,0,0,0.0,0.0,0.0,0,0,0,0,0,0,0,0,0,2020-12-27 19:15:002020-12-27 19:15:002020-12-27 19:15:00
4205,9386,Reece Grego-Cox,2923,[2014],Queens Park Rangers,2,0,2,46,0,0,2,1,1,95,0,0,4,1,3,141,0,0,0.0,0.0,0.0,0,0,0,0,0,0,0,0,0,2020-12-27 19:15:00
4206,9387,Reece James,2960,[2014],Manchester United,0,0,0,0,0,0,0,0,0,0,0,0,0,0,0,0,0,0,0.0,0.0,0.0,0,0,0,0,0,0,0,0,0,2020-12-27 19:15:00
4207,18777,Reece James,2960,"[2019, 2020]",Chelsea FC,16,12,4,1124,0,0,21,16,5,1472,1,0,37,28,9,2596,1,0,0.0,0.0,0.0,0,1,1,0,0,0,0,0,0,2020-12-27 19:15:002020-12-27 19:15:00
4208,37566,Reece Oxford,2789,"[2014, 2015, 2016, 2017]",West Ham United,3,1,2,74,0,0,5,2,3,141,0,0,8,3,5,215,0,0,0.0,0.0,0.0,0,0,0,0,0,0,0,0,0,2020-12-27 19:15:002020-12-27 19:15:002020-12-27 19:15:002020-12-27 19:15:00
4209,9394,Reece Wabara,2864,[2010],Manchester City,0,0,0,0,0,0,1,0,1,3,0,0,1,0,1,3,0,0,0.0,0.0,0.0,0,0,0,0,0,0,0,0,0,2020-12-27 19:15:00
4210,9395,Rees Greenwood,4396,[2015],Sunderland AFC,0,0,0,0,0,0,1,1,0,52,0,0,1,1,0,52,0,0,0.0,0.0,0.0,0,0,0,0,0,0,0,0,0,2020-12-27 19:15:00
4211,9396,Reguilón,1035,[2020],Tottenham Hotspur,5,5,0,450,0,0,6,5,1,431,0,0,11,10,1,881,0,0,0.0,0.0,0.0,0,0,0,0,0,0,0,0,0,2020-12-27 19:15:00
4212,28194,Reiss Nelson,1477,"[2017, 2019, 2020]",Arsenal FC,10,5,5,422,1,0,12,4,8,421,0,0,22,9,13,843,1,0,3.0,0.0,3.0,1,0,1,0,0,0,0,0,0,2020-12-27 19:15:002020-12-27 19:15:002020-12-27 19:15:00
4213,28203,Rekeem Harper,3213,"[2016, 2017, 2020]",West Bromwich Albion,2,0,2,41,0,0,0,0,0,0,0,0,2,0,2,41,0,0,0.0,0.0,0.0,0,0,0,0,0,0,0,0,0,2020-12-27 19:15:002020-12-27 19:15:002020-12-27 19:15:00
4214,18807,Remie Streete,4221,"[2012, 2014]",Newcastle United,0,0,0,0,0,0,0,0,0,0,0,0,0,0,0,0,0,0,0.0,0.0,0.0,0,0,0,0,0,0,0,0,0,2020-12-27 19:15:002020-12-27 19:15:00
4215,9405,Renato Sanches,3228,[2017],Swansea City,5,4,1,313,0,0,7,5,2,392,0,0,12,9,3,705,0,0,0.0,0.0,0.0,0,0,0,0,0,0,0,0,0,2020-12-27 19:15:00
4216,18813,Rene Gilmartin,3637,"[2015, 2016]",Watford FC,0,0,0,0,0,0,0,0,0,0,0,0,0,0,0,0,0,0,0.0,0.0,0.0,0,0,0,0,0,0,0,0,0,2020-12-27 19:15:002020-12-27 19:15:00
4217,18818,Reto Ziegler,1938,"[2004, 2006]",Tottenham Hotspur,9,6,3,575,1,0,14,6,8,541,0,0,23,12,11,1116,1,0,0.0,0.0,0.0,0,0,0,0,0,0,0,0,0,2020-12-27 19:15:002020-12-27 19:15:00
4218,9409,Reto Ziegler,1938,[2005],Wigan Athletic,6,2,4,279,0,0,4,3,1,275,0,0,10,5,5,554,0,0,0.0,0.0,0.0,0,0,0,0,0,0,0,0,0,2020-12-27 19:15:00
4219,28236,Reyes,1604,"[2003, 2004, 2005]",Arsenal FC,36,29,7,2388,7,0,32,23,9,1946,9,0,68,52,16,4334,16,0,3.0,7.0,10.0,2,5,7,0,0,0,0,0,0,2020-12-27 19:15:002020-12-27 19:15:002020-12-27 19:15:00
4220,18829,Rhian Brewster,4234,"[2016, 2019]",Liverpool FC,0,0,0,0,0,0,0,0,0,0,0,0,0,0,0,0,0,0,0.0,0.0,0.0,0,0,0,0,0,0,0,0,0,2020-12-27 19:15:002020-12-27 19:15:00
4221,9416,Rhian Brewster,4234,[2020],Sheffield United,6,2,4,242,0,0,5,3,2,237,0,0,11,5,6,479,0,0,0.0,0.0,0.0,0,0,0,0,0,0,0,0,0,2020-12-27 19:15:00
4222,9417,Rhoys Wiggins,3648,[2015],AFC Bournemouth,0,0,0,0,0,0,0,0,0,0,0,0,0,0,0,0,0,0,0.0,0.0,0.0,0,0,0,0,0,0,0,0,0,2020-12-27 19:15:00
4223,18837,Rhys Healey,3154,"[2013, 2018]",Cardiff City,2,0,2,30,0,0,2,0,2,32,0,0,4,0,4,62,0,0,0.0,0.0,0.0,0,0,0,0,0,0,0,0,0,2020-12-27 19:15:002020-12-27 19:15:00
4224,9420,Rhys Williams,1023,[2020],Liverpool FC,2,1,1,120,0,0,0,0,0,0,0,0,2,1,1,120,0,0,0.0,0.0,0.0,0,0,0,0,0,0,0,0,0,2020-12-27 19:15:00
4225,9421,Ricardo,4461,[2002],Manchester United,1,0,1,45,0,0,0,0,0,0,0,0,1,0,1,45,0,0,0.0,0.0,0.0,0,0,0,0,0,0,0,0,0,2020-12-27 19:15:00
4226,56547,Ricardo Carvalho,1760,"[2004, 2005, 2006, 2007, 2008, 2009]",Chelsea FC,70,68,2,5751,4,0,65,61,4,5405,3,0,135,129,6,11156,7,0,9.0,1.0,10.0,3,2,5,0,0,0,0,0,0,2020-12-27 19:15:002020-12-27 19:15:002020-12-27 19:15:002020-12-27 19:15:002020-12-27 19:15:002020-12-27 19:15:00
4227,9428,Ricardo Fuller,2500,[2004],Portsmouth FC,16,7,9,728,1,0,15,6,9,744,0,0,31,13,18,1472,1,0,0.0,0.0,0.0,1,0,1,0,0,0,0,0,0,2020-12-27 19:15:00
4228,37722,Ricardo Fuller,2500,"[2008, 2009, 2010, 2011]",Stoke City,51,32,19,3185,12,0,59,27,32,2961,6,0,110,59,51,6146,18,0,7.0,3.0,10.0,9,4,13,1,1,2,0,0,0,2020-12-27 19:15:002020-12-27 19:15:002020-12-27 19:15:002020-12-27 19:15:00
4229,103818,Ricardo Gardner,2411,"[2001, 2002, 2003, 2004, 2005, 2006, 2007, 2008, 2009, 2010, 2011]",Bolton Wanderers,122,101,21,9226,9,0,127,106,21,9720,1,0,249,207,42,18946,10,0,6.0,0.0,6.0,7,1,8,0,0,0,0,0,0,2020-12-27 19:15:002020-12-27 19:15:002020-12-27 19:15:002020-12-27 19:15:002020-12-27 19:15:002020-12-27 19:15:002020-12-27 19:15:002020-12-27 19:15:002020-12-27 19:15:002020-12-27 19:15:002020-12-27 19:15:00
4230,18889,Ricardo Pereira,2438,"[2018, 2019]",Leicester City,32,32,0,2876,5,0,31,31,0,2769,0,0,63,63,0,5645,5,0,3.0,0.0,3.0,4,0,4,0,0,0,0,0,0,2020-12-27 19:15:002020-12-27 19:15:00
4231,9446,Ricardo Quaresma,4233,[2008],Chelsea FC,2,1,1,72,0,0,2,0,2,59,0,0,4,1,3,131,0,0,0.0,0.0,0.0,0,0,0,0,0,0,0,0,0,2020-12-27 19:15:00
4232,18895,Ricardo Rocha,2954,"[2006, 2007]",Tottenham Hotspur,6,5,1,522,0,0,8,8,0,669,0,0,14,13,1,1191,0,0,0.0,0.0,0.0,0,0,0,0,0,0,0,0,0,2020-12-27 19:15:002020-12-27 19:15:00
4233,9449,Ricardo Rocha,2954,[2009],Portsmouth FC,4,4,0,310,0,0,6,6,0,496,0,0,10,10,0,806,0,0,0.0,0.0,0.0,0,0,0,0,0,0,0,0,0,2020-12-27 19:15:00
4234,56715,Ricardo Vaz Tê,3416,"[2003, 2004, 2005, 2006, 2007, 2008]",Bolton Wanderers,31,7,24,1032,3,0,26,3,23,690,0,0,57,10,47,1722,3,0,4.0,0.0,4.0,3,0,3,0,0,0,0,0,0,2020-12-27 19:15:002020-12-27 19:15:002020-12-27 19:15:002020-12-27 19:15:002020-12-27 19:15:002020-12-27 19:15:00
4235,28371,Ricardo Vaz Tê,3416,"[2012, 2013, 2014]",West Ham United,17,14,3,1063,3,0,19,10,9,1022,2,0,36,24,12,2085,5,0,0.0,0.0,0.0,1,0,1,0,0,0,0,0,0,2020-12-27 19:15:002020-12-27 19:15:002020-12-27 19:15:00
4236,9459,Ricardo Álvarez,3178,[2014],Sunderland AFC,9,4,5,357,0,0,4,1,3,138,0,0,13,5,8,495,0,0,0.0,0.0,0.0,0,0,0,0,0,0,0,0,0,2020-12-27 19:15:00
4237,9460,Riccardo Calder,4551,[2014],Aston Villa,0,0,0,0,0,0,0,0,0,0,0,0,0,0,0,0,0,0,0.0,0.0,0.0,0,0,0,0,0,0,0,0,0,2020-12-27 19:15:00
4238,9461,Riccardo Scimeca,1316,[2003],Leicester City,14,14,0,1260,0,0,15,14,1,1275,1,0,29,28,1,2535,1,0,0.0,0.0,0.0,0,0,0,0,0,0,0,0,0,2020-12-27 19:15:00
4239,18925,Riccardo Scimeca,1316,"[2004, 2005]",West Bromwich Albion,18,14,4,1298,0,0,17,15,2,1354,0,0,35,29,6,2652,0,0,0.0,0.0,0.0,0,0,0,0,0,0,0,0,0,2020-12-27 19:15:002020-12-27 19:15:00
4240,9464,Richairo Živković,3655,[2019],Sheffield United,2,0,2,26,0,0,3,0,3,81,0,0,5,0,5,107,0,0,0.0,0.0,0.0,0,0,0,0,0,0,0,0,0,2020-12-27 19:15:00
4241,18931,Richard Chaplow,3541,"[2004, 2005]",West Bromwich Albion,3,1,2,100,0,0,8,6,2,520,0,0,11,7,4,620,0,0,0.0,0.0,0.0,0,0,0,0,0,0,0,0,0,2020-12-27 19:15:002020-12-27 19:15:00
4242,9467,Richard Chaplow,3541,[2012],Southampton FC,1,0,1,28,0,0,2,0,2,24,0,0,3,0,3,52,0,0,0.0,0.0,0.0,0,0,0,0,0,0,0,0,0,2020-12-27 19:15:00
4243,9468,Richard Cresswell,1998,[2000],Leicester City,3,1,2,123,0,0,5,2,3,202,0,0,8,3,5,325,0,0,0.0,0.0,0.0,0,0,0,0,0,0,0,0,0,2020-12-27 19:15:00
4244,18939,Richard Cresswell,1998,"[2008, 2009]",Stoke City,14,3,11,522,0,0,18,9,9,954,0,0,32,12,20,1476,0,0,0.0,0.0,0.0,0,0,0,0,0,0,0,0,0,2020-12-27 19:15:002020-12-27 19:15:00
4245,9471,Richard Duffy,1075,[2003],Portsmouth FC,1,0,1,68,0,0,0,0,0,0,0,0,1,0,1,68,0,0,0.0,0.0,0.0,0,0,0,0,0,0,0,0,0,2020-12-27 19:15:00
4246,75804,Richard Dunne,1617,"[2000, 2002, 2003, 2004, 2005, 2006, 2007, 2008]",Manchester City,123,122,1,10675,5,0,116,114,2,10268,1,0,239,236,3,20943,6,0,3.0,0.0,3.0,3,1,4,0,0,0,0,0,0,2020-12-27 19:15:002020-12-27 19:15:002020-12-27 19:15:002020-12-27 19:15:002020-12-27 19:15:002020-12-27 19:15:002020-12-27 19:15:002020-12-27 19:15:00
4247,28443,Richard Dunne,1617,"[2009, 2010, 2011]",Aston Villa,47,47,0,4093,3,0,45,45,0,4011,1,0,92,92,0,8104,4,0,0.0,0.0,0.0,3,1,4,0,0,0,0,0,0,2020-12-27 19:15:002020-12-27 19:15:002020-12-27 19:15:00
4248,9483,Richard Dunne,1617,[2014],Queens Park Rangers,13,12,1,1018,0,0,10,10,0,856,0,0,23,22,1,1874,0,0,0.0,0.0,0.0,0,0,0,0,0,0,0,0,0,2020-12-27 19:15:00
4249,9484,Richard Eckersley,3328,[2008],Manchester United,0,0,0,0,0,0,2,0,2,49,0,0,2,0,2,49,0,0,0.0,0.0,0.0,0,0,0,0,0,0,0,0,0,2020-12-27 19:15:00
4250,9485,Richard Edghill,4216,[2000],Manchester City,3,3,0,230,0,0,2,2,0,180,0,0,5,5,0,410,0,0,0.0,0.0,0.0,0,0,0,0,0,0,0,0,0,2020-12-27 19:15:00
4251,9486,Richard García,1632,[2001],West Ham United,4,0,4,24,0,0,4,2,2,161,0,0,8,2,6,185,0,0,0.0,0.0,0.0,0,0,0,0,0,0,0,0,0,2020-12-27 19:15:00
4252,18975,Richard García,1632,"[2008, 2009]",Hull City,23,15,8,1196,0,0,18,12,6,1068,1,0,41,27,14,2264,1,0,0.0,1.0,1.0,0,1,1,0,0,0,0,0,0,2020-12-27 19:15:002020-12-27 19:15:00
4253,9489,Richard Gough,3841,[2000],Everton FC,7,7,0,484,0,0,2,2,0,180,0,0,9,9,0,664,0,0,0.0,0.0,0.0,0,0,0,0,0,0,0,0,0,2020-12-27 19:15:00
4254,66451,Richard Hughes,2812,"[2003, 2004, 2005, 2006, 2007, 2008, 2009]",Portsmouth FC,56,44,12,3826,0,0,57,42,15,3707,0,0,113,86,27,7533,0,0,0.0,0.0,0.0,0,0,0,0,0,0,0,0,0,2020-12-27 19:15:002020-12-27 19:15:002020-12-27 19:15:002020-12-27 19:15:002020-12-27 19:15:002020-12-27 19:15:002020-12-27 19:15:00
4255,18995,Richard Jackson,3357,"[2000, 2001]",Derby County,5,4,1,381,0,0,3,2,1,152,0,0,8,6,2,533,0,0,0.0,0.0,0.0,0,0,0,0,0,0,0,0,0,2020-12-27 19:15:002020-12-27 19:15:00
4256,9499,Richard Kingson,2600,[2007],Birmingham City,1,1,0,90,0,0,0,0,0,0,0,0,1,1,0,90,0,0,0.0,0.0,0.0,0,0,0,0,0,0,0,0,0,2020-12-27 19:15:00
4257,9500,Richard Kingson,2600,[2008],Wigan Athletic,2,2,0,180,0,0,2,1,1,170,0,0,4,3,1,350,0,0,0.0,0.0,0.0,0,0,0,0,0,0,0,0,0,2020-12-27 19:15:00
4258,9501,Richard Kingson,2600,[2010],Blackpool FC,10,10,0,843,0,0,10,9,1,854,0,0,20,19,1,1697,0,0,0.0,0.0,0.0,0,0,0,0,0,0,0,0,0,2020-12-27 19:15:00
4259,9502,Richard Lee,3727,[2006],Watford FC,5,5,0,450,0,0,3,2,1,224,0,0,8,7,1,674,0,0,0.0,0.0,0.0,0,0,0,0,0,0,0,0,0,2020-12-27 19:15:00
4260,19007,Richard Naylor,4062,"[2000, 2001]",Ipswich Town,14,5,9,527,2,0,12,5,7,524,1,0,26,10,16,1051,3,0,0.0,1.0,1.0,1,1,2,0,0,0,0,0,0,2020-12-27 19:15:002020-12-27 19:15:00
4261,28518,Richard Rufus,1670,"[2000, 2001, 2002]",Charlton Athletic,36,35,1,3181,4,0,35,35,0,3095,1,0,71,70,1,6276,5,0,3.0,0.0,3.0,3,1,4,0,0,0,0,0,0,2020-12-27 19:15:002020-12-27 19:15:002020-12-27 19:15:00
4262,9508,Richard Shaw,2096,[2000],Leeds United,1,1,0,90,0,0,0,0,0,0,0,0,1,1,0,90,0,0,0.0,0.0,0.0,0,0,0,0,0,0,0,0,0,2020-12-27 19:15:00
4263,28530,Richard Stearman,3430,"[2009, 2010, 2011]",Wolverhampton Wanderers,38,32,6,3067,1,0,39,35,4,3009,0,0,77,67,10,6076,1,0,1.0,0.0,1.0,1,0,1,0,0,0,0,0,0,2020-12-27 19:15:002020-12-27 19:15:002020-12-27 19:15:00
4264,9512,Richard Stearman,3430,[2019],Sheffield United,0,0,0,0,0,0,0,0,0,0,0,0,0,0,0,0,0,0,0.0,0.0,0.0,0,0,0,0,0,0,0,0,0,2020-12-27 19:15:00
4265,9513,Richard Wright,2977,[2000],Ipswich Town,17,17,0,1530,0,0,17,17,0,1530,0,0,34,34,0,3060,0,0,0.0,0.0,0.0,0,0,0,0,0,0,0,0,0,2020-12-27 19:15:00
4266,9514,Richard Wright,2977,[2001],Arsenal FC,4,4,0,354,0,0,7,7,0,630,0,0,11,11,0,984,0,0,0.0,0.0,0.0,0,0,0,0,0,0,0,0,0,2020-12-27 19:15:00
4267,47585,Richard Wright,2977,"[2002, 2003, 2004, 2005, 2006]",Everton FC,28,28,0,2455,0,0,30,28,2,2574,0,0,58,56,2,5029,0,0,0.0,0.0,0.0,0,0,0,0,0,0,0,0,0,2020-12-27 19:15:002020-12-27 19:15:002020-12-27 19:15:002020-12-27 19:15:002020-12-27 19:15:00
4268,19041,Richard Wright,2977,"[2012, 2015]",Manchester City,0,0,0,0,0,0,0,0,0,0,0,0,0,0,0,0,0,0,0.0,0.0,0.0,0,0,0,0,0,0,0,0,0,2020-12-27 19:15:002020-12-27 19:15:00
4269,9522,Richarlison,1461,[2017],Watford FC,19,14,5,1265,1,0,19,18,1,1562,4,0,38,32,6,2827,5,0,0.0,4.0,4.0,0,4,4,0,0,0,0,0,0,2020-12-27 19:15:00
4270,28572,Richarlison,1461,"[2018, 2019, 2020]",Everton FC,41,39,2,3278,14,0,41,40,1,3441,14,0,82,79,3,6719,28,0,8.0,12.0,20.0,12,10,22,0,1,1,0,0,0,2020-12-27 19:15:002020-12-27 19:15:002020-12-27 19:15:00
4271,9526,Richie Ryan,3793,[2002],Sunderland AFC,2,0,2,59,0,0,0,0,0,0,0,0,2,0,2,59,0,0,0.0,0.0,0.0,0,0,0,0,0,0,0,0,0,2020-12-27 19:15:00
4272,19055,Rickie Lambert,2597,"[2012, 2013]",Southampton FC,37,34,3,2993,15,0,38,32,6,2954,13,0,75,66,9,5947,28,0,4.0,10.0,14.0,9,10,19,2,4,6,0,0,0,2020-12-27 19:15:002020-12-27 19:15:00
4273,9529,Rickie Lambert,2597,[2014],Liverpool FC,14,4,10,450,0,0,11,3,8,374,2,0,25,7,18,824,2,0,0.0,0.0,0.0,0,1,1,0,0,0,0,0,0,2020-12-27 19:15:00
4274,19061,Rickie Lambert,2597,"[2015, 2016]",West Bromwich Albion,12,3,9,334,1,0,8,2,6,294,0,0,20,5,15,628,1,0,0.0,0.0,0.0,0,0,0,1,0,1,0,0,0,2020-12-27 19:15:002020-12-27 19:15:00
4275,19065,Ricky van Wolfswinkel,3674,"[2013, 2015]",Norwich City,14,9,5,803,1,0,11,7,4,593,0,0,25,16,9,1396,1,0,1.0,0.0,1.0,1,0,1,0,0,0,0,0,0,2020-12-27 19:15:002020-12-27 19:15:00
4276,19069,Riga Mustapha,2727,"[2008, 2009]",Bolton Wanderers,9,1,8,230,0,0,8,0,8,149,0,0,17,1,16,379,0,0,0.0,0.0,0.0,0,0,0,0,0,0,0,0,0,2020-12-27 19:15:002020-12-27 19:15:00
4277,19073,Rigobert Song,2340,"[2000, 2001]",West Ham United,9,9,0,810,0,0,13,12,1,1070,0,0,22,21,1,1880,0,0,0.0,0.0,0.0,0,0,0,0,0,0,0,0,0,2020-12-27 19:15:002020-12-27 19:15:00
4278,19077,Rio Ferdinand,1294,"[2000, 2001]",Leeds United,22,22,0,1980,0,0,24,24,0,2160,2,0,46,46,0,4140,2,0,0.0,0.0,0.0,0,1,1,0,0,0,0,0,0,2020-12-27 19:15:002020-12-27 19:15:00
4279,114546,Rio Ferdinand,1294,"[2002, 2003, 2004, 2005, 2006, 2007, 2008, 2009, 2010, 2011, 2012, 2013]",Manchester United,150,147,3,13086,6,0,158,154,4,13768,1,0,308,301,7,26854,7,0,6.0,0.0,6.0,3,0,3,0,0,0,0,0,0,2020-12-27 19:15:002020-12-27 19:15:002020-12-27 19:15:002020-12-27 19:15:002020-12-27 19:15:002020-12-27 19:15:002020-12-27 19:15:002020-12-27 19:15:002020-12-27 19:15:002020-12-27 19:15:002020-12-27 19:15:002020-12-27 19:15:00
4280,9552,Rio Ferdinand,1294,[2014],Queens Park Rangers,4,4,0,360,0,0,7,7,0,630,0,0,11,11,0,990,0,0,0.0,0.0,0.0,0,0,0,0,0,0,0,0,0,2020-12-27 19:15:00
4281,19107,Ritchie De Laet,2514,"[2008, 2009]",Manchester United,1,1,0,90,0,0,2,2,0,137,0,0,3,3,0,227,0,0,0.0,0.0,0.0,0,0,0,0,0,0,0,0,0,2020-12-27 19:15:002020-12-27 19:15:00
4282,9555,Ritchie De Laet,2514,[2011],Norwich City,4,4,0,302,1,0,2,2,0,180,0,0,6,6,0,482,1,0,0.0,0.0,0.0,1,0,1,0,0,0,0,0,0,2020-12-27 19:15:00
4283,19113,Ritchie De Laet,2514,"[2014, 2015]",Leicester City,20,13,7,1333,1,0,18,14,4,1206,0,0,38,27,11,2539,1,0,0.0,0.0,0.0,0,0,0,0,0,0,0,0,0,2020-12-27 19:15:002020-12-27 19:15:00
4284,38238,Riyad Mahrez,1842,"[2014, 2015, 2016, 2017]",Leicester City,70,67,3,5789,17,0,69,61,8,5149,22,0,139,128,11,10938,39,0,3.0,9.0,12.0,9,16,25,2,5,7,0,0,0,2020-12-27 19:15:002020-12-27 19:15:002020-12-27 19:15:002020-12-27 19:15:00
4285,28689,Riyad Mahrez,1842,"[2018, 2019, 2020]",Manchester City,34,21,13,1949,12,0,36,23,13,2099,10,0,70,44,26,4048,22,0,3.0,6.0,9.0,4,4,8,1,0,1,0,0,0,2020-12-27 19:15:002020-12-27 19:15:002020-12-27 19:15:00
4286,9565,Rob Davies,4543,[2005],West Bromwich Albion,0,0,0,0,0,0,1,1,0,90,0,0,1,1,0,90,0,0,0.0,0.0,0.0,0,0,0,0,0,0,0,0,0,2020-12-27 19:15:00
4287,9566,Rob Edwards,2602,[2002],Aston Villa,4,3,1,294,0,0,4,4,0,214,0,0,8,7,1,508,0,0,0.0,0.0,0.0,0,0,0,0,0,0,0,0,0,2020-12-27 19:15:00
4288,9567,Rob Edwards,2602,[2010],Blackpool FC,0,0,0,0,0,0,2,1,1,106,0,0,2,1,1,106,0,0,0.0,0.0,0.0,0,0,0,0,0,0,0,0,0,2020-12-27 19:15:00
4289,66997,Rob Elliot,2456,"[2011, 2012, 2013, 2014, 2015, 2017, 2019]",Newcastle United,25,24,1,2149,0,0,27,27,0,2430,0,0,52,51,1,4579,0,0,0.0,0.0,0.0,0,0,0,0,0,0,0,0,0,2020-12-27 19:15:002020-12-27 19:15:002020-12-27 19:15:002020-12-27 19:15:002020-12-27 19:15:002020-12-27 19:15:002020-12-27 19:15:00
4290,47885,Rob Holding,2510,"[2016, 2017, 2018, 2019, 2020]",Arsenal FC,24,19,5,1854,0,0,26,24,2,2107,0,0,50,43,7,3961,0,0,0.0,0.0,0.0,0,0,0,0,0,0,1,0,1,2020-12-27 19:15:002020-12-27 19:15:002020-12-27 19:15:002020-12-27 19:15:002020-12-27 19:15:00
4291,9580,Rob Hulse,1327,[2004],West Bromwich Albion,2,0,2,48,0,0,3,0,3,37,0,0,5,0,5,85,0,0,0.0,0.0,0.0,0,0,0,0,0,0,0,0,0,2020-12-27 19:15:00
4292,9581,Rob Hulse,1327,[2006],Sheffield United,14,13,1,1186,6,0,13,13,0,1087,2,0,27,26,1,2273,8,0,0.0,3.0,3.0,4,2,6,0,0,0,0,0,0,2020-12-27 19:15:00
4293,9582,Rob Hulse,1327,[2011],Queens Park Rangers,1,0,1,16,0,0,1,1,0,54,0,0,2,1,1,70,0,0,0.0,0.0,0.0,0,0,0,0,0,0,0,0,0,2020-12-27 19:15:00
4294,9583,Rob Kozluk,3891,[2006],Sheffield United,8,7,1,655,0,0,10,9,1,744,0,0,18,16,2,1399,0,0,0.0,0.0,0.0,0,0,0,0,0,0,0,0,0,2020-12-27 19:15:00
4295,19169,Rob Lainton,4497,"[2010, 2011]",Bolton Wanderers,0,0,0,0,0,0,0,0,0,0,0,0,0,0,0,0,0,0,0.0,0.0,0.0,0,0,0,0,0,0,0,0,0,2020-12-27 19:15:002020-12-27 19:15:00
4296,19173,Rob Lee,3396,"[2000, 2001]",Newcastle United,16,14,2,1192,1,0,22,22,0,1824,0,0,38,36,2,3016,1,0,0.0,0.0,0.0,1,0,1,0,0,0,0,0,0,2020-12-27 19:15:002020-12-27 19:15:00
4297,9588,Robbie Blake,2551,[2000],Bradford City,9,6,3,554,4,0,8,4,4,361,0,0,17,10,7,915,4,0,0.0,0.0,0.0,2,0,2,2,0,2,0,0,0,2020-12-27 19:15:00
4298,9589,Robbie Blake,2551,[2004],Birmingham City,4,1,3,143,2,0,7,1,6,192,0,0,11,2,9,335,2,0,0.0,0.0,0.0,1,0,1,1,0,1,0,0,0,2020-12-27 19:15:00
4299,9590,Robbie Blake,2551,[2009],Burnley FC,18,12,6,1022,1,0,13,8,5,632,1,0,31,20,11,1654,2,0,3.0,0.0,3.0,1,1,2,0,0,0,0,0,0,2020-12-27 19:15:00
4300,19183,Robbie Blake,2551,"[2010, 2011]",Bolton Wanderers,6,0,6,31,1,0,3,0,3,15,0,0,9,0,9,46,1,0,1.0,0.0,1.0,1,0,1,0,0,0,0,0,0,2020-12-27 19:15:002020-12-27 19:15:00
4301,19187,Robbie Brady,2230,"[2013, 2014]",Hull City,24,15,9,1424,2,0,19,13,6,1225,1,0,43,28,15,2649,3,0,6.0,0.0,6.0,2,1,3,2,0,2,0,0,0,2020-12-27 19:15:002020-12-27 19:15:00
4302,9595,Robbie Brady,2230,[2015],Norwich City,17,16,1,1387,1,0,19,18,1,1601,2,0,36,34,2,2988,3,0,0.0,3.0,3.0,1,2,3,0,0,0,0,0,0,2020-12-27 19:15:00
4303,47990,Robbie Brady,2230,"[2016, 2017, 2018, 2019, 2020]",Burnley FC,36,18,18,1651,3,0,35,21,14,2035,1,0,71,39,32,3686,4,0,1.0,0.0,1.0,2,0,2,0,0,0,0,0,0,2020-12-27 19:15:002020-12-27 19:15:002020-12-27 19:15:002020-12-27 19:15:002020-12-27 19:15:00
4304,38410,Robbie Elliott,1945,"[2001, 2002, 2004, 2005]",Newcastle United,30,27,3,2290,1,0,32,27,5,2442,1,0,62,54,8,4732,2,0,0.0,0.0,0.0,1,0,1,0,0,0,0,0,0,2020-12-27 19:15:002020-12-27 19:15:002020-12-27 19:15:002020-12-27 19:15:00
4305,38432,Robbie Fowler,2691,"[2000, 2001, 2005, 2006]",Liverpool FC,35,18,17,1725,9,0,31,19,12,1792,10,0,66,37,29,3517,19,0,3.0,4.0,7.0,3,7,10,2,1,3,0,0,0,2020-12-27 19:15:002020-12-27 19:15:002020-12-27 19:15:002020-12-27 19:15:00
4306,28824,Robbie Fowler,2691,"[2002, 2003, 2004]",Manchester City,38,31,7,2581,9,0,32,26,6,2270,10,0,70,57,13,4851,19,0,5.0,3.0,8.0,6,10,16,1,1,2,0,0,0,2020-12-27 19:15:002020-12-27 19:15:002020-12-27 19:15:00
4307,9612,Robbie Fowler,2691,[2008],Blackburn Rovers,1,0,1,13,0,0,2,1,1,102,0,0,3,1,2,115,0,0,0.0,0.0,0.0,0,0,0,0,0,0,0,0,0,2020-12-27 19:15:00
4308,19227,Robbie Keane,1126,"[2000, 2001]",Leeds United,19,11,8,1013,6,0,16,10,6,973,6,0,35,21,14,1986,12,0,4.0,0.0,4.0,4,3,7,1,0,1,0,0,0,2020-12-27 19:15:002020-12-27 19:15:00
4309,67331,Robbie Keane,1126,"[2002, 2003, 2004, 2005, 2007, 2009, 2010]",Tottenham Hotspur,97,78,19,6710,47,0,97,76,21,7002,28,0,194,154,40,13712,75,0,15.0,19.0,34.0,27,24,51,9,2,11,0,0,0,2020-12-27 19:15:002020-12-27 19:15:002020-12-27 19:15:002020-12-27 19:15:002020-12-27 19:15:002020-12-27 19:15:002020-12-27 19:15:00
4310,9619,Robbie Keane,1126,[2006],Watford FC,1,1,0,76,0,0,0,0,0,0,0,0,1,1,0,76,0,0,0.0,0.0,0.0,0,0,0,0,0,0,0,0,0,2020-12-27 19:15:00
4311,9621,Robbie Keane,1126,[2008],Liverpool FC,10,9,1,728,4,0,9,7,2,534,1,0,19,16,3,1262,5,0,0.0,1.0,1.0,1,1,2,0,0,0,0,0,0,2020-12-27 19:15:00
4312,9624,Robbie Keane,1126,[2011],Aston Villa,3,2,1,189,0,0,3,3,0,270,3,0,6,5,1,459,3,0,0.0,3.0,3.0,0,3,3,0,0,0,0,0,0,2020-12-27 19:15:00
4313,9625,Robbie Mustoe,2919,[2000],Sunderland AFC,1,1,0,90,0,0,0,0,0,0,0,0,1,1,0,90,0,0,0.0,0.0,0.0,0,0,0,0,0,0,0,0,0,2020-12-27 19:15:00
4314,9626,Robbie Mustoe,2919,[2001],Middlesbrough FC,18,16,2,1358,1,0,17,14,3,1318,1,0,35,30,5,2676,2,0,0.0,3.0,3.0,0,1,1,0,0,0,0,0,0,2020-12-27 19:15:00
4315,9627,Robbie Mustoe,2919,[2002],Charlton Athletic,3,3,0,256,0,0,3,3,0,234,0,0,6,6,0,490,0,0,0.0,0.0,0.0,0,0,0,0,0,0,0,0,0,2020-12-27 19:15:00
4316,19257,Robbie Savage,1309,"[2000, 2001]",Leicester City,36,36,0,3233,3,0,31,31,0,2702,1,0,67,67,0,5935,4,0,3.0,3.0,6.0,2,1,3,1,0,1,0,0,0,2020-12-27 19:15:002020-12-27 19:15:00
4317,28893,Robbie Savage,1309,"[2002, 2003, 2004]",Birmingham City,41,41,0,3604,4,0,40,40,0,3491,7,0,81,81,0,7095,11,0,0.0,0.0,0.0,2,4,6,2,2,4,0,0,0,2020-12-27 19:15:002020-12-27 19:15:002020-12-27 19:15:00
4318,28902,Robbie Savage,1309,"[2005, 2006, 2007]",Blackburn Rovers,33,32,1,2802,0,0,33,32,1,2772,1,0,66,64,2,5574,1,0,0.0,0.0,0.0,0,1,1,0,0,0,0,0,0,2020-12-27 19:15:002020-12-27 19:15:002020-12-27 19:15:00
4319,28911,Robbie Stockdale,2697,"[2001, 2002, 2003]",Middlesbrough FC,22,20,2,1776,0,0,20,17,3,1607,1,0,42,37,5,3383,1,0,0.0,0.0,0.0,0,0,0,0,0,0,0,0,0,2020-12-27 19:15:002020-12-27 19:15:002020-12-27 19:15:00
4320,9639,Robert Betts,3974,[2000],Coventry City,1,0,1,2,0,0,0,0,0,0,0,0,1,0,1,2,0,0,0.0,0.0,0.0,0,0,0,0,0,0,0,0,0,2020-12-27 19:15:00
4321,19281,Robert Earnshaw,1325,"[2004, 2005]",West Bromwich Albion,21,12,9,1085,3,0,22,10,12,1049,9,0,43,22,21,2134,12,0,1.0,2.0,3.0,2,7,9,0,2,2,0,0,0,2020-12-27 19:15:002020-12-27 19:15:00
4322,9642,Robert Earnshaw,1325,[2007],Derby County,13,3,10,500,1,0,9,4,5,431,0,0,22,7,15,931,1,0,0.0,0.0,0.0,0,0,0,0,0,0,0,0,0,2020-12-27 19:15:00
4323,9643,Robert Green,1277,[2004],Norwich City,18,18,0,1620,0,0,19,19,0,1683,0,0,37,37,0,3303,0,0,0.0,0.0,0.0,0,0,0,0,0,0,0,0,0,2020-12-27 19:15:00
4324,48230,Robert Green,1277,"[2006, 2007, 2008, 2009, 2010]",West Ham United,89,89,0,7994,0,0,85,85,0,7650,0,0,174,174,0,15644,0,0,0.0,0.0,0.0,0,0,0,0,0,0,0,0,0,2020-12-27 19:15:002020-12-27 19:15:002020-12-27 19:15:002020-12-27 19:15:002020-12-27 19:15:00
4325,19299,Robert Green,1277,"[2012, 2014]",Queens Park Rangers,26,26,0,2284,0,0,26,24,2,2220,0,0,52,50,2,4504,0,0,0.0,0.0,0.0,0,0,0,0,0,0,0,0,0,2020-12-27 19:15:002020-12-27 19:15:00
4326,9651,Robert Green,1277,[2017],Huddersfield Town,0,0,0,0,0,0,0,0,0,0,0,0,0,0,0,0,0,0,0.0,0.0,0.0,0,0,0,0,0,0,0,0,0,2020-12-27 19:15:00
4327,9652,Robert Hall,2764,[2012],West Ham United,1,0,1,12,0,0,0,0,0,0,0,0,1,0,1,12,0,0,0.0,0.0,0.0,0,0,0,0,0,0,0,0,0,2020-12-27 19:15:00
4328,48275,Robert Huth,1884,"[2001, 2002, 2003, 2004, 2005]",Chelsea FC,16,10,6,907,0,0,26,13,13,1195,0,0,42,23,19,2102,0,0,0.0,0.0,0.0,0,0,0,0,0,0,0,0,0,2020-12-27 19:15:002020-12-27 19:15:002020-12-27 19:15:002020-12-27 19:15:002020-12-27 19:15:00
4329,28977,Robert Huth,1884,"[2006, 2007, 2008]",Middlesbrough FC,25,20,5,1896,0,0,23,19,4,1801,2,0,48,39,9,3697,2,0,0.0,1.0,1.0,0,2,2,0,0,0,0,0,0,2020-12-27 19:15:002020-12-27 19:15:002020-12-27 19:15:00
4330,48315,Robert Huth,1884,"[2009, 2010, 2011, 2012, 2013]",Stoke City,74,71,3,6368,7,0,74,72,2,6580,6,0,148,143,5,12948,13,0,7.0,4.0,11.0,7,6,13,0,0,0,0,0,0,2020-12-27 19:15:002020-12-27 19:15:002020-12-27 19:15:002020-12-27 19:15:002020-12-27 19:15:00
4331,29001,Robert Huth,1884,"[2014, 2015, 2016]",Leicester City,41,41,0,3591,0,0,41,41,0,3668,6,0,82,82,0,7259,6,0,0.0,3.0,3.0,0,4,4,0,0,0,0,0,0,2020-12-27 19:15:002020-12-27 19:15:002020-12-27 19:15:00
4332,9669,Robert Koren,2000,[2008],West Bromwich Albion,17,16,1,1440,2,0,18,18,0,1555,0,0,35,34,1,2995,2,0,0.0,0.0,0.0,0,0,0,0,0,0,0,0,0,2020-12-27 19:15:00
4333,9670,Robert Koren,2000,[2013],Hull City,14,5,9,623,2,0,8,5,3,509,0,0,22,10,12,1132,2,0,0.0,0.0,0.0,0,0,0,0,0,0,0,0,0,2020-12-27 19:15:00
4334,9671,Robert Milsom,4273,[2008],Fulham FC,0,0,0,0,0,0,1,0,1,10,0,0,1,0,1,10,0,0,0.0,0.0,0.0,0,0,0,0,0,0,0,0,0,2020-12-27 19:15:00
4335,9672,Robert Molenaar,2834,[2000],Bradford City,10,10,0,829,0,0,7,7,0,604,1,0,17,17,0,1433,1,0,0.0,0.0,0.0,0,0,0,0,0,0,0,0,0,2020-12-27 19:15:00
4336,58053,Robert Pirés,1603,"[2000, 2001, 2002, 2003, 2004, 2005]",Arsenal FC,97,85,12,7360,37,0,87,70,17,6213,25,0,184,155,29,13573,62,0,9.0,15.0,24.0,25,12,37,2,2,4,0,0,0,2020-12-27 19:15:002020-12-27 19:15:002020-12-27 19:15:002020-12-27 19:15:002020-12-27 19:15:002020-12-27 19:15:00
4337,9679,Robert Pirés,1603,[2010],Aston Villa,5,2,3,171,0,0,4,0,4,78,0,0,9,2,7,249,0,0,0.0,0.0,0.0,0,0,0,0,0,0,0,0,0,2020-12-27 19:15:00
4338,19361,Robert Snodgrass,2207,"[2012, 2013]",Norwich City,34,33,1,2897,6,0,33,31,2,2737,6,0,67,64,3,5634,12,0,3.0,2.0,5.0,5,4,9,0,0,0,0,0,0,2020-12-27 19:15:002020-12-27 19:15:00
4339,19365,Robert Snodgrass,2207,"[2014, 2016]",Hull City,11,10,1,908,5,0,10,10,0,845,2,0,21,20,1,1753,7,0,3.0,1.0,4.0,4,2,6,2,0,2,0,0,0,2020-12-27 19:15:002020-12-27 19:15:00
4340,29055,Robert Snodgrass,2207,"[2018, 2019, 2020]",West Ham United,30,21,9,1896,5,0,30,21,9,1843,2,0,60,42,18,3739,7,0,0.0,0.0,0.0,2,2,4,0,0,0,0,0,0,2020-12-27 19:15:002020-12-27 19:15:002020-12-27 19:15:00
4341,9687,Robert Sánchez,1059,[2020],Brighton & Hove Albion,1,1,0,90,0,0,3,3,0,270,0,0,4,4,0,360,0,0,0.0,0.0,0.0,0,0,0,0,0,0,0,0,0,2020-12-27 19:15:00
4342,9688,Roberto,2212,[2019],West Ham United,4,4,0,360,0,0,4,3,1,326,0,0,8,7,1,686,0,0,0.0,0.0,0.0,0,0,0,0,0,0,0,0,0,2020-12-27 19:15:00
4343,9689,Roberto Di Matteo,3790,[2000],Chelsea FC,3,3,0,270,0,0,4,4,0,360,0,0,7,7,0,630,0,0,0.0,0.0,0.0,0,0,0,0,0,0,0,0,0,2020-12-27 19:15:00
4344,58155,Roberto Firmino,1186,"[2015, 2016, 2017, 2018, 2019, 2020]",Liverpool FC,96,86,10,7520,31,0,93,83,10,7064,31,0,189,169,20,14584,62,0,3.0,16.0,19.0,16,16,32,1,1,2,0,0,0,2020-12-27 19:15:002020-12-27 19:15:002020-12-27 19:15:002020-12-27 19:15:002020-12-27 19:15:002020-12-27 19:15:00
4345,9696,Roberto Mancini,4107,[2000],Leicester City,2,2,0,133,0,0,2,1,1,109,0,0,4,3,1,242,0,0,0.0,0.0,0.0,0,0,0,0,0,0,0,0,0,2020-12-27 19:15:00
4346,38794,Roberto Pereyra,2090,"[2016, 2017, 2018, 2019]",Watford FC,54,40,14,3651,13,0,52,40,12,3490,3,0,106,80,26,7141,16,0,1.0,0.0,1.0,8,1,9,1,0,1,0,0,0,2020-12-27 19:15:002020-12-27 19:15:002020-12-27 19:15:002020-12-27 19:15:00
4347,9701,Robin Koch,1063,[2020],Leeds United,5,5,0,450,0,0,6,6,0,459,0,0,11,11,0,909,0,0,0.0,0.0,0.0,0,0,0,0,0,0,0,0,0,2020-12-27 19:15:00
4348,9702,Robin Olsen,1001,[2020],Everton FC,0,0,0,0,0,0,2,2,0,180,0,0,2,2,0,180,0,0,0.0,0.0,0.0,0,0,0,0,0,0,0,0,0,2020-12-27 19:15:00
4349,77652,Robin van Persie,1528,"[2004, 2005, 2006, 2007, 2008, 2009, 2010, 2011]",Arsenal FC,96,69,27,6276,51,0,95,77,18,6811,45,0,191,146,45,13087,96,0,14.0,27.0,41.0,31,33,64,5,4,9,0,0,0,2020-12-27 19:15:002020-12-27 19:15:002020-12-27 19:15:002020-12-27 19:15:002020-12-27 19:15:002020-12-27 19:15:002020-12-27 19:15:002020-12-27 19:15:00
4350,29136,Robin van Persie,1528,"[2012, 2013, 2014]",Manchester United,45,39,6,3525,26,0,41,39,2,3293,22,0,86,78,8,6818,48,0,7.0,17.0,24.0,16,15,31,2,4,6,0,0,0,2020-12-27 19:15:002020-12-27 19:15:002020-12-27 19:15:00
4351,19429,Robinho,3088,"[2008, 2009]",Manchester City,22,20,2,1761,11,0,19,16,3,1441,3,0,41,36,5,3202,14,0,0.0,1.0,1.0,4,3,7,0,1,1,0,0,0,2020-12-27 19:15:002020-12-27 19:15:00
4352,9716,Rodney Wallace,4022,[2001],Bolton Wanderers,9,9,0,693,1,0,10,5,5,539,2,0,19,14,5,1232,3,0,0.0,0.0,0.0,1,2,3,0,0,0,0,0,0,2020-12-27 19:15:00
4353,19435,Rodri,1840,"[2019, 2020]",Manchester City,24,20,4,1635,1,0,25,23,2,2036,2,0,49,43,6,3671,3,0,0.0,0.0,0.0,1,0,1,0,0,0,0,0,0,2020-12-27 19:15:002020-12-27 19:15:00
4354,9719,Rodrigo,2530,[2010],Bolton Wanderers,9,1,8,222,1,0,8,3,5,272,0,0,17,4,13,494,1,0,0.0,0.0,0.0,1,0,1,0,0,0,0,0,0,2020-12-27 19:15:00
4355,9720,Rodrigo,2530,[2020],Leeds United,7,5,2,421,2,0,6,2,4,263,0,0,13,7,6,684,2,0,1.0,0.0,1.0,2,0,2,0,0,0,0,0,0,2020-12-27 19:15:00
4356,9721,Rodrigo Beckham,3388,[2002],Everton FC,2,0,2,19,0,0,2,0,2,33,0,0,4,0,4,52,0,0,0.0,0.0,0.0,0,0,0,0,0,0,0,0,0,2020-12-27 19:15:00
4357,9722,Rodrigo Possebon,4413,[2008],Manchester United,1,0,1,27,0,0,2,0,2,25,0,0,3,0,3,52,0,0,0.0,0.0,0.0,0,0,0,0,0,0,0,0,0,2020-12-27 19:15:00
4358,9723,Roger Espinoza,4115,[2012],Wigan Athletic,6,3,3,348,1,0,6,3,3,257,0,0,12,6,6,605,1,0,0.0,0.0,0.0,1,0,1,0,0,0,0,0,0,2020-12-27 19:15:00
4359,19449,Roger Johnson,1781,"[2009, 2010]",Birmingham City,38,38,0,3420,1,0,38,38,0,3376,1,0,76,76,0,6796,2,0,0.0,0.0,0.0,1,1,2,0,0,0,0,0,0,2020-12-27 19:15:002020-12-27 19:15:00
4360,9726,Roger Johnson,1781,[2011],Wolverhampton Wanderers,14,13,1,1186,0,0,13,13,0,1170,0,0,27,26,1,2356,0,0,0.0,0.0,0.0,0,0,0,0,0,0,0,0,0,2020-12-27 19:15:00
4361,9727,Roger Johnson,1781,[2013],West Ham United,2,1,1,171,0,0,2,1,1,102,0,0,4,2,2,273,0,0,0.0,0.0,0.0,0,0,0,0,0,0,0,0,0,2020-12-27 19:15:00
4362,19457,Rohan Ricketts,1124,"[2003, 2004]",Tottenham Hotspur,16,10,6,861,1,0,14,7,7,671,0,0,30,17,13,1532,1,0,0.0,0.0,0.0,1,0,1,0,0,0,0,0,0,2020-12-27 19:15:002020-12-27 19:15:00
4363,19461,Roland Lamah,3732,"[2012, 2013]",Swansea City,7,2,5,319,1,0,7,3,4,286,1,0,14,5,9,605,2,0,0.0,1.0,1.0,1,1,2,0,0,0,0,0,0,2020-12-27 19:15:002020-12-27 19:15:00
4364,29199,Rolando Aarons,2284,"[2014, 2015, 2017]",Newcastle United,10,2,8,325,2,0,8,2,6,316,0,0,18,4,14,641,2,0,0.0,0.0,0.0,1,0,1,0,0,0,0,0,0,2020-12-27 19:15:002020-12-27 19:15:002020-12-27 19:15:00
4365,9735,Rolando Bianchi,3032,[2007],Manchester City,8,4,4,402,1,0,11,3,8,359,3,0,19,7,12,761,4,0,0.0,0.0,0.0,1,3,4,0,0,0,0,0,0,2020-12-27 19:15:00
4366,9736,Romain Amalfitano,4187,[2012],Newcastle United,0,0,0,0,0,0,0,0,0,0,0,0,0,0,0,0,0,0,0.0,0.0,0.0,0,0,0,0,0,0,0,0,0,2020-12-27 19:15:00
4367,29214,Romain Saïss,2153,"[2018, 2019, 2020]",Wolverhampton Wanderers,28,26,2,2322,2,0,34,27,7,2423,4,0,62,53,9,4745,6,0,1.0,1.0,2.0,2,3,5,0,0,0,0,0,0,2020-12-27 19:15:002020-12-27 19:15:002020-12-27 19:15:00
4368,9740,Romaine Sawyers,1029,[2020],West Bromwich Albion,6,5,1,429,0,0,7,6,1,533,0,0,13,11,2,962,0,0,0.0,0.0,0.0,0,0,0,0,0,0,0,0,0,2020-12-27 19:15:00
4369,19483,Roman Bednář,2005,"[2008, 2010]",West Bromwich Albion,15,8,7,851,6,0,15,5,10,514,0,0,30,13,17,1365,6,0,6.0,0.0,6.0,5,0,5,2,0,2,0,0,0,2020-12-27 19:15:002020-12-27 19:15:00
4370,38978,Roman Pavlyuchenko,2528,"[2008, 2009, 2010, 2011]",Tottenham Hotspur,45,28,17,2411,15,0,32,16,16,1466,6,0,77,44,33,3877,21,0,15.0,0.0,15.0,11,2,13,0,0,0,0,0,0,2020-12-27 19:15:002020-12-27 19:15:002020-12-27 19:15:002020-12-27 19:15:00
4371,9747,Romelu Lukaku,1645,[2011],Chelsea FC,3,1,2,79,0,0,5,0,5,78,0,0,8,1,7,157,0,0,0.0,0.0,0.0,0,0,0,0,0,0,0,0,0,2020-12-27 19:15:00
4372,9748,Romelu Lukaku,1645,[2012],West Bromwich Albion,17,9,8,909,10,0,18,11,7,1094,7,0,35,20,15,2003,17,0,7.0,0.0,7.0,6,2,8,1,1,2,0,0,0,2020-12-27 19:15:00
4373,39002,Romelu Lukaku,1645,"[2013, 2014, 2015, 2016]",Everton FC,70,66,4,5881,40,0,71,67,4,5996,28,0,141,133,8,11877,68,0,8.0,13.0,21.0,20,15,35,1,3,4,0,0,0,2020-12-27 19:15:002020-12-27 19:15:002020-12-27 19:15:002020-12-27 19:15:00
4374,19507,Romelu Lukaku,1645,"[2017, 2018]",Manchester United,34,28,6,2473,14,0,32,27,5,2526,14,0,66,55,11,4999,28,0,6.0,3.0,9.0,7,8,15,0,0,0,0,0,0,2020-12-27 19:15:002020-12-27 19:15:00
4375,19511,Román Golobart,4117,"[2010, 2012]",Wigan Athletic,1,1,0,90,0,0,2,1,1,122,0,0,3,2,1,212,0,0,0.0,0.0,0.0,0,0,0,0,0,0,0,0,0,2020-12-27 19:15:002020-12-27 19:15:00
4376,29274,Ron Vlaar,1436,"[2012, 2013, 2014]",Aston Villa,39,39,0,3396,1,0,40,39,1,3448,1,0,79,78,1,6844,2,0,0.0,1.0,1.0,1,1,2,0,0,0,0,0,0,2020-12-27 19:15:002020-12-27 19:15:002020-12-27 19:15:00
4377,9760,Ron-Robert Zieler,3186,[2016],Leicester City,5,4,1,393,0,0,4,4,0,360,0,0,9,8,1,753,0,0,0.0,0.0,0.0,0,0,0,0,0,0,0,0,0,2020-12-27 19:15:00
4378,29286,Ronald Zubar,2887,"[2009, 2010, 2011]",Wolverhampton Wanderers,26,25,1,2249,1,0,26,25,1,2193,2,0,52,50,2,4442,3,0,1.0,0.0,1.0,1,0,1,0,0,0,0,0,0,2020-12-27 19:15:002020-12-27 19:15:002020-12-27 19:15:00
4379,29295,Ronnie Stam,2878,"[2010, 2011, 2012]",Wigan Athletic,34,20,14,1959,0,0,28,21,7,1860,1,0,62,41,21,3819,1,0,0.0,1.0,1.0,0,1,1,0,0,0,0,0,0,2020-12-27 19:15:002020-12-27 19:15:002020-12-27 19:15:00
4380,19535,Ronnie Wallwork,1600,"[2000, 2001]",Manchester United,9,2,7,345,0,0,4,2,2,229,0,0,13,4,9,574,0,0,0.0,0.0,0.0,0,0,0,0,0,0,0,0,0,2020-12-27 19:15:002020-12-27 19:15:00
4381,29310,Ronnie Wallwork,1600,"[2002, 2004, 2005]",West Bromwich Albion,39,36,3,3230,1,0,38,36,2,3234,0,0,77,72,5,6464,1,0,0.0,0.0,0.0,0,0,0,0,0,0,0,0,0,2020-12-27 19:15:002020-12-27 19:15:002020-12-27 19:15:00
4382,19545,Ronny Johnsen,2031,"[2000, 2001]",Manchester United,10,9,1,719,2,0,11,11,0,990,0,0,21,20,1,1709,2,0,0.0,0.0,0.0,2,0,2,0,0,0,0,0,0,2020-12-27 19:15:002020-12-27 19:15:00
4383,19549,Ronny Johnsen,2031,"[2002, 2003]",Aston Villa,23,21,2,1771,1,0,23,22,1,1880,0,0,46,43,3,3651,1,0,0.0,0.0,0.0,0,0,0,0,0,0,0,0,0,2020-12-27 19:15:002020-12-27 19:15:00
4384,9776,Ronny Johnsen,2031,[2004],Newcastle United,1,1,0,90,0,0,2,2,0,146,0,0,3,3,0,236,0,0,0.0,0.0,0.0,0,0,0,0,0,0,0,0,0,2020-12-27 19:15:00
4385,19555,Rony Lopes,4423,"[2012, 2013]",Manchester City,0,0,0,0,0,0,0,0,0,0,0,0,0,0,0,0,0,0,0.0,0.0,0.0,0,0,0,0,0,0,0,0,0,2020-12-27 19:15:002020-12-27 19:15:00
4386,9779,Roque Junior,2798,[2003],Leeds United,2,2,0,180,0,0,3,3,0,242,0,0,5,5,0,422,0,0,0.0,0.0,0.0,0,0,0,0,0,0,0,0,0,2020-12-27 19:15:00
4387,9780,Roque Mesa,3229,[2017],Swansea City,6,5,1,470,0,0,5,4,1,287,0,0,11,9,2,757,0,0,0.0,0.0,0.0,0,0,0,0,0,0,0,0,0,2020-12-27 19:15:00
4388,29347,Roque Santa Cruz,2110,"[2007, 2008, 2010]",Blackburn Rovers,34,31,3,2683,7,0,30,27,3,2358,16,0,64,58,6,5041,23,0,0.0,4.0,4.0,3,11,14,0,0,0,0,0,0,2020-12-27 19:15:002020-12-27 19:15:002020-12-27 19:15:00
4389,9783,Roque Santa Cruz,2110,[2009],Manchester City,7,1,6,173,2,0,12,5,7,465,1,0,19,6,13,638,3,0,3.0,0.0,3.0,2,1,3,0,0,0,0,0,0,2020-12-27 19:15:00
4390,9785,Rory Delap,1993,[2000],Derby County,18,18,0,1580,1,0,13,12,1,1124,2,0,31,30,1,2704,3,0,0.0,3.0,3.0,0,2,2,0,0,0,0,0,0,2020-12-27 19:15:00
4391,39150,Rory Delap,1993,"[2001, 2002, 2003, 2004]",Southampton FC,54,51,3,4410,2,0,56,49,7,4269,3,0,110,100,10,8679,5,0,4.0,0.0,4.0,2,3,5,0,0,0,0,0,0,2020-12-27 19:15:002020-12-27 19:15:002020-12-27 19:15:002020-12-27 19:15:00
4392,9790,Rory Delap,1993,[2005],Sunderland AFC,2,2,0,136,0,0,4,3,1,286,1,0,6,5,1,422,1,0,0.0,1.0,1.0,0,1,1,0,0,0,0,0,0,2020-12-27 19:15:00
4393,48965,Rory Delap,1993,"[2008, 2009, 2010, 2011, 2012]",Stoke City,71,66,5,5722,4,0,63,53,10,4572,2,0,134,119,15,10294,6,0,3.0,0.0,3.0,3,2,5,0,0,0,0,0,0,2020-12-27 19:15:002020-12-27 19:15:002020-12-27 19:15:002020-12-27 19:15:002020-12-27 19:15:00
4394,19593,Rory Donnelly,4244,"[2012, 2013]",Swansea City,0,0,0,0,0,0,0,0,0,0,0,0,0,0,0,0,0,0,0.0,0.0,0.0,0,0,0,0,0,0,0,0,0,2020-12-27 19:15:002020-12-27 19:15:00
4395,9798,Rory Watson,4489,[2014],Hull City,0,0,0,0,0,0,0,0,0,0,0,0,0,0,0,0,0,0,0.0,0.0,0.0,0,0,0,0,0,0,0,0,0,2020-12-27 19:15:00
4396,68614,Ross Barkley,1754,"[2010, 2011, 2012, 2013, 2014, 2015, 2016]",Everton FC,77,62,15,5624,14,0,73,57,16,5044,7,0,150,119,31,10668,21,0,3.0,4.0,7.0,6,5,11,2,0,2,0,0,0,2020-12-27 19:15:002020-12-27 19:15:002020-12-27 19:15:002020-12-27 19:15:002020-12-27 19:15:002020-12-27 19:15:002020-12-27 19:15:00
4397,39231,Ross Barkley,1754,"[2017, 2018, 2019, 2020]",Chelsea FC,24,13,11,1137,2,0,28,15,13,1379,2,0,52,28,24,2516,4,0,1.0,0.0,1.0,1,0,1,0,0,0,0,0,0,2020-12-27 19:15:002020-12-27 19:15:002020-12-27 19:15:002020-12-27 19:15:00
4398,9809,Ross Barkley,1754,[2020],Aston Villa,4,4,0,275,1,0,2,2,0,180,1,0,6,6,0,455,2,0,0.0,3.0,3.0,0,1,1,0,0,0,0,0,0,2020-12-27 19:15:00
4399,29436,Ross Turnbull,2217,"[2005, 2007, 2008]",Middlesbrough FC,12,12,0,1080,0,0,15,15,0,1350,0,0,27,27,0,2430,0,0,0.0,0.0,0.0,0,0,0,0,0,0,0,0,0,2020-12-27 19:15:002020-12-27 19:15:002020-12-27 19:15:00
4400,39262,Ross Turnbull,2217,"[2009, 2010, 2011, 2012]",Chelsea FC,3,3,0,270,0,0,4,3,1,314,0,0,7,6,1,584,0,0,0.0,0.0,0.0,0,0,0,0,0,0,0,0,0,2020-12-27 19:15:002020-12-27 19:15:002020-12-27 19:15:002020-12-27 19:15:00
4401,9818,Ross Wallace,1221,[2007],Sunderland AFC,10,10,0,760,1,0,11,8,3,737,1,0,21,18,3,1497,2,0,0.0,0.0,0.0,0,0,0,0,0,0,0,0,0,2020-12-27 19:15:00
4402,9819,Ross Wallace,1221,[2014],Burnley FC,5,0,5,38,0,0,10,1,9,190,1,0,15,1,14,228,1,0,0.0,1.0,1.0,0,1,1,0,0,0,0,0,0,2020-12-27 19:15:00
4403,39286,Roy Carroll,1939,"[2001, 2002, 2003, 2004]",Manchester United,20,18,2,1688,0,0,28,27,1,2483,0,0,48,45,3,4171,0,0,0.0,0.0,0.0,0,0,0,0,0,0,0,0,0,2020-12-27 19:15:002020-12-27 19:15:002020-12-27 19:15:002020-12-27 19:15:00
4404,19649,Roy Carroll,1939,"[2005, 2006]",West Ham United,15,15,0,1350,0,0,16,16,0,1440,0,0,31,31,0,2790,0,0,0.0,0.0,0.0,0,0,0,0,0,0,0,0,0,2020-12-27 19:15:002020-12-27 19:15:00
4405,9826,Roy Carroll,1939,[2007],Derby County,7,7,0,630,0,0,7,7,0,630,0,0,14,14,0,1260,0,0,0.0,0.0,0.0,0,0,0,0,0,0,0,0,0,2020-12-27 19:15:00
4406,58977,Roy Keane,1111,"[2000, 2001, 2002, 2003, 2004, 2005]",Manchester United,69,63,6,5667,6,0,69,66,3,5861,3,0,138,129,9,11528,9,0,3.0,3.0,6.0,2,2,4,0,0,0,0,0,0,2020-12-27 19:15:002020-12-27 19:15:002020-12-27 19:15:002020-12-27 19:15:002020-12-27 19:15:002020-12-27 19:15:00
4407,9833,Roy O’Donovan,1225,[2007],Sunderland AFC,10,2,8,247,0,0,6,2,4,177,0,0,16,4,12,424,0,0,0.0,0.0,0.0,0,0,0,0,0,0,0,0,0,2020-12-27 19:15:00
4408,9834,Royston Drenthe,3173,[2011],Everton FC,12,5,7,560,1,0,9,5,4,475,2,0,21,10,11,1035,3,0,0.0,0.0,0.0,0,2,2,0,0,0,0,0,0,2020-12-27 19:15:00
4409,59028,Ruben Loftus-Cheek,1852,"[2014, 2015, 2016, 2018, 2019, 2020]",Chelsea FC,27,7,20,896,3,0,27,8,19,926,4,0,54,15,39,1822,7,0,0.0,3.0,3.0,1,3,4,0,0,0,0,0,0,2020-12-27 19:15:002020-12-27 19:15:002020-12-27 19:15:002020-12-27 19:15:002020-12-27 19:15:002020-12-27 19:15:00
4410,9838,Ruben Loftus-Cheek,1852,[2017],Crystal Palace,12,11,1,962,2,0,12,10,2,914,0,0,24,21,3,1876,2,0,0.0,0.0,0.0,1,0,1,0,0,0,0,0,0,2020-12-27 19:15:00
4411,9842,Ruben Loftus-Cheek,1852,[2020],Fulham FC,5,4,1,347,1,0,5,3,2,263,0,0,10,7,3,610,1,0,0.0,0.0,0.0,0,0,0,0,0,0,0,0,0,2020-12-27 19:15:00
4412,19687,Rubén Rochina,3423,"[2010, 2011]",Blackburn Rovers,11,4,7,410,0,0,11,6,5,525,2,0,22,10,12,935,2,0,0.0,0.0,0.0,0,1,1,0,0,0,0,0,0,2020-12-27 19:15:002020-12-27 19:15:00
4413,9845,Rudolphe Douala,4049,[2006],Portsmouth FC,3,0,3,86,0,0,4,1,3,158,0,0,7,1,6,244,0,0,0.0,0.0,0.0,0,0,0,0,0,0,0,0,0,2020-12-27 19:15:00
4414,9846,Rudy Gestede,1874,[2013],Cardiff City,0,0,0,0,0,0,3,0,3,49,0,0,3,0,3,49,0,0,0.0,0.0,0.0,0,0,0,0,0,0,0,0,0,2020-12-27 19:15:00
4415,9847,Rudy Gestede,1874,[2015],Aston Villa,15,7,8,808,2,0,17,7,10,856,3,0,32,14,18,1664,5,0,1.0,3.0,4.0,1,1,2,0,0,0,0,0,0,2020-12-27 19:15:00
4416,9848,Rudy Gestede,1874,[2016],Middlesbrough FC,8,1,7,143,1,0,8,3,5,381,0,0,16,4,12,524,1,0,0.0,0.0,0.0,0,0,0,0,0,0,0,0,0,2020-12-27 19:15:00
4417,19699,Rufus Brevett,2893,"[2001, 2002]",Fulham FC,25,24,1,2167,0,0,25,25,0,2223,0,0,50,49,1,4390,0,0,0.0,0.0,0.0,0,0,0,0,0,0,0,0,0,2020-12-27 19:15:002020-12-27 19:15:00
4418,29556,Rui Patrício,2141,"[2018, 2019, 2020]",Wolverhampton Wanderers,45,45,0,4050,0,0,45,45,0,4050,0,0,90,90,0,8100,0,0,0.0,0.0,0.0,0,0,0,0,0,0,0,0,0,2020-12-27 19:15:002020-12-27 19:15:002020-12-27 19:15:00
4419,19709,Rushian Hepburn-Murphy,1873,"[2014, 2015]",Aston Villa,1,0,1,1,0,0,1,0,1,7,0,0,2,0,2,8,0,0,0.0,0.0,0.0,0,0,0,0,0,0,0,0,0,2020-12-27 19:15:002020-12-27 19:15:00
4420,9856,Russell Anderson,4532,[2007],Sunderland AFC,0,0,0,0,0,0,1,0,1,28,0,0,1,0,1,28,0,0,0.0,0.0,0.0,0,0,0,0,0,0,0,0,0,2020-12-27 19:15:00
4421,9857,Russell Griffiths,2241,[2014],Everton FC,0,0,0,0,0,0,0,0,0,0,0,0,0,0,0,0,0,0,0.0,0.0,0.0,0,0,0,0,0,0,0,0,0,2020-12-27 19:15:00
4422,29577,Russell Hoult,1315,"[2002, 2004, 2005]",West Bromwich Albion,36,36,0,3240,0,0,37,36,1,3201,0,0,73,72,1,6441,0,0,0.0,0.0,0.0,0,0,0,0,0,0,0,0,0,2020-12-27 19:15:002020-12-27 19:15:002020-12-27 19:15:00
4423,39450,Russell Martin,1368,"[2011, 2012, 2013, 2015]",Norwich City,60,58,2,5365,5,0,65,61,4,5492,3,0,125,119,6,10857,8,0,1.0,1.0,2.0,2,2,4,0,0,0,0,0,0,2020-12-27 19:15:002020-12-27 19:15:002020-12-27 19:15:002020-12-27 19:15:00
4424,9865,Ruud Boffin,3821,[2010],West Ham United,0,0,0,0,0,0,1,1,0,90,0,0,1,1,0,90,0,0,0.0,0.0,0.0,0,0,0,0,0,0,0,0,0,2020-12-27 19:15:00
4425,49340,Ruud van Nistelrooy,1453,"[2001, 2002, 2003, 2004, 2005]",Manchester United,70,65,5,5687,48,0,75,67,8,6038,47,0,145,132,13,11725,95,0,22.0,27.0,49.0,26,25,51,10,5,15,0,0,0,2020-12-27 19:15:002020-12-27 19:15:002020-12-27 19:15:002020-12-27 19:15:002020-12-27 19:15:00
4426,19743,Ryan Allsop,3288,"[2015, 2016]",AFC Bournemouth,1,0,1,44,0,0,1,1,0,90,0,0,2,1,1,134,0,0,0.0,0.0,0.0,0,0,0,0,0,0,0,0,0,2020-12-27 19:15:002020-12-27 19:15:00
4427,39498,Ryan Babel,1897,"[2007, 2008, 2009, 2010]",Liverpool FC,45,14,31,1535,7,0,46,17,29,1863,5,0,91,31,60,3398,12,0,3.0,0.0,3.0,1,0,1,0,0,0,0,0,0,2020-12-27 19:15:002020-12-27 19:15:002020-12-27 19:15:002020-12-27 19:15:00
4428,9877,Ryan Babel,1897,[2018],Fulham FC,9,8,1,668,3,0,7,7,0,592,2,0,16,15,1,1260,5,0,3.0,0.0,3.0,2,2,4,0,0,0,0,0,0,2020-12-27 19:15:00
4429,39518,Ryan Bennett,1382,"[2011, 2012, 2013, 2015]",Norwich City,28,23,5,2244,2,0,32,28,4,2635,0,0,60,51,9,4879,2,0,3.0,0.0,3.0,2,0,2,0,0,0,0,0,0,2020-12-27 19:15:002020-12-27 19:15:002020-12-27 19:15:002020-12-27 19:15:00
4430,19765,Ryan Bennett,1382,"[2018, 2019]",Wolverhampton Wanderers,25,22,3,1914,1,0,20,19,1,1751,0,0,45,41,4,3665,1,0,0.0,0.0,0.0,0,0,0,0,0,0,0,0,0,2020-12-27 19:15:002020-12-27 19:15:00
4431,29655,Ryan Bertrand,1148,"[2010, 2011, 2012]",Chelsea FC,11,8,3,763,0,0,16,12,4,1095,0,0,27,20,7,1858,0,0,0.0,0.0,0.0,0,0,0,0,0,0,0,0,0,2020-12-27 19:15:002020-12-27 19:15:002020-12-27 19:15:00
4432,9887,Ryan Bertrand,1148,[2013],Aston Villa,7,7,0,614,0,0,9,9,0,777,0,0,16,16,0,1391,0,0,0.0,0.0,0.0,0,0,0,0,0,0,0,0,0,2020-12-27 19:15:00
4433,69237,Ryan Bertrand,1148,"[2014, 2015, 2016, 2017, 2018, 2019, 2020]",Southampton FC,97,96,1,8646,4,0,102,102,0,9165,3,0,199,198,1,17811,7,0,0.0,0.0,0.0,2,1,3,1,0,1,0,0,0,2020-12-27 19:15:002020-12-27 19:15:002020-12-27 19:15:002020-12-27 19:15:002020-12-27 19:15:002020-12-27 19:15:002020-12-27 19:15:00
4434,19791,Ryan Donaldson,2542,"[2010, 2011]",Newcastle United,0,0,0,0,0,0,0,0,0,0,0,0,0,0,0,0,0,0,0.0,0.0,0.0,0,0,0,0,0,0,0,0,0,2020-12-27 19:15:002020-12-27 19:15:00
4435,9897,Ryan Donk,3326,[2008],West Bromwich Albion,9,7,2,624,0,0,7,7,0,630,0,0,16,14,2,1254,0,0,0.0,0.0,0.0,0,0,0,0,0,0,0,0,0,2020-12-27 19:15:00
4436,9898,Ryan France,3050,[2008],Hull City,1,1,0,83,0,0,1,0,1,9,0,0,2,1,1,92,0,0,0.0,0.0,0.0,0,0,0,0,0,0,0,0,0,2020-12-27 19:15:00
4437,39602,Ryan Fraser,1041,"[2016, 2017, 2018, 2019]",AFC Bournemouth,60,49,11,4488,12,0,60,49,11,4524,4,0,120,98,22,9012,16,0,7.0,0.0,7.0,8,1,9,0,0,0,0,0,0,2020-12-27 19:15:002020-12-27 19:15:002020-12-27 19:15:002020-12-27 19:15:00
4438,9903,Ryan Fraser,1041,[2020],Newcastle United,5,0,5,119,0,0,2,2,0,153,0,0,7,2,5,272,0,0,0.0,0.0,0.0,0,0,0,0,0,0,0,0,0,2020-12-27 19:15:00
4439,19809,Ryan Fredericks,2202,"[2011, 2013]",Tottenham Hotspur,0,0,0,0,0,0,0,0,0,0,0,0,0,0,0,0,0,0,0.0,0.0,0.0,0,0,0,0,0,0,0,0,0,2020-12-27 19:15:002020-12-27 19:15:00
4440,29721,Ryan Fredericks,2202,"[2018, 2019, 2020]",West Ham United,21,18,3,1640,1,0,25,22,3,1912,0,0,46,40,6,3552,1,0,0.0,0.0,0.0,0,0,0,0,0,0,0,0,0,2020-12-27 19:15:002020-12-27 19:15:002020-12-27 19:15:00
4441,9909,Ryan Fulton,4464,[2015],Liverpool FC,0,0,0,0,0,0,0,0,0,0,0,0,0,0,0,0,0,0,0.0,0.0,0.0,0,0,0,0,0,0,0,0,0,2020-12-27 19:15:00
4442,9910,Ryan Garry,4572,[2002],Arsenal FC,1,1,0,90,0,0,0,0,0,0,0,0,1,1,0,90,0,0,0.0,0.0,0.0,0,0,0,0,0,0,0,0,0,2020-12-27 19:15:00
4443,138845,Ryan Giggs,1110,"[2000, 2001, 2002, 2003, 2004, 2005, 2006, 2007, 2008, 2009, 2010, 2011, 2012, 2013]",Manchester United,177,127,50,11601,20,0,196,153,43,13794,35,0,373,280,93,25395,55,0,4.0,14.0,18.0,12,17,29,2,0,2,0,0,0,2020-12-27 19:15:002020-12-27 19:15:002020-12-27 19:15:002020-12-27 19:15:002020-12-27 19:15:002020-12-27 19:15:002020-12-27 19:15:002020-12-27 19:15:002020-12-27 19:15:002020-12-27 19:15:002020-12-27 19:15:002020-12-27 19:15:002020-12-27 19:15:002020-12-27 19:15:00
4444,19851,Ryan Giles,3293,"[2018, 2019]",Wolverhampton Wanderers,0,0,0,0,0,0,0,0,0,0,0,0,0,0,0,0,0,0,0.0,0.0,0.0,0,0,0,0,0,0,0,0,0,2020-12-27 19:15:002020-12-27 19:15:00
4445,19855,Ryan Inniss,3236,"[2013, 2020]",Crystal Palace,0,0,0,0,0,0,0,0,0,0,0,0,0,0,0,0,0,0,0.0,0.0,0.0,0,0,0,0,0,0,0,0,0,2020-12-27 19:15:002020-12-27 19:15:00
4446,9929,Ryan Jarvis,4021,[2004],Norwich City,1,0,1,12,1,0,3,1,2,102,0,0,4,1,3,114,1,0,0.0,0.0,0.0,0,0,0,0,0,0,0,0,0,2020-12-27 19:15:00
4447,19861,Ryan Ledson,2298,"[2013, 2014]",Everton FC,0,0,0,0,0,0,0,0,0,0,0,0,0,0,0,0,0,0,0.0,0.0,0.0,0,0,0,0,0,0,0,0,0,2020-12-27 19:15:002020-12-27 19:15:00
4448,29799,Ryan Mason,1166,"[2012, 2014, 2015]",Tottenham Hotspur,26,19,7,1551,1,0,27,18,9,1573,1,0,53,37,16,3124,2,0,0.0,3.0,3.0,1,1,2,0,0,0,0,0,0,2020-12-27 19:15:002020-12-27 19:15:002020-12-27 19:15:00
4449,9935,Ryan Mason,1166,[2016],Hull City,7,5,2,461,0,0,9,6,3,468,1,0,16,11,5,929,1,0,0.0,0.0,0.0,0,1,1,0,0,0,0,0,0,2020-12-27 19:15:00
4450,9936,Ryan McGivern,1682,[2010],Manchester City,1,0,1,20,0,0,0,0,0,0,0,0,1,0,1,20,0,0,0.0,0.0,0.0,0,0,0,0,0,0,0,0,0,2020-12-27 19:15:00
4451,59638,Ryan Nelsen,2007,"[2004, 2005, 2006, 2007, 2008, 2010]",Blackburn Rovers,68,68,0,6020,3,0,72,72,0,6389,1,0,140,140,0,12409,4,0,0.0,0.0,0.0,1,0,1,0,0,0,0,0,0,2020-12-27 19:15:002020-12-27 19:15:002020-12-27 19:15:002020-12-27 19:15:002020-12-27 19:15:002020-12-27 19:15:00
4452,9942,Ryan Nelsen,2007,[2009],Wigan Athletic,1,1,0,90,0,0,0,0,0,0,0,0,1,1,0,90,0,0,0.0,0.0,0.0,0,0,0,0,0,0,0,0,0,2020-12-27 19:15:00
4453,9944,Ryan Nelsen,2007,[2011],Tottenham Hotspur,4,0,4,107,0,0,1,0,1,3,0,0,5,0,5,110,0,0,0.0,0.0,0.0,0,0,0,0,0,0,0,0,0,2020-12-27 19:15:00
4454,9945,Ryan Nelsen,2007,[2012],Queens Park Rangers,10,10,0,893,0,0,11,11,0,990,1,0,21,21,0,1883,1,0,0.0,0.0,0.0,0,1,1,0,0,0,0,0,0,2020-12-27 19:15:00
4455,19893,Ryan Noble,3238,"[2010, 2011]",Sunderland AFC,2,0,2,22,0,0,3,0,3,45,0,0,5,0,5,67,0,0,0.0,0.0,0.0,0,0,0,0,0,0,0,0,0,2020-12-27 19:15:002020-12-27 19:15:00
4456,9948,Ryan Schofield,4481,[2018],Huddersfield Town,0,0,0,0,0,0,0,0,0,0,0,0,0,0,0,0,0,0,0.0,0.0,0.0,0,0,0,0,0,0,0,0,0,2020-12-27 19:15:00
4457,19899,Ryan Seager,4092,"[2014, 2015]",Southampton FC,1,0,1,1,0,0,0,0,0,0,0,0,1,0,1,1,0,0,0.0,0.0,0.0,0,0,0,0,0,0,0,0,0,2020-12-27 19:15:002020-12-27 19:15:00
4458,9951,Ryan Sessegnon,2987,[2018],Fulham FC,18,11,7,1095,1,0,17,15,2,1203,1,0,35,26,9,2298,2,0,0.0,0.0,0.0,1,1,2,0,0,0,0,0,0,2020-12-27 19:15:00
4459,9952,Ryan Sessegnon,2987,[2019],Tottenham Hotspur,3,2,1,161,0,0,3,2,1,181,0,0,6,4,2,342,0,0,0.0,0.0,0.0,0,0,0,0,0,0,0,0,0,2020-12-27 19:15:00
4460,99575,Ryan Shawcross,1547,"[2008, 2009, 2010, 2011, 2012, 2013, 2014, 2015, 2016, 2017]",Stoke City,160,159,1,14188,9,0,157,156,1,13900,5,0,317,315,2,28088,14,0,7.0,1.0,8.0,7,1,8,0,0,0,0,0,0,2020-12-27 19:15:002020-12-27 19:15:002020-12-27 19:15:002020-12-27 19:15:002020-12-27 19:15:002020-12-27 19:15:002020-12-27 19:15:002020-12-27 19:15:002020-12-27 19:15:002020-12-27 19:15:00
4461,39858,Ryan Shotton,3517,"[2010, 2011, 2012, 2013]",Stoke City,23,17,6,1547,0,0,25,17,8,1716,1,0,48,34,14,3263,1,0,0.0,3.0,3.0,0,1,1,0,0,0,0,0,0,2020-12-27 19:15:002020-12-27 19:15:002020-12-27 19:15:002020-12-27 19:15:00
4462,29905,Ryan Taylor,2341,"[2005, 2006, 2008]",Wigan Athletic,20,12,8,1216,2,0,18,13,5,1099,1,0,38,25,13,2315,3,0,3.0,0.0,3.0,2,1,3,0,0,0,0,0,0,2020-12-27 19:15:002020-12-27 19:15:002020-12-27 19:15:00
4463,9969,Ryan Taylor,2341,[2007],Blackburn Rovers,0,0,0,0,0,0,1,1,0,89,0,0,1,1,0,89,0,0,0.0,0.0,0.0,0,0,0,0,0,0,0,0,0,2020-12-27 19:15:00
4464,39890,Ryan Taylor,2341,"[2010, 2011, 2012, 2014]",Newcastle United,24,20,4,1715,1,0,26,17,9,1641,1,0,50,37,13,3356,2,0,0.0,3.0,3.0,0,1,1,0,0,0,0,0,0,2020-12-27 19:15:002020-12-27 19:15:002020-12-27 19:15:002020-12-27 19:15:00
4465,9975,Ryan Tunnicliffe,4032,[2012],Manchester United,0,0,0,0,0,0,0,0,0,0,0,0,0,0,0,0,0,0,0.0,0.0,0.0,0,0,0,0,0,0,0,0,0,2020-12-27 19:15:00
4466,9976,Ryan Tunnicliffe,4032,[2013],Fulham FC,2,1,1,101,0,0,1,1,0,65,0,0,3,2,1,166,0,0,0.0,0.0,0.0,0,0,0,0,0,0,0,0,0,2020-12-27 19:15:00
4467,9977,Ryo Miyaichi,2497,[2011],Bolton Wanderers,6,4,2,342,0,0,6,4,2,340,0,0,12,8,4,682,0,0,0.0,0.0,0.0,0,0,0,0,0,0,0,0,0,2020-12-27 19:15:00
4468,9978,Ryo Miyaichi,2497,[2012],Wigan Athletic,2,0,2,23,0,0,2,0,2,26,0,0,4,0,4,49,0,0,0.0,0.0,0.0,0,0,0,0,0,0,0,0,0,2020-12-27 19:15:00
4469,9979,Ryo Miyaichi,2497,[2013],Arsenal FC,1,0,1,17,0,0,0,0,0,0,0,0,1,0,1,17,0,0,0.0,0.0,0.0,0,0,0,0,0,0,0,0,0,2020-12-27 19:15:00
4470,9980,Rémy Cabella,2927,[2014],Newcastle United,15,11,4,921,0,0,16,10,6,1022,1,0,31,21,10,1943,1,0,0.0,0.0,0.0,0,1,1,0,0,0,0,0,0,2020-12-27 19:15:00
4471,9981,Rúben Dias,1050,[2020],Manchester City,6,6,0,520,0,0,6,6,0,540,0,0,12,12,0,1060,0,0,0.0,0.0,0.0,0,0,0,0,0,0,0,1,1,2020-12-27 19:15:00
4472,29949,Rúben Neves,2146,"[2018, 2019, 2020]",Wolverhampton Wanderers,44,41,3,3604,5,0,44,39,5,3439,1,0,88,80,8,7043,6,0,1.0,0.0,1.0,4,1,5,1,1,2,0,0,0,2020-12-27 19:15:002020-12-27 19:15:002020-12-27 19:15:00
4473,29958,Rúben Vinagre,2154,"[2018, 2019, 2020]",Wolverhampton Wanderers,17,6,11,720,0,0,18,8,10,803,0,0,35,14,21,1523,0,0,0.0,0.0,0.0,0,0,0,0,0,0,0,0,0,2020-12-27 19:15:002020-12-27 19:15:002020-12-27 19:15:00
4474,9988,Răzvan Raţ,3092,[2013],West Ham United,6,5,1,502,0,0,9,6,3,627,0,0,15,11,4,1129,0,0,0.0,0.0,0.0,0,0,0,0,0,0,0,0,0,2020-12-27 19:15:00
4475,19979,Sadio Mané,1151,"[2014, 2015]",Southampton FC,35,29,6,2506,14,0,32,25,7,2234,7,0,67,54,13,4740,21,0,9.0,5.0,14.0,7,6,13,0,0,0,0,0,0,2020-12-27 19:15:002020-12-27 19:15:00
4476,49965,Sadio Mané,1151,"[2016, 2017, 2018, 2019, 2020]",Liverpool FC,73,70,3,6015,46,0,67,62,5,5395,23,0,140,132,8,11410,69,0,12.0,9.0,21.0,22,17,39,0,0,0,0,0,0,2020-12-27 19:15:002020-12-27 19:15:002020-12-27 19:15:002020-12-27 19:15:002020-12-27 19:15:00
4477,39990,Saido Berahino,1905,"[2013, 2014, 2015, 2016]",West Bromwich Albion,54,34,20,3395,17,0,51,29,22,2927,6,0,105,63,42,6322,23,0,16.0,8.0,24.0,12,6,18,4,1,5,0,0,0,2020-12-27 19:15:002020-12-27 19:15:002020-12-27 19:15:002020-12-27 19:15:00
4478,10000,Saido Berahino,1905,[2017],Stoke City,10,1,9,274,0,0,5,2,3,210,0,0,15,3,12,484,0,0,0.0,0.0,0.0,0,0,0,0,0,0,0,0,0,2020-12-27 19:15:00
4479,20003,Salif Diao,1992,"[2002, 2003]",Liverpool FC,14,7,7,671,0,0,15,8,7,791,1,0,29,15,14,1462,1,0,0.0,3.0,3.0,0,1,1,0,0,0,0,0,0,2020-12-27 19:15:002020-12-27 19:15:00
4480,10003,Salif Diao,1992,[2004],Birmingham City,1,1,0,90,0,0,1,1,0,68,0,0,2,2,0,158,0,0,0.0,0.0,0.0,0,0,0,0,0,0,0,0,0,2020-12-27 19:15:00
4481,10004,Salif Diao,1992,[2005],Portsmouth FC,6,3,3,282,0,0,5,4,1,374,0,0,11,7,4,656,0,0,0.0,0.0,0.0,0,0,0,0,0,0,0,0,0,2020-12-27 19:15:00
4482,40026,Salif Diao,1992,"[2008, 2009, 2010, 2011]",Stoke City,20,13,7,1101,0,0,30,21,9,1664,1,0,50,34,16,2765,1,0,0.0,3.0,3.0,0,1,1,0,0,0,0,0,0,2020-12-27 19:15:002020-12-27 19:15:002020-12-27 19:15:002020-12-27 19:15:00
4483,60069,Salomon Kalou,1770,"[2006, 2007, 2008, 2009, 2010, 2011]",Chelsea FC,78,45,33,4203,18,0,78,49,29,4459,19,0,156,94,62,8662,37,0,7.0,10.0,17.0,7,10,17,0,0,0,0,0,0,2020-12-27 19:15:002020-12-27 19:15:002020-12-27 19:15:002020-12-27 19:15:002020-12-27 19:15:002020-12-27 19:15:00
4484,10015,Salomon Olembé,2344,[2003],Leeds United,6,5,1,440,0,0,6,3,3,400,0,0,12,8,4,840,0,0,0.0,0.0,0.0,0,0,0,0,0,0,0,0,0,2020-12-27 19:15:00
4485,10016,Salomon Olembé,2344,[2007],Blackburn Rovers,0,0,0,0,0,0,1,0,1,1,0,0,1,0,1,1,0,0,0.0,0.0,0.0,0,0,0,0,0,0,0,0,0,2020-12-27 19:15:00
4486,30054,Salomón Rondón,1659,"[2015, 2016, 2017]",West Bromwich Albion,52,50,2,4250,14,0,56,44,12,3984,10,0,108,94,14,8234,24,0,5.0,13.0,18.0,8,9,17,0,0,0,0,0,0,2020-12-27 19:15:002020-12-27 19:15:002020-12-27 19:15:00
4487,10020,Salomón Rondón,1659,[2018],Newcastle United,16,15,1,1343,6,0,16,15,1,1266,5,0,32,30,2,2609,11,0,0.0,3.0,3.0,4,4,8,0,0,0,0,0,0,2020-12-27 19:15:00
4488,10021,Salva Ballesta,3503,[2002],Bolton Wanderers,2,0,2,40,0,0,4,1,3,101,0,0,6,1,5,141,0,0,0.0,0.0,0.0,0,0,0,0,0,0,0,0,0,2020-12-27 19:15:00
4489,10022,Sam Baldock,3862,[2017],Brighton & Hove Albion,1,0,1,6,0,0,1,0,1,24,0,0,2,0,2,30,0,0,0.0,0.0,0.0,0,0,0,0,0,0,0,0,0,2020-12-27 19:15:00
4490,30072,Sam Byram,1823,"[2015, 2016, 2017]",West Ham United,15,10,5,973,0,0,12,7,5,806,0,0,27,17,10,1779,0,0,0.0,0.0,0.0,0,0,0,0,0,0,0,0,0,2020-12-27 19:15:002020-12-27 19:15:002020-12-27 19:15:00
4491,10026,Sam Byram,1823,[2019],Norwich City,9,7,2,574,0,0,8,8,0,720,0,0,17,15,2,1294,0,0,0.0,0.0,0.0,0,0,0,0,0,0,0,0,0,2020-12-27 19:15:00
4492,10027,Sam Clucas,2734,[2016],Hull City,18,17,1,1543,2,0,19,19,0,1647,1,0,37,36,1,3190,3,0,0.0,0.0,0.0,0,1,1,0,0,0,0,0,0,2020-12-27 19:15:00
4493,10028,Sam Clucas,2734,[2017],Swansea City,13,11,2,963,2,0,16,12,4,1082,1,0,29,23,6,2045,3,0,0.0,0.0,0.0,1,1,2,0,0,0,0,0,0,2020-12-27 19:15:00
4494,40122,Sam Field,1665,"[2015, 2016, 2017, 2020]",West Bromwich Albion,11,5,6,411,1,0,11,6,5,469,0,0,22,11,11,880,1,0,0.0,0.0,0.0,0,0,0,0,0,0,0,0,0,2020-12-27 19:15:002020-12-27 19:15:002020-12-27 19:15:002020-12-27 19:15:00
4495,30102,Sam Gallagher,3689,"[2013, 2014, 2018]",Southampton FC,9,2,7,236,1,0,13,1,12,179,0,0,22,3,19,415,1,0,0.0,0.0,0.0,0,0,0,0,0,0,0,0,0,2020-12-27 19:15:002020-12-27 19:15:002020-12-27 19:15:00
4496,10036,Sam Hughes,4065,[2017],Leicester City,0,0,0,0,0,0,0,0,0,0,0,0,0,0,0,0,0,0,0.0,0.0,0.0,0,0,0,0,0,0,0,0,0,2020-12-27 19:15:00
4497,30114,Sam Hutchinson,3894,"[2006, 2009, 2011]",Chelsea FC,4,1,3,97,0,0,1,0,1,4,0,0,5,1,4,101,0,0,0.0,0.0,0.0,0,0,0,0,0,0,0,0,0,2020-12-27 19:15:002020-12-27 19:15:002020-12-27 19:15:00
4498,30123,Sam Johnstone,3408,"[2012, 2013, 2015]",Manchester United,0,0,0,0,0,0,0,0,0,0,0,0,0,0,0,0,0,0,0.0,0.0,0.0,0,0,0,0,0,0,0,0,0,2020-12-27 19:15:002020-12-27 19:15:002020-12-27 19:15:00
4499,10043,Sam Johnstone,3408,[2020],West Bromwich Albion,7,7,0,630,0,0,8,8,0,720,0,0,15,15,0,1350,0,0,0.0,0.0,0.0,0,0,0,0,0,0,0,0,0,2020-12-27 19:15:00
4500,10044,Sam Mantom,4245,[2011],West Bromwich Albion,0,0,0,0,0,0,0,0,0,0,0,0,0,0,0,0,0,0,0.0,0.0,0.0,0,0,0,0,0,0,0,0,0,2020-12-27 19:15:00
4501,30138,Sam McQueen,1246,"[2014, 2016, 2017]",Southampton FC,9,3,6,387,0,0,11,3,8,363,0,0,20,6,14,750,0,0,0.0,0.0,0.0,0,0,0,0,0,0,0,0,0,2020-12-27 19:15:002020-12-27 19:15:002020-12-27 19:15:00
4502,10048,Sam Ricketts,2489,[2008],Hull City,15,14,1,1281,0,0,14,13,1,1250,0,0,29,27,2,2531,0,0,0.0,0.0,0.0,0,0,0,0,0,0,0,0,0,2020-12-27 19:15:00
4503,30150,Sam Ricketts,2489,"[2009, 2010, 2011]",Bolton Wanderers,30,29,1,2636,1,0,34,30,4,2738,0,0,64,59,5,5374,1,0,0.0,0.0,0.0,1,0,1,0,0,0,0,0,0,2020-12-27 19:15:002020-12-27 19:15:002020-12-27 19:15:00
4504,10052,Sam Sodje,4280,[2006],Reading FC,0,0,0,0,0,0,3,2,1,190,0,0,3,2,1,190,0,0,0.0,0.0,0.0,0,0,0,0,0,0,0,0,0,2020-12-27 19:15:00
4505,30162,Sam Surridge,3940,"[2016, 2018, 2019]",AFC Bournemouth,3,0,3,24,0,0,3,0,3,12,0,0,6,0,6,36,0,0,0.0,0.0,0.0,0,0,0,0,0,0,0,0,0,2020-12-27 19:15:002020-12-27 19:15:002020-12-27 19:15:00
4506,30171,Sam Vokes,1257,"[2009, 2010, 2011]",Wolverhampton Wanderers,6,0,6,78,0,0,5,0,5,54,0,0,11,0,11,132,0,0,0.0,0.0,0.0,0,0,0,0,0,0,0,0,0,2020-12-27 19:15:002020-12-27 19:15:002020-12-27 19:15:00
4507,40242,Sam Vokes,1257,"[2014, 2016, 2017, 2018]",Burnley FC,49,23,26,2342,9,0,53,20,33,2170,8,0,102,43,59,4512,17,0,4.0,6.0,10.0,8,6,14,0,2,2,0,0,0,2020-12-27 19:15:002020-12-27 19:15:002020-12-27 19:15:002020-12-27 19:15:00
4508,10063,Sam Williamson,4524,[2007],Manchester City,1,0,1,36,0,0,0,0,0,0,0,0,1,0,1,36,0,0,0.0,0.0,0.0,0,0,0,0,0,0,0,0,0,2020-12-27 19:15:00
4509,10064,Sam Winnall,4284,[2010],Wolverhampton Wanderers,0,0,0,0,0,0,0,0,0,0,0,0,0,0,0,0,0,0,0.0,0.0,0.0,0,0,0,0,0,0,0,0,0,2020-12-27 19:15:00
4510,30198,Sam Woods,3710,"[2018, 2019, 2020]",Crystal Palace,0,0,0,0,0,0,0,0,0,0,0,0,0,0,0,0,0,0,0.0,0.0,0.0,0,0,0,0,0,0,0,0,0,2020-12-27 19:15:002020-12-27 19:15:002020-12-27 19:15:00
4511,20137,Samba Diakité,2541,"[2011, 2012]",Queens Park Rangers,13,11,2,960,1,0,10,9,1,725,0,0,23,20,3,1685,1,0,3.0,0.0,3.0,1,0,1,0,0,0,0,0,0,2020-12-27 19:15:002020-12-27 19:15:00
4512,80595,Sami Hyypiä,2361,"[2000, 2002, 2003, 2004, 2005, 2006, 2007, 2008]",Liverpool FC,117,112,5,10038,8,0,121,118,3,10346,9,0,238,230,8,20384,17,0,4.0,3.0,7.0,6,6,12,0,0,0,0,0,0,2020-12-27 19:15:002020-12-27 19:15:002020-12-27 19:15:002020-12-27 19:15:002020-12-27 19:15:002020-12-27 19:15:002020-12-27 19:15:002020-12-27 19:15:00
4513,10071,Sami Hyypiä,2361,[2001],West Ham United,1,1,0,90,0,0,0,0,0,0,0,0,1,1,0,90,0,0,0.0,0.0,0.0,0,0,0,0,0,0,0,0,0,2020-12-27 19:15:00
4514,20159,Samir Carruthers,2670,"[2011, 2012]",Aston Villa,0,0,0,0,0,0,3,0,3,20,0,0,3,0,3,20,0,0,0.0,0.0,0.0,0,0,0,0,0,0,0,0,0,2020-12-27 19:15:002020-12-27 19:15:00
4515,30246,Samir Nasri,1358,"[2008, 2009, 2010]",Arsenal FC,43,42,1,3470,10,0,41,35,6,3125,8,0,84,77,7,6595,18,0,6.0,0.0,6.0,7,4,11,1,0,1,0,0,0,2020-12-27 19:15:002020-12-27 19:15:002020-12-27 19:15:00
4516,60519,Samir Nasri,1358,"[2011, 2012, 2013, 2014, 2015, 2016]",Manchester City,61,47,14,4261,13,0,68,52,16,4398,5,0,129,99,30,8659,18,0,10.0,0.0,10.0,7,1,8,0,0,0,0,0,0,2020-12-27 19:15:002020-12-27 19:15:002020-12-27 19:15:002020-12-27 19:15:002020-12-27 19:15:002020-12-27 19:15:00
4517,10090,Samir Nasri,1358,[2018],West Ham United,2,1,1,102,0,0,3,2,1,144,0,0,5,3,2,246,0,0,0.0,0.0,0.0,0,0,0,0,0,0,0,0,0,2020-12-27 19:15:00
4518,50465,Sammy Ameobi,2459,"[2010, 2011, 2012, 2013, 2014]",Newcastle United,25,11,14,1157,0,0,36,10,26,1218,2,0,61,21,40,2375,2,0,0.0,0.0,0.0,0,1,1,0,0,0,0,0,0,2020-12-27 19:15:002020-12-27 19:15:002020-12-27 19:15:002020-12-27 19:15:002020-12-27 19:15:00
4519,10096,Samuel Eto'o,2243,[2013],Chelsea FC,13,12,1,873,9,0,8,4,4,430,0,0,21,16,5,1303,9,0,3.0,0.0,3.0,7,0,7,0,0,0,0,0,0,2020-12-27 19:15:00
4520,10097,Samuel Eto'o,2243,[2014],Everton FC,7,2,5,261,1,0,7,6,1,521,2,0,14,8,6,782,3,0,0.0,0.0,0.0,0,1,1,0,0,0,0,0,0,2020-12-27 19:15:00
4521,10098,Samuel Shashoua,4083,[2016],Tottenham Hotspur,0,0,0,0,0,0,0,0,0,0,0,0,0,0,0,0,0,0,0.0,0.0,0.0,0,0,0,0,0,0,0,0,0,2020-12-27 19:15:00
4522,20199,Samuele Dalla Bona,3055,"[2000, 2001]",Chelsea FC,25,21,4,1955,5,0,27,20,7,1770,1,0,52,41,11,3725,6,0,3.0,0.0,3.0,1,1,2,0,0,0,0,0,0,2020-12-27 19:15:002020-12-27 19:15:00
4523,20203,Sander Berge,3581,"[2019, 2020]",Sheffield United,14,12,2,952,1,0,13,12,1,1013,1,0,27,24,3,1965,2,0,0.0,0.0,0.0,1,1,2,0,1,1,0,0,0,2020-12-27 19:15:002020-12-27 19:15:00
4524,20207,Sander Westerveld,2687,"[2000, 2001]",Liverpool FC,19,19,0,1710,0,0,18,18,0,1620,0,0,37,37,0,3330,0,0,0.0,0.0,0.0,0,0,0,0,0,0,0,0,0,2020-12-27 19:15:002020-12-27 19:15:00
4525,10105,Sander Westerveld,2687,[2005],Portsmouth FC,3,3,0,270,0,0,3,3,0,270,0,0,6,6,0,540,0,0,0.0,0.0,0.0,0,0,0,0,0,0,0,0,0,2020-12-27 19:15:00
4526,10106,Sandor Torghelle,4060,[2004],Crystal Palace,4,1,3,89,0,0,8,2,6,308,0,0,12,3,9,397,0,0,0.0,0.0,0.0,0,0,0,0,0,0,0,0,0,2020-12-27 19:15:00
4527,40434,Sandro,2409,"[2010, 2011, 2012, 2013]",Tottenham Hotspur,41,26,15,2218,1,0,40,34,6,2883,2,0,81,60,21,5101,3,0,0.0,0.0,0.0,1,2,3,0,0,0,0,0,0,2020-12-27 19:15:002020-12-27 19:15:002020-12-27 19:15:002020-12-27 19:15:00
4528,10111,Sandro,2409,[2014],Queens Park Rangers,8,8,0,584,1,0,9,9,0,637,0,0,17,17,0,1221,1,0,0.0,0.0,0.0,0,0,0,0,0,0,0,0,0,2020-12-27 19:15:00
4529,10112,Sandro,2409,[2015],West Bromwich Albion,4,1,3,102,0,0,8,4,4,279,0,0,12,5,7,381,0,0,0.0,0.0,0.0,0,0,0,0,0,0,0,0,0,2020-12-27 19:15:00
4530,20227,Sandro,2409,"[2017, 2018]",Everton FC,5,2,3,176,0,0,3,1,2,100,0,0,8,3,5,276,0,0,0.0,0.0,0.0,0,0,0,0,0,0,0,0,0,2020-12-27 19:15:002020-12-27 19:15:00
4531,50585,Santi Cazorla,1502,"[2012, 2013, 2014, 2015, 2016]",Arsenal FC,64,59,5,5320,12,0,64,63,1,5470,13,0,128,122,6,10790,25,0,6.0,3.0,9.0,5,6,11,3,5,8,0,0,0,2020-12-27 19:15:002020-12-27 19:15:002020-12-27 19:15:002020-12-27 19:15:002020-12-27 19:15:00
4532,20241,Santiago Vergini,2262,"[2013, 2014]",Sunderland AFC,22,20,2,1929,0,0,20,18,2,1672,0,0,42,38,4,3601,0,0,0.0,0.0,0.0,0,0,0,0,0,0,0,0,0,2020-12-27 19:15:002020-12-27 19:15:00
4533,10122,Saphir Taïder,4279,[2014],Southampton FC,0,0,0,0,0,0,0,0,0,0,0,0,0,0,0,0,0,0,0.0,0.0,0.0,0,0,0,0,0,0,0,0,0,2020-12-27 19:15:00
4534,20247,Sascha Riether,2554,"[2012, 2013]",Fulham FC,35,34,1,3008,0,0,31,31,0,2684,1,0,66,65,1,5692,1,0,0.0,0.0,0.0,0,0,0,0,0,0,0,0,0,2020-12-27 19:15:002020-12-27 19:15:00
4535,10125,Savio Nsereko,2949,[2008],West Ham United,5,1,4,150,0,0,5,0,5,88,0,0,10,1,9,238,0,0,0.0,0.0,0.0,0,0,0,0,0,0,0,0,0,2020-12-27 19:15:00
4536,10126,Saïd Benrahma,1058,[2020],West Ham United,4,1,3,165,0,0,3,1,2,108,0,0,7,2,5,273,0,0,0.0,0.0,0.0,0,0,0,0,0,0,0,0,0,2020-12-27 19:15:00
4537,10127,Saša Ilić,1667,[2000],Charlton Athletic,6,6,0,540,0,0,7,7,0,630,0,0,13,13,0,1170,0,0,0.0,0.0,0.0,0,0,0,0,0,0,0,0,0,2020-12-27 19:15:00
4538,10128,Scott Allan,4348,[2011],West Bromwich Albion,0,0,0,0,0,0,0,0,0,0,0,0,0,0,0,0,0,0,0.0,0.0,0.0,0,0,0,0,0,0,0,0,0,2020-12-27 19:15:00
4539,30390,Scott Arfield,1265,"[2014, 2016, 2017]",Burnley FC,42,35,7,3174,4,0,44,39,5,3473,1,0,86,74,12,6647,5,0,6.0,0.0,6.0,4,1,5,0,0,0,0,0,0,2020-12-27 19:15:002020-12-27 19:15:002020-12-27 19:15:00
4540,10132,Scott Carson,1999,[2003],Leeds United,1,0,1,1,0,0,2,2,0,180,0,0,3,2,1,181,0,0,0.0,0.0,0.0,0,0,0,0,0,0,0,0,0,2020-12-27 19:15:00
4541,10133,Scott Carson,1999,[2004],Liverpool FC,2,2,0,180,0,0,2,2,0,180,0,0,4,4,0,360,0,0,0.0,0.0,0.0,0,0,0,0,0,0,0,0,0,2020-12-27 19:15:00
4542,10134,Scott Carson,1999,[2006],Charlton Athletic,18,18,0,1620,0,0,18,18,0,1620,0,0,36,36,0,3240,0,0,0.0,0.0,0.0,0,0,0,0,0,0,0,0,0,2020-12-27 19:15:00
4543,10135,Scott Carson,1999,[2007],Aston Villa,18,18,0,1620,0,0,17,17,0,1530,0,0,35,35,0,3150,0,0,0.0,0.0,0.0,0,0,0,0,0,0,0,0,0,2020-12-27 19:15:00
4544,20273,Scott Carson,1999,"[2008, 2010]",West Bromwich Albion,32,32,0,2880,0,0,35,35,0,3150,0,0,67,67,0,6030,0,0,0.0,0.0,0.0,0,0,0,0,0,0,0,0,0,2020-12-27 19:15:002020-12-27 19:15:00
4545,20277,Scott Carson,1999,"[2019, 2020]",Manchester City,0,0,0,0,0,0,0,0,0,0,0,0,0,0,0,0,0,0,0.0,0.0,0.0,0,0,0,0,0,0,0,0,0,2020-12-27 19:15:002020-12-27 19:15:00
4546,20281,Scott Dann,1020,"[2009, 2010]",Birmingham City,25,25,0,2250,0,0,25,25,0,2250,2,0,50,50,0,4500,2,0,0.0,3.0,3.0,0,1,1,0,0,0,0,0,0,2020-12-27 19:15:002020-12-27 19:15:00
4547,10142,Scott Dann,1020,[2011],Blackburn Rovers,12,12,0,1080,1,0,15,15,0,1323,0,0,27,27,0,2403,1,0,0.0,0.0,0.0,1,0,1,0,0,0,0,0,0,2020-12-27 19:15:00
4548,81172,Scott Dann,1020,"[2013, 2014, 2015, 2016, 2017, 2018, 2019, 2020]",Crystal Palace,80,76,4,6851,7,0,77,71,6,6342,6,0,157,147,10,13193,13,0,1.0,4.0,5.0,5,4,9,0,0,0,0,0,0,2020-12-27 19:15:002020-12-27 19:15:002020-12-27 19:15:002020-12-27 19:15:002020-12-27 19:15:002020-12-27 19:15:002020-12-27 19:15:002020-12-27 19:15:00
4549,20303,Scott Dobie,3085,"[2002, 2004]",West Bromwich Albion,18,3,15,558,2,0,17,8,9,810,4,0,35,11,24,1368,6,0,0.0,0.0,0.0,2,2,4,0,0,0,0,0,0,2020-12-27 19:15:002020-12-27 19:15:00
4550,30462,Scott Gemmill,3734,"[2000, 2001, 2002]",Everton FC,39,32,7,3017,2,0,36,33,3,2951,1,0,75,65,10,5968,3,0,0.0,0.0,0.0,1,1,2,0,0,0,0,0,0,2020-12-27 19:15:002020-12-27 19:15:002020-12-27 19:15:00
4551,10156,Scott Golbourne,4478,[2007],Reading FC,0,0,0,0,0,0,1,1,0,62,0,0,1,1,0,62,0,0,0.0,0.0,0.0,0,0,0,0,0,0,0,0,0,2020-12-27 19:15:00
4552,10157,Scott Harrison,4043,[2012],Sunderland AFC,0,0,0,0,0,0,0,0,0,0,0,0,0,0,0,0,0,0,0.0,0.0,0.0,0,0,0,0,0,0,0,0,0,2020-12-27 19:15:00
4553,10158,Scott Kerr,3979,[2000],Bradford City,0,0,0,0,0,0,1,0,1,7,0,0,1,0,1,7,0,0,0.0,0.0,0.0,0,0,0,0,0,0,0,0,0,2020-12-27 19:15:00
4554,10159,Scott Malone,3096,[2017],Huddersfield Town,11,7,4,587,0,0,11,5,6,529,0,0,22,12,10,1116,0,0,0.0,0.0,0.0,0,0,0,0,0,0,0,0,0,2020-12-27 19:15:00
4555,10160,Scott McDonald,4356,[2001],Southampton FC,1,0,1,13,0,0,1,0,1,14,0,0,2,0,2,27,0,0,0.0,0.0,0.0,0,0,0,0,0,0,0,0,0,2020-12-27 19:15:00
4556,50815,Scott McTominay,1652,"[2016, 2017, 2018, 2019, 2020]",Manchester United,35,24,11,2186,4,0,36,23,13,2118,3,0,71,47,24,4304,7,0,0.0,0.0,0.0,2,3,5,0,0,0,0,0,0,2020-12-27 19:15:002020-12-27 19:15:002020-12-27 19:15:002020-12-27 19:15:002020-12-27 19:15:00
4557,30501,Scott Minto,2463,"[2000, 2001, 2002]",West Ham United,5,4,1,387,0,0,12,10,2,867,0,0,17,14,3,1254,0,0,0.0,0.0,0.0,0,0,0,0,0,0,0,0,0,2020-12-27 19:15:002020-12-27 19:15:002020-12-27 19:15:00
4558,40682,Scott Parker,1282,"[2000, 2001, 2002, 2003]",Charlton Athletic,51,49,2,4123,5,0,49,44,5,3860,3,0,100,93,7,7983,8,0,3.0,3.0,6.0,4,2,6,0,0,0,0,0,0,2020-12-27 19:15:002020-12-27 19:15:002020-12-27 19:15:002020-12-27 19:15:00
4559,10173,Scott Parker,1282,[2004],Chelsea FC,3,1,2,112,0,0,1,0,1,13,0,0,4,1,3,125,0,0,0.0,0.0,0.0,0,0,0,0,0,0,0,0,0,2020-12-27 19:15:00
4560,20349,Scott Parker,1282,"[2005, 2006]",Newcastle United,29,28,1,2438,3,0,25,25,0,2208,1,0,54,53,1,4646,4,0,0.0,0.0,0.0,2,1,3,0,0,0,0,0,0,2020-12-27 19:15:002020-12-27 19:15:00
4561,40710,Scott Parker,1282,"[2007, 2008, 2009, 2010]",West Ham United,59,56,3,4856,5,0,48,47,1,4099,4,0,107,103,4,8955,9,0,3.0,3.0,6.0,3,3,6,0,0,0,0,0,0,2020-12-27 19:15:002020-12-27 19:15:002020-12-27 19:15:002020-12-27 19:15:00
4562,20361,Scott Parker,1282,"[2011, 2012]",Tottenham Hotspur,22,19,3,1662,0,0,28,24,4,2181,0,0,50,43,7,3843,0,0,0.0,0.0,0.0,0,0,0,0,0,0,0,0,0,2020-12-27 19:15:002020-12-27 19:15:00
4563,10182,Scott Parker,1282,[2013],Fulham FC,15,14,1,1158,1,0,14,13,1,1161,1,0,29,27,2,2319,2,0,0.0,3.0,3.0,1,1,2,0,0,0,0,0,0,2020-12-27 19:15:00
4564,30552,Scott Sinclair,1420,"[2006, 2007, 2008]",Chelsea FC,3,1,2,72,0,0,2,0,2,21,0,0,5,1,4,93,0,0,0.0,0.0,0.0,0,0,0,0,0,0,0,0,0,2020-12-27 19:15:002020-12-27 19:15:002020-12-27 19:15:00
4565,10186,Scott Sinclair,1420,[2009],Wigan Athletic,8,0,8,138,0,0,10,1,9,205,1,0,18,1,17,343,1,0,0.0,0.0,0.0,0,0,0,0,0,0,0,0,0,2020-12-27 19:15:00
4566,10187,Scott Sinclair,1420,[2011],Swansea City,19,18,1,1596,7,0,19,17,2,1526,1,0,38,35,3,3122,8,0,1.0,0.0,1.0,6,1,7,4,0,4,0,0,0,2020-12-27 19:15:00
4567,10188,Scott Sinclair,1420,[2012],Manchester City,6,1,5,98,0,0,5,1,4,92,0,0,11,2,9,190,0,0,0.0,0.0,0.0,0,0,0,0,0,0,0,0,0,2020-12-27 19:15:00
4568,10189,Scott Sinclair,1420,[2013],West Bromwich Albion,3,3,0,190,0,0,5,1,4,111,0,0,8,4,4,301,0,0,0.0,0.0,0.0,0,0,0,0,0,0,0,0,0,2020-12-27 19:15:00
4569,20381,Scott Sinclair,1420,"[2014, 2015]",Aston Villa,17,12,5,1021,3,0,19,12,7,1038,0,0,36,24,12,2059,3,0,0.0,0.0,0.0,3,0,3,1,0,1,0,0,0,2020-12-27 19:15:002020-12-27 19:15:00
4570,10192,Scott Wootton,3846,[2012],Manchester United,0,0,0,0,0,0,0,0,0,0,0,0,0,0,0,0,0,0,0.0,0.0,0.0,0,0,0,0,0,0,0,0,0,2020-12-27 19:15:00
4571,10193,Sead Hakšabanović,4184,[2017],West Ham United,0,0,0,0,0,0,0,0,0,0,0,0,0,0,0,0,0,0,0.0,0.0,0.0,0,0,0,0,0,0,0,0,0,2020-12-27 19:15:00
4572,40782,Sead Kolašinac,2216,"[2017, 2018, 2019, 2020]",Arsenal FC,43,35,8,3047,2,0,35,32,3,2784,0,0,78,67,11,5831,2,0,0.0,0.0,0.0,1,0,1,0,0,0,0,0,0,2020-12-27 19:15:002020-12-27 19:15:002020-12-27 19:15:002020-12-27 19:15:00
4573,30597,Sean Davis,1087,"[2001, 2002, 2003]",Fulham FC,40,35,5,3079,5,0,33,31,2,2743,3,0,73,66,7,5822,8,0,3.0,1.0,4.0,3,1,4,0,0,0,0,0,0,2020-12-27 19:15:002020-12-27 19:15:002020-12-27 19:15:00
4574,10201,Sean Davis,1087,[2004],Tottenham Hotspur,8,6,2,524,0,0,9,7,2,684,0,0,17,13,4,1208,0,0,0.0,0.0,0.0,0,0,0,0,0,0,0,0,0,2020-12-27 19:15:00
4575,40814,Sean Davis,1087,"[2005, 2006, 2007, 2008]",Portsmouth FC,50,46,4,3970,2,0,51,47,4,4044,1,0,101,93,8,8014,3,0,3.0,0.0,3.0,1,0,1,0,0,0,0,0,0,2020-12-27 19:15:002020-12-27 19:15:002020-12-27 19:15:002020-12-27 19:15:00
4576,20413,Sean Davis,1087,"[2009, 2010]",Bolton Wanderers,3,3,0,270,0,0,1,1,0,90,0,0,4,4,0,360,0,0,0.0,0.0,0.0,0,0,0,0,0,0,0,0,0,2020-12-27 19:15:002020-12-27 19:15:00
4577,10208,Sean Goss,4324,[2015],Manchester United,0,0,0,0,0,0,0,0,0,0,0,0,0,0,0,0,0,0,0.0,0.0,0.0,0,0,0,0,0,0,0,0,0,2020-12-27 19:15:00
4578,10209,Sean Gregan,3081,[2002],West Bromwich Albion,17,17,0,1507,1,0,18,18,0,1590,0,0,35,35,0,3097,1,0,3.0,0.0,3.0,1,0,1,0,0,0,0,0,0,2020-12-27 19:15:00
4579,30633,Sean Longstaff,2475,"[2018, 2019, 2020]",Newcastle United,20,12,8,1226,1,0,22,17,5,1486,1,0,42,29,13,2712,2,0,0.0,0.0,0.0,0,0,0,0,0,0,0,0,0,2020-12-27 19:15:002020-12-27 19:15:002020-12-27 19:15:00
4580,10213,Sean Morrison,1978,[2012],Reading FC,8,8,0,720,1,0,7,7,0,605,1,0,15,15,0,1325,2,0,0.0,0.0,0.0,1,1,2,0,0,0,0,0,0,2020-12-27 19:15:00
4581,10214,Sean Morrison,1978,[2018],Cardiff City,18,18,0,1600,0,0,16,16,0,1440,1,0,34,34,0,3040,1,0,0.0,0.0,0.0,0,0,0,0,0,0,0,0,0,2020-12-27 19:15:00
4582,10215,Sean Thornton,3791,[2002],Sunderland AFC,5,5,0,405,1,0,6,6,0,540,0,0,11,11,0,945,1,0,0.0,0.0,0.0,1,0,1,0,0,0,0,0,0,2020-12-27 19:15:00
4583,10216,Seb Hines,3994,[2008],Middlesbrough FC,0,0,0,0,0,0,1,0,1,3,0,0,1,0,1,3,0,0,0.0,0.0,0.0,0,0,0,0,0,0,0,0,0,2020-12-27 19:15:00
4584,10217,Sebastian Larsson,1402,[2005],Arsenal FC,2,1,1,117,0,0,1,1,0,90,0,0,3,2,1,207,0,0,0.0,0.0,0.0,0,0,0,0,0,0,0,0,0,2020-12-27 19:15:00
4585,30657,Sebastian Larsson,1402,"[2007, 2009, 2010]",Birmingham City,51,45,6,3907,6,0,52,44,8,3979,8,0,103,89,14,7886,14,0,2.0,4.0,6.0,4,5,9,0,1,1,0,0,0,2020-12-27 19:15:002020-12-27 19:15:002020-12-27 19:15:00
4586,61341,Sebastian Larsson,1402,"[2011, 2012, 2013, 2014, 2015, 2016]",Sunderland AFC,86,72,14,6399,5,0,90,79,11,6648,7,0,176,151,25,13047,12,0,3.0,5.0,8.0,4,6,10,0,0,0,0,0,0,2020-12-27 19:15:002020-12-27 19:15:002020-12-27 19:15:002020-12-27 19:15:002020-12-27 19:15:002020-12-27 19:15:00
4587,20455,Sebastian Lletget,4006,"[2012, 2014]",West Ham United,0,0,0,0,0,0,0,0,0,0,0,0,0,0,0,0,0,0,0.0,0.0,0.0,0,0,0,0,0,0,0,0,0,2020-12-27 19:15:002020-12-27 19:15:00
4588,51155,Sebastian Prödl,2366,"[2015, 2016, 2017, 2018, 2019]",Watford FC,37,34,3,2980,2,0,40,35,5,3208,1,0,77,69,8,6188,3,0,0.0,0.0,0.0,2,0,2,0,0,0,0,0,0,2020-12-27 19:15:002020-12-27 19:15:002020-12-27 19:15:002020-12-27 19:15:002020-12-27 19:15:00
4589,10234,Sebastian Usai,4575,[2011],Blackburn Rovers,0,0,0,0,0,0,0,0,0,0,0,0,0,0,0,0,0,0,0.0,0.0,0.0,0,0,0,0,0,0,0,0,0,2020-12-27 19:15:00
4590,30708,Sebastien Schemmel,1624,"[2000, 2001, 2002]",West Ham United,27,24,3,2224,1,0,30,30,0,2511,0,0,57,54,3,4735,1,0,0.0,0.0,0.0,1,0,1,0,0,0,0,0,0,2020-12-27 19:15:002020-12-27 19:15:002020-12-27 19:15:00
4591,10238,Sebastien Schemmel,1624,[2003],Portsmouth FC,6,5,1,442,0,0,7,7,0,556,0,0,13,12,1,998,0,0,0.0,0.0,0.0,0,0,0,0,0,0,0,0,0,2020-12-27 19:15:00
4592,10239,Sebastián Blanco,3649,[2014],West Bromwich Albion,2,0,2,27,0,0,1,0,1,9,0,0,3,0,3,36,0,0,0.0,0.0,0.0,0,0,0,0,0,0,0,0,0,2020-12-27 19:15:00
4593,20481,Sebastián Coates,2526,"[2011, 2012]",Liverpool FC,4,3,1,275,0,0,8,3,5,442,1,0,12,6,6,717,1,0,0.0,0.0,0.0,0,1,1,0,0,0,0,0,0,2020-12-27 19:15:002020-12-27 19:15:00
4594,20485,Sebastián Coates,2526,"[2014, 2015]",Sunderland AFC,13,11,2,1026,0,0,13,12,1,1025,0,0,26,23,3,2051,0,0,0.0,0.0,0.0,0,0,0,0,0,0,0,0,0,2020-12-27 19:15:002020-12-27 19:15:00
4595,10244,Segundo Castillo,3953,[2008],Everton FC,2,1,1,75,0,0,6,3,3,324,0,0,8,4,4,399,0,0,0.0,0.0,0.0,0,0,0,0,0,0,0,0,0,2020-12-27 19:15:00
4596,10245,Segundo Castillo,3953,[2009],Wolverhampton Wanderers,3,3,0,245,0,0,5,4,1,259,0,0,8,7,1,504,0,0,0.0,0.0,0.0,0,0,0,0,0,0,0,0,0,2020-12-27 19:15:00
4597,10246,Semi Ajayi,4061,[2014],Arsenal FC,0,0,0,0,0,0,0,0,0,0,0,0,0,0,0,0,0,0,0.0,0.0,0.0,0,0,0,0,0,0,0,0,0,2020-12-27 19:15:00
4598,10247,Semi Ajayi,4061,[2020],West Bromwich Albion,6,6,0,540,0,0,8,8,0,720,1,0,14,14,0,1260,1,0,0.0,1.0,1.0,0,1,1,0,0,0,0,0,0,2020-12-27 19:15:00
4599,40998,Serge Aurier,1863,"[2017, 2018, 2019, 2020]",Tottenham Hotspur,31,30,1,2634,2,0,35,31,4,2837,2,0,66,61,5,5471,4,0,0.0,0.0,0.0,2,0,2,0,0,0,0,0,0,2020-12-27 19:15:002020-12-27 19:15:002020-12-27 19:15:002020-12-27 19:15:00
4600,20505,Serge Gnabry,2943,"[2012, 2013]",Arsenal FC,3,2,1,161,0,0,7,3,4,331,1,0,10,5,5,492,1,0,0.0,0.0,0.0,0,1,1,0,0,0,0,0,0,2020-12-27 19:15:002020-12-27 19:15:00
4601,10254,Serge Gnabry,2943,[2015],West Bromwich Albion,1,0,1,12,0,0,0,0,0,0,0,0,1,0,1,12,0,0,0.0,0.0,0.0,0,0,0,0,0,0,0,0,0,2020-12-27 19:15:00
4602,10255,Sergey Kornilenko,3593,[2010],Blackpool FC,3,1,2,82,0,0,3,2,1,97,0,0,6,3,3,179,0,0,0.0,0.0,0.0,0,0,0,0,0,0,0,0,0,2020-12-27 19:15:00
4603,10256,Sergi Canós,4553,[2015],Liverpool FC,0,0,0,0,0,0,1,0,1,9,0,0,1,0,1,9,0,0,0.0,0.0,0.0,0,0,0,0,0,0,0,0,0,2020-12-27 19:15:00
4604,20515,Sergio Peter,3087,"[2005, 2006]",Blackburn Rovers,9,1,8,236,0,0,8,1,7,290,0,0,17,2,15,526,0,0,0.0,0.0,0.0,0,0,0,0,0,0,0,0,0,2020-12-27 19:15:002020-12-27 19:15:00
4605,10259,Sergio Rico,3913,[2018],Fulham FC,15,15,0,1350,0,0,14,14,0,1260,0,0,29,29,0,2610,0,0,0.0,0.0,0.0,0,0,0,0,0,0,0,0,0,2020-12-27 19:15:00
4606,51310,Sergio Romero,2192,"[2015, 2016, 2017, 2018, 2019]",Manchester United,3,3,0,270,0,0,4,4,0,360,0,0,7,7,0,630,0,0,0.0,0.0,0.0,0,0,0,0,0,0,0,0,0,2020-12-27 19:15:002020-12-27 19:15:002020-12-27 19:15:002020-12-27 19:15:002020-12-27 19:15:00
4607,20531,Serhiy Rebrov,2081,"[2000, 2001]",Tottenham Hotspur,31,21,10,1853,6,0,26,14,12,1345,4,0,57,35,22,3198,10,0,0.0,3.0,3.0,2,2,4,1,0,1,0,0,0,2020-12-27 19:15:002020-12-27 19:15:00
4608,10267,Seth Johnson,2292,[2000],Derby County,16,16,0,1440,0,0,11,11,0,984,1,0,27,27,0,2424,1,0,0.0,0.0,0.0,0,0,0,0,0,0,0,0,0,2020-12-27 19:15:00
4609,30807,Seth Johnson,2292,"[2001, 2002, 2003]",Leeds United,22,17,5,1512,3,0,22,18,4,1560,0,0,44,35,9,3072,3,0,3.0,0.0,3.0,2,0,2,0,0,0,0,0,0,2020-12-27 19:15:002020-12-27 19:15:002020-12-27 19:15:00
4610,10271,Seydou Doumbia,4201,[2015],Newcastle United,0,0,0,0,0,0,3,0,3,29,0,0,3,0,3,29,0,0,0.0,0.0,0.0,0,0,0,0,0,0,0,0,0,2020-12-27 19:15:00
4611,10272,Seyi Olofinjana,1614,[2008],Stoke City,8,6,2,555,2,0,10,8,2,674,0,0,18,14,4,1229,2,0,0.0,0.0,0.0,0,0,0,0,0,0,0,0,0,2020-12-27 19:15:00
4612,10273,Seyi Olofinjana,1614,[2009],Hull City,11,6,5,581,1,0,8,5,3,551,0,0,19,11,8,1132,1,0,0.0,0.0,0.0,1,0,1,0,0,0,0,0,0,2020-12-27 19:15:00
4613,10274,Shabani Nonda,3508,[2006],Blackburn Rovers,14,9,5,797,4,0,12,8,4,779,3,0,26,17,9,1576,7,0,0.0,3.0,3.0,3,2,5,0,1,1,0,0,0,2020-12-27 19:15:00
4614,30830,Shaka Hislop,1064,"[2000, 2001, 2005]",West Ham United,24,24,0,2085,0,0,28,28,0,2520,0,0,52,52,0,4605,0,0,0.0,0.0,0.0,0,0,0,0,0,0,0,0,0,2020-12-27 19:15:002020-12-27 19:15:002020-12-27 19:15:00
4615,20555,Shaka Hislop,1064,"[2003, 2004]",Portsmouth FC,25,25,0,2250,0,0,22,22,0,1980,0,0,47,47,0,4230,0,0,0.0,0.0,0.0,0,0,0,0,0,0,0,0,0,2020-12-27 19:15:002020-12-27 19:15:00
4616,30843,Shane Duffy,2429,"[2010, 2011, 2012]",Everton FC,2,1,1,91,0,0,3,1,2,122,0,0,5,2,3,213,0,0,0.0,0.0,0.0,0,0,0,0,0,0,0,0,0,2020-12-27 19:15:002020-12-27 19:15:002020-12-27 19:15:00
4617,30852,Shane Duffy,2429,"[2017, 2018, 2019]",Brighton & Hove Albion,45,43,2,3911,3,0,46,41,5,3765,3,0,91,84,7,7676,6,0,0.0,0.0,0.0,0,1,1,0,0,0,0,0,0,2020-12-27 19:15:002020-12-27 19:15:002020-12-27 19:15:00
4618,30861,Shane Ferguson,2403,"[2010, 2011, 2012]",Newcastle United,11,5,6,479,0,0,12,2,10,327,0,0,23,7,16,806,0,0,0.0,0.0,0.0,0,0,0,0,0,0,0,0,0,2020-12-27 19:15:002020-12-27 19:15:002020-12-27 19:15:00
4619,20579,Shane Long,1154,"[2006, 2007]",Reading FC,25,8,17,766,4,0,22,7,15,698,1,0,47,15,32,1464,5,0,3.0,0.0,3.0,4,0,4,0,0,0,0,0,0,2020-12-27 19:15:002020-12-27 19:15:00
4620,30876,Shane Long,1154,"[2011, 2012, 2013]",West Bromwich Albion,42,30,12,2786,11,0,39,30,9,2594,8,0,81,60,21,5380,19,0,3.0,1.0,4.0,9,4,13,1,0,1,0,0,0,2020-12-27 19:15:002020-12-27 19:15:002020-12-27 19:15:00
4621,72079,Shane Long,1154,"[2014, 2015, 2016, 2017, 2018, 2019, 2020]",Southampton FC,90,41,49,4243,18,0,93,51,42,5075,9,0,183,92,91,9318,27,0,0.0,4.0,4.0,11,6,17,0,0,0,0,0,0,2020-12-27 19:15:002020-12-27 19:15:002020-12-27 19:15:002020-12-27 19:15:002020-12-27 19:15:002020-12-27 19:15:002020-12-27 19:15:00
4622,20603,Shane Lowry,2174,"[2010, 2011]",Aston Villa,0,0,0,0,0,0,0,0,0,0,0,0,0,0,0,0,0,0,0.0,0.0,0.0,0,0,0,0,0,0,0,0,0,2020-12-27 19:15:002020-12-27 19:15:00
4623,61833,Shaun Bartlett,1675,"[2000, 2001, 2002, 2003, 2004, 2005]",Charlton Athletic,64,53,11,4323,12,0,56,39,17,3609,12,0,120,92,28,7932,24,0,0.0,15.0,15.0,8,9,17,0,0,0,0,0,0,2020-12-27 19:15:002020-12-27 19:15:002020-12-27 19:15:002020-12-27 19:15:002020-12-27 19:15:002020-12-27 19:15:00
4624,10309,Shaun Byrne,4576,[2001],West Ham United,0,0,0,0,0,0,1,0,1,13,0,0,1,0,1,13,0,0,0.0,0.0,0.0,0,0,0,0,0,0,0,0,0,2020-12-27 19:15:00
4625,10310,Shaun Cummings,1979,[2012],Reading FC,4,4,0,360,0,0,5,5,0,450,0,0,9,9,0,810,0,0,0.0,0.0,0.0,0,0,0,0,0,0,0,0,0,2020-12-27 19:15:00
4626,10311,Shaun Derry,2164,[2004],Crystal Palace,2,1,1,77,0,0,5,0,5,38,0,0,7,1,6,115,0,0,0.0,0.0,0.0,0,0,0,0,0,0,0,0,0,2020-12-27 19:15:00
4627,20625,Shaun Derry,2164,"[2011, 2012]",Queens Park Rangers,24,17,7,1690,1,0,23,21,2,1702,0,0,47,38,9,3392,1,0,0.0,0.0,0.0,0,0,0,0,0,0,0,0,0,2020-12-27 19:15:002020-12-27 19:15:00
4628,20629,Shaun Goater,3203,"[2000, 2002]",Manchester City,28,20,8,1730,6,0,22,12,10,1170,7,0,50,32,18,2900,13,0,1.0,8.0,9.0,4,6,10,0,0,0,0,0,0,2020-12-27 19:15:002020-12-27 19:15:00
4629,10316,Shaun MacDonald,1017,[2015],AFC Bournemouth,0,0,0,0,0,0,3,0,3,29,0,0,3,0,3,29,0,0,0.0,0.0,0.0,0,0,0,0,0,0,0,0,0,2020-12-27 19:15:00
4630,20635,Shaun Maloney,2738,"[2006, 2007]",Aston Villa,14,5,9,573,1,0,16,11,5,872,4,0,30,16,14,1445,5,0,3.0,1.0,4.0,1,2,3,0,0,0,0,0,0,2020-12-27 19:15:002020-12-27 19:15:00
4631,20639,Shaun Maloney,2738,"[2011, 2012]",Wigan Athletic,24,22,2,1867,4,0,25,20,5,1850,5,0,49,42,7,3717,9,0,4.0,1.0,5.0,3,4,7,1,1,2,0,0,0,2020-12-27 19:15:002020-12-27 19:15:00
4632,10321,Shaun Maloney,2738,[2016],Hull City,4,1,3,147,0,0,5,1,4,131,1,0,9,2,7,278,1,0,0.0,0.0,0.0,0,1,1,0,0,0,0,0,0,2020-12-27 19:15:00
4633,10322,Shaun Newton,2862,[2000],Charlton Athletic,5,1,4,129,0,0,5,0,5,91,0,0,10,1,9,220,0,0,0.0,0.0,0.0,0,0,0,0,0,0,0,0,0,2020-12-27 19:15:00
4634,10323,Shaun Newton,2862,[2003],Wolverhampton Wanderers,15,11,4,973,0,0,13,9,4,744,0,0,28,20,8,1717,0,0,0.0,0.0,0.0,0,0,0,0,0,0,0,0,0,2020-12-27 19:15:00
4635,20649,Shaun Newton,2862,"[2005, 2006]",West Ham United,12,2,10,285,1,0,16,5,11,616,0,0,28,7,21,901,1,0,3.0,0.0,3.0,1,0,1,0,0,0,0,0,0,2020-12-27 19:15:002020-12-27 19:15:00
4636,72312,Shaun Wright-Phillips,1683,"[2000, 2002, 2003, 2004, 2008, 2009, 2010]",Manchester City,93,75,18,6903,17,0,75,60,15,5564,10,0,168,135,33,12467,27,0,1.0,1.0,2.0,5,6,11,0,0,0,0,0,0,2020-12-27 19:15:002020-12-27 19:15:002020-12-27 19:15:002020-12-27 19:15:002020-12-27 19:15:002020-12-27 19:15:002020-12-27 19:15:00
4637,30993,Shaun Wright-Phillips,1683,"[2005, 2006, 2007]",Chelsea FC,41,24,17,2104,1,0,40,19,21,1823,3,0,81,43,38,3927,4,0,0.0,0.0,0.0,0,2,2,0,0,0,0,0,0,2020-12-27 19:15:002020-12-27 19:15:002020-12-27 19:15:00
4638,31011,Shaun Wright-Phillips,1683,"[2011, 2012, 2014]",Queens Park Rangers,27,20,7,1712,0,0,29,19,10,1875,1,0,56,39,17,3587,1,0,0.0,3.0,3.0,0,1,1,0,0,0,0,0,0,2020-12-27 19:15:002020-12-27 19:15:002020-12-27 19:15:00
4639,82740,Shay Given,1581,"[2000, 2001, 2002, 2003, 2004, 2005, 2006, 2007]",Newcastle United,129,129,0,11475,0,0,123,123,0,10985,0,0,252,252,0,22460,0,0,0.0,0.0,0.0,0,0,0,0,0,0,0,0,0,2020-12-27 19:15:002020-12-27 19:15:002020-12-27 19:15:002020-12-27 19:15:002020-12-27 19:15:002020-12-27 19:15:002020-12-27 19:15:002020-12-27 19:15:00
4640,31044,Shay Given,1581,"[2008, 2009, 2010]",Manchester City,24,24,0,2160,0,0,25,25,0,2233,0,0,49,49,0,4393,0,0,0.0,0.0,0.0,0,0,0,0,0,0,0,0,0,2020-12-27 19:15:002020-12-27 19:15:002020-12-27 19:15:00
4641,31053,Shay Given,1581,"[2011, 2012, 2014]",Aston Villa,19,19,0,1658,0,0,18,18,0,1620,0,0,37,37,0,3278,0,0,0.0,0.0,0.0,0,0,0,0,0,0,0,0,0,2020-12-27 19:15:002020-12-27 19:15:002020-12-27 19:15:00
4642,20707,Shay Given,1581,"[2015, 2016]",Stoke City,4,4,0,360,0,0,4,4,0,316,0,0,8,8,0,676,0,0,0.0,0.0,0.0,0,0,0,0,0,0,0,0,0,2020-12-27 19:15:002020-12-27 19:15:00
4643,10355,Shay Logan,4568,[2008],Manchester City,0,0,0,0,0,0,1,1,0,90,0,0,1,1,0,90,0,0,0.0,0.0,0.0,0,0,0,0,0,0,0,0,0,2020-12-27 19:15:00
4644,20713,Shefki Kuqi,2013,"[2005, 2006]",Blackburn Rovers,16,6,10,805,5,0,18,9,9,857,2,0,34,15,19,1662,7,0,4.0,0.0,4.0,3,1,4,0,0,0,0,0,0,2020-12-27 19:15:002020-12-27 19:15:00
4645,10358,Shefki Kuqi,2013,[2007],Fulham FC,5,0,5,98,0,0,5,3,2,307,0,0,10,3,7,405,0,0,0.0,0.0,0.0,0,0,0,0,0,0,0,0,0,2020-12-27 19:15:00
4646,10359,Shefki Kuqi,2013,[2010],Newcastle United,2,0,2,6,0,0,4,0,4,17,0,0,6,0,6,23,0,0,0.0,0.0,0.0,0,0,0,0,0,0,0,0,0,2020-12-27 19:15:00
4647,10360,Shelton Martis,3389,[2008],West Bromwich Albion,5,4,1,370,0,0,2,2,0,180,0,0,7,6,1,550,0,0,0.0,0.0,0.0,0,0,0,0,0,0,0,0,0,2020-12-27 19:15:00
4648,10361,Sherjill MacDonald,4036,[2008],West Bromwich Albion,2,0,2,30,0,0,3,0,3,128,0,0,5,0,5,158,0,0,0.0,0.0,0.0,0,0,0,0,0,0,0,0,0,2020-12-27 19:15:00
4649,20725,Sheyi Ojo,3626,"[2014, 2015]",Liverpool FC,4,2,2,133,0,0,4,3,1,264,0,0,8,5,3,397,0,0,0.0,0.0,0.0,0,0,0,0,0,0,0,0,0,2020-12-27 19:15:002020-12-27 19:15:00
4650,31095,Shinji Kagawa,2321,"[2012, 2013, 2014]",Manchester United,20,16,4,1296,5,0,18,15,3,1200,1,0,38,31,7,2496,6,0,0.0,0.0,0.0,2,1,3,0,0,0,0,0,0,2020-12-27 19:15:002020-12-27 19:15:002020-12-27 19:15:00
4651,41474,Shinji Okazaki,2668,"[2015, 2016, 2017, 2018]",Leicester City,60,32,28,2562,4,0,54,35,19,2684,10,0,114,67,47,5246,14,0,3.0,0.0,3.0,2,3,5,0,0,0,0,0,0,2020-12-27 19:15:002020-12-27 19:15:002020-12-27 19:15:002020-12-27 19:15:00
4652,20743,Shkodran Mustafi,1483,"[2010, 2011]",Everton FC,0,0,0,0,0,0,0,0,0,0,0,0,0,0,0,0,0,0,0.0,0.0,0.0,0,0,0,0,0,0,0,0,0,2020-12-27 19:15:002020-12-27 19:15:00
4653,51875,Shkodran Mustafi,1483,"[2016, 2017, 2018, 2019, 2020]",Arsenal FC,51,47,4,4095,4,0,51,48,3,4321,3,0,102,95,7,8416,7,0,1.0,0.0,1.0,4,3,7,0,0,0,0,0,0,2020-12-27 19:15:002020-12-27 19:15:002020-12-27 19:15:002020-12-27 19:15:002020-12-27 19:15:00
4654,134992,Shola Ameobi,1950,"[2000, 2001, 2002, 2003, 2004, 2005, 2006, 2007, 2008, 2010, 2011, 2012, 2013]",Newcastle United,147,80,67,7521,31,0,134,72,62,6813,12,0,281,152,129,14334,43,0,9.0,6.0,15.0,20,7,27,5,0,5,0,0,0,2020-12-27 19:15:002020-12-27 19:15:002020-12-27 19:15:002020-12-27 19:15:002020-12-27 19:15:002020-12-27 19:15:002020-12-27 19:15:002020-12-27 19:15:002020-12-27 19:15:002020-12-27 19:15:002020-12-27 19:15:002020-12-27 19:15:002020-12-27 19:15:00
4655,10391,Shola Ameobi,1950,[2014],Crystal Palace,1,0,1,10,0,0,3,0,3,28,0,0,4,0,4,38,0,0,0.0,0.0,0.0,0,0,0,0,0,0,0,0,0,2020-12-27 19:15:00
4656,20785,Siem de Jong,2633,"[2014, 2015]",Newcastle United,12,3,9,336,1,0,10,1,9,257,0,0,22,4,18,593,1,0,0.0,0.0,0.0,0,0,0,0,0,0,0,0,0,2020-12-27 19:15:002020-12-27 19:15:00
4657,10394,Silas,3272,[2003],Wolverhampton Wanderers,3,1,2,74,0,0,6,1,5,168,0,0,9,2,7,242,0,0,0.0,0.0,0.0,0,0,0,0,0,0,0,0,0,2020-12-27 19:15:00
4658,20791,Simeon Jackson,3047,"[2011, 2012]",Norwich City,19,10,9,786,3,0,16,5,11,561,1,0,35,15,20,1347,4,0,1.0,0.0,1.0,2,1,3,0,0,0,0,0,0,2020-12-27 19:15:002020-12-27 19:15:00
4659,20795,Simo Valakari,3359,"[2000, 2001]",Derby County,10,8,2,738,1,0,9,6,3,604,0,0,19,14,5,1342,1,0,0.0,0.0,0.0,0,0,0,0,0,0,0,0,0,2020-12-27 19:15:002020-12-27 19:15:00
4660,31200,Simon Charlton,2388,"[2001, 2002, 2003]",Bolton Wanderers,48,44,4,3817,0,0,50,46,4,4079,0,0,98,90,8,7896,0,0,0.0,0.0,0.0,0,0,0,0,0,0,0,0,0,2020-12-27 19:15:002020-12-27 19:15:002020-12-27 19:15:00
4661,10402,Simon Charlton,2388,[2004],Norwich City,11,10,1,791,1,0,12,11,1,997,0,0,23,21,2,1788,1,0,1.0,0.0,1.0,1,0,1,0,0,0,0,0,0,2020-12-27 19:15:00
4662,10403,Simon Church,4425,[2012],Reading FC,0,0,0,0,0,0,0,0,0,0,0,0,0,0,0,0,0,0,0.0,0.0,0.0,0,0,0,0,0,0,0,0,0,2020-12-27 19:15:00
4663,20809,Simon Cox,1741,"[2010, 2011]",West Bromwich Albion,17,7,10,766,0,0,20,8,12,759,1,0,37,15,22,1525,1,0,0.0,1.0,1.0,0,1,1,0,0,0,0,0,0,2020-12-27 19:15:002020-12-27 19:15:00
4664,52040,Simon Davies,1125,"[2000, 2001, 2002, 2003, 2004]",Tottenham Hotspur,57,50,7,4503,9,0,56,44,12,4098,4,0,113,94,19,8601,13,0,3.0,3.0,6.0,3,4,7,0,0,0,0,0,0,2020-12-27 19:15:002020-12-27 19:15:002020-12-27 19:15:002020-12-27 19:15:002020-12-27 19:15:00
4665,10411,Simon Davies,1125,[2005],Everton FC,15,12,3,920,0,0,14,9,5,839,1,0,29,21,8,1759,1,0,0.0,3.0,3.0,0,1,1,0,0,0,0,0,0,2020-12-27 19:15:00
4666,72905,Simon Davies,1125,"[2006, 2007, 2008, 2009, 2010, 2011, 2012]",Fulham FC,69,59,10,5181,6,0,61,57,4,5064,7,0,130,116,14,10245,13,0,0.0,0.0,0.0,6,5,11,0,0,0,0,0,0,2020-12-27 19:15:002020-12-27 19:15:002020-12-27 19:15:002020-12-27 19:15:002020-12-27 19:15:002020-12-27 19:15:002020-12-27 19:15:00
4667,10419,Simon Dawkins,2979,[2012],Aston Villa,2,0,2,32,0,0,2,0,2,40,0,0,4,0,4,72,0,0,0.0,0.0,0.0,0,0,0,0,0,0,0,0,0,2020-12-27 19:15:00
4668,10420,Simon Elliott,3653,[2005],Fulham FC,6,6,0,508,0,0,6,6,0,493,0,0,12,12,0,1001,0,0,0.0,0.0,0.0,0,0,0,0,0,0,0,0,0,2020-12-27 19:15:00
4669,52115,Simon Francis,1001,"[2015, 2016, 2017, 2018, 2019]",AFC Bournemouth,70,67,3,5936,0,0,66,59,7,5428,0,0,136,126,10,11364,0,0,0.0,0.0,0.0,0,0,0,0,0,0,0,0,0,2020-12-27 19:15:002020-12-27 19:15:002020-12-27 19:15:002020-12-27 19:15:002020-12-27 19:15:00
4670,20853,Simon Johnson,2780,"[2002, 2003]",Leeds United,5,3,2,266,0,0,5,0,5,54,0,0,10,3,7,320,0,0,0.0,0.0,0.0,0,0,0,0,0,0,0,0,0,2020-12-27 19:15:002020-12-27 19:15:00
4671,20857,Simon Lappin,4264,"[2011, 2012]",Norwich City,2,2,0,136,0,0,2,2,0,156,0,0,4,4,0,292,0,0,0.0,0.0,0.0,0,0,0,0,0,0,0,0,0,2020-12-27 19:15:002020-12-27 19:15:00
4672,31293,Simon Mignolet,1191,"[2010, 2011, 2012]",Sunderland AFC,44,44,0,3922,0,0,46,46,0,4140,0,0,90,90,0,8062,0,0,0.0,0.0,0.0,0,0,0,0,0,0,0,0,0,2020-12-27 19:15:002020-12-27 19:15:002020-12-27 19:15:00
4673,62613,Simon Mignolet,1191,"[2013, 2014, 2015, 2016, 2017, 2018]",Liverpool FC,77,77,0,6930,0,0,77,76,1,6914,0,0,154,153,1,13844,0,0,0.0,0.0,0.0,0,0,0,0,0,0,0,0,0,2020-12-27 19:15:002020-12-27 19:15:002020-12-27 19:15:002020-12-27 19:15:002020-12-27 19:15:002020-12-27 19:15:00
4674,10439,Simon Moore,3602,[2013],Cardiff City,0,0,0,0,0,0,0,0,0,0,0,0,0,0,0,0,0,0,0.0,0.0,0.0,0,0,0,0,0,0,0,0,0,2020-12-27 19:15:00
4675,10440,Simon Moore,3602,[2019],Sheffield United,1,1,0,90,0,0,1,1,0,90,0,0,2,2,0,180,0,0,0.0,0.0,0.0,0,0,0,0,0,0,0,0,0,2020-12-27 19:15:00
4676,10441,Simon Royce,2832,[2000],Leicester City,8,7,1,674,0,0,11,9,2,869,0,0,19,16,3,1543,0,0,0.0,0.0,0.0,0,0,0,0,0,0,0,0,0,2020-12-27 19:15:00
4677,10442,Simon Royce,2832,[2003],Charlton Athletic,1,1,0,90,0,0,0,0,0,0,0,0,1,1,0,90,0,0,0.0,0.0,0.0,0,0,0,0,0,0,0,0,0,2020-12-27 19:15:00
4678,10443,Simon Vukčević,3427,[2011],Blackburn Rovers,5,3,2,272,0,0,2,1,1,105,1,0,7,4,3,377,1,0,0.0,0.0,0.0,0,1,1,0,0,0,0,0,0,2020-12-27 19:15:00
4679,10444,Simone Zaza,2787,[2016],West Ham United,4,3,1,280,0,0,4,2,2,180,0,0,8,5,3,460,0,0,0.0,0.0,0.0,0,0,0,0,0,0,0,0,0,2020-12-27 19:15:00
4680,10445,Sixto Peralta,3378,[2001],Ipswich Town,11,8,3,779,1,0,11,8,3,696,2,0,22,16,6,1475,3,0,0.0,0.0,0.0,0,1,1,0,0,0,0,0,0,2020-12-27 19:15:00
4681,20893,Slaviša Jokanović,3057,"[2000, 2001]",Chelsea FC,17,6,11,745,0,0,21,13,8,1121,0,0,38,19,19,1866,0,0,0.0,0.0,0.0,0,0,0,0,0,0,0,0,0,2020-12-27 19:15:002020-12-27 19:15:00
4682,31347,Sofiane Boufal,1912,"[2016, 2017, 2019]",Southampton FC,35,16,19,1628,2,0,35,15,20,1447,1,0,70,31,39,3075,3,0,6.0,0.0,6.0,2,0,2,0,0,0,0,0,0,2020-12-27 19:15:002020-12-27 19:15:002020-12-27 19:15:00
4683,10451,Sofiane Féghouli,2788,[2016],West Ham United,10,5,5,524,2,0,11,6,5,589,1,0,21,11,10,1113,3,0,0.0,0.0,0.0,2,1,3,0,0,0,0,0,0,2020-12-27 19:15:00
4684,20905,Sokratis Papastathopoulos,2215,"[2018, 2019]",Arsenal FC,24,24,0,2109,2,0,20,20,0,1787,1,0,44,44,0,3896,3,0,0.0,0.0,0.0,1,0,1,0,0,0,0,0,0,2020-12-27 19:15:002020-12-27 19:15:00
4685,10454,Sol Bamba,3145,[2018],Cardiff City,14,14,0,1260,2,0,14,14,0,1215,2,0,28,28,0,2475,4,0,3.0,0.0,3.0,1,2,3,0,0,0,0,0,0,2020-12-27 19:15:00
4686,10455,Sol Campbell,1388,[2000],Tottenham Hotspur,10,10,0,900,1,0,9,9,0,810,1,0,19,19,0,1710,2,0,3.0,0.0,3.0,1,1,2,0,0,0,0,0,0,2020-12-27 19:15:00
4687,62754,Sol Campbell,1388,"[2001, 2002, 2003, 2004, 2005, 2009]",Arsenal FC,68,68,0,6065,5,0,76,73,3,6631,3,0,144,141,3,12696,8,0,0.0,3.0,3.0,4,1,5,0,0,0,0,0,0,2020-12-27 19:15:002020-12-27 19:15:002020-12-27 19:15:002020-12-27 19:15:002020-12-27 19:15:002020-12-27 19:15:00
4688,31386,Sol Campbell,1388,"[2006, 2007, 2008]",Portsmouth FC,45,45,0,4006,1,0,49,49,0,4410,1,0,94,94,0,8416,2,0,0.0,0.0,0.0,1,1,2,0,0,0,0,0,0,2020-12-27 19:15:002020-12-27 19:15:002020-12-27 19:15:00
4689,10465,Sol Campbell,1388,[2010],Newcastle United,2,2,0,180,0,0,5,2,3,226,0,0,7,4,3,406,0,0,0.0,0.0,0.0,0,0,0,0,0,0,0,0,0,2020-12-27 19:15:00
4690,20933,Soldado,1173,"[2013, 2014]",Tottenham Hotspur,27,15,12,1417,5,0,25,14,11,1309,2,0,52,29,23,2726,7,0,12.0,3.0,15.0,5,1,6,3,1,4,0,0,0,2020-12-27 19:15:002020-12-27 19:15:00
4691,41878,Solly March,2422,"[2017, 2018, 2019, 2020]",Brighton & Hove Albion,49,33,16,3047,2,0,55,40,15,3614,2,0,104,73,31,6661,4,0,0.0,3.0,3.0,1,2,3,0,0,0,0,0,0,2020-12-27 19:15:002020-12-27 19:15:002020-12-27 19:15:002020-12-27 19:15:00
4692,20945,Somen Tchoyi,1739,"[2010, 2011]",West Bromwich Albion,20,6,14,636,1,0,21,7,14,828,6,0,41,13,28,1464,7,0,0.0,3.0,3.0,1,3,4,0,0,0,0,0,0,2020-12-27 19:15:002020-12-27 19:15:00
4693,20949,Sone Aluko,2233,"[2013, 2014]",Hull City,21,11,10,1050,0,0,21,12,9,1128,2,0,42,23,19,2178,2,0,0.0,4.0,4.0,0,2,2,0,0,0,0,0,0,2020-12-27 19:15:002020-12-27 19:15:00
4694,20953,Sotirios Kyrgiakos,3170,"[2009, 2010]",Liverpool FC,15,11,4,1173,2,0,15,12,3,1155,1,0,30,23,7,2328,3,0,0.0,0.0,0.0,1,1,2,0,0,0,0,0,0,2020-12-27 19:15:002020-12-27 19:15:00
4695,10478,Sotirios Kyrgiakos,3170,[2011],Sunderland AFC,1,1,0,90,0,0,2,1,1,99,0,0,3,2,1,189,0,0,0.0,0.0,0.0,0,0,0,0,0,0,0,0,0,2020-12-27 19:15:00
4696,10479,Souleymane Diawara,4072,[2006],Charlton Athletic,12,9,3,884,0,0,11,9,2,765,0,0,23,18,5,1649,0,0,0.0,0.0,0.0,0,0,0,0,0,0,0,0,0,2020-12-27 19:15:00
4697,10480,Spencer Prior,3311,[2000],Manchester City,8,8,0,720,0,0,11,8,3,773,1,0,19,16,3,1493,1,0,0.0,0.0,0.0,0,1,1,0,0,0,0,0,0,2020-12-27 19:15:00
4698,10481,Stan Collymore,2843,[2000],Bradford City,4,4,0,341,2,0,3,1,2,120,0,0,7,5,2,461,2,0,0.0,0.0,0.0,2,0,2,0,0,0,0,0,0,2020-12-27 19:15:00
4699,41934,Stan Lazaridis,2624,"[2002, 2003, 2004, 2005]",Birmingham City,50,38,12,3446,3,0,46,29,17,2881,1,0,96,67,29,6327,4,0,0.0,0.0,0.0,0,1,1,0,0,0,0,0,0,2020-12-27 19:15:002020-12-27 19:15:002020-12-27 19:15:002020-12-27 19:15:00
4700,10486,Stanislav Manolev,4005,[2012],Fulham FC,1,1,0,90,0,0,4,3,1,340,0,0,5,4,1,430,0,0,0.0,0.0,0.0,0,0,0,0,0,0,0,0,0,2020-12-27 19:15:00
4701,20975,Stanislav Varga,1091,"[2000, 2001]",Sunderland AFC,10,7,3,674,0,0,9,9,0,739,1,0,19,16,3,1413,1,0,0.0,0.0,0.0,0,1,1,0,0,0,0,0,0,2020-12-27 19:15:002020-12-27 19:15:00
4702,10489,Stathis Tavlaridis,4573,[2002],Arsenal FC,1,0,1,15,0,0,0,0,0,0,0,0,1,0,1,15,0,0,0.0,0.0,0.0,0,0,0,0,0,0,0,0,0,2020-12-27 19:15:00
4703,52460,Steed Malbranque,1086,"[2001, 2002, 2003, 2004, 2005]",Fulham FC,84,78,6,6959,17,0,75,69,6,6075,15,0,159,147,12,13034,32,0,12.0,6.0,18.0,13,8,21,5,1,6,0,0,0,2020-12-27 19:15:002020-12-27 19:15:002020-12-27 19:15:002020-12-27 19:15:002020-12-27 19:15:00
4704,20991,Steed Malbranque,1086,"[2006, 2007]",Tottenham Hotspur,30,26,4,2113,5,0,31,26,5,2236,1,0,61,52,9,4349,6,0,1.0,1.0,2.0,3,1,4,0,0,0,0,0,0,2020-12-27 19:15:002020-12-27 19:15:00
4705,31494,Steed Malbranque,1086,"[2008, 2009, 2010]",Sunderland AFC,50,43,7,3610,0,0,52,45,7,3337,1,0,102,88,14,6947,1,0,0.0,0.0,0.0,0,1,1,0,0,0,0,0,0,2020-12-27 19:15:002020-12-27 19:15:002020-12-27 19:15:00
4706,21001,Stefan Johansen,3912,"[2018, 2020]",Fulham FC,5,1,4,130,0,0,7,3,4,282,0,0,12,4,8,412,0,0,0.0,0.0,0.0,0,0,0,0,0,0,0,0,0,2020-12-27 19:15:002020-12-27 19:15:00
4707,21005,Stefan Maierhofer,3954,"[2009, 2011]",Wolverhampton Wanderers,3,0,3,40,0,0,6,1,5,140,1,0,9,1,8,180,1,0,0.0,0.0,0.0,0,0,0,0,0,0,0,0,0,2020-12-27 19:15:002020-12-27 19:15:00
4708,10504,Stefan Malz,4540,[2000],Arsenal FC,0,0,0,0,0,0,1,0,1,17,0,0,1,0,1,17,0,0,0.0,0.0,0.0,0,0,0,0,0,0,0,0,0,2020-12-27 19:15:00
4709,31518,Stefan Moore,3065,"[2002, 2003, 2004]",Aston Villa,15,3,12,338,1,0,14,6,8,569,1,0,29,9,20,907,2,0,0.0,0.0,0.0,0,1,1,0,0,0,0,0,0,2020-12-27 19:15:002020-12-27 19:15:002020-12-27 19:15:00
4710,21017,Stefan Oakes,1313,"[2000, 2001]",Leicester City,17,11,6,1005,0,0,16,9,7,970,1,0,33,20,13,1975,1,0,0.0,0.0,0.0,0,0,0,0,0,0,0,0,0,2020-12-27 19:15:002020-12-27 19:15:00
4711,31533,Stefan Postma,3271,"[2002, 2003, 2004]",Aston Villa,6,3,3,397,0,0,5,4,1,404,0,0,11,7,4,801,0,0,0.0,0.0,0.0,0,0,0,0,0,0,0,0,0,2020-12-27 19:15:002020-12-27 19:15:002020-12-27 19:15:00
4712,21027,Stefan Savić,3300,"[2011, 2012]",Manchester City,6,2,4,246,0,0,5,3,2,296,1,0,11,5,6,542,1,0,0.0,0.0,0.0,0,0,0,0,0,0,0,0,0,2020-12-27 19:15:002020-12-27 19:15:00
4713,10515,Stefan Schnoor,4164,[2000],Derby County,4,4,0,360,0,0,4,2,2,201,0,0,8,6,2,561,0,0,0.0,0.0,0.0,0,0,0,0,0,0,0,0,0,2020-12-27 19:15:00
4714,21033,Stefan Schwarz,1098,"[2000, 2001]",Sunderland AFC,18,16,2,1371,2,0,19,16,3,1423,0,0,37,32,5,2794,2,0,1.0,0.0,1.0,1,0,1,0,0,0,0,0,0,2020-12-27 19:15:002020-12-27 19:15:00
4715,10518,Stefan Wessels,4427,[2007],Everton FC,1,1,0,90,0,0,1,1,0,90,0,0,2,2,0,180,0,0,0.0,0.0,0.0,0,0,0,0,0,0,0,0,0,2020-12-27 19:15:00
4716,10519,Stefano Eranio,3373,[2000],Derby County,14,13,1,1045,2,0,11,9,2,641,0,0,25,22,3,1686,2,0,0.0,0.0,0.0,1,0,1,0,0,0,0,0,0,2020-12-27 19:15:00
4717,10520,Stefano Okaka,2333,[2009],Fulham FC,6,1,5,191,2,0,5,2,3,252,0,0,11,3,8,443,2,0,0.0,0.0,0.0,1,0,1,0,0,0,0,0,0,2020-12-27 19:15:00
4718,31566,Stefano Okaka,2333,"[2016, 2017, 2018]",Watford FC,20,8,12,859,4,0,16,5,11,563,1,0,36,13,23,1422,5,0,0.0,0.0,0.0,3,1,4,0,0,0,0,0,0,2020-12-27 19:15:002020-12-27 19:15:002020-12-27 19:15:00
4719,31575,Steffen Freund,2079,"[2000, 2001, 2002]",Tottenham Hotspur,27,23,4,2000,0,0,29,26,3,2385,0,0,56,49,7,4385,0,0,0.0,0.0,0.0,0,0,0,0,0,0,0,0,0,2020-12-27 19:15:002020-12-27 19:15:002020-12-27 19:15:00
4720,10527,Steffen Freund,2079,[2003],Leicester City,6,6,0,499,0,0,8,7,1,591,0,0,14,13,1,1090,0,0,0.0,0.0,0.0,0,0,0,0,0,0,0,0,0,2020-12-27 19:15:00
4721,31587,Steffen Iversen,2080,"[2000, 2001, 2002]",Tottenham Hotspur,21,9,12,1061,5,0,28,19,9,1705,2,0,49,28,21,2766,7,0,1.0,0.0,1.0,5,2,7,0,0,0,0,0,0,2020-12-27 19:15:002020-12-27 19:15:002020-12-27 19:15:00
4722,10531,Steffen Iversen,2080,[2003],Wolverhampton Wanderers,9,7,2,563,3,0,7,4,3,315,1,0,16,11,5,878,4,0,1.0,0.0,1.0,2,0,2,0,0,0,0,0,0,2020-12-27 19:15:00
4723,21065,Stephan Andersen,3225,"[2004, 2005]",Charlton Athletic,8,8,0,720,0,0,8,8,0,720,0,0,16,16,0,1440,0,0,0.0,0.0,0.0,0,0,0,0,0,0,0,0,0,2020-12-27 19:15:002020-12-27 19:15:00
4724,10534,Stephan Lichtsteiner,3699,[2018],Arsenal FC,7,5,2,408,0,0,7,5,2,532,0,0,14,10,4,940,0,0,0.0,0.0,0.0,0,0,0,0,0,0,0,0,0,2020-12-27 19:15:00
4725,21071,Stephen Bywater,1568,"[2000, 2005]",West Ham United,1,0,1,30,0,0,1,1,0,90,0,0,2,1,1,120,0,0,0.0,0.0,0.0,0,0,0,0,0,0,0,0,0,2020-12-27 19:15:002020-12-27 19:15:00
4726,10537,Stephen Bywater,1568,[2007],Derby County,8,8,0,720,0,0,10,10,0,900,0,0,18,18,0,1620,0,0,0.0,0.0,0.0,0,0,0,0,0,0,0,0,0,2020-12-27 19:15:00
4727,31617,Stephen Carr,1780,"[2000, 2002, 2003]",Tottenham Hotspur,45,45,0,3981,2,0,44,43,1,3810,2,0,89,88,1,7791,4,0,0.0,0.0,0.0,2,1,3,0,0,0,0,0,0,2020-12-27 19:15:002020-12-27 19:15:002020-12-27 19:15:00
4728,42170,Stephen Carr,1780,"[2004, 2005, 2006, 2007]",Newcastle United,38,37,1,3195,0,0,38,37,1,3194,1,0,76,74,2,6389,1,0,0.0,3.0,3.0,0,1,1,0,0,0,0,0,0,2020-12-27 19:15:002020-12-27 19:15:002020-12-27 19:15:002020-12-27 19:15:00
4729,21091,Stephen Carr,1780,"[2009, 2010]",Birmingham City,36,36,0,3214,0,0,37,37,0,3273,0,0,73,73,0,6487,0,0,0.0,0.0,0.0,0,0,0,0,0,0,0,0,0,2020-12-27 19:15:002020-12-27 19:15:00
4730,21095,Stephen Clemence,1516,"[2000, 2001]",Tottenham Hotspur,17,15,2,1384,0,0,14,12,2,997,1,0,31,27,4,2381,1,0,0.0,0.0,0.0,0,0,0,0,0,0,0,0,0,2020-12-27 19:15:002020-12-27 19:15:00
4731,42202,Stephen Clemence,1516,"[2002, 2003, 2004, 2005]",Birmingham City,45,38,7,3144,4,0,42,35,7,3105,0,0,87,73,14,6249,4,0,0.0,0.0,0.0,3,0,3,0,0,0,0,0,0,2020-12-27 19:15:002020-12-27 19:15:002020-12-27 19:15:002020-12-27 19:15:00
4732,10553,Stephen Crainey,3162,[2003],Southampton FC,1,1,0,90,0,0,4,4,0,350,0,0,5,5,0,440,0,0,0.0,0.0,0.0,0,0,0,0,0,0,0,0,0,2020-12-27 19:15:00
4733,10554,Stephen Crainey,3162,[2010],Blackpool FC,15,15,0,1309,0,0,16,16,0,1440,0,0,31,31,0,2749,0,0,0.0,0.0,0.0,0,0,0,0,0,0,0,0,0,2020-12-27 19:15:00
4734,10555,Stephen Darby,4459,[2009],Liverpool FC,1,0,1,1,0,0,0,0,0,0,0,0,1,0,1,1,0,0,0.0,0.0,0.0,0,0,0,0,0,0,0,0,0,2020-12-27 19:15:00
4735,21113,Stephen Dobbie,3175,"[2011, 2012]",Swansea City,4,1,3,128,0,0,4,1,3,130,0,0,8,2,6,258,0,0,0.0,0.0,0.0,0,0,0,0,0,0,0,0,0,2020-12-27 19:15:002020-12-27 19:15:00
4736,10558,Stephen Dobbie,3175,[2013],Crystal Palace,1,1,0,66,0,0,0,0,0,0,0,0,1,1,0,66,0,0,0.0,0.0,0.0,0,0,0,0,0,0,0,0,0,2020-12-27 19:15:00
4737,10559,Stephen Elliott,3224,[2003],Manchester City,0,0,0,0,0,0,2,0,2,18,0,0,2,0,2,18,0,0,0.0,0.0,0.0,0,0,0,0,0,0,0,0,0,2020-12-27 19:15:00
4738,10560,Stephen Elliott,3224,[2005],Sunderland AFC,7,6,1,514,1,0,8,5,3,549,1,0,15,11,4,1063,2,0,0.0,0.0,0.0,0,1,1,0,0,0,0,0,0,2020-12-27 19:15:00
4739,10561,Stephen Glass,3888,[2000],Newcastle United,8,4,4,441,3,0,6,1,5,127,0,0,14,5,9,568,3,0,1.0,0.0,1.0,2,0,2,0,0,0,0,0,0,2020-12-27 19:15:00
4740,10562,Stephen Henderson,2314,[2012],West Ham United,0,0,0,0,0,0,0,0,0,0,0,0,0,0,0,0,0,0,0.0,0.0,0.0,0,0,0,0,0,0,0,0,0,2020-12-27 19:15:00
4741,21127,Stephen Henderson,2314,"[2019, 2020]",Crystal Palace,0,0,0,0,0,0,0,0,0,0,0,0,0,0,0,0,0,0,0.0,0.0,0.0,0,0,0,0,0,0,0,0,0,2020-12-27 19:15:002020-12-27 19:15:00
4742,10565,Stephen Hendrie,3698,[2015],West Ham United,0,0,0,0,0,0,0,0,0,0,0,0,0,0,0,0,0,0,0.0,0.0,0.0,0,0,0,0,0,0,0,0,0,2020-12-27 19:15:00
4743,21133,Stephen Howey,3305,"[2000, 2002]",Manchester City,27,27,0,2387,5,0,29,29,0,2413,3,0,56,56,0,4800,8,0,0.0,2.0,2.0,3,3,6,0,0,0,0,0,0,2020-12-27 19:15:002020-12-27 19:15:00
4744,10568,Stephen Howey,3305,[2003],Leicester City,6,6,0,466,1,0,7,7,0,501,0,0,13,13,0,967,1,0,0.0,0.0,0.0,0,0,0,0,0,0,0,0,0,2020-12-27 19:15:00
4745,10569,Stephen Hughes,3769,[2000],Everton FC,11,9,2,805,0,0,7,7,0,546,0,0,18,16,2,1351,0,0,0.0,0.0,0.0,0,0,0,0,0,0,0,0,0,2020-12-27 19:15:00
4746,21141,Stephen Hunt,2596,"[2006, 2007]",Reading FC,37,35,2,3099,6,0,32,27,5,2377,3,0,69,62,7,5476,9,0,9.0,1.0,10.0,4,1,5,1,1,2,0,0,0,2020-12-27 19:15:002020-12-27 19:15:00
4747,10572,Stephen Hunt,2596,[2009],Hull City,13,13,0,1150,3,0,14,14,0,1173,3,0,27,27,0,2323,6,0,0.0,1.0,1.0,2,2,4,1,0,1,0,0,0,2020-12-27 19:15:00
4748,21147,Stephen Hunt,2596,"[2010, 2011]",Wolverhampton Wanderers,20,16,4,1426,4,0,24,14,10,1308,2,0,44,30,14,2734,6,0,3.0,0.0,3.0,3,1,4,1,2,3,0,0,0,2020-12-27 19:15:002020-12-27 19:15:00
4749,52885,Stephen Ireland,1809,"[2005, 2006, 2007, 2008, 2009]",Manchester City,70,59,11,5064,8,0,64,47,17,4305,8,0,134,106,28,9369,16,0,6.0,4.0,10.0,7,6,13,0,0,0,0,0,0,2020-12-27 19:15:002020-12-27 19:15:002020-12-27 19:15:002020-12-27 19:15:002020-12-27 19:15:00
4750,31743,Stephen Ireland,1809,"[2010, 2011, 2012]",Aston Villa,23,15,8,1341,0,0,22,18,4,1410,1,0,45,33,12,2751,1,0,0.0,0.0,0.0,0,1,1,0,0,0,0,0,0,2020-12-27 19:15:002020-12-27 19:15:002020-12-27 19:15:00
4751,42338,Stephen Ireland,1809,"[2013, 2014, 2015, 2017]",Stoke City,28,14,14,1363,1,0,31,12,19,1319,1,0,59,26,33,2682,2,0,0.0,0.0,0.0,1,0,1,0,0,0,0,0,0,2020-12-27 19:15:002020-12-27 19:15:002020-12-27 19:15:002020-12-27 19:15:00
4752,52945,Stephen Jordan,2549,"[2002, 2003, 2004, 2005, 2006]",Manchester City,24,23,1,1944,0,0,24,21,3,1877,0,0,48,44,4,3821,0,0,0.0,0.0,0.0,0,0,0,0,0,0,0,0,0,2020-12-27 19:15:002020-12-27 19:15:002020-12-27 19:15:002020-12-27 19:15:002020-12-27 19:15:00
4753,10592,Stephen Jordan,2549,[2009],Burnley FC,13,11,2,1008,0,0,12,12,0,1045,0,0,25,23,2,2053,0,0,0.0,0.0,0.0,0,0,0,0,0,0,0,0,0,2020-12-27 19:15:00
4754,31782,Stephen Kelly,1121,"[2003, 2004, 2005]",Tottenham Hotspur,17,14,3,1311,1,0,20,15,5,1484,0,0,37,29,8,2795,1,0,0.0,0.0,0.0,0,0,0,0,0,0,0,0,0,2020-12-27 19:15:002020-12-27 19:15:002020-12-27 19:15:00
4755,10596,Stephen Kelly,1121,[2007],Birmingham City,19,19,0,1710,0,0,19,19,0,1710,0,0,38,38,0,3420,0,0,0.0,0.0,0.0,0,0,0,0,0,0,0,0,0,2020-12-27 19:15:00
4756,10597,Stephen Kelly,1121,[2008],Stoke City,3,0,3,85,0,0,3,2,1,174,0,0,6,2,4,259,0,0,0.0,0.0,0.0,0,0,0,0,0,0,0,0,0,2020-12-27 19:15:00
4757,42398,Stephen Kelly,1121,"[2009, 2010, 2011, 2012]",Fulham FC,20,14,6,1410,0,0,24,22,2,2039,0,0,44,36,8,3449,0,0,0.0,0.0,0.0,0,0,0,0,0,0,0,0,0,2020-12-27 19:15:002020-12-27 19:15:002020-12-27 19:15:002020-12-27 19:15:00
4758,21205,Stephen Kingsley,3317,"[2015, 2016]",Swansea City,10,9,1,807,0,0,7,7,0,586,0,0,17,16,1,1393,0,0,0.0,0.0,0.0,0,0,0,0,0,0,0,0,0,2020-12-27 19:15:002020-12-27 19:15:00
4759,42422,Stephen McPhail,3695,"[2000, 2001, 2002, 2003]",Leeds United,12,5,7,646,1,0,18,10,8,932,0,0,30,15,15,1578,1,0,0.0,0.0,0.0,1,0,1,0,0,0,0,0,0,2020-12-27 19:15:002020-12-27 19:15:002020-12-27 19:15:002020-12-27 19:15:00
4760,10608,Stephen Pearson,1575,[2007],Derby County,11,11,0,919,0,0,13,12,1,1075,0,0,24,23,1,1994,0,0,0.0,0.0,0.0,0,0,0,0,0,0,0,0,0,2020-12-27 19:15:00
4761,10609,Stephen Quinn,3177,[2006],Sheffield United,8,8,0,633,2,0,5,5,0,394,0,0,13,13,0,1027,2,0,0.0,0.0,0.0,2,0,2,0,0,0,0,0,0,2020-12-27 19:15:00
4762,21221,Stephen Quinn,3177,"[2013, 2014]",Hull City,18,10,8,875,1,0,25,11,14,1266,0,0,43,21,22,2141,1,0,0.0,0.0,0.0,0,0,0,0,0,0,0,0,0,2020-12-27 19:15:002020-12-27 19:15:00
4763,31839,Stephen Ward,1252,"[2009, 2010, 2011]",Wolverhampton Wanderers,47,42,5,3774,2,0,47,41,6,3652,2,0,94,83,11,7426,4,0,0.0,6.0,6.0,1,2,3,0,0,0,0,0,0,2020-12-27 19:15:002020-12-27 19:15:002020-12-27 19:15:00
4764,42466,Stephen Ward,1252,"[2014, 2016, 2017, 2018]",Burnley FC,39,38,1,3318,1,0,38,37,1,3229,1,0,77,75,2,6547,2,0,0.0,0.0,0.0,0,0,0,0,0,0,0,0,0,2020-12-27 19:15:002020-12-27 19:15:002020-12-27 19:15:002020-12-27 19:15:00
4765,21239,Stephen Warnock,1616,"[2004, 2005]",Liverpool FC,19,12,7,953,1,0,20,14,6,1126,0,0,39,26,13,2079,1,0,0.0,0.0,0.0,0,0,0,0,0,0,0,0,0,2020-12-27 19:15:002020-12-27 19:15:00
4766,31866,Stephen Warnock,1616,"[2006, 2007, 2008]",Blackburn Rovers,45,45,0,4014,2,0,38,38,0,3354,3,0,83,83,0,7368,5,0,0.0,1.0,1.0,0,3,3,0,0,0,0,0,0,2020-12-27 19:15:002020-12-27 19:15:002020-12-27 19:15:00
4767,31875,Stephen Warnock,1616,"[2009, 2010, 2011]",Aston Villa,41,41,0,3588,1,0,42,41,1,3681,1,0,83,82,1,7269,2,0,0.0,0.0,0.0,1,0,1,0,0,0,0,0,0,2020-12-27 19:15:002020-12-27 19:15:002020-12-27 19:15:00
4768,21255,Stephen Wright,3024,"[2000, 2001]",Liverpool FC,5,3,2,306,0,0,9,7,2,657,0,0,14,10,4,963,0,0,0.0,0.0,0.0,0,0,0,0,0,0,0,0,0,2020-12-27 19:15:002020-12-27 19:15:00
4769,21259,Stephen Wright,3024,"[2002, 2005]",Sunderland AFC,14,14,0,1147,0,0,14,13,1,1205,0,0,28,27,1,2352,0,0,0.0,0.0,0.0,0,0,0,0,0,0,0,0,0,2020-12-27 19:15:002020-12-27 19:15:00
4770,31896,Stern John,1971,"[2002, 2003, 2004]",Birmingham City,32,11,21,1221,2,0,30,16,14,1442,7,0,62,27,35,2663,9,0,1.0,6.0,7.0,2,6,8,0,1,1,0,0,0,2020-12-27 19:15:002020-12-27 19:15:002020-12-27 19:15:00
4771,10634,Stern John,1971,[2007],Sunderland AFC,0,0,0,0,0,0,1,0,1,32,1,0,1,0,1,32,1,0,0.0,1.0,1.0,0,1,1,0,0,0,0,0,0,2020-12-27 19:15:00
4772,21271,Stevan Jovetić,2299,"[2013, 2014]",Manchester City,17,5,12,666,6,0,13,6,7,501,2,0,30,11,19,1167,8,0,0.0,0.0,0.0,2,1,3,0,0,0,0,0,0,2020-12-27 19:15:002020-12-27 19:15:00
4773,10637,Steve Banks,4196,[2001],Bolton Wanderers,0,0,0,0,0,0,1,1,0,90,0,0,1,1,0,90,0,0,0.0,0.0,0.0,0,0,0,0,0,0,0,0,0,2020-12-27 19:15:00
4774,10638,Steve Bould,4192,[2000],Manchester City,1,0,1,43,0,0,0,0,0,0,0,0,1,0,1,43,0,0,0.0,0.0,0.0,0,0,0,0,0,0,0,0,0,2020-12-27 19:15:00
4775,31920,Steve Brown,2686,"[2000, 2001, 2002]",Charlton Athletic,18,13,5,1213,0,0,22,12,10,1369,2,0,40,25,15,2582,2,0,0.0,0.0,0.0,0,1,1,0,0,0,0,0,0,2020-12-27 19:15:002020-12-27 19:15:002020-12-27 19:15:00
4776,53220,Steve Cook,1002,"[2015, 2016, 2017, 2018, 2019]",AFC Bournemouth,82,80,2,7153,5,0,86,84,2,7505,5,0,168,164,4,14658,10,0,3.0,6.0,9.0,4,4,8,0,0,0,0,0,0,2020-12-27 19:15:002020-12-27 19:15:002020-12-27 19:15:002020-12-27 19:15:002020-12-27 19:15:00
4777,10647,Steve Cooke,4101,[2002],Aston Villa,2,0,2,13,0,0,1,0,1,16,0,0,3,0,3,29,0,0,0.0,0.0,0.0,0,0,0,0,0,0,0,0,0,2020-12-27 19:15:00
4778,10648,Steve De Ridder,4320,[2012],Southampton FC,3,0,3,45,0,0,1,0,1,3,0,0,4,0,4,48,0,0,0.0,0.0,0.0,0,0,0,0,0,0,0,0,0,2020-12-27 19:15:00
4779,21299,Steve Finnan,2883,"[2001, 2002]",Fulham FC,33,33,0,2970,0,0,30,30,0,2700,0,0,63,63,0,5670,0,0,0.0,0.0,0.0,0,0,0,0,0,0,0,0,0,2020-12-27 19:15:002020-12-27 19:15:00
4780,53265,Steve Finnan,2883,"[2003, 2004, 2005, 2006, 2007]",Liverpool FC,68,61,7,5581,1,0,74,70,4,6197,0,0,142,131,11,11778,1,0,0.0,0.0,0.0,0,0,0,0,0,0,0,0,0,2020-12-27 19:15:002020-12-27 19:15:002020-12-27 19:15:002020-12-27 19:15:002020-12-27 19:15:00
4781,10656,Steve Finnan,2883,[2009],Portsmouth FC,11,11,0,935,0,0,10,9,1,873,0,0,21,20,1,1808,0,0,0.0,0.0,0.0,0,0,0,0,0,0,0,0,0,2020-12-27 19:15:00
4782,31974,Steve Gohouri,2881,"[2009, 2010, 2011]",Wigan Athletic,21,21,0,1846,1,0,21,17,4,1594,1,0,42,38,4,3440,2,0,1.0,1.0,2.0,1,1,2,0,0,0,0,0,0,2020-12-27 19:15:002020-12-27 19:15:002020-12-27 19:15:00
4783,21321,Steve Guppy,2648,"[2000, 2003]",Leicester City,22,14,8,1519,1,0,21,12,9,1073,0,0,43,26,17,2592,1,0,0.0,0.0,0.0,1,0,1,0,0,0,0,0,0,2020-12-27 19:15:002020-12-27 19:15:00
4784,95994,Steve Harper,2231,"[2000, 2002, 2004, 2006, 2007, 2008, 2010, 2011, 2012]",Newcastle United,41,38,3,3552,0,0,43,39,4,3548,0,0,84,77,7,7100,0,0,0.0,0.0,0.0,0,0,0,0,0,0,0,0,0,2020-12-27 19:15:002020-12-27 19:15:002020-12-27 19:15:002020-12-27 19:15:002020-12-27 19:15:002020-12-27 19:15:002020-12-27 19:15:002020-12-27 19:15:002020-12-27 19:15:00
4785,21343,Steve Harper,2231,"[2013, 2014]",Hull City,11,10,1,944,0,0,12,11,1,1008,0,0,23,21,2,1952,0,0,0.0,0.0,0.0,0,0,0,0,0,0,0,0,0,2020-12-27 19:15:002020-12-27 19:15:00
4786,10673,Steve Howard,1579,[2007],Derby County,10,6,4,655,0,0,10,8,2,736,1,0,20,14,6,1391,1,0,0.0,0.0,0.0,0,0,0,0,0,0,0,0,0,2020-12-27 19:15:00
4787,10674,Steve Kabba,3740,[2006],Watford FC,6,4,2,402,0,0,5,2,3,241,0,0,11,6,5,643,0,0,0.0,0.0,0.0,0,0,0,0,0,0,0,0,0,2020-12-27 19:15:00
4788,32028,Steve Lomas,1629,"[2000, 2001, 2002]",West Ham United,27,25,2,2179,5,0,30,29,1,2570,0,0,57,54,3,4749,5,0,0.0,0.0,0.0,4,0,4,0,0,0,0,0,0,2020-12-27 19:15:002020-12-27 19:15:002020-12-27 19:15:00
4789,10678,Steve Mandanda,2125,[2016],Crystal Palace,4,4,0,360,0,0,5,5,0,450,0,0,9,9,0,810,0,0,0.0,0.0,0.0,0,0,0,0,0,0,0,0,0,2020-12-27 19:15:00
4790,32040,Steve Marlet,2896,"[2001, 2002, 2003]",Fulham FC,26,21,5,1877,6,0,23,23,0,1927,5,0,49,44,5,3804,11,0,3.0,0.0,3.0,3,4,7,1,0,1,0,0,0,2020-12-27 19:15:002020-12-27 19:15:002020-12-27 19:15:00
4791,21365,Steve McManaman,3679,"[2003, 2004]",Manchester City,19,13,6,1110,0,0,14,11,3,1004,0,0,33,24,9,2114,0,0,0.0,0.0,0.0,0,0,0,0,0,0,0,0,0,2020-12-27 19:15:002020-12-27 19:15:00
4792,10684,Steve McMillan,4166,[2005],Wigan Athletic,1,0,1,16,0,0,1,0,1,44,0,0,2,0,2,60,0,0,0.0,0.0,0.0,0,0,0,0,0,0,0,0,0,2020-12-27 19:15:00
4793,21371,Steve Morison,3044,"[2011, 2012]",Norwich City,25,12,13,1121,5,0,28,14,14,1443,5,0,53,26,27,2564,10,0,0.0,7.0,7.0,2,3,5,0,0,0,0,0,0,2020-12-27 19:15:002020-12-27 19:15:00
4794,21375,Steve Mounié,3108,"[2017, 2018]",Huddersfield Town,30,24,6,2065,5,0,29,16,13,1627,4,0,59,40,19,3692,9,0,3.0,1.0,4.0,4,1,5,0,0,0,0,0,0,2020-12-27 19:15:002020-12-27 19:15:00
4795,10689,Steve Potts,3837,[2000],West Ham United,4,2,2,250,0,0,2,0,2,30,0,0,6,2,4,280,0,0,0.0,0.0,0.0,0,0,0,0,0,0,0,0,0,2020-12-27 19:15:00
4796,42766,Steve Simonsen,2918,"[2000, 2001, 2002, 2003]",Everton FC,14,13,1,1171,0,0,15,15,0,1350,0,0,29,28,1,2521,0,0,0.0,0.0,0.0,0,0,0,0,0,0,0,0,0,2020-12-27 19:15:002020-12-27 19:15:002020-12-27 19:15:002020-12-27 19:15:00
4797,21389,Steve Simonsen,2918,"[2008, 2009]",Stoke City,3,1,2,163,0,0,5,4,1,335,0,0,8,5,3,498,0,0,0.0,0.0,0.0,0,0,0,0,0,0,0,0,0,2020-12-27 19:15:002020-12-27 19:15:00
4798,32091,Steve Staunton,3494,"[2000, 2001, 2002]",Aston Villa,33,30,3,2714,0,0,37,32,5,2988,0,0,70,62,8,5702,0,0,0.0,0.0,0.0,0,0,0,0,0,0,0,0,0,2020-12-27 19:15:002020-12-27 19:15:002020-12-27 19:15:00
4799,21399,Steve Stone,1071,"[2000, 2001]",Aston Villa,27,22,5,1943,1,0,25,21,4,1814,2,0,52,43,9,3757,3,0,0.0,0.0,0.0,1,0,1,0,0,0,0,0,0,2020-12-27 19:15:002020-12-27 19:15:00
4800,21403,Steve Stone,1071,"[2003, 2004]",Portsmouth FC,29,28,1,2411,4,0,25,22,3,1967,1,0,54,50,4,4378,5,0,4.0,1.0,5.0,3,1,4,0,0,0,0,0,0,2020-12-27 19:15:002020-12-27 19:15:00
4801,21407,Steve Vickers,2066,"[2000, 2001]",Middlesbrough FC,16,15,1,1253,0,0,15,15,0,1322,0,0,31,30,1,2575,0,0,0.0,0.0,0.0,0,0,0,0,0,0,0,0,0,2020-12-27 19:15:002020-12-27 19:15:00
4802,10705,Steve Vickers,2066,[2002],Birmingham City,3,3,0,270,0,0,2,2,0,124,0,0,5,5,0,394,0,0,0.0,0.0,0.0,0,0,0,0,0,0,0,0,0,2020-12-27 19:15:00
4803,10706,Steve Walsh,4203,[2000],Leicester City,1,0,1,8,0,0,0,0,0,0,0,0,1,0,1,8,0,0,0.0,0.0,0.0,0,0,0,0,0,0,0,0,0,2020-12-27 19:15:00
4804,53545,Steve Watson,2794,"[2000, 2001, 2002, 2003, 2004]",Everton FC,63,57,6,5007,7,0,58,45,13,4015,7,0,121,102,19,9022,14,0,0.0,3.0,3.0,2,5,7,0,0,0,0,0,0,2020-12-27 19:15:002020-12-27 19:15:002020-12-27 19:15:002020-12-27 19:15:002020-12-27 19:15:00
4805,10712,Steve Watson,2794,[2005],West Bromwich Albion,16,15,1,1248,1,0,13,12,1,974,0,0,29,27,2,2222,1,0,0.0,0.0,0.0,1,0,1,0,0,0,0,0,0,2020-12-27 19:15:00
4806,21427,Steven Alzate,2930,"[2019, 2020]",Brighton & Hove Albion,12,8,4,761,0,0,15,9,6,943,0,0,27,17,10,1704,0,0,0.0,0.0,0.0,0,0,0,0,0,0,0,0,0,2020-12-27 19:15:002020-12-27 19:15:00
4807,10715,Steven Berghuis,3636,[2015],Watford FC,5,0,5,105,0,0,4,0,4,117,0,0,9,0,9,222,0,0,0.0,0.0,0.0,0,0,0,0,0,0,0,0,0,2020-12-27 19:15:00
4808,21433,Steven Bergwijn,2981,"[2019, 2020]",Tottenham Hotspur,12,6,6,590,3,0,12,8,4,706,0,0,24,14,10,1296,3,0,0.0,0.0,0.0,3,0,3,0,0,0,0,0,0,2020-12-27 19:15:002020-12-27 19:15:00
4809,32157,Steven Caldwell,2375,"[2000, 2002, 2003]",Newcastle United,13,11,2,1109,1,0,12,7,5,862,0,0,25,18,7,1971,1,0,0.0,0.0,0.0,0,0,0,0,0,0,0,0,0,2020-12-27 19:15:002020-12-27 19:15:002020-12-27 19:15:00
4810,10721,Steven Caldwell,2375,[2005],Sunderland AFC,13,13,0,1144,0,0,11,10,1,864,0,0,24,23,1,2008,0,0,0.0,0.0,0.0,0,0,0,0,0,0,0,0,0,2020-12-27 19:15:00
4811,10722,Steven Caldwell,2375,[2009],Burnley FC,7,7,0,630,1,0,6,5,1,433,0,0,13,12,1,1063,1,0,0.0,0.0,0.0,1,0,1,0,0,0,0,0,0,2020-12-27 19:15:00
4812,10723,Steven Caldwell,2375,[2010],Wigan Athletic,4,3,1,343,0,0,7,6,1,559,0,0,11,9,2,902,0,0,0.0,0.0,0.0,0,0,0,0,0,0,0,0,0,2020-12-27 19:15:00
4813,10724,Steven Caulker,2806,[2011],Swansea City,13,13,0,1170,0,0,13,13,0,1170,0,0,26,26,0,2340,0,0,0.0,0.0,0.0,0,0,0,0,0,0,0,0,0,2020-12-27 19:15:00
4814,10725,Steven Caulker,2806,[2012],Tottenham Hotspur,10,9,1,854,1,0,8,8,0,720,1,0,18,17,1,1574,2,0,0.0,0.0,0.0,1,1,2,0,0,0,0,0,0,2020-12-27 19:15:00
4815,10726,Steven Caulker,2806,[2013],Cardiff City,19,19,0,1710,3,0,19,19,0,1710,2,0,38,38,0,3420,5,0,3.0,0.0,3.0,3,2,5,0,0,0,0,0,0,2020-12-27 19:15:00
4816,10727,Steven Caulker,2806,[2014],Queens Park Rangers,19,18,1,1620,1,0,16,16,0,1396,0,0,35,34,1,3016,1,0,0.0,0.0,0.0,1,0,1,0,0,0,0,0,0,2020-12-27 19:15:00
4817,10728,Steven Caulker,2806,[2015],Southampton FC,0,0,0,0,0,0,3,1,2,145,0,0,3,1,2,145,0,0,0.0,0.0,0.0,0,0,0,0,0,0,0,0,0,2020-12-27 19:15:00
4818,32190,Steven Davis,1149,"[2004, 2005, 2006]",Aston Villa,40,33,7,2969,3,0,48,34,14,3260,2,0,88,67,21,6229,5,0,4.0,3.0,7.0,2,2,4,0,0,0,0,0,0,2020-12-27 19:15:002020-12-27 19:15:002020-12-27 19:15:00
4819,10732,Steven Davis,1149,[2007],Fulham FC,12,12,0,949,0,0,10,10,0,900,0,0,22,22,0,1849,0,0,0.0,0.0,0.0,0,0,0,0,0,0,0,0,0,2020-12-27 19:15:00
4820,75152,Steven Davis,1149,"[2012, 2013, 2014, 2015, 2016, 2017, 2018]",Southampton FC,100,86,14,7292,6,0,93,74,19,6810,6,0,193,160,33,14102,12,0,0.0,6.0,6.0,2,6,8,0,0,0,0,0,0,2020-12-27 19:15:002020-12-27 19:15:002020-12-27 19:15:002020-12-27 19:15:002020-12-27 19:15:002020-12-27 19:15:002020-12-27 19:15:00
4821,32223,Steven Defour,1255,"[2016, 2017, 2018]",Burnley FC,28,25,3,1975,1,0,23,21,2,1565,1,0,51,46,5,3540,2,0,0.0,0.0,0.0,1,0,1,0,0,0,0,0,0,2020-12-27 19:15:002020-12-27 19:15:002020-12-27 19:15:00
4822,21487,Steven Elliott,4165,"[2000, 2001]",Derby County,4,1,3,112,0,0,6,5,1,383,0,0,10,6,4,495,0,0,0.0,0.0,0.0,0,0,0,0,0,0,0,0,0,2020-12-27 19:15:002020-12-27 19:15:00
4823,10745,Steven Fletcher,1408,[2009],Burnley FC,17,17,0,1417,4,0,18,18,0,1454,4,0,35,35,0,2871,8,0,0.0,0.0,0.0,3,1,4,0,0,0,0,0,0,2020-12-27 19:15:00
4824,21493,Steven Fletcher,1408,"[2010, 2011]",Wolverhampton Wanderers,31,23,8,2021,11,0,30,18,12,1724,11,0,61,41,20,3745,22,0,4.0,2.0,6.0,6,7,13,0,1,1,0,0,0,2020-12-27 19:15:002020-12-27 19:15:00
4825,42998,Steven Fletcher,1408,"[2012, 2013, 2014, 2015]",Sunderland AFC,47,36,11,3159,8,0,47,36,11,3250,15,0,94,72,22,6409,23,0,3.0,3.0,6.0,5,11,16,0,0,0,0,0,0,2020-12-27 19:15:002020-12-27 19:15:002020-12-27 19:15:002020-12-27 19:15:00
4826,150632,Steven Gerrard,1424,"[2000, 2002, 2003, 2004, 2005, 2006, 2007, 2008, 2009, 2010, 2011, 2012, 2013, 2014]",Liverpool FC,222,208,14,18534,66,0,207,196,11,17533,50,0,429,404,25,36067,116,0,29.0,20.0,49.0,40,29,69,16,15,31,0,0,0,2020-12-27 19:15:002020-12-27 19:15:002020-12-27 19:15:002020-12-27 19:15:002020-12-27 19:15:002020-12-27 19:15:002020-12-27 19:15:002020-12-27 19:15:002020-12-27 19:15:002020-12-27 19:15:002020-12-27 19:15:002020-12-27 19:15:002020-12-27 19:15:002020-12-27 19:15:00
4827,10753,Steven Gerrard,1424,[2001],West Ham United,1,0,1,45,0,0,0,0,0,0,0,0,1,0,1,45,0,0,0.0,0.0,0.0,0,0,0,0,0,0,0,0,0,2020-12-27 19:15:00
4828,10767,Steven Hewitt,4570,[2014],Burnley FC,0,0,0,0,0,0,0,0,0,0,0,0,0,0,0,0,0,0,0.0,0.0,0.0,0,0,0,0,0,0,0,0,0,2020-12-27 19:15:00
4829,10768,Steven Mouyokolo,1608,[2009],Hull City,11,10,1,857,1,0,10,9,1,817,0,0,21,19,2,1674,1,0,0.0,0.0,0.0,1,0,1,0,0,0,0,0,0,2020-12-27 19:15:00
4830,10769,Steven Mouyokolo,1608,[2010],Wolverhampton Wanderers,2,1,1,92,0,0,2,1,1,67,0,0,4,2,2,159,0,0,0.0,0.0,0.0,0,0,0,0,0,0,0,0,0,2020-12-27 19:15:00
4831,10770,Steven N'Zonzi,1550,[2009],Wigan Athletic,1,1,0,90,0,0,0,0,0,0,0,0,1,1,0,90,0,0,0.0,0.0,0.0,0,0,0,0,0,0,0,0,0,2020-12-27 19:15:00
4832,21543,Steven N'Zonzi,1550,"[2010, 2011]",Blackburn Rovers,26,21,5,2028,1,0,27,23,4,2064,2,0,53,44,9,4092,3,0,0.0,0.0,0.0,0,1,1,0,0,0,0,0,0,2020-12-27 19:15:002020-12-27 19:15:00
4833,32322,Steven N'Zonzi,1550,"[2012, 2013, 2014]",Stoke City,55,54,1,4863,4,0,54,53,1,4719,2,0,109,107,2,9582,6,0,0.0,0.0,0.0,1,1,2,0,0,0,0,0,0,2020-12-27 19:15:002020-12-27 19:15:002020-12-27 19:15:00
4834,32331,Steven Naismith,2239,"[2012, 2013, 2014]",Everton FC,43,21,22,2213,11,0,50,27,23,2531,5,0,93,48,45,4744,16,0,5.0,0.0,5.0,7,4,11,0,0,0,0,0,0,2020-12-27 19:15:002020-12-27 19:15:002020-12-27 19:15:00
4835,10779,Steven Naismith,2239,[2015],Norwich City,6,6,0,468,1,0,7,5,2,412,0,0,13,11,2,880,1,0,0.0,0.0,0.0,1,0,1,0,0,0,0,0,0,2020-12-27 19:15:00
4836,86273,Steven Pienaar,2406,"[2007, 2008, 2009, 2011, 2012, 2013, 2014, 2015]",Everton FC,82,71,11,6452,13,0,85,78,7,6768,7,0,167,149,18,13220,20,0,6.0,7.0,13.0,7,6,13,0,0,0,0,0,0,2020-12-27 19:15:002020-12-27 19:15:002020-12-27 19:15:002020-12-27 19:15:002020-12-27 19:15:002020-12-27 19:15:002020-12-27 19:15:002020-12-27 19:15:00
4837,10783,Steven Pienaar,2406,[2010],Tottenham Hotspur,1,0,1,44,0,0,7,5,2,449,0,0,8,5,3,493,0,0,0.0,0.0,0.0,0,0,0,0,0,0,0,0,0,2020-12-27 19:15:00
4838,10789,Steven Pienaar,2406,[2016],Sunderland AFC,6,4,2,283,0,0,9,6,3,555,0,0,15,10,5,838,0,0,0.0,0.0,0.0,0,0,0,0,0,0,0,0,0,2020-12-27 19:15:00
4839,75551,Steven Reid,1140,"[2003, 2004, 2005, 2006, 2007, 2008, 2009]",Blackburn Rovers,57,47,10,4143,3,0,54,42,12,3874,3,0,111,89,22,8017,6,0,3.0,3.0,6.0,1,2,3,0,0,0,0,0,0,2020-12-27 19:15:002020-12-27 19:15:002020-12-27 19:15:002020-12-27 19:15:002020-12-27 19:15:002020-12-27 19:15:002020-12-27 19:15:00
4840,43194,Steven Reid,1140,"[2010, 2011, 2012, 2013]",West Bromwich Albion,35,29,6,2498,2,0,37,32,5,2766,0,0,72,61,11,5264,2,0,0.0,0.0,0.0,2,0,2,0,0,0,0,0,0,2020-12-27 19:15:002020-12-27 19:15:002020-12-27 19:15:002020-12-27 19:15:00
4841,10801,Steven Reid,1140,[2014],Burnley FC,3,0,3,4,0,0,4,1,3,106,0,0,7,1,6,110,0,0,0.0,0.0,0.0,0,0,0,0,0,0,0,0,0,2020-12-27 19:15:00
4842,10802,Steven Sessegnon,4018,[2018],Fulham FC,0,0,0,0,0,0,0,0,0,0,0,0,0,0,0,0,0,0,0.0,0.0,0.0,0,0,0,0,0,0,0,0,0,2020-12-27 19:15:00
4843,10803,Steven Sidwell,1622,[2006],Reading FC,17,17,0,1530,4,0,16,16,0,1383,0,0,33,33,0,2913,4,0,0.0,0.0,0.0,3,0,3,0,0,0,0,0,0,2020-12-27 19:15:00
4844,10804,Steven Sidwell,1622,[2007],Chelsea FC,8,3,5,231,0,0,7,4,3,286,0,0,15,7,8,517,0,0,0.0,0.0,0.0,0,0,0,0,0,0,0,0,0,2020-12-27 19:15:00
4845,21611,Steven Sidwell,1622,"[2008, 2009]",Aston Villa,19,9,10,927,1,0,17,10,7,939,2,0,36,19,17,1866,3,0,0.0,0.0,0.0,1,1,2,0,0,0,0,0,0,2020-12-27 19:15:002020-12-27 19:15:00
4846,43234,Steven Sidwell,1622,"[2010, 2011, 2012, 2013]",Fulham FC,48,42,6,3800,11,0,44,40,4,3649,3,0,92,82,10,7449,14,0,1.0,0.0,1.0,7,3,10,1,0,1,0,0,0,2020-12-27 19:15:002020-12-27 19:15:002020-12-27 19:15:002020-12-27 19:15:00
4847,21623,Steven Sidwell,1622,"[2014, 2015]",Stoke City,6,2,4,207,0,0,7,3,4,252,0,0,13,5,8,459,0,0,0.0,0.0,0.0,0,0,0,0,0,0,0,0,0,2020-12-27 19:15:002020-12-27 19:15:00
4848,10813,Steven Sidwell,1622,[2017],Brighton & Hove Albion,0,0,0,0,0,0,0,0,0,0,0,0,0,0,0,0,0,0,0.0,0.0,0.0,0,0,0,0,0,0,0,0,0,2020-12-27 19:15:00
4849,129834,Steven Taylor,2014,"[2003, 2004, 2005, 2006, 2007, 2008, 2010, 2011, 2012, 2013, 2014, 2015]",Newcastle United,95,86,9,7821,6,0,96,90,6,7947,6,0,191,176,15,15768,12,0,1.0,5.0,6.0,4,3,7,0,0,0,0,0,0,2020-12-27 19:15:002020-12-27 19:15:002020-12-27 19:15:002020-12-27 19:15:002020-12-27 19:15:002020-12-27 19:15:002020-12-27 19:15:002020-12-27 19:15:002020-12-27 19:15:002020-12-27 19:15:002020-12-27 19:15:002020-12-27 19:15:00
4850,10826,Steven Thompson,3332,[2009],Burnley FC,10,1,9,170,2,0,10,0,10,212,2,0,20,1,19,382,4,0,0.0,0.0,0.0,0,0,0,0,0,0,0,0,0,2020-12-27 19:15:00
4851,10827,Steven Watt,4073,[2004],Chelsea FC,0,0,0,0,0,0,1,0,1,1,0,0,1,0,1,1,0,0,0.0,0.0,0.0,0,0,0,0,0,0,0,0,0,2020-12-27 19:15:00
4852,32487,Steven Whittaker,1369,"[2012, 2013, 2015]",Norwich City,14,12,2,1082,1,0,27,24,3,2108,2,0,41,36,5,3190,3,0,0.0,0.0,0.0,1,1,2,0,0,0,0,0,0,2020-12-27 19:15:002020-12-27 19:15:002020-12-27 19:15:00
4853,97521,Stewart Downing,1335,"[2001, 2002, 2003, 2004, 2005, 2006, 2007, 2008, 2016]",Middlesbrough FC,108,87,21,8180,12,0,101,92,9,8274,6,0,209,179,30,16454,18,0,1.0,2.0,3.0,6,5,11,2,0,2,0,0,0,2020-12-27 19:15:002020-12-27 19:15:002020-12-27 19:15:002020-12-27 19:15:002020-12-27 19:15:002020-12-27 19:15:002020-12-27 19:15:002020-12-27 19:15:002020-12-27 19:15:00
4854,21679,Stewart Downing,1335,"[2009, 2010]",Aston Villa,31,31,0,2735,7,0,29,27,2,2458,2,0,60,58,2,5193,9,0,3.0,0.0,3.0,5,2,7,0,0,0,0,0,0,2020-12-27 19:15:002020-12-27 19:15:00
4855,21683,Stewart Downing,1335,"[2011, 2012]",Liverpool FC,32,27,5,2364,2,0,33,26,7,2305,1,0,65,53,12,4669,3,0,0.0,0.0,0.0,1,1,2,0,0,0,0,0,0,2020-12-27 19:15:002020-12-27 19:15:00
4856,21687,Stewart Downing,1335,"[2013, 2014]",West Ham United,34,33,1,2951,4,0,35,33,2,2875,3,0,69,66,3,5826,7,0,0.0,2.0,2.0,1,2,3,0,0,0,0,0,0,2020-12-27 19:15:002020-12-27 19:15:00
4857,10846,Stig Inge Bjørnebye,1344,[2001],Blackburn Rovers,9,9,0,779,0,0,12,12,0,892,0,0,21,21,0,1671,0,0,0.0,0.0,0.0,0,0,0,0,0,0,0,0,0,2020-12-27 19:15:00
4858,21695,Stig Tøfting,4050,"[2001, 2002]",Bolton Wanderers,6,4,2,391,0,0,8,4,4,369,0,0,14,8,6,760,0,0,0.0,0.0,0.0,0,0,0,0,0,0,0,0,0,2020-12-27 19:15:002020-12-27 19:15:00
4859,65109,Stilian Petrov,1620,"[2006, 2007, 2008, 2009, 2010, 2011]",Aston Villa,89,83,6,7296,2,0,88,83,5,7313,7,0,177,166,11,14609,9,0,0.0,0.0,0.0,1,4,5,0,0,0,0,0,0,2020-12-27 19:15:002020-12-27 19:15:002020-12-27 19:15:002020-12-27 19:15:002020-12-27 19:15:002020-12-27 19:15:00
4860,10855,Stipe Pletikosa,2407,[2010],Tottenham Hotspur,0,0,0,0,0,0,0,0,0,0,0,0,0,0,0,0,0,0,0.0,0.0,0.0,0,0,0,0,0,0,0,0,0,2020-12-27 19:15:00
4861,32571,Stuart Armstrong,2158,"[2018, 2019, 2020]",Southampton FC,32,19,13,1727,4,0,39,28,11,2448,6,0,71,47,24,4175,10,0,0.0,0.0,0.0,1,4,5,0,0,0,0,0,0,2020-12-27 19:15:002020-12-27 19:15:002020-12-27 19:15:00
4862,10859,Stuart Dallas,1064,[2020],Leeds United,8,8,0,711,2,0,7,7,0,630,1,0,15,15,0,1341,3,0,0.0,0.0,0.0,1,0,1,0,0,0,0,0,0,2020-12-27 19:15:00
4863,21721,Stuart Holden,2529,"[2009, 2010]",Bolton Wanderers,15,14,1,1270,1,0,13,13,0,1139,1,0,28,27,1,2409,2,0,3.0,0.0,3.0,1,0,1,0,0,0,0,0,0,2020-12-27 19:15:002020-12-27 19:15:00
4864,10862,Stuart McCall,2838,[2000],Bradford City,17,16,1,1449,1,0,14,14,0,1254,0,0,31,30,1,2703,1,0,0.0,0.0,0.0,1,0,1,0,0,0,0,0,0,2020-12-27 19:15:00
4865,10863,Stuart Nicholson,4177,[2005],West Bromwich Albion,2,0,2,26,0,0,2,0,2,32,0,0,4,0,4,58,0,0,0.0,0.0,0.0,0,0,0,0,0,0,0,0,0,2020-12-27 19:15:00
4866,21729,Stuart O'Keefe,3133,"[2013, 2014]",Crystal Palace,9,2,7,289,1,0,5,1,4,184,0,0,14,3,11,473,1,0,0.0,0.0,0.0,0,0,0,0,0,0,0,0,0,2020-12-27 19:15:002020-12-27 19:15:00
4867,54340,Stuart Parnaby,1881,"[2002, 2003, 2004, 2005, 2006]",Middlesbrough FC,45,36,9,3263,1,0,45,36,9,3094,1,0,90,72,18,6357,2,0,3.0,0.0,3.0,1,0,1,0,0,0,0,0,0,2020-12-27 19:15:002020-12-27 19:15:002020-12-27 19:15:002020-12-27 19:15:002020-12-27 19:15:00
4868,32616,Stuart Parnaby,1881,"[2007, 2009, 2010]",Birmingham City,13,8,5,876,0,0,13,7,6,712,0,0,26,15,11,1588,0,0,0.0,0.0,0.0,0,0,0,0,0,0,0,0,0,2020-12-27 19:15:002020-12-27 19:15:002020-12-27 19:15:00
4869,10874,Stuart Pearce,3836,[2000],West Ham United,11,11,0,911,1,0,14,14,0,1252,1,0,25,25,0,2163,2,0,0.0,0.0,0.0,0,1,1,0,0,0,0,0,0,2020-12-27 19:15:00
4870,21751,Stuart Ripley,2052,"[2000, 2001]",Southampton FC,6,2,4,214,0,0,2,0,2,52,0,0,8,2,6,266,0,0,0.0,0.0,0.0,0,0,0,0,0,0,0,0,0,2020-12-27 19:15:002020-12-27 19:15:00
4871,32634,Stuart Taylor,1684,"[2001, 2002, 2004]",Arsenal FC,10,9,1,816,0,0,7,7,0,630,0,0,17,16,1,1446,0,0,0.0,0.0,0.0,0,0,0,0,0,0,0,0,0,2020-12-27 19:15:002020-12-27 19:15:002020-12-27 19:15:00
4872,32643,Stuart Taylor,1684,"[2005, 2006, 2007]",Aston Villa,5,3,2,314,0,0,7,6,1,584,0,0,12,9,3,898,0,0,0.0,0.0,0.0,0,0,0,0,0,0,0,0,0,2020-12-27 19:15:002020-12-27 19:15:002020-12-27 19:15:00
4873,21767,Stuart Taylor,1684,"[2010, 2011]",Manchester City,0,0,0,0,0,0,0,0,0,0,0,0,0,0,0,0,0,0,0.0,0.0,0.0,0,0,0,0,0,0,0,0,0,2020-12-27 19:15:002020-12-27 19:15:00
4874,10885,Stuart Taylor,1684,[2012],Reading FC,1,1,0,90,0,0,3,3,0,270,0,0,4,4,0,360,0,0,0.0,0.0,0.0,0,0,0,0,0,0,0,0,0,2020-12-27 19:15:00
4875,21773,Stuart Taylor,1684,"[2016, 2017]",Southampton FC,0,0,0,0,0,0,0,0,0,0,0,0,0,0,0,0,0,0,0.0,0.0,0.0,0,0,0,0,0,0,0,0,0,2020-12-27 19:15:002020-12-27 19:15:00
4876,54450,Stylianos Giannakopoulos,1717,"[2003, 2004, 2005, 2006, 2007]",Bolton Wanderers,68,42,26,3758,11,0,68,43,25,3841,9,0,136,85,51,7599,20,0,12.0,0.0,12.0,7,5,12,0,0,0,0,0,0,2020-12-27 19:15:002020-12-27 19:15:002020-12-27 19:15:002020-12-27 19:15:002020-12-27 19:15:00
4877,10893,Stylianos Giannakopoulos,1717,[2008],Hull City,1,0,1,22,0,0,1,0,1,8,0,0,2,0,2,30,0,0,0.0,0.0,0.0,0,0,0,0,0,0,0,0,0,2020-12-27 19:15:00
4878,10894,Stéphane Dalmat,2901,[2003],Tottenham Hotspur,10,7,3,542,3,0,12,5,7,577,0,0,22,12,10,1119,3,0,0.0,0.0,0.0,1,0,1,0,0,0,0,0,0,2020-12-27 19:15:00
4879,32690,Stéphane Henchoz,2360,"[2000, 2002, 2003]",Liverpool FC,34,34,0,2899,0,0,31,28,3,2607,0,0,65,62,3,5506,0,0,0.0,0.0,0.0,0,0,0,0,0,0,0,0,0,2020-12-27 19:15:002020-12-27 19:15:002020-12-27 19:15:00
4880,10896,Stéphane Henchoz,2360,[2001],West Ham United,1,1,0,90,0,0,0,0,0,0,0,0,1,1,0,90,0,0,0.0,0.0,0.0,0,0,0,0,0,0,0,0,0,2020-12-27 19:15:00
4881,10899,Stéphane Henchoz,2360,[2005],Wigan Athletic,13,13,0,1166,0,0,13,13,0,1125,0,0,26,26,0,2291,0,0,0.0,0.0,0.0,0,0,0,0,0,0,0,0,0,2020-12-27 19:15:00
4882,10900,Stéphane Henchoz,2360,[2006],Blackburn Rovers,6,5,1,451,0,0,6,5,1,427,0,0,12,10,2,878,0,0,0.0,0.0,0.0,0,0,0,0,0,0,0,0,0,2020-12-27 19:15:00
4883,10901,Stéphane M'bia,2980,[2012],Queens Park Rangers,15,15,0,1189,0,0,14,14,0,1196,0,0,29,29,0,2385,0,0,0.0,0.0,0.0,0,0,0,0,0,0,0,0,0,2020-12-27 19:15:00
4884,32709,Stéphane Sessègnon,1406,"[2010, 2011, 2012]",Sunderland AFC,42,41,1,3626,10,0,43,42,1,3640,7,0,85,83,2,7266,17,0,5.0,0.0,5.0,5,2,7,1,0,1,0,0,0,2020-12-27 19:15:002020-12-27 19:15:002020-12-27 19:15:00
4885,32718,Stéphane Sessègnon,1406,"[2013, 2014, 2015]",West Bromwich Albion,41,33,8,2741,5,0,38,31,7,2745,3,0,79,64,15,5486,8,0,0.0,0.0,0.0,4,3,7,0,0,0,0,0,0,2020-12-27 19:15:002020-12-27 19:15:002020-12-27 19:15:00
4886,10908,Suk-young Yun,2922,[2014],Queens Park Rangers,11,9,2,780,0,0,12,10,2,946,0,0,23,19,4,1726,0,0,0.0,0.0,0.0,0,0,0,0,0,0,0,0,0,2020-12-27 19:15:00
4887,43642,Sullay Kaikai,2777,"[2015, 2016, 2017, 2018]",Crystal Palace,0,0,0,0,0,0,3,0,3,80,0,0,3,0,3,80,0,0,0.0,0.0,0.0,0,0,0,0,0,0,0,0,0,2020-12-27 19:15:002020-12-27 19:15:002020-12-27 19:15:002020-12-27 19:15:00
4888,10913,Sulley Ali Muntari,1688,[2007],Portsmouth FC,14,12,2,1068,1,0,14,14,0,1231,3,0,28,26,2,2299,4,0,0.0,0.0,0.0,0,1,1,1,0,1,0,0,0,2020-12-27 19:15:00
4889,10914,Sulley Ali Muntari,1688,[2010],Sunderland AFC,4,3,1,201,0,0,5,4,1,336,0,0,9,7,2,537,0,0,0.0,0.0,0.0,0,0,0,0,0,0,0,0,0,2020-12-27 19:15:00
4890,54589,Sung-yueng Ki,1698,"[2012, 2014, 2015, 2016, 2017]",Swansea City,70,50,20,4907,8,0,68,55,13,4829,4,0,138,105,33,9736,12,0,7.0,3.0,10.0,7,3,10,0,0,0,0,0,0,2020-12-27 19:15:002020-12-27 19:15:002020-12-27 19:15:002020-12-27 19:15:002020-12-27 19:15:00
4891,10916,Sung-yueng Ki,1698,[2013],Sunderland AFC,15,14,1,1233,0,0,12,11,1,952,3,0,27,25,2,2185,3,0,0.0,3.0,3.0,0,1,1,0,1,1,0,0,0,2020-12-27 19:15:00
4892,21843,Sung-yueng Ki,1698,"[2018, 2019]",Newcastle United,11,9,2,841,0,0,10,6,4,597,0,0,21,15,6,1438,0,0,0.0,0.0,0.0,0,0,0,0,0,0,0,0,0,2020-12-27 19:15:002020-12-27 19:15:00
4893,21847,Suso,3811,"[2012, 2014]",Liverpool FC,8,5,3,396,0,0,6,3,3,206,0,0,14,8,6,602,0,0,0.0,0.0,0.0,0,0,0,0,0,0,0,0,0,2020-12-27 19:15:002020-12-27 19:15:00
4894,21851,Svetoslav Todorov,2967,"[2000, 2001]",West Ham United,4,2,2,267,0,0,10,2,8,368,1,0,14,4,10,635,1,0,0.0,0.0,0.0,0,1,1,0,0,0,0,0,0,2020-12-27 19:15:002020-12-27 19:15:00
4895,21855,Svetoslav Todorov,2967,"[2003, 2005]",Portsmouth FC,11,3,8,502,3,0,14,4,10,563,1,0,25,7,18,1065,4,0,4.0,0.0,4.0,3,0,3,0,0,0,0,0,0,2020-12-27 19:15:002020-12-27 19:15:00
4896,10929,Svetoslav Todorov,2967,[2006],Wigan Athletic,3,1,2,109,0,0,2,1,1,116,0,0,5,2,3,225,0,0,0.0,0.0,0.0,0,0,0,0,0,0,0,0,0,2020-12-27 19:15:00
4897,10930,Sylvain Distin,1015,[2001],Newcastle United,14,11,3,1032,0,0,13,8,5,820,0,0,27,19,8,1852,0,0,0.0,0.0,0.0,0,0,0,0,0,0,0,0,0,2020-12-27 19:15:00
4898,54665,Sylvain Distin,1015,"[2002, 2003, 2004, 2005, 2006]",Manchester City,87,87,0,7812,2,0,80,80,0,7119,3,0,167,167,0,14931,5,0,0.0,1.0,1.0,2,2,4,0,0,0,0,0,0,2020-12-27 19:15:002020-12-27 19:15:002020-12-27 19:15:002020-12-27 19:15:002020-12-27 19:15:00
4899,21873,Sylvain Distin,1015,"[2007, 2008]",Portsmouth FC,36,36,0,3240,0,0,37,37,0,3286,0,0,73,73,0,6526,0,0,0.0,0.0,0.0,0,0,0,0,0,0,0,0,0,2020-12-27 19:15:002020-12-27 19:15:00
4900,65643,Sylvain Distin,1015,"[2009, 2010, 2011, 2012, 2013, 2014]",Everton FC,86,83,3,7417,1,0,88,84,4,7642,1,0,174,167,7,15059,2,0,0.0,0.0,0.0,1,1,2,0,0,0,0,0,0,2020-12-27 19:15:002020-12-27 19:15:002020-12-27 19:15:002020-12-27 19:15:002020-12-27 19:15:002020-12-27 19:15:00
4901,10944,Sylvain Distin,1015,[2015],AFC Bournemouth,5,5,0,450,0,0,7,4,3,392,0,0,12,9,3,842,0,0,0.0,0.0,0.0,0,0,0,0,0,0,0,0,0,2020-12-27 19:15:00
4902,32838,Sylvain Ebanks-Blake,3432,"[2009, 2010, 2011]",Wolverhampton Wanderers,42,18,24,1923,7,0,34,13,21,1572,3,0,76,31,45,3495,10,0,5.0,1.0,6.0,5,2,7,1,0,1,0,0,0,2020-12-27 19:15:002020-12-27 19:15:002020-12-27 19:15:00
4903,54750,Sylvain Legwinski,1083,"[2001, 2002, 2003, 2004, 2005]",Fulham FC,62,56,6,4888,7,0,54,48,6,4189,1,0,116,104,12,9077,8,0,3.0,0.0,3.0,4,1,5,0,0,0,0,0,0,2020-12-27 19:15:002020-12-27 19:15:002020-12-27 19:15:002020-12-27 19:15:002020-12-27 19:15:00
4904,43818,Sylvain Marveaux,2711,"[2011, 2012, 2013, 2015]",Newcastle United,22,8,14,796,0,0,16,5,11,557,1,0,38,13,25,1353,1,0,0.0,0.0,0.0,0,1,1,0,0,0,0,0,0,2020-12-27 19:15:002020-12-27 19:15:002020-12-27 19:15:002020-12-27 19:15:00
4905,43834,Sylvain Wiltord,2356,"[2000, 2001, 2002, 2003]",Arsenal FC,51,37,14,3167,19,0,50,38,12,3371,12,0,101,75,26,6538,31,0,6.0,7.0,13.0,7,6,13,0,0,0,0,0,0,2020-12-27 19:15:002020-12-27 19:15:002020-12-27 19:15:002020-12-27 19:15:00
4906,10961,Sylvinho,3496,[2000],Arsenal FC,12,11,1,959,1,0,11,11,0,964,1,0,23,22,1,1923,2,0,0.0,1.0,1.0,0,1,1,0,0,0,0,0,0,2020-12-27 19:15:00
4907,10962,Sylvinho,3496,[2009],Manchester City,4,2,2,164,0,0,6,4,2,322,0,0,10,6,4,486,0,0,0.0,0.0,0.0,0,0,0,0,0,0,0,0,0,2020-12-27 19:15:00
4908,54825,Szilárd Németh,2139,"[2001, 2002, 2003, 2004, 2005]",Middlesbrough FC,60,33,27,3305,18,0,54,27,27,2528,5,0,114,60,54,5833,23,0,6.0,0.0,6.0,8,2,10,0,0,0,0,0,0,2020-12-27 19:15:002020-12-27 19:15:002020-12-27 19:15:002020-12-27 19:15:002020-12-27 19:15:00
4909,131682,Séamus Coleman,1467,"[2009, 2010, 2011, 2012, 2013, 2014, 2015, 2016, 2017, 2018, 2019, 2020]",Everton FC,147,132,15,11746,13,0,135,122,13,10896,7,0,282,254,28,22642,20,0,7.0,5.0,12.0,10,6,16,0,0,0,0,0,0,2020-12-27 19:15:002020-12-27 19:15:002020-12-27 19:15:002020-12-27 19:15:002020-12-27 19:15:002020-12-27 19:15:002020-12-27 19:15:002020-12-27 19:15:002020-12-27 19:15:002020-12-27 19:15:002020-12-27 19:15:002020-12-27 19:15:00
4910,10980,Sébastien Bassong,1370,[2008],Newcastle United,14,13,1,1140,0,0,16,13,3,1293,0,0,30,26,4,2433,0,0,0.0,0.0,0.0,0,0,0,0,0,0,0,0,0,2020-12-27 19:15:00
4911,32946,Sébastien Bassong,1370,"[2009, 2010, 2011]",Tottenham Hotspur,19,14,5,1374,1,0,25,18,7,1878,1,0,44,32,12,3252,2,0,3.0,0.0,3.0,1,1,2,0,0,0,0,0,0,2020-12-27 19:15:002020-12-27 19:15:002020-12-27 19:15:00
4912,32955,Sébastien Bassong,1370,"[2012, 2013, 2015]",Norwich City,48,48,0,4268,2,0,45,43,2,3861,2,0,93,91,2,8129,4,0,0.0,1.0,1.0,2,1,3,0,0,0,0,0,0,2020-12-27 19:15:002020-12-27 19:15:002020-12-27 19:15:00
4913,21975,Sébastien Haller,2210,"[2019, 2020]",West Ham United,25,17,8,1695,6,0,21,15,6,1365,4,0,46,32,14,3060,10,0,1.0,6.0,7.0,4,3,7,0,0,0,0,0,0,2020-12-27 19:15:002020-12-27 19:15:00
4914,21979,Sébastien Pocognoli,3547,"[2014, 2015]",West Bromwich Albion,10,9,1,744,0,0,6,6,0,510,0,0,16,15,1,1254,0,0,0.0,0.0,0.0,0,0,0,0,0,0,0,0,0,2020-12-27 19:15:002020-12-27 19:15:00
4915,10991,Sébastien Puygrenier,4346,[2008],Bolton Wanderers,4,2,2,171,1,0,3,3,0,209,0,0,7,5,2,380,1,0,0.0,0.0,0.0,1,0,1,0,0,0,0,0,0,2020-12-27 19:15:00
4916,32979,Sébastien Squillaci,2867,"[2010, 2011, 2012]",Arsenal FC,11,10,1,877,1,0,12,10,2,951,0,0,23,20,3,1828,1,0,3.0,0.0,3.0,1,0,1,0,0,0,0,0,0,2020-12-27 19:15:002020-12-27 19:15:002020-12-27 19:15:00
4917,21991,Tadanari Lee,2875,"[2012, 2013]",Southampton FC,0,0,0,0,0,0,0,0,0,0,0,0,0,0,0,0,0,0,0.0,0.0,0.0,0,0,0,0,0,0,0,0,0,2020-12-27 19:15:002020-12-27 19:15:00
4918,21995,Taher El-Khalej,2045,"[2000, 2001]",Southampton FC,21,15,6,1527,1,0,21,18,3,1614,1,0,42,33,9,3141,2,0,0.0,1.0,1.0,0,1,1,0,0,0,0,0,0,2020-12-27 19:15:002020-12-27 19:15:00
4919,10999,Taher El-Khalej,2045,[2002],Charlton Athletic,3,2,1,195,0,0,0,0,0,0,0,0,3,2,1,195,0,0,0.0,0.0,0.0,0,0,0,0,0,0,0,0,0,2020-12-27 19:15:00
4920,22001,Tahith Chong,3729,"[2018, 2019]",Manchester United,3,0,3,31,0,0,2,0,2,40,0,0,5,0,5,71,0,0,0.0,0.0,0.0,0,0,0,0,0,0,0,0,0,2020-12-27 19:15:002020-12-27 19:15:00
4921,22005,Takumi Minamino,2307,"[2019, 2020]",Liverpool FC,6,0,6,37,0,0,12,4,8,487,1,0,18,4,14,524,1,0,0.0,0.0,0.0,0,1,1,0,0,0,0,0,0,2020-12-27 19:15:002020-12-27 19:15:00
4922,33015,Tal Ben Haim,1715,"[2004, 2005, 2006]",Bolton Wanderers,46,42,4,3809,1,0,39,36,3,3198,0,0,85,78,7,7007,1,0,0.0,0.0,0.0,1,0,1,0,0,0,0,0,0,2020-12-27 19:15:002020-12-27 19:15:002020-12-27 19:15:00
4923,11007,Tal Ben Haim,1715,[2007],Chelsea FC,6,4,2,424,0,0,7,6,1,591,0,0,13,10,3,1015,0,0,0.0,0.0,0.0,0,0,0,0,0,0,0,0,0,2020-12-27 19:15:00
4924,11008,Tal Ben Haim,1715,[2008],Sunderland AFC,2,2,0,167,0,0,3,3,0,270,0,0,5,5,0,437,0,0,0.0,0.0,0.0,0,0,0,0,0,0,0,0,0,2020-12-27 19:15:00
4925,11009,Tal Ben Haim,1715,[2009],Portsmouth FC,10,10,0,900,0,0,12,11,1,1014,0,0,22,21,1,1914,0,0,0.0,0.0,0.0,0,0,0,0,0,0,0,0,0,2020-12-27 19:15:00
4926,11010,Tal Ben Haim,1715,[2010],West Ham United,3,3,0,270,0,0,5,5,0,443,0,0,8,8,0,713,0,0,0.0,0.0,0.0,0,0,0,0,0,0,0,0,0,2020-12-27 19:15:00
4927,11011,Tal Ben Haim,1715,[2012],Queens Park Rangers,3,2,1,196,0,0,0,0,0,0,0,0,3,2,1,196,0,0,0.0,0.0,0.0,0,0,0,0,0,0,0,0,0,2020-12-27 19:15:00
4928,11012,Talal El-Karkouri,1959,[2002],Sunderland AFC,4,4,0,328,0,0,4,4,0,325,0,0,8,8,0,653,0,0,0.0,0.0,0.0,0,0,0,0,0,0,0,0,0,2020-12-27 19:15:00
4929,33042,Talal El-Karkouri,1959,"[2004, 2005, 2006]",Charlton Athletic,41,34,7,3144,7,0,35,32,3,2912,1,0,76,66,10,6056,8,0,6.0,1.0,7.0,6,1,7,0,0,0,0,0,0,2020-12-27 19:15:002020-12-27 19:15:002020-12-27 19:15:00
4930,44070,Tamir Cohen,2671,"[2007, 2008, 2009, 2010]",Bolton Wanderers,22,17,5,1511,4,0,27,18,9,1443,2,0,49,35,14,2954,6,0,4.0,0.0,4.0,3,2,5,0,0,0,0,0,0,2020-12-27 19:15:002020-12-27 19:15:002020-12-27 19:15:002020-12-27 19:15:00
4931,33065,Tammy Abraham,2959,"[2015, 2019, 2020]",Chelsea FC,24,14,10,1366,8,0,26,19,7,1688,13,0,50,33,17,3054,21,0,0.0,7.0,7.0,4,6,10,0,0,0,0,0,0,2020-12-27 19:15:002020-12-27 19:15:002020-12-27 19:15:00
4932,11021,Tammy Abraham,2959,[2017],Swansea City,15,6,9,743,3,0,16,9,7,974,2,0,31,15,16,1717,5,0,0.0,1.0,1.0,2,2,4,0,0,0,0,0,0,2020-12-27 19:15:00
4933,11024,Tamás Kádár,4138,[2010],Newcastle United,0,0,0,0,0,0,0,0,0,0,0,0,0,0,0,0,0,0,0.0,0.0,0.0,0,0,0,0,0,0,0,0,0,2020-12-27 19:15:00
4934,11025,Tamás Priskin,2123,[2006],Watford FC,8,2,6,298,2,0,8,5,3,455,0,0,16,7,9,753,2,0,1.0,0.0,1.0,1,0,1,0,0,0,0,0,0,2020-12-27 19:15:00
4935,22053,Tanguy NDombèlé,2984,"[2019, 2020]",Tottenham Hotspur,15,8,7,656,2,0,19,15,4,1089,2,0,34,23,11,1745,4,0,0.0,0.0,0.0,2,2,4,0,0,0,0,0,0,2020-12-27 19:15:002020-12-27 19:15:00
4936,11028,Taribo West,3371,[2000],Derby County,11,11,0,990,0,0,5,5,0,450,0,0,16,16,0,1440,0,0,0.0,0.0,0.0,0,0,0,0,0,0,0,0,0,2020-12-27 19:15:00
4937,22059,Tariq Lamptey,2509,"[2019, 2020]",Brighton & Hove Albion,9,8,1,703,0,0,10,10,0,779,1,0,19,18,1,1482,1,0,0.0,0.0,0.0,0,1,1,0,0,0,0,0,0,2020-12-27 19:15:002020-12-27 19:15:00
4938,11031,Tashan Oakley-Boothe,3880,[2017],Tottenham Hotspur,0,0,0,0,0,0,0,0,0,0,0,0,0,0,0,0,0,0,0.0,0.0,0.0,0,0,0,0,0,0,0,0,0,2020-12-27 19:15:00
4939,11032,Taye Taïwo,2804,[2011],Queens Park Rangers,7,6,1,566,0,0,8,7,1,627,1,0,15,13,2,1193,1,0,0.0,0.0,0.0,0,0,0,0,0,0,0,0,0,2020-12-27 19:15:00
4940,11033,Taylor Harwood-Bellis,2961,[2019],Manchester City,0,0,0,0,0,0,0,0,0,0,0,0,0,0,0,0,0,0,0.0,0.0,0.0,0,0,0,0,0,0,0,0,0,2020-12-27 19:15:00
4941,23032,Taylor Perry,4210,"[2019, 2020]",Wolverhampton Wanderers,0,0,0,0,0,0,0,0,0,0,0,0,0,0,0,0,0,0,0.0,0.0,0.0,0,0,0,0,0,0,0,0,0,2020-12-27 19:15:002020-12-27 19:15:00
4942,11035,Teddy Lučić,2132,[2002],Leeds United,8,7,1,594,0,0,9,9,0,765,1,0,17,16,1,1359,1,0,0.0,0.0,0.0,0,1,1,0,0,0,0,0,0,2020-12-27 19:15:00
4943,11036,Teddy Sheringham,1076,[2000],Manchester United,14,10,4,945,11,0,15,13,2,1062,4,0,29,23,6,2007,15,0,3.0,0.0,3.0,3,3,6,1,0,1,0,0,0,2020-12-27 19:15:00
4944,22075,Teddy Sheringham,1076,"[2001, 2002]",Tottenham Hotspur,33,32,1,2873,12,0,36,34,2,2991,10,0,69,66,3,5864,22,0,7.0,3.0,10.0,8,8,16,4,2,6,0,0,0,2020-12-27 19:15:002020-12-27 19:15:00
4945,11039,Teddy Sheringham,1076,[2003],Portsmouth FC,15,12,3,1104,7,0,17,13,4,1110,2,0,32,25,7,2214,9,0,0.0,0.0,0.0,3,2,5,1,0,1,0,0,0,2020-12-27 19:15:00
4946,22081,Teddy Sheringham,1076,"[2005, 2006]",West Ham United,23,11,12,1200,7,0,18,8,10,775,1,0,41,19,22,1975,8,0,3.0,0.0,3.0,4,0,4,1,0,1,0,0,0,2020-12-27 19:15:002020-12-27 19:15:00
4947,11042,Teemu Pukki,1832,[2019],Norwich City,18,16,2,1424,7,0,18,17,1,1470,4,0,36,33,3,2894,11,0,3.0,0.0,3.0,4,2,6,1,1,2,0,0,0,2020-12-27 19:15:00
4948,33132,Teemu Tainio,1395,"[2005, 2006, 2007]",Tottenham Hotspur,31,22,9,1756,2,0,28,25,3,2053,1,0,59,47,12,3809,3,0,0.0,0.0,0.0,1,1,2,0,0,0,0,0,0,2020-12-27 19:15:002020-12-27 19:15:002020-12-27 19:15:00
4949,11046,Teemu Tainio,1395,[2008],Sunderland AFC,11,9,2,695,0,0,10,9,1,740,0,0,21,18,3,1435,0,0,0.0,0.0,0.0,0,0,0,0,0,0,0,0,0,2020-12-27 19:15:00
4950,11047,Teemu Tainio,1395,[2009],Birmingham City,2,2,0,151,0,0,4,3,1,210,0,0,6,5,1,361,0,0,0.0,0.0,0.0,0,0,0,0,0,0,0,0,0,2020-12-27 19:15:00
4951,11048,Tendayi Darikwa,3713,[2016],Burnley FC,0,0,0,0,0,0,0,0,0,0,0,0,0,0,0,0,0,0,0.0,0.0,0.0,0,0,0,0,0,0,0,0,0,2020-12-27 19:15:00
4952,22099,Terence Kongolo,3214,"[2017, 2018]",Huddersfield Town,23,21,2,1822,0,0,22,22,0,1947,1,0,45,43,2,3769,1,0,0.0,0.0,0.0,0,0,0,0,0,0,0,0,0,2020-12-27 19:15:002020-12-27 19:15:00
4953,11051,Terry Dunfield,4579,[2000],Manchester City,1,0,1,58,0,0,0,0,0,0,0,0,1,0,1,58,0,0,0.0,0.0,0.0,0,0,0,0,0,0,0,0,0,2020-12-27 19:15:00
4954,12000,Theo Corbeanu,1000,[2020],Wolverhampton Wanderers,0,0,0,0,0,0,0,0,0,0,0,0,0,0,0,0,0,0,0.0,0.0,0.0,0,0,0,0,0,0,0,0,0,2020-12-27 19:15:00
4955,11052,Theo Robinson,4317,[2006],Watford FC,1,0,1,3,0,0,0,0,0,0,0,0,1,0,1,3,0,0,0.0,0.0,0.0,0,0,0,0,0,0,0,0,0,2020-12-27 19:15:00
4956,132702,Theo Walcott,1237,"[2006, 2007, 2008, 2009, 2010, 2011, 2012, 2013, 2014, 2015, 2016, 2017]",Arsenal FC,145,93,52,8526,37,0,123,75,48,6975,28,0,268,168,100,15501,65,0,1.0,7.0,8.0,16,20,36,0,0,0,0,0,0,2020-12-27 19:15:002020-12-27 19:15:002020-12-27 19:15:002020-12-27 19:15:002020-12-27 19:15:002020-12-27 19:15:002020-12-27 19:15:002020-12-27 19:15:002020-12-27 19:15:002020-12-27 19:15:002020-12-27 19:15:002020-12-27 19:15:00
4957,33198,Theo Walcott,1237,"[2018, 2019, 2020]",Everton FC,34,23,11,1823,4,0,29,18,11,1608,3,0,63,41,22,3431,7,0,1.0,3.0,4.0,3,3,6,0,0,0,0,0,0,2020-12-27 19:15:002020-12-27 19:15:002020-12-27 19:15:00
4958,11068,Theo Walcott,1237,[2020],Southampton FC,4,4,0,348,0,0,6,6,0,492,2,0,10,10,0,840,2,0,0.0,0.0,0.0,0,2,2,0,0,0,0,0,0,2020-12-27 19:15:00
4959,11069,Theofanis Gekas,4467,[2008],Portsmouth FC,1,0,1,1,0,0,0,0,0,0,0,0,1,0,1,1,0,0,0.0,0.0,0.0,0,0,0,0,0,0,0,0,0,2020-12-27 19:15:00
4960,11070,Thiago,1051,[2020],Liverpool FC,0,0,0,0,0,0,2,1,1,134,0,0,2,1,1,134,0,0,0.0,0.0,0.0,0,0,0,0,0,0,0,0,0,2020-12-27 19:15:00
4961,11071,Thiago Silva,1003,[2020],Chelsea FC,5,5,0,450,2,0,6,6,0,523,0,0,11,11,0,973,2,0,0.0,0.0,0.0,1,0,1,0,0,0,0,0,0,2020-12-27 19:15:00
4962,11072,Thibaud Verlinden,4465,[2016],Stoke City,0,0,0,0,0,0,0,0,0,0,0,0,0,0,0,0,0,0,0.0,0.0,0.0,0,0,0,0,0,0,0,0,0,2020-12-27 19:15:00
4963,44298,Thibaut Courtois,2730,"[2014, 2015, 2016, 2017]",Chelsea FC,63,63,0,5604,0,0,63,63,0,5670,0,0,126,126,0,11274,0,0,0.0,0.0,0.0,0,0,0,0,0,0,0,0,0,2020-12-27 19:15:002020-12-27 19:15:002020-12-27 19:15:002020-12-27 19:15:00
4964,11077,Thierry Ambrose,4571,[2014],Manchester City,0,0,0,0,0,0,0,0,0,0,0,0,0,0,0,0,0,0,0.0,0.0,0.0,0,0,0,0,0,0,0,0,0,2020-12-27 19:15:00
4965,88652,Thierry Henry,2357,"[2000, 2001, 2002, 2003, 2004, 2005, 2006, 2011]",Arsenal FC,119,110,9,10046,110,0,103,94,9,8564,49,0,222,204,18,18610,159,0,32.0,11.0,43.0,57,26,83,15,6,21,0,0,0,2020-12-27 19:15:002020-12-27 19:15:002020-12-27 19:15:002020-12-27 19:15:002020-12-27 19:15:002020-12-27 19:15:002020-12-27 19:15:002020-12-27 19:15:00
4966,11086,Thievy Bifouma,3850,[2013],West Bromwich Albion,3,2,1,136,1,0,3,1,2,116,1,0,6,3,3,252,2,0,0.0,0.0,0.0,1,0,1,0,0,0,0,0,0,2020-12-27 19:15:00
4967,11087,Thimothée Atouba,3530,[2004],Tottenham Hotspur,7,5,2,507,0,0,11,10,1,892,1,0,18,15,3,1399,1,0,0.0,3.0,3.0,0,1,1,0,0,0,0,0,0,2020-12-27 19:15:00
4968,33267,Thomas Butler,1637,"[2000, 2001, 2002]",Sunderland AFC,8,4,4,451,0,0,10,5,5,551,0,0,18,9,9,1002,0,0,0.0,0.0,0.0,0,0,0,0,0,0,0,0,0,2020-12-27 19:15:002020-12-27 19:15:002020-12-27 19:15:00
4969,22183,Thomas Doyle,2962,"[2019, 2020]",Manchester City,1,0,1,15,0,0,0,0,0,0,0,0,1,0,1,15,0,0,0.0,0.0,0.0,0,0,0,0,0,0,0,0,0,2020-12-27 19:15:002020-12-27 19:15:00
4970,11093,Thomas Gaardsøe,1598,[2001],Ipswich Town,3,2,1,189,1,0,1,1,0,90,0,0,4,3,1,279,1,0,0.0,0.0,0.0,0,0,0,0,0,0,0,0,0,2020-12-27 19:15:00
4971,22189,Thomas Gaardsøe,1598,"[2004, 2005]",West Bromwich Albion,17,16,1,1506,0,0,18,16,2,1267,0,0,35,32,3,2773,0,0,0.0,0.0,0.0,0,0,0,0,0,0,0,0,0,2020-12-27 19:15:002020-12-27 19:15:00
4972,66591,Thomas Gravesen,2796,"[2000, 2001, 2002, 2003, 2004, 2007]",Everton FC,76,68,8,5976,7,0,68,59,9,5291,4,0,144,127,17,11267,11,0,0.0,3.0,3.0,2,4,6,0,2,2,0,0,0,2020-12-27 19:15:002020-12-27 19:15:002020-12-27 19:15:002020-12-27 19:15:002020-12-27 19:15:002020-12-27 19:15:00
4973,11102,Thomas Helveg,2392,[2004],Norwich City,10,10,0,855,0,0,10,6,4,483,0,0,20,16,4,1338,0,0,0.0,0.0,0.0,0,0,0,0,0,0,0,0,0,2020-12-27 19:15:00
4974,55525,Thomas Hitzlsperger,1792,"[2000, 2001, 2002, 2003, 2004]",Aston Villa,47,35,12,3238,3,0,49,36,13,3292,5,0,96,71,25,6530,8,0,3.0,6.0,9.0,2,4,6,0,0,0,0,0,0,2020-12-27 19:15:002020-12-27 19:15:002020-12-27 19:15:002020-12-27 19:15:002020-12-27 19:15:00
4975,11108,Thomas Hitzlsperger,1792,[2010],West Ham United,6,6,0,540,2,0,5,5,0,450,0,0,11,11,0,990,2,0,1.0,0.0,1.0,1,0,1,0,0,0,0,0,0,2020-12-27 19:15:00
4976,11109,Thomas Hitzlsperger,1792,[2012],Everton FC,6,3,3,269,0,0,1,1,0,82,0,0,7,4,3,351,0,0,0.0,0.0,0.0,0,0,0,0,0,0,0,0,0,2020-12-27 19:15:00
4977,11110,Thomas James,4354,[2013],Cardiff City,1,0,1,1,0,0,0,0,0,0,0,0,1,0,1,1,0,0,0.0,0.0,0.0,0,0,0,0,0,0,0,0,0,2020-12-27 19:15:00
4978,11111,Thomas Myhre,1951,[2000],Everton FC,3,3,0,270,0,0,3,3,0,270,0,0,6,6,0,540,0,0,0.0,0.0,0.0,0,0,0,0,0,0,0,0,0,2020-12-27 19:15:00
4979,11112,Thomas Myhre,1951,[2002],Sunderland AFC,0,0,0,0,0,0,2,1,1,104,0,0,2,1,1,104,0,0,0.0,0.0,0.0,0,0,0,0,0,0,0,0,0,2020-12-27 19:15:00
4980,22227,Thomas Myhre,1951,"[2005, 2006]",Charlton Athletic,11,11,0,990,0,0,10,10,0,900,0,0,21,21,0,1890,0,0,0.0,0.0,0.0,0,0,0,0,0,0,0,0,0,2020-12-27 19:15:002020-12-27 19:15:00
4981,11115,Thomas Partey,1074,[2020],Arsenal FC,2,2,0,136,0,0,3,2,1,142,0,0,5,4,1,278,0,0,0.0,0.0,0.0,0,0,0,0,0,0,0,0,0,2020-12-27 19:15:00
4982,33351,Thomas Sørensen,1090,"[2000, 2001, 2002]",Sunderland AFC,43,43,0,3828,0,0,39,39,0,3433,0,0,82,82,0,7261,0,0,0.0,0.0,0.0,0,0,0,0,0,0,0,0,0,2020-12-27 19:15:002020-12-27 19:15:002020-12-27 19:15:00
4983,44482,Thomas Sørensen,1090,"[2003, 2004, 2005, 2006]",Aston Villa,68,68,0,6016,0,0,66,66,0,5852,0,0,134,134,0,11868,0,0,0.0,0.0,0.0,0,0,0,0,0,0,0,0,0,2020-12-27 19:15:002020-12-27 19:15:002020-12-27 19:15:002020-12-27 19:15:00
4984,77882,Thomas Sørensen,1090,"[2008, 2009, 2010, 2011, 2012, 2013, 2014]",Stoke City,50,50,0,4383,0,0,49,48,1,4274,0,0,99,98,1,8657,0,0,0.0,0.0,0.0,0,0,0,0,0,0,0,0,0,2020-12-27 19:15:002020-12-27 19:15:002020-12-27 19:15:002020-12-27 19:15:002020-12-27 19:15:002020-12-27 19:15:002020-12-27 19:15:00
4985,55660,Thomas Vermaelen,2749,"[2009, 2010, 2011, 2012, 2013]",Arsenal FC,56,52,4,4628,9,0,54,46,8,4164,4,0,110,98,12,8792,13,0,4.0,3.0,7.0,5,1,6,0,0,0,0,0,0,2020-12-27 19:15:002020-12-27 19:15:002020-12-27 19:15:002020-12-27 19:15:002020-12-27 19:15:00
4986,11135,Tiago,3579,[2004],Chelsea FC,17,9,8,858,1,0,17,12,5,1108,3,0,34,21,13,1966,4,0,0.0,0.0,0.0,0,1,1,0,0,0,0,0,0,2020-12-27 19:15:00
4987,11136,Tiago Ilori,3233,[2013],Liverpool FC,0,0,0,0,0,0,0,0,0,0,0,0,0,0,0,0,0,0,0.0,0.0,0.0,0,0,0,0,0,0,0,0,0,2020-12-27 19:15:00
4988,11137,Tiago Ilori,3233,[2015],Aston Villa,0,0,0,0,0,0,0,0,0,0,0,0,0,0,0,0,0,0,0.0,0.0,0.0,0,0,0,0,0,0,0,0,0,2020-12-27 19:15:00
4989,22277,Tie Li,3387,"[2002, 2003]",Everton FC,16,15,1,1145,0,0,17,16,1,1300,0,0,33,31,2,2445,0,0,0.0,0.0,0.0,0,0,0,0,0,0,0,0,0,2020-12-27 19:15:002020-12-27 19:15:00
4990,11140,Tiemoué Bakayoko,3380,[2017],Chelsea FC,13,8,5,801,0,0,16,16,0,1383,2,0,29,24,5,2184,2,0,0.0,0.0,0.0,0,2,2,0,0,0,0,0,0,2020-12-27 19:15:00
4991,89156,Tim Cahill,1746,"[2004, 2005, 2006, 2007, 2008, 2009, 2010, 2011]",Everton FC,111,102,9,8717,25,0,108,102,6,8762,31,0,219,204,15,17479,56,0,1.0,29.0,30.0,12,24,36,0,0,0,0,0,0,2020-12-27 19:15:002020-12-27 19:15:002020-12-27 19:15:002020-12-27 19:15:002020-12-27 19:15:002020-12-27 19:15:002020-12-27 19:15:002020-12-27 19:15:00
4992,22299,Tim Flowers,1302,"[2000, 2001]",Leicester City,15,14,1,1282,0,0,11,11,0,931,0,0,26,25,1,2213,0,0,0.0,0.0,0.0,0,0,0,0,0,0,0,0,0,2020-12-27 19:15:002020-12-27 19:15:00
4993,11151,Tim Flowers,1302,[2002],Manchester City,0,0,0,0,0,0,0,0,0,0,0,0,0,0,0,0,0,0,0.0,0.0,0.0,0,0,0,0,0,0,0,0,0,2020-12-27 19:15:00
4994,33459,Tim Howard,1743,"[2003, 2004, 2005]",Manchester United,23,23,0,2070,0,0,22,21,1,1935,0,0,45,44,1,4005,0,0,0.0,0.0,0.0,0,0,0,0,0,0,0,0,0,2020-12-27 19:15:002020-12-27 19:15:002020-12-27 19:15:00
4995,111595,Tim Howard,1743,"[2006, 2007, 2008, 2009, 2010, 2011, 2012, 2013, 2014, 2015]",Everton FC,177,177,0,15886,1,0,171,171,0,15390,0,0,348,348,0,31276,1,0,0.0,0.0,0.0,1,0,1,0,0,0,0,0,0,2020-12-27 19:15:002020-12-27 19:15:002020-12-27 19:15:002020-12-27 19:15:002020-12-27 19:15:002020-12-27 19:15:002020-12-27 19:15:002020-12-27 19:15:002020-12-27 19:15:002020-12-27 19:15:00
4996,67005,Tim Krul,1822,"[2010, 2011, 2012, 2013, 2014, 2015]",Newcastle United,80,80,0,7167,0,0,77,76,1,6895,0,0,157,156,1,14062,0,0,0.0,0.0,0.0,0,0,0,0,0,0,0,0,0,2020-12-27 19:15:002020-12-27 19:15:002020-12-27 19:15:002020-12-27 19:15:002020-12-27 19:15:002020-12-27 19:15:00
4997,11171,Tim Krul,1822,[2017],Brighton & Hove Albion,0,0,0,0,0,0,0,0,0,0,0,0,0,0,0,0,0,0,0.0,0.0,0.0,0,0,0,0,0,0,0,0,0,2020-12-27 19:15:00
4998,11172,Tim Krul,1822,[2019],Norwich City,18,18,0,1620,0,0,18,18,0,1620,0,0,36,36,0,3240,0,0,0.0,0.0,0.0,0,0,0,0,0,0,0,0,0,2020-12-27 19:15:00
4999,11173,Tim Ream,2490,[2011],Bolton Wanderers,6,6,0,540,0,0,7,7,0,630,0,0,13,13,0,1170,0,0,0.0,0.0,0.0,0,0,0,0,0,0,0,0,0,2020-12-27 19:15:00
5000,22349,Tim Ream,2490,"[2018, 2020]",Fulham FC,16,15,1,1213,0,0,15,15,0,1288,0,0,31,30,1,2501,0,0,0.0,0.0,0.0,0,0,0,0,0,0,0,0,0,2020-12-27 19:15:002020-12-27 19:15:00
5001,22353,Tim Sherwood,2077,"[2000, 2001]",Tottenham Hotspur,24,22,2,2001,2,0,27,23,4,2122,0,0,51,45,6,4123,2,0,3.0,0.0,3.0,2,0,2,0,0,0,0,0,0,2020-12-27 19:15:002020-12-27 19:15:00
5002,11178,Tim Sherwood,2077,[2003],Portsmouth FC,6,4,2,379,0,0,7,3,4,290,0,0,13,7,6,669,0,0,0.0,0.0,0.0,0,0,0,0,0,0,0,0,0,2020-12-27 19:15:00
5003,22359,Timm Klose,2626,"[2015, 2019]",Norwich City,10,10,0,856,1,0,7,7,0,580,0,0,17,17,0,1436,1,0,0.0,0.0,0.0,1,0,1,0,0,0,0,0,0,2020-12-27 19:15:002020-12-27 19:15:00
5004,11181,Timo Werner,1005,[2020],Chelsea FC,7,7,0,611,3,0,8,8,0,643,1,0,15,15,0,1254,4,0,0.0,0.0,0.0,1,0,1,0,0,0,0,0,0,2020-12-27 19:15:00
5005,11182,Timothy Castagne,1045,[2020],Leicester City,4,4,0,360,0,0,4,4,0,330,1,0,8,8,0,690,1,0,0.0,0.0,0.0,0,1,1,0,0,0,0,0,0,2020-12-27 19:15:00
5006,11183,Timothy Eyoma,4067,[2018],Tottenham Hotspur,0,0,0,0,0,0,0,0,0,0,0,0,0,0,0,0,0,0,0.0,0.0,0.0,0,0,0,0,0,0,0,0,0,2020-12-27 19:15:00
5007,44746,Timothy Fosu-Mensah,2255,"[2015, 2016, 2019, 2020]",Manchester United,8,4,4,388,0,0,8,2,6,179,0,0,16,6,10,567,0,0,0.0,0.0,0.0,0,0,0,0,0,0,0,0,0,2020-12-27 19:15:002020-12-27 19:15:002020-12-27 19:15:002020-12-27 19:15:00
5008,11186,Timothy Fosu-Mensah,2255,[2017],Crystal Palace,13,9,4,874,0,0,8,8,0,720,0,0,21,17,4,1594,0,0,0.0,0.0,0.0,0,0,0,0,0,0,0,0,0,2020-12-27 19:15:00
5009,11187,Timothy Fosu-Mensah,2255,[2018],Fulham FC,6,6,0,499,0,0,6,4,2,296,0,0,12,10,2,795,0,0,0.0,0.0,0.0,0,0,0,0,0,0,0,0,0,2020-12-27 19:15:00
5010,33573,Titi Camara,3949,"[2000, 2001, 2002]",West Ham United,5,1,4,135,0,0,6,4,2,326,0,0,11,5,6,461,0,0,0.0,0.0,0.0,0,0,0,0,0,0,0,0,0,2020-12-27 19:15:002020-12-27 19:15:002020-12-27 19:15:00
5011,22387,Titus Bramble,1411,"[2000, 2001]",Ipswich Town,24,22,2,2023,1,0,18,16,2,1492,0,0,42,38,4,3515,1,0,3.0,0.0,3.0,1,0,1,0,0,0,0,0,0,2020-12-27 19:15:002020-12-27 19:15:00
5012,55985,Titus Bramble,1411,"[2002, 2003, 2004, 2005, 2006]",Newcastle United,56,52,4,4738,3,0,43,38,5,3554,0,0,99,90,9,8292,3,0,3.0,0.0,3.0,2,0,2,0,0,0,0,0,0,2020-12-27 19:15:002020-12-27 19:15:002020-12-27 19:15:002020-12-27 19:15:002020-12-27 19:15:00
5013,11200,Titus Bramble,1411,[2007],Blackburn Rovers,0,0,0,0,0,0,1,1,0,90,0,0,1,1,0,90,0,0,0.0,0.0,0.0,0,0,0,0,0,0,0,0,0,2020-12-27 19:15:00
5014,22403,Titus Bramble,1411,"[2008, 2009]",Wigan Athletic,33,33,0,2919,2,0,35,35,0,3147,1,0,68,68,0,6066,3,0,0.0,1.0,1.0,2,1,3,0,0,0,0,0,0,2020-12-27 19:15:002020-12-27 19:15:00
5015,33612,Titus Bramble,1411,"[2010, 2011, 2012]",Sunderland AFC,26,21,5,1978,1,0,21,21,0,1890,0,0,47,42,5,3868,1,0,0.0,0.0,0.0,1,0,1,0,0,0,0,0,0,2020-12-27 19:15:002020-12-27 19:15:002020-12-27 19:15:00
5016,33621,Tobias Linderoth,2797,"[2001, 2002, 2003]",Everton FC,18,12,6,1183,0,0,19,14,5,1210,0,0,37,26,11,2393,0,0,0.0,0.0,0.0,0,0,0,0,0,0,0,0,0,2020-12-27 19:15:002020-12-27 19:15:002020-12-27 19:15:00
5017,11209,Toby Alderweireld,1147,[2014],Southampton FC,13,13,0,1170,0,0,13,13,0,1093,1,0,26,26,0,2263,1,0,0.0,0.0,0.0,0,0,0,0,0,0,0,0,0,2020-12-27 19:15:00
5018,67275,Toby Alderweireld,1147,"[2015, 2016, 2017, 2018, 2019, 2020]",Tottenham Hotspur,80,78,2,6996,5,0,79,79,0,6978,2,0,159,157,2,13974,7,0,3.0,0.0,3.0,3,1,4,0,0,0,0,1,1,2020-12-27 19:15:002020-12-27 19:15:002020-12-27 19:15:002020-12-27 19:15:002020-12-27 19:15:002020-12-27 19:15:00
5019,11216,Todd Cantwell,1826,[2019],Norwich City,19,13,6,1126,5,0,18,17,1,1377,1,0,37,30,7,2503,6,0,0.0,0.0,0.0,4,1,5,0,0,0,0,0,0,2020-12-27 19:15:00
5020,11217,Tokelo Rantie,1012,[2015],AFC Bournemouth,2,0,2,30,0,0,1,0,1,8,0,0,3,0,3,38,0,0,0.0,0.0,0.0,0,0,0,0,0,0,0,0,0,2020-12-27 19:15:00
5021,11218,Tom Allan,3037,[2019],Newcastle United,0,0,0,0,0,0,0,0,0,0,0,0,0,0,0,0,0,0,0.0,0.0,0.0,0,0,0,0,0,0,0,0,0,2020-12-27 19:15:00
5022,11219,Tom Beadling,4501,[2015],Sunderland AFC,0,0,0,0,0,0,0,0,0,0,0,0,0,0,0,0,0,0,0.0,0.0,0.0,0,0,0,0,0,0,0,0,0,2020-12-27 19:15:00
5023,11220,Tom Cairney,1611,[2009],Hull City,6,5,1,474,0,0,5,5,0,424,1,0,11,10,1,898,1,0,0.0,0.0,0.0,0,1,1,0,0,0,0,0,0,2020-12-27 19:15:00
5024,22443,Tom Cairney,1611,"[2018, 2020]",Fulham FC,21,16,5,1525,2,0,20,17,3,1433,0,0,41,33,8,2958,2,0,0.0,0.0,0.0,1,0,1,0,0,0,0,0,0,2020-12-27 19:15:002020-12-27 19:15:00
5025,44899,Tom Carroll,2816,"[2011, 2012, 2013, 2015]",Tottenham Hotspur,12,2,10,246,1,0,14,2,12,333,0,0,26,4,22,579,1,0,0.0,0.0,0.0,0,0,0,0,0,0,0,0,0,2020-12-27 19:15:002020-12-27 19:15:002020-12-27 19:15:002020-12-27 19:15:00
5026,33683,Tom Carroll,2816,"[2014, 2016, 2017]",Swansea City,34,25,9,2290,1,0,33,27,6,2361,0,0,67,52,15,4651,1,0,0.0,0.0,0.0,0,0,0,0,0,0,0,0,0,2020-12-27 19:15:002020-12-27 19:15:002020-12-27 19:15:00
5027,11230,Tom Cleverley,2091,[2010],Wigan Athletic,12,9,3,800,2,0,13,10,3,835,2,0,25,19,6,1635,4,0,1.0,0.0,1.0,2,0,2,0,0,0,0,0,0,2020-12-27 19:15:00
5028,33696,Tom Cleverley,2091,"[2011, 2012, 2013]",Manchester United,25,16,9,1397,1,0,28,24,4,1981,2,0,53,40,13,3378,3,0,0.0,0.0,0.0,0,0,0,0,0,0,0,0,0,2020-12-27 19:15:002020-12-27 19:15:002020-12-27 19:15:00
5029,11234,Tom Cleverley,2091,[2014],Aston Villa,15,15,0,1122,2,0,16,16,0,1398,1,0,31,31,0,2520,3,0,3.0,0.0,3.0,1,0,1,0,0,0,0,0,0,2020-12-27 19:15:00
5030,22471,Tom Cleverley,2091,"[2015, 2016]",Everton FC,16,11,5,1096,1,0,16,10,6,945,1,0,32,21,11,2041,2,0,0.0,3.0,3.0,1,1,2,0,0,0,0,0,0,2020-12-27 19:15:002020-12-27 19:15:00
5031,33714,Tom Cleverley,2091,"[2017, 2018, 2019]",Watford FC,23,17,6,1426,2,0,31,20,11,1921,1,0,54,37,17,3347,3,0,3.0,3.0,6.0,1,1,2,0,0,0,0,0,0,2020-12-27 19:15:002020-12-27 19:15:002020-12-27 19:15:00
5032,22481,Tom Craddock,3753,"[2005, 2007]",Middlesbrough FC,1,0,1,8,0,0,3,1,2,97,0,0,4,1,3,105,0,0,0.0,0.0,0.0,0,0,0,0,0,0,0,0,0,2020-12-27 19:15:002020-12-27 19:15:00
5033,67467,Tom Davies,1063,"[2015, 2016, 2017, 2018, 2019, 2020]",Everton FC,59,38,21,3713,4,0,54,38,16,3168,1,0,113,76,37,6881,5,0,1.0,0.0,1.0,2,1,3,0,0,0,0,0,0,2020-12-27 19:15:002020-12-27 19:15:002020-12-27 19:15:002020-12-27 19:15:002020-12-27 19:15:002020-12-27 19:15:00
5034,11248,Tom Dele-Bashiru,3951,[2019],Watford FC,0,0,0,0,0,0,0,0,0,0,0,0,0,0,0,0,0,0,0.0,0.0,0.0,0,0,0,0,0,0,0,0,0,2020-12-27 19:15:00
5035,22499,Tom Edwards,2377,"[2016, 2017]",Stoke City,2,2,0,180,0,0,4,4,0,303,0,0,6,6,0,483,0,0,0.0,0.0,0.0,0,0,0,0,0,0,0,0,0,2020-12-27 19:15:002020-12-27 19:15:00
5036,45010,Tom Heaton,1249,"[2014, 2016, 2017, 2018]",Burnley FC,49,49,0,4356,0,0,47,47,0,4230,0,0,96,96,0,8586,0,0,0.0,0.0,0.0,0,0,0,0,0,0,0,0,0,2020-12-27 19:15:002020-12-27 19:15:002020-12-27 19:15:002020-12-27 19:15:00
5037,23259,Tom Heaton,1249,"[2019, 2020]",Aston Villa,10,10,0,900,0,0,10,10,0,895,0,0,20,20,0,1795,0,0,0.0,0.0,0.0,0,0,0,0,0,0,0,0,0,2020-12-27 19:15:002020-12-27 19:15:00
5038,11256,Tom Hopper,4175,[2014],Leicester City,0,0,0,0,0,0,0,0,0,0,0,0,0,0,0,0,0,0,0.0,0.0,0.0,0,0,0,0,0,0,0,0,0,2020-12-27 19:15:00
5039,90084,Tom Huddlestone,1270,"[2005, 2006, 2007, 2008, 2009, 2010, 2011, 2012]",Tottenham Hotspur,81,59,22,5725,6,0,60,42,18,4030,2,0,141,101,40,9755,8,0,3.0,3.0,6.0,2,1,3,0,0,0,0,0,0,2020-12-27 19:15:002020-12-27 19:15:002020-12-27 19:15:002020-12-27 19:15:002020-12-27 19:15:002020-12-27 19:15:002020-12-27 19:15:002020-12-27 19:15:00
5040,33798,Tom Huddlestone,1270,"[2013, 2014, 2016]",Hull City,49,44,5,3916,2,0,49,44,5,3865,1,0,98,88,10,7781,3,0,0.0,0.0,0.0,1,1,2,1,0,1,0,0,0,2020-12-27 19:15:002020-12-27 19:15:002020-12-27 19:15:00
5041,11268,Tom Ince,2232,[2013],Crystal Palace,5,2,3,222,1,0,3,3,0,191,0,0,8,5,3,413,1,0,0.0,0.0,0.0,1,0,1,0,0,0,0,0,0,2020-12-27 19:15:00
5042,11269,Tom Ince,2232,[2014],Hull City,3,1,2,108,0,0,4,2,2,192,0,0,7,3,4,300,0,0,0.0,0.0,0.0,0,0,0,0,0,0,0,0,0,2020-12-27 19:15:00
5043,11270,Tom Ince,2232,[2017],Huddersfield Town,18,16,2,1350,2,0,15,11,4,1106,0,0,33,27,6,2456,2,0,3.0,0.0,3.0,2,0,2,0,0,0,0,0,0,2020-12-27 19:15:00
5044,11271,Tom Lawrence,3730,[2013],Manchester United,1,1,0,70,0,0,0,0,0,0,0,0,1,1,0,70,0,0,0.0,0.0,0.0,0,0,0,0,0,0,0,0,0,2020-12-27 19:15:00
5045,11272,Tom Lawrence,3730,[2014],Leicester City,3,0,3,51,0,0,0,0,0,0,0,0,3,0,3,51,0,0,0.0,0.0,0.0,0,0,0,0,0,0,0,0,0,2020-12-27 19:15:00
5046,33822,Tom Robson,2527,"[2014, 2015, 2016]",Sunderland AFC,0,0,0,0,0,0,1,1,0,90,0,0,1,1,0,90,0,0,0.0,0.0,0.0,0,0,0,0,0,0,0,0,0,2020-12-27 19:15:002020-12-27 19:15:002020-12-27 19:15:00
5047,22553,Tom Smith,3106,"[2017, 2018]",Huddersfield Town,17,14,3,1356,0,0,22,20,2,1762,0,0,39,34,5,3118,0,0,0.0,0.0,0.0,0,0,0,0,0,0,0,0,0,2020-12-27 19:15:002020-12-27 19:15:00
5048,11278,Tom Soares,1991,[2004],Crystal Palace,9,7,2,659,0,0,13,9,4,894,0,0,22,16,6,1553,0,0,0.0,0.0,0.0,0,0,0,0,0,0,0,0,0,2020-12-27 19:15:00
5049,33840,Tom Soares,1991,"[2008, 2010, 2011]",Stoke City,4,4,0,287,0,0,3,1,2,125,0,0,7,5,2,412,0,0,0.0,0.0,0.0,0,0,0,0,0,0,0,0,0,2020-12-27 19:15:002020-12-27 19:15:002020-12-27 19:15:00
5050,11282,Tom Thorpe,4429,[2014],Manchester United,1,0,1,1,0,0,0,0,0,0,0,0,1,0,1,1,0,0,0.0,0.0,0.0,0,0,0,0,0,0,0,0,0,2020-12-27 19:15:00
5051,11283,Tom Trybull,2178,[2019],Norwich City,7,6,1,511,0,0,9,8,1,627,0,0,16,14,2,1138,0,0,0.0,0.0,0.0,0,0,0,0,0,0,0,0,0,2020-12-27 19:15:00
5052,11284,Tomas Danilevičius,4290,[2000],Arsenal FC,1,0,1,11,0,0,1,0,1,26,0,0,2,0,2,37,0,0,0.0,0.0,0.0,0,0,0,0,0,0,0,0,0,2020-12-27 19:15:00
5053,22571,Tomasz Kuszczak,1786,"[2004, 2005]",West Bromwich Albion,15,15,0,1350,0,0,15,14,1,1299,0,0,30,29,1,2649,0,0,0.0,0.0,0.0,0,0,0,0,0,0,0,0,0,2020-12-27 19:15:002020-12-27 19:15:00
5054,67737,Tomasz Kuszczak,1786,"[2006, 2007, 2008, 2009, 2010, 2011]",Manchester United,17,17,0,1530,0,0,15,13,2,1272,0,0,32,30,2,2802,0,0,0.0,0.0,0.0,0,0,0,0,0,0,0,0,0,2020-12-27 19:15:002020-12-27 19:15:002020-12-27 19:15:002020-12-27 19:15:002020-12-27 19:15:002020-12-27 19:15:00
5055,33882,Tomasz Radzinski,1935,"[2001, 2002, 2003]",Everton FC,46,36,10,3274,18,0,41,38,3,3265,7,0,87,74,13,6539,25,0,15.0,1.0,16.0,15,4,19,0,0,0,0,0,0,2020-12-27 19:15:002020-12-27 19:15:002020-12-27 19:15:00
5056,33891,Tomasz Radzinski,1935,"[2004, 2005, 2006]",Fulham FC,49,36,13,3171,6,0,48,31,17,3030,4,0,97,67,30,6201,10,0,3.0,0.0,3.0,1,2,3,0,0,0,0,0,0,2020-12-27 19:15:002020-12-27 19:15:002020-12-27 19:15:00
5057,11299,Tomer Hemed,2662,[2017],Brighton & Hove Albion,7,5,2,420,2,0,9,4,5,428,0,0,16,9,7,848,2,0,3.0,0.0,3.0,1,0,1,0,0,0,0,0,0,2020-12-27 19:15:00
5058,22601,Tommie Hoban,3815,"[2015, 2016]",Watford FC,0,0,0,0,0,0,0,0,0,0,0,0,0,0,0,0,0,0,0.0,0.0,0.0,0,0,0,0,0,0,0,0,0,2020-12-27 19:15:002020-12-27 19:15:00
5059,11302,Tommy Elphick,3206,[2015],AFC Bournemouth,6,5,1,472,1,0,6,6,0,540,0,0,12,11,1,1012,1,0,0.0,0.0,0.0,0,0,0,0,0,0,0,0,0,2020-12-27 19:15:00
5060,11303,Tommy Miller,3221,[2001],Ipswich Town,2,2,0,180,0,0,6,3,3,334,0,0,8,5,3,514,0,0,0.0,0.0,0.0,0,0,0,0,0,0,0,0,0,2020-12-27 19:15:00
5061,11304,Tommy Miller,3221,[2005],Sunderland AFC,16,16,0,1322,1,0,13,11,2,994,2,0,29,27,2,2316,3,0,0.0,0.0,0.0,1,2,3,0,0,0,0,0,0,2020-12-27 19:15:00
5062,11305,Tommy Mooney,4089,[2002],Birmingham City,1,0,1,5,0,0,0,0,0,0,0,0,1,0,1,5,0,0,0.0,0.0,0.0,0,0,0,0,0,0,0,0,0,2020-12-27 19:15:00
5063,11306,Tommy Smith,2121,[2006],Watford FC,13,13,0,1135,1,0,16,16,0,1202,0,0,29,29,0,2337,1,0,0.0,0.0,0.0,1,0,1,0,0,0,0,0,0,2020-12-27 19:15:00
5064,11307,Tommy Smith,2121,[2009],Portsmouth FC,10,7,3,575,1,0,6,5,1,451,0,0,16,12,4,1026,1,0,0.0,0.0,0.0,1,0,1,0,0,0,0,0,0,2020-12-27 19:15:00
5065,11308,Tommy Smith,2121,[2011],Queens Park Rangers,7,1,6,162,1,0,10,3,7,378,1,0,17,4,13,540,2,0,0.0,3.0,3.0,0,1,1,0,0,0,0,0,0,2020-12-27 19:15:00
5066,11309,Tommy Smith,2121,[2013],Cardiff City,0,0,0,0,0,0,0,0,0,0,0,0,0,0,0,0,0,0,0.0,0.0,0.0,0,0,0,0,0,0,0,0,0,2020-12-27 19:15:00
5067,11310,Tommy Williamson,4520,[2001],Leicester City,1,0,1,1,0,0,0,0,0,0,0,0,1,0,1,1,0,0,0.0,0.0,0.0,0,0,0,0,0,0,0,0,0,2020-12-27 19:15:00
5068,11311,Tommy Wright,4452,[2001],Leicester City,1,0,1,4,0,0,0,0,0,0,0,0,1,0,1,4,0,0,0.0,0.0,0.0,0,0,0,0,0,0,0,0,0,2020-12-27 19:15:00
5069,11312,Tomáš Kalas,1542,[2013],Chelsea FC,0,0,0,0,0,0,2,2,0,180,0,0,2,2,0,180,0,0,0.0,0.0,0.0,0,0,0,0,0,0,0,0,0,2020-12-27 19:15:00
5070,90532,Tomáš Rosický,1509,"[2006, 2007, 2009, 2010, 2011, 2012, 2013, 2014]",Arsenal FC,86,58,28,5205,12,0,82,47,35,4543,7,0,168,105,63,9748,19,0,4.0,3.0,7.0,5,2,7,0,0,0,0,0,0,2020-12-27 19:15:002020-12-27 19:15:002020-12-27 19:15:002020-12-27 19:15:002020-12-27 19:15:002020-12-27 19:15:002020-12-27 19:15:002020-12-27 19:15:00
5071,22643,Tomáš Souček,4057,"[2019, 2020]",West Ham United,14,14,0,1255,5,0,14,13,1,1136,2,0,28,27,1,2391,7,0,4.0,0.0,4.0,4,2,6,0,0,0,0,0,0,2020-12-27 19:15:002020-12-27 19:15:00
5072,33972,Tomáš Řepka,1625,"[2001, 2002, 2005]",West Ham United,39,39,0,3451,0,0,39,39,0,3285,0,0,78,78,0,6736,0,0,0.0,0.0,0.0,0,0,0,0,0,0,0,0,0,2020-12-27 19:15:002020-12-27 19:15:002020-12-27 19:15:00
5073,22653,Toni Kallio,2037,"[2008, 2009]",Fulham FC,2,1,1,87,0,0,2,1,1,134,0,0,4,2,2,221,0,0,0.0,0.0,0.0,0,0,0,0,0,0,0,0,0,2020-12-27 19:15:002020-12-27 19:15:00
5074,11328,Toni Martínez,4460,[2017],West Ham United,0,0,0,0,0,0,0,0,0,0,0,0,0,0,0,0,0,0,0.0,0.0,0.0,0,0,0,0,0,0,0,0,0,2020-12-27 19:15:00
5075,22659,Tony Adams,3243,"[2000, 2001]",Arsenal FC,24,24,0,2160,1,0,11,11,0,977,0,0,35,35,0,3137,1,0,0.0,0.0,0.0,0,0,0,0,0,0,0,0,0,2020-12-27 19:15:002020-12-27 19:15:00
5076,11331,Tony Andreu,4366,[2015],Norwich City,0,0,0,0,0,0,0,0,0,0,0,0,0,0,0,0,0,0,0.0,0.0,0.0,0,0,0,0,0,0,0,0,0,2020-12-27 19:15:00
5077,11332,Tony Caig,4390,[2000],Charlton Athletic,1,0,1,45,0,0,0,0,0,0,0,0,1,0,1,45,0,0,0.0,0.0,0.0,0,0,0,0,0,0,0,0,0,2020-12-27 19:15:00
5078,11333,Tony Cottee,4547,[2000],Leicester City,0,0,0,0,0,0,2,0,2,24,0,0,2,0,2,24,0,0,0.0,0.0,0.0,0,0,0,0,0,0,0,0,0,2020-12-27 19:15:00
5079,11334,Tony Grant,3308,[2000],Manchester City,4,1,3,180,0,0,5,3,2,230,0,0,9,4,5,410,0,0,0.0,0.0,0.0,0,0,0,0,0,0,0,0,0,2020-12-27 19:15:00
5080,181480,Tony Hibbert,1744,"[2000, 2001, 2002, 2003, 2004, 2005, 2006, 2007, 2008, 2009, 2010, 2011, 2012, 2013, 2014, 2015]",Everton FC,133,120,13,10606,0,0,123,113,10,10059,0,0,256,233,23,20665,0,0,0.0,0.0,0.0,0,0,0,0,0,0,0,0,0,2020-12-27 19:15:002020-12-27 19:15:002020-12-27 19:15:002020-12-27 19:15:002020-12-27 19:15:002020-12-27 19:15:002020-12-27 19:15:002020-12-27 19:15:002020-12-27 19:15:002020-12-27 19:15:002020-12-27 19:15:002020-12-27 19:15:002020-12-27 19:15:002020-12-27 19:15:002020-12-27 19:15:002020-12-27 19:15:00
5081,45410,Tony McMahon,1332,"[2004, 2005, 2007, 2008]",Middlesbrough FC,14,13,1,1141,0,0,16,15,1,1167,0,0,30,28,2,2308,0,0,0.0,0.0,0.0,0,0,0,0,0,0,0,0,0,2020-12-27 19:15:002020-12-27 19:15:002020-12-27 19:15:002020-12-27 19:15:00
5082,11355,Tony Popovic,2022,[2004],Crystal Palace,11,10,1,880,0,0,11,10,1,871,0,0,22,20,2,1751,0,0,0.0,0.0,0.0,0,0,0,0,0,0,0,0,0,2020-12-27 19:15:00
5083,11356,Tony Vidmar,3428,[2002],Middlesbrough FC,6,6,0,495,0,0,5,3,2,386,0,0,11,9,2,881,0,0,0.0,0.0,0.0,0,0,0,0,0,0,0,0,0,2020-12-27 19:15:00
5084,22715,Tony Warner,3268,"[2005, 2007]",Fulham FC,8,7,1,657,0,0,12,11,1,1009,0,0,20,18,2,1666,0,0,0.0,0.0,0.0,0,0,0,0,0,0,0,0,0,2020-12-27 19:15:002020-12-27 19:15:00
5085,11359,Tope Obadeyi,4167,[2008],Bolton Wanderers,2,0,2,29,0,0,1,0,1,12,0,0,3,0,3,41,0,0,0.0,0.0,0.0,0,0,0,0,0,0,0,0,0,2020-12-27 19:15:00
5086,11360,Tore André Flo,3482,[2000],Chelsea FC,7,1,6,231,1,0,6,3,3,386,2,0,13,4,9,617,3,0,0.0,1.0,1.0,0,1,1,0,0,0,0,0,0,2020-12-27 19:15:00
5087,11361,Tore André Flo,3482,[2002],Sunderland AFC,13,12,1,999,2,0,16,11,5,996,2,0,29,23,6,1995,4,0,1.0,0.0,1.0,1,2,3,0,0,0,0,0,0,2020-12-27 19:15:00
5088,22725,Tosin Adarabioyo,2778,"[2016, 2017]",Manchester City,0,0,0,0,0,0,0,0,0,0,0,0,0,0,0,0,0,0,0.0,0.0,0.0,0,0,0,0,0,0,0,0,0,2020-12-27 19:15:002020-12-27 19:15:00
5089,11364,Tosin Adarabioyo,2778,[2020],Fulham FC,6,6,0,540,0,0,5,5,0,450,0,0,11,11,0,990,0,0,0.0,0.0,0.0,0,0,0,0,0,0,0,0,0,2020-12-27 19:15:00
5090,56835,Trent Alexander-Arnold,1192,"[2016, 2017, 2018, 2019, 2020]",Liverpool FC,55,48,7,4339,3,0,51,46,5,4098,3,0,106,94,12,8437,6,0,0.0,0.0,0.0,1,1,2,0,0,0,0,0,0,2020-12-27 19:15:002020-12-27 19:15:002020-12-27 19:15:002020-12-27 19:15:002020-12-27 19:15:00
5091,11370,Trevoh Chalobah,4104,[2017],Chelsea FC,0,0,0,0,0,0,0,0,0,0,0,0,0,0,0,0,0,0,0.0,0.0,0.0,0,0,0,0,0,0,0,0,0,2020-12-27 19:15:00
5092,34116,Trevor Benjamin,1314,"[2000, 2001, 2003]",Leicester City,15,4,11,452,0,0,21,9,12,918,1,0,36,13,23,1370,1,0,0.0,0.0,0.0,0,0,0,0,0,0,0,0,0,2020-12-27 19:15:002020-12-27 19:15:002020-12-27 19:15:00
5093,22749,Trevor Carson,3885,"[2010, 2011]",Sunderland AFC,0,0,0,0,0,0,0,0,0,0,0,0,0,0,0,0,0,0,0.0,0.0,0.0,0,0,0,0,0,0,0,0,0,2020-12-27 19:15:002020-12-27 19:15:00
5094,34131,Trevor Sinclair,1628,"[2000, 2001, 2002]",West Ham United,38,37,1,3288,11,0,41,40,1,3537,6,0,79,77,2,6825,17,0,7.0,9.0,16.0,8,5,13,1,0,1,0,0,0,2020-12-27 19:15:002020-12-27 19:15:002020-12-27 19:15:00
5095,45522,Trevor Sinclair,1628,"[2003, 2004, 2005, 2006]",Manchester City,41,31,10,2790,3,0,40,33,7,2999,2,0,81,64,17,5789,5,0,0.0,0.0,0.0,1,1,2,0,0,0,0,0,0,2020-12-27 19:15:002020-12-27 19:15:002020-12-27 19:15:002020-12-27 19:15:00
5096,22767,Trezeguet,2848,"[2019, 2020]",Aston Villa,22,12,10,1274,4,0,21,16,5,1434,2,0,43,28,15,2708,6,0,3.0,0.0,3.0,3,1,4,0,0,0,0,0,0,2020-12-27 19:15:002020-12-27 19:15:00
5097,11385,Trond Soltvedt,3020,[2000],Southampton FC,3,1,2,142,0,0,2,1,1,134,1,0,5,2,3,276,1,0,0.0,0.0,0.0,0,1,1,0,0,0,0,0,0,2020-12-27 19:15:00
5098,56940,Troy Deeney,1928,"[2015, 2016, 2017, 2018, 2019]",Watford FC,82,73,9,6788,27,0,81,68,13,6205,20,0,163,141,22,12993,47,0,14.0,3.0,17.0,19,11,30,13,5,18,0,0,0,2020-12-27 19:15:002020-12-27 19:15:002020-12-27 19:15:002020-12-27 19:15:002020-12-27 19:15:00
5099,11391,Troy Hewitt,3671,[2011],Queens Park Rangers,0,0,0,0,0,0,0,0,0,0,0,0,0,0,0,0,0,0,0.0,0.0,0.0,0,0,0,0,0,0,0,0,0,2020-12-27 19:15:00
5100,11392,Troy Parrott,4003,[2019],Tottenham Hotspur,2,0,2,6,0,0,0,0,0,0,0,0,2,0,2,6,0,0,0.0,0.0,0.0,0,0,0,0,0,0,0,0,0,2020-12-27 19:15:00
5101,11393,Tudor Băluţă,2931,[2019],Brighton & Hove Albion,0,0,0,0,0,0,0,0,0,0,0,0,0,0,0,0,0,0,0.0,0.0,0.0,0,0,0,0,0,0,0,0,0,2020-12-27 19:15:00
5102,91180,Tugay Kerimoğlu,1136,"[2001, 2002, 2003, 2004, 2005, 2006, 2007, 2008]",Blackburn Rovers,121,92,29,8478,8,0,103,83,20,7318,3,0,224,175,49,15796,11,0,3.0,0.0,3.0,4,2,6,0,0,0,0,0,0,2020-12-27 19:15:002020-12-27 19:15:002020-12-27 19:15:002020-12-27 19:15:002020-12-27 19:15:002020-12-27 19:15:002020-12-27 19:15:002020-12-27 19:15:00
5103,22805,Tuncay Şanlı,2220,"[2007, 2008]",Middlesbrough FC,34,30,4,2448,7,0,33,27,6,2441,8,0,67,57,10,4889,15,0,6.0,10.0,16.0,4,8,12,0,0,0,0,0,0,2020-12-27 19:15:002020-12-27 19:15:00
5104,22809,Tuncay Şanlı,2220,"[2009, 2010]",Stoke City,23,7,16,843,3,0,21,11,10,1152,2,0,44,18,26,1995,5,0,0.0,1.0,1.0,3,2,5,0,0,0,0,0,0,2020-12-27 19:15:002020-12-27 19:15:00
5105,11406,Tuncay Şanlı,2220,[2011],Bolton Wanderers,11,2,9,239,0,0,5,1,4,145,0,0,16,3,13,384,0,0,0.0,0.0,0.0,0,0,0,0,0,0,0,0,0,2020-12-27 19:15:00
5106,57045,Tyias Browning,3608,"[2012, 2013, 2014, 2015, 2018]",Everton FC,2,1,1,135,0,0,5,2,3,193,0,0,7,3,4,328,0,0,0.0,0.0,0.0,0,0,0,0,0,0,0,0,0,2020-12-27 19:15:002020-12-27 19:15:002020-12-27 19:15:002020-12-27 19:15:002020-12-27 19:15:00
5107,11412,Tyler Blackett,2380,[2014],Manchester United,5,2,3,241,0,0,6,4,2,414,0,0,11,6,5,655,0,0,0.0,0.0,0.0,0,0,0,0,0,0,0,0,0,2020-12-27 19:15:00
5108,22827,Tyler Roberts,4303,"[2014, 2015]",West Bromwich Albion,1,0,1,17,0,0,0,0,0,0,0,0,1,0,1,17,0,0,0.0,0.0,0.0,0,0,0,0,0,0,0,0,0,2020-12-27 19:15:002020-12-27 19:15:00
5109,11415,Tyler Roberts,4303,[2020],Leeds United,5,1,4,145,0,0,3,1,2,93,0,0,8,2,6,238,0,0,0.0,0.0,0.0,0,0,0,0,0,0,0,0,0,2020-12-27 19:15:00
5110,11416,Tyreece John-Jules,4475,[2019],Arsenal FC,0,0,0,0,0,0,0,0,0,0,0,0,0,0,0,0,0,0,0.0,0.0,0.0,0,0,0,0,0,0,0,0,0,2020-12-27 19:15:00
5111,11417,Tyreke Johnson,4051,[2018],Southampton FC,1,0,1,1,0,0,0,0,0,0,0,0,1,0,1,1,0,0,0.0,0.0,0.0,0,0,0,0,0,0,0,0,0,2020-12-27 19:15:00
5112,11418,Tyrese Campbell,3324,[2017],Stoke City,3,0,3,49,0,0,1,0,1,26,0,0,4,0,4,75,0,0,0.0,0.0,0.0,0,0,0,0,0,0,0,0,0,2020-12-27 19:15:00
5113,22839,Tyrick Mitchell,2316,"[2019, 2020]",Crystal Palace,5,4,1,366,0,0,5,4,1,367,0,0,10,8,2,733,0,0,0.0,0.0,0.0,0,0,0,0,0,0,0,0,0,2020-12-27 19:15:002020-12-27 19:15:00
5114,11421,Tyrone Mears,1572,[2006],West Ham United,4,3,1,206,0,0,1,0,1,9,0,0,5,3,2,215,0,0,0.0,0.0,0.0,0,0,0,0,0,0,0,0,0,2020-12-27 19:15:00
5115,11422,Tyrone Mears,1572,[2007],Derby County,13,12,1,1081,0,0,12,10,2,914,1,0,25,22,3,1995,1,0,0.0,0.0,0.0,0,1,1,0,0,0,0,0,0,2020-12-27 19:15:00
5116,11423,Tyrone Mears,1572,[2009],Burnley FC,19,19,0,1710,0,0,19,19,0,1710,0,0,38,38,0,3420,0,0,0.0,0.0,0.0,0,0,0,0,0,0,0,0,0,2020-12-27 19:15:00
5117,11424,Tyrone Mears,1572,[2011],Bolton Wanderers,0,0,0,0,0,0,1,1,0,90,0,0,1,1,0,90,0,0,0.0,0.0,0.0,0,0,0,0,0,0,0,0,0,2020-12-27 19:15:00
5118,45706,Tyrone Mings,2772,"[2015, 2016, 2017, 2018]",AFC Bournemouth,8,2,6,301,0,0,9,8,1,594,0,0,17,10,7,895,0,0,0.0,0.0,0.0,0,0,0,0,0,0,0,0,0,2020-12-27 19:15:002020-12-27 19:15:002020-12-27 19:15:002020-12-27 19:15:00
5119,22859,Tyrone Mings,2772,"[2019, 2020]",Aston Villa,23,23,0,2003,2,0,23,23,0,2070,2,0,46,46,0,4073,4,0,3.0,1.0,4.0,1,1,2,0,0,0,0,0,0,2020-12-27 19:15:002020-12-27 19:15:00
5120,68601,Ugo Ehiogu,2134,"[2000, 2001, 2002, 2003, 2004, 2005]",Middlesbrough FC,64,61,3,5364,6,0,57,56,1,4794,1,0,121,117,4,10158,7,0,4.0,1.0,5.0,4,1,5,0,0,0,0,0,0,2020-12-27 19:15:002020-12-27 19:15:002020-12-27 19:15:002020-12-27 19:15:002020-12-27 19:15:002020-12-27 19:15:00
5121,45754,Ulises De la Cruz,1794,"[2002, 2003, 2004, 2005]",Aston Villa,46,35,11,3339,1,0,40,28,12,2764,0,0,86,63,23,6103,1,0,0.0,0.0,0.0,1,0,1,0,0,0,0,0,0,2020-12-27 19:15:002020-12-27 19:15:002020-12-27 19:15:002020-12-27 19:15:00
5122,22883,Ulises De la Cruz,1794,"[2006, 2007]",Reading FC,6,4,2,391,1,0,7,7,0,590,0,0,13,11,2,981,1,0,0.0,0.0,0.0,0,0,0,0,0,0,0,0,0,2020-12-27 19:15:002020-12-27 19:15:00
5123,11443,Ulrich Le Pen,4342,[2001],Ipswich Town,1,0,1,11,0,0,0,0,0,0,0,0,1,0,1,11,0,0,0.0,0.0,0.0,0,0,0,0,0,0,0,0,0,2020-12-27 19:15:00
5124,11444,Urby Emanuelson,3639,[2012],Fulham FC,7,3,4,420,0,0,6,2,4,233,1,0,13,5,8,653,1,0,0.0,0.0,0.0,0,0,0,0,0,0,0,0,0,2020-12-27 19:15:00
5125,11445,Uwe Hünemeier,3018,[2017],Brighton & Hove Albion,1,0,1,17,0,0,0,0,0,0,0,0,1,0,1,17,0,0,0.0,0.0,0.0,0,0,0,0,0,0,0,0,0,2020-12-27 19:15:00
5126,22893,Uwe Rösler,3021,"[2000, 2001]",Southampton FC,10,4,6,374,0,0,13,5,8,554,0,0,23,9,14,928,0,0,0.0,0.0,0.0,0,0,0,0,0,0,0,0,0,2020-12-27 19:15:002020-12-27 19:15:00
5127,11448,Vadis Odjidja-Ofoe,3718,[2015],Norwich City,5,0,5,59,0,0,5,3,2,216,0,0,10,3,7,275,0,0,0.0,0.0,0.0,0,0,0,0,0,0,0,0,0,2020-12-27 19:15:00
5128,22899,Valentin Roberge,3188,"[2013, 2014]",Sunderland AFC,5,4,1,348,0,0,5,4,1,412,0,0,10,8,2,760,0,0,0.0,0.0,0.0,0,0,0,0,0,0,0,0,0,2020-12-27 19:15:002020-12-27 19:15:00
5129,11451,Valentino Lazaro,3654,[2019],Newcastle United,6,1,5,191,0,0,7,3,4,283,1,0,13,4,9,474,1,0,0.0,0.0,0.0,0,0,0,0,0,0,0,0,0,2020-12-27 19:15:00
5130,22905,Valeri Bojinov,3890,"[2007, 2008]",Manchester City,6,3,3,175,0,0,5,0,5,95,1,0,11,3,8,270,1,0,0.0,0.0,0.0,0,1,1,0,0,0,0,0,0,2020-12-27 19:15:002020-12-27 19:15:00
5131,34365,Valon Behrami,1284,"[2008, 2009, 2010]",West Ham United,29,27,2,2268,2,0,28,26,2,2215,2,0,57,53,4,4483,4,0,0.0,3.0,3.0,2,1,3,0,0,0,0,0,0,2020-12-27 19:15:002020-12-27 19:15:002020-12-27 19:15:00
5132,22915,Valon Behrami,1284,"[2015, 2016]",Watford FC,26,22,4,1852,0,0,22,18,4,1491,0,0,48,40,8,3343,0,0,0.0,0.0,0.0,0,0,0,0,0,0,0,0,0,2020-12-27 19:15:002020-12-27 19:15:00
5133,11459,Valéry Mézague,4019,[2004],Portsmouth FC,3,1,2,130,0,0,8,2,6,241,0,0,11,3,8,371,0,0,0.0,0.0,0.0,0,0,0,0,0,0,0,0,0,2020-12-27 19:15:00
5134,11460,Vangelis Moras,3945,[2011],Swansea City,0,0,0,0,0,0,1,0,1,5,0,0,1,0,1,5,0,0,0.0,0.0,0.0,0,0,0,0,0,0,0,0,0,2020-12-27 19:15:00
5135,11461,Varela,3798,[2014],West Bromwich Albion,3,2,1,182,0,0,4,1,3,151,1,0,7,3,4,333,1,0,0.0,0.0,0.0,0,0,0,0,0,0,0,0,0,2020-12-27 19:15:00
5136,11462,Vassilios Lakis,2029,[2004],Crystal Palace,10,2,8,315,0,0,8,4,4,387,0,0,18,6,12,702,0,0,0.0,0.0,0.0,0,0,0,0,0,0,0,0,0,2020-12-27 19:15:00
5137,11463,Vedran Ćorluka,1268,[2007],Manchester City,18,18,0,1540,0,0,17,16,1,1432,0,0,35,34,1,2972,0,0,0.0,0.0,0.0,0,0,0,0,0,0,0,0,0,2020-12-27 19:15:00
5138,45862,Vedran Ćorluka,1268,"[2008, 2009, 2010, 2011]",Tottenham Hotspur,39,37,2,3300,0,0,39,36,3,3252,1,0,78,73,5,6552,1,0,0.0,1.0,1.0,0,1,1,0,0,0,0,0,0,2020-12-27 19:15:002020-12-27 19:15:002020-12-27 19:15:002020-12-27 19:15:00
5139,11468,Vegard Forren,3706,[2012],Southampton FC,0,0,0,0,0,0,0,0,0,0,0,0,0,0,0,0,0,0,0.0,0.0,0.0,0,0,0,0,0,0,0,0,0,2020-12-27 19:15:00
5140,11469,Vegard Heggem,4304,[2000],West Ham United,1,0,1,18,0,0,0,0,0,0,0,0,1,0,1,18,0,0,0.0,0.0,0.0,0,0,0,0,0,0,0,0,0,2020-12-27 19:15:00
5141,91788,Victor Anichebe,1751,"[2005, 2006, 2007, 2008, 2009, 2010, 2011, 2012]",Everton FC,66,29,37,2880,10,0,62,28,34,2762,8,0,128,57,71,5642,18,0,0.0,8.0,8.0,3,7,10,0,0,0,0,0,0,2020-12-27 19:15:002020-12-27 19:15:002020-12-27 19:15:002020-12-27 19:15:002020-12-27 19:15:002020-12-27 19:15:002020-12-27 19:15:002020-12-27 19:15:00
5142,34437,Victor Anichebe,1751,"[2013, 2014, 2015]",West Bromwich Albion,26,8,18,1152,5,0,29,17,12,1461,1,0,55,25,30,2613,6,0,2.0,0.0,2.0,2,1,3,0,0,0,0,0,0,2020-12-27 19:15:002020-12-27 19:15:002020-12-27 19:15:00
5143,11481,Victor Anichebe,1751,[2016],Sunderland AFC,8,7,1,581,2,0,10,7,3,636,1,0,18,14,4,1217,3,0,0.0,0.0,0.0,0,1,1,0,0,0,0,0,0,2020-12-27 19:15:00
5144,11482,Victor Camarasa,3286,[2018],Cardiff City,16,16,0,1267,4,0,16,15,1,1312,1,0,32,31,1,2579,5,0,0.0,3.0,3.0,2,1,3,1,0,1,0,0,0,2020-12-27 19:15:00
5145,11483,Victor Camarasa,3286,[2019],Crystal Palace,0,0,0,0,0,0,1,0,1,5,0,0,1,0,1,5,0,0,0.0,0.0,0.0,0,0,0,0,0,0,0,0,0,2020-12-27 19:15:00
5146,45942,Victor Lindelöf,1639,"[2017, 2018, 2019, 2020]",Manchester United,45,43,2,3902,3,0,51,48,3,4313,0,0,96,91,5,8215,3,0,1.0,0.0,1.0,2,0,2,0,0,0,0,0,0,2020-12-27 19:15:002020-12-27 19:15:002020-12-27 19:15:002020-12-27 19:15:00
5147,34467,Victor Moses,1434,"[2009, 2010, 2011]",Wigan Athletic,37,23,14,2285,5,0,36,23,13,2174,3,0,73,46,27,4459,8,0,3.0,1.0,4.0,3,3,6,0,0,0,0,0,0,2020-12-27 19:15:002020-12-27 19:15:002020-12-27 19:15:00
5148,45979,Victor Moses,1434,"[2012, 2016, 2017, 2018]",Chelsea FC,37,26,11,2356,4,0,49,39,10,3318,3,0,86,65,21,5674,7,0,3.0,3.0,6.0,1,2,3,0,0,0,0,0,0,2020-12-27 19:15:002020-12-27 19:15:002020-12-27 19:15:002020-12-27 19:15:00
5149,11492,Victor Moses,1434,[2013],Liverpool FC,9,2,7,239,0,0,10,4,6,404,1,0,19,6,13,643,1,0,0.0,0.0,0.0,0,1,1,0,0,0,0,0,0,2020-12-27 19:15:00
5150,11493,Victor Moses,1434,[2014],Stoke City,9,9,0,741,2,0,10,10,0,714,1,0,19,19,0,1455,3,0,0.0,3.0,3.0,2,1,3,0,1,1,0,0,0,2020-12-27 19:15:00
5151,11494,Victor Moses,1434,[2015],West Ham United,9,5,4,450,0,0,12,8,4,532,1,0,21,13,8,982,1,0,0.0,0.0,0.0,0,1,1,0,0,0,0,0,0,2020-12-27 19:15:00
5152,11498,Victor Obinna,3803,[2010],West Ham United,14,10,4,922,1,0,11,7,4,651,2,0,25,17,8,1573,3,0,0.0,0.0,0.0,0,1,1,0,0,0,0,0,0,2020-12-27 19:15:00
5153,34500,Victor Wanyama,1864,"[2013, 2014, 2015]",Southampton FC,41,35,6,3185,2,0,44,39,5,3401,2,0,85,74,11,6586,4,0,0.0,6.0,6.0,0,2,2,0,0,0,0,0,0,2020-12-27 19:15:002020-12-27 19:15:002020-12-27 19:15:00
5154,46014,Victor Wanyama,1864,"[2016, 2017, 2018, 2019]",Tottenham Hotspur,36,23,13,2175,4,0,33,24,9,2214,2,0,69,47,22,4389,6,0,3.0,0.0,3.0,3,1,4,0,0,0,0,0,0,2020-12-27 19:15:002020-12-27 19:15:002020-12-27 19:15:002020-12-27 19:15:00
5155,11506,Viktor Fischer,3008,[2016],Middlesbrough FC,7,4,3,254,0,0,6,2,4,184,0,0,13,6,7,438,0,0,0.0,0.0,0.0,0,0,0,0,0,0,0,0,0,2020-12-27 19:15:00
5156,11507,Viktor Gyökeres,3968,[2018],Brighton & Hove Albion,0,0,0,0,0,0,0,0,0,0,0,0,0,0,0,0,0,0,0.0,0.0,0.0,0,0,0,0,0,0,0,0,0,2020-12-27 19:15:00
5157,46038,Vince Grella,3623,"[2008, 2009, 2010, 2011]",Blackburn Rovers,20,17,3,1454,0,0,17,11,6,979,0,0,37,28,9,2433,0,0,0.0,0.0,0.0,0,0,0,0,0,0,0,0,0,2020-12-27 19:15:002020-12-27 19:15:002020-12-27 19:15:002020-12-27 19:15:00
5158,11512,Vincent Candela,3263,[2004],Bolton Wanderers,5,4,1,361,0,0,4,4,0,330,0,0,9,8,1,691,0,0,0.0,0.0,0.0,0,0,0,0,0,0,0,0,0,2020-12-27 19:15:00
5159,34542,Vincent Janssen,2773,"[2016, 2017, 2018]",Tottenham Hotspur,15,4,11,421,2,0,16,3,13,448,0,0,31,7,24,869,2,0,0.0,0.0,0.0,1,0,1,1,0,1,0,0,0,2020-12-27 19:15:002020-12-27 19:15:002020-12-27 19:15:00
5160,126731,Vincent Kompany,1414,"[2008, 2009, 2010, 2011, 2012, 2013, 2014, 2015, 2016, 2017, 2018]",Manchester City,129,121,8,10771,10,0,134,130,4,11450,8,0,263,251,12,22221,18,0,6.0,0.0,6.0,4,4,8,0,0,0,0,0,0,2020-12-27 19:15:002020-12-27 19:15:002020-12-27 19:15:002020-12-27 19:15:002020-12-27 19:15:002020-12-27 19:15:002020-12-27 19:15:002020-12-27 19:15:002020-12-27 19:15:002020-12-27 19:15:002020-12-27 19:15:00
5161,23055,Vincent Péricard,2968,"[2003, 2005]",Portsmouth FC,7,1,6,96,0,0,5,2,3,174,0,0,12,3,9,270,0,0,0.0,0.0,0.0,0,0,0,0,0,0,0,0,0,2020-12-27 19:15:002020-12-27 19:15:00
5162,11529,Vincent Péricard,2968,[2008],Stoke City,2,0,2,23,0,0,2,1,1,96,0,0,4,1,3,119,0,0,0.0,0.0,0.0,0,0,0,0,0,0,0,0,0,2020-12-27 19:15:00
5163,11530,Vincenzo Montella,3248,[2006],Fulham FC,6,2,4,214,2,0,3,0,3,65,0,0,9,2,7,279,2,0,0.0,0.0,0.0,2,0,2,1,0,1,0,0,0,2020-12-27 19:15:00
5164,34596,Virgil van Dijk,1241,"[2015, 2016, 2017]",Southampton FC,34,34,0,3025,4,0,33,32,1,2883,0,0,67,66,1,5908,4,0,1.0,0.0,1.0,3,0,3,0,0,0,0,0,0,2020-12-27 19:15:002020-12-27 19:15:002020-12-27 19:15:00
5165,34605,Virgil van Dijk,1241,"[2018, 2019, 2020]",Liverpool FC,40,40,0,3565,7,0,41,41,0,3611,3,0,81,81,0,7176,10,0,0.0,0.0,0.0,3,2,5,0,0,0,0,0,0,2020-12-27 19:15:002020-12-27 19:15:002020-12-27 19:15:00
5166,11537,Vitinha,1007,[2020],Wolverhampton Wanderers,3,0,3,7,0,0,4,0,4,46,0,0,7,0,7,53,0,0,0.0,0.0,0.0,0,0,0,0,0,0,0,0,0,2020-12-27 19:15:00
5167,34617,Vito Mannone,2261,"[2008, 2009, 2012]",Arsenal FC,7,7,0,630,0,0,8,8,0,720,0,0,15,15,0,1350,0,0,0.0,0.0,0.0,0,0,0,0,0,0,0,0,0,2020-12-27 19:15:002020-12-27 19:15:002020-12-27 19:15:00
5168,46170,Vito Mannone,2261,"[2013, 2014, 2015, 2016]",Sunderland AFC,35,35,0,3150,0,0,32,31,1,2837,0,0,67,66,1,5987,0,0,0.0,0.0,0.0,0,0,0,0,0,0,0,0,0,2020-12-27 19:15:002020-12-27 19:15:002020-12-27 19:15:002020-12-27 19:15:00
5169,23091,Vlad Chiricheş,1171,"[2013, 2014]",Tottenham Hotspur,13,13,0,1095,0,0,14,11,3,1066,1,0,27,24,3,2161,1,0,0.0,0.0,0.0,0,1,1,0,0,0,0,0,0,2020-12-27 19:15:002020-12-27 19:15:00
5170,11547,Vladimir Stojković,4352,[2009],Wigan Athletic,2,2,0,180,0,0,2,2,0,180,0,0,4,4,0,360,0,0,0.0,0.0,0.0,0,0,0,0,0,0,0,0,0,2020-12-27 19:15:00
5171,11548,Vladimír Coufal,1054,[2020],West Ham United,6,6,0,535,0,0,6,6,0,540,0,0,12,12,0,1075,0,0,0.0,0.0,0.0,0,0,0,0,0,0,0,0,0,2020-12-27 19:15:00
5172,23099,Vladimír Labant,1631,"[2001, 2002]",West Ham United,5,2,3,267,0,0,8,5,3,459,0,0,13,7,6,726,0,0,0.0,0.0,0.0,0,0,0,0,0,0,0,0,0,2020-12-27 19:15:002020-12-27 19:15:00
5173,11551,Vladimír Weiss,2672,[2008],Manchester City,1,0,1,19,0,0,0,0,0,0,0,0,1,0,1,19,0,0,0.0,0.0,0.0,0,0,0,0,0,0,0,0,0,2020-12-27 19:15:00
5174,11552,Vladimír Weiss,2672,[2009],Bolton Wanderers,7,2,5,198,0,0,6,1,5,188,0,0,13,3,10,386,0,0,0.0,0.0,0.0,0,0,0,0,0,0,0,0,0,2020-12-27 19:15:00
5175,46221,Vladimír Šmicer,2692,"[2000, 2002, 2003, 2004]",Liverpool FC,44,26,18,2241,2,0,33,17,16,1724,3,0,77,43,34,3965,5,0,0.0,0.0,0.0,1,3,4,0,0,0,0,0,0,2020-12-27 19:15:002020-12-27 19:15:002020-12-27 19:15:002020-12-27 19:15:00
5176,11554,Vladimír Šmicer,2692,[2001],West Ham United,1,1,0,75,0,0,0,0,0,0,0,0,1,1,0,75,0,0,0.0,0.0,0.0,0,0,0,0,0,0,0,0,0,2020-12-27 19:15:00
5177,34678,Vratislav Greško,2010,"[2002, 2003, 2005]",Blackburn Rovers,16,14,2,1258,2,0,20,18,2,1570,0,0,36,32,4,2828,2,0,3.0,0.0,3.0,2,0,2,0,0,0,0,0,0,2020-12-27 19:15:002020-12-27 19:15:002020-12-27 19:15:00
5178,11560,Vratislav Greško,2010,[2004],Southampton FC,1,0,1,1,0,0,0,0,0,0,0,0,1,0,1,1,0,0,0.0,0.0,0.0,0,0,0,0,0,0,0,0,0,2020-12-27 19:15:00
5179,46254,Vurnon Anita,2281,"[2012, 2013, 2014, 2015]",Newcastle United,58,43,15,3973,1,0,48,43,5,3604,1,0,106,86,20,7577,2,0,1.0,0.0,1.0,1,0,1,0,0,0,0,0,0,2020-12-27 19:15:002020-12-27 19:15:002020-12-27 19:15:002020-12-27 19:15:00
5180,11566,Víctor Ibarbo,3635,[2015],Watford FC,2,0,2,23,0,0,2,0,2,41,0,0,4,0,4,64,0,0,0.0,0.0,0.0,0,0,0,0,0,0,0,0,0,2020-12-27 19:15:00
5181,11567,Víctor Valdés,2998,[2014],Manchester United,1,0,1,17,0,0,1,1,0,90,0,0,2,1,1,107,0,0,0.0,0.0,0.0,0,0,0,0,0,0,0,0,0,2020-12-27 19:15:00
5182,11568,Víctor Valdés,2998,[2016],Middlesbrough FC,14,14,0,1260,0,0,14,14,0,1260,0,0,28,28,0,2520,0,0,0.0,0.0,0.0,0,0,0,0,0,0,0,0,0,2020-12-27 19:15:00
5183,11569,Wade Elliott,2550,[2009],Burnley FC,19,17,2,1565,3,0,19,17,2,1554,1,0,38,34,4,3119,4,0,4.0,0.0,4.0,2,0,2,0,0,0,0,0,0,2020-12-27 19:15:00
5184,23141,Wahbi Khazri,3137,"[2015, 2016]",Sunderland AFC,20,11,9,1136,3,0,15,9,6,781,0,0,35,20,15,1917,3,0,0.0,0.0,0.0,3,0,3,0,0,0,0,0,0,2020-12-27 19:15:002020-12-27 19:15:00
5185,11572,Walter López,4215,[2008],West Ham United,2,0,2,4,0,0,3,0,3,16,0,0,5,0,5,20,0,0,0.0,0.0,0.0,0,0,0,0,0,0,0,0,0,2020-12-27 19:15:00
5186,23147,Walter Pandiani,1518,"[2004, 2005]",Birmingham City,15,10,5,905,5,0,16,10,6,857,1,0,31,20,11,1762,6,0,1.0,0.0,1.0,5,1,6,1,0,1,0,0,0,2020-12-27 19:15:002020-12-27 19:15:00
5187,11575,Warren Barton,3394,[2000],Newcastle United,16,14,2,1140,0,0,11,11,0,990,0,0,27,25,2,2130,0,0,0.0,0.0,0.0,0,0,0,0,0,0,0,0,0,2020-12-27 19:15:00
5188,11576,Warren Barton,3394,[2001],Derby County,7,7,0,630,0,0,6,6,0,540,0,0,13,13,0,1170,0,0,0.0,0.0,0.0,0,0,0,0,0,0,0,0,0,2020-12-27 19:15:00
5189,11577,Wayne Andrews,3829,[2004],Crystal Palace,4,0,4,21,0,0,4,0,4,65,0,0,8,0,8,86,0,0,0.0,0.0,0.0,0,0,0,0,0,0,0,0,0,2020-12-27 19:15:00
5190,34737,Wayne Bridge,1768,"[2000, 2001, 2002]",Southampton FC,54,54,0,4850,0,0,50,50,0,4500,1,0,104,104,0,9350,1,0,0.0,0.0,0.0,0,1,1,0,0,0,0,0,0,2020-12-27 19:15:002020-12-27 19:15:002020-12-27 19:15:00
5191,46332,Wayne Bridge,1768,"[2003, 2004, 2006, 2007]",Chelsea FC,42,38,4,3438,1,0,38,32,6,2950,0,0,80,70,10,6388,1,0,0.0,0.0,0.0,1,0,1,0,0,0,0,0,0,2020-12-27 19:15:002020-12-27 19:15:002020-12-27 19:15:002020-12-27 19:15:00
5192,11583,Wayne Bridge,1768,[2005],Fulham FC,6,6,0,540,0,0,6,6,0,540,0,0,12,12,0,1080,0,0,0.0,0.0,0.0,0,0,0,0,0,0,0,0,0,2020-12-27 19:15:00
5193,23173,Wayne Bridge,1768,"[2008, 2009]",Manchester City,19,19,0,1668,0,0,19,19,0,1500,0,0,38,38,0,3168,0,0,0.0,0.0,0.0,0,0,0,0,0,0,0,0,0,2020-12-27 19:15:002020-12-27 19:15:00
5194,11588,Wayne Bridge,1768,[2010],West Ham United,8,8,0,719,0,0,7,7,0,630,0,0,15,15,0,1349,0,0,0.0,0.0,0.0,0,0,0,0,0,0,0,0,0,2020-12-27 19:15:00
5195,11589,Wayne Bridge,1768,[2011],Sunderland AFC,5,2,3,204,0,0,3,1,2,113,0,0,8,3,5,317,0,0,0.0,0.0,0.0,0,0,0,0,0,0,0,0,0,2020-12-27 19:15:00
5196,11590,Wayne Brown,3924,[2000],Ipswich Town,1,0,1,1,0,0,3,0,3,83,0,0,4,0,4,84,0,0,0.0,0.0,0.0,0,0,0,0,0,0,0,0,0,2020-12-27 19:15:00
5197,11591,Wayne Brown,3924,[2008],Fulham FC,0,0,0,0,0,0,1,0,1,4,0,0,1,0,1,4,0,0,0.0,0.0,0.0,0,0,0,0,0,0,0,0,0,2020-12-27 19:15:00
5198,11592,Wayne Henderson,4554,[2004],Aston Villa,0,0,0,0,0,0,0,0,0,0,0,0,0,0,0,0,0,0,0.0,0.0,0.0,0,0,0,0,0,0,0,0,0,2020-12-27 19:15:00
5199,34782,Wayne Hennessey,1018,"[2009, 2010, 2011]",Wolverhampton Wanderers,35,35,0,3150,0,0,36,36,0,3240,0,0,71,71,0,6390,0,0,0.0,0.0,0.0,0,0,0,0,0,0,0,0,0,2020-12-27 19:15:002020-12-27 19:15:002020-12-27 19:15:00
5200,92796,Wayne Hennessey,1018,"[2013, 2014, 2015, 2016, 2017, 2018, 2019, 2020]",Crystal Palace,53,52,1,4725,0,0,57,56,1,5076,0,0,110,108,2,9801,0,0,0.0,0.0,0.0,0,0,0,0,0,0,0,0,0,2020-12-27 19:15:002020-12-27 19:15:002020-12-27 19:15:002020-12-27 19:15:002020-12-27 19:15:002020-12-27 19:15:002020-12-27 19:15:002020-12-27 19:15:00
5201,11604,Wayne Jacobs,2835,[2000],Bradford City,10,9,1,776,1,0,6,5,1,481,1,0,16,14,2,1257,2,0,0.0,0.0,0.0,1,0,1,0,0,0,0,0,0,2020-12-27 19:15:00
5202,11605,Wayne Quinn,3775,[2000],Newcastle United,7,6,1,552,0,0,7,7,0,630,0,0,14,13,1,1182,0,0,0.0,0.0,0.0,0,0,0,0,0,0,0,0,0,2020-12-27 19:15:00
5203,34834,Wayne Rooney,1058,"[2002, 2003, 2017]",Everton FC,50,37,13,3334,13,0,44,26,18,2640,12,0,94,63,31,5974,25,0,18.0,12.0,30.0,10,11,21,1,2,3,0,0,0,2020-12-27 19:15:002020-12-27 19:15:002020-12-27 19:15:00
5204,150982,Wayne Rooney,1058,"[2004, 2005, 2006, 2007, 2008, 2009, 2010, 2011, 2012, 2013, 2014, 2015, 2016]",Manchester United,197,172,25,15525,101,0,194,180,14,16045,82,0,391,352,39,31570,183,0,24.0,22.0,46.0,48,49,97,11,9,20,0,0,0,2020-12-27 19:15:002020-12-27 19:15:002020-12-27 19:15:002020-12-27 19:15:002020-12-27 19:15:002020-12-27 19:15:002020-12-27 19:15:002020-12-27 19:15:002020-12-27 19:15:002020-12-27 19:15:002020-12-27 19:15:002020-12-27 19:15:002020-12-27 19:15:00
5205,11622,Wayne Routledge,1758,[2004],Crystal Palace,19,19,0,1570,0,0,18,18,0,1498,1,0,37,37,0,3068,1,0,0.0,0.0,0.0,0,1,1,0,0,0,0,0,0,2020-12-27 19:15:00
5206,11623,Wayne Routledge,1758,[2005],Portsmouth FC,8,1,7,272,0,0,5,2,3,165,0,0,13,3,10,437,0,0,0.0,0.0,0.0,0,0,0,0,0,0,0,0,0,2020-12-27 19:15:00
5207,11624,Wayne Routledge,1758,[2006],Fulham FC,13,7,6,738,0,0,9,5,4,569,0,0,22,12,10,1307,0,0,0.0,0.0,0.0,0,0,0,0,0,0,0,0,0,2020-12-27 19:15:00
5208,23251,Wayne Routledge,1758,"[2007, 2008]",Aston Villa,1,0,1,4,0,0,1,0,1,17,0,0,2,0,2,21,0,0,0.0,0.0,0.0,0,0,0,0,0,0,0,0,0,2020-12-27 19:15:002020-12-27 19:15:00
5209,11627,Wayne Routledge,1758,[2010],Newcastle United,8,4,4,361,0,0,8,5,3,556,0,0,16,9,7,917,0,0,0.0,0.0,0.0,0,0,0,0,0,0,0,0,0,2020-12-27 19:15:00
5210,81417,Wayne Routledge,1758,"[2011, 2012, 2013, 2014, 2015, 2016, 2017]",Swansea City,101,81,20,6616,11,0,97,75,22,6435,5,0,198,156,42,13051,16,0,1.0,0.0,1.0,6,3,9,0,0,0,0,0,0,2020-12-27 19:15:002020-12-27 19:15:002020-12-27 19:15:002020-12-27 19:15:002020-12-27 19:15:002020-12-27 19:15:002020-12-27 19:15:00
5211,11635,Weifeng Li,3385,[2002],Everton FC,0,0,0,0,0,0,1,1,0,90,0,0,1,1,0,90,0,0,0.0,0.0,0.0,0,0,0,0,0,0,0,0,0,2020-12-27 19:15:00
5212,11636,Wellington Paulista,3741,[2012],West Ham United,0,0,0,0,0,0,0,0,0,0,0,0,0,0,0,0,0,0,0.0,0.0,0.0,0,0,0,0,0,0,0,0,0,2020-12-27 19:15:00
5213,128062,Wes Brown,1108,"[2000, 2001, 2002, 2003, 2004, 2005, 2006, 2007, 2008, 2009, 2010]",Manchester United,100,87,13,7976,2,0,112,100,12,8934,1,0,212,187,25,16910,3,0,3.0,0.0,3.0,2,1,3,0,0,0,0,0,0,2020-12-27 19:15:002020-12-27 19:15:002020-12-27 19:15:002020-12-27 19:15:002020-12-27 19:15:002020-12-27 19:15:002020-12-27 19:15:002020-12-27 19:15:002020-12-27 19:15:002020-12-27 19:15:002020-12-27 19:15:00
5214,46598,Wes Brown,1108,"[2011, 2013, 2014, 2015]",Sunderland AFC,37,36,1,3203,0,0,39,37,2,3296,1,0,76,73,3,6499,1,0,0.0,3.0,3.0,0,1,1,0,0,0,0,0,0,2020-12-27 19:15:002020-12-27 19:15:002020-12-27 19:15:002020-12-27 19:15:00
5215,46614,Wes Hoolahan,1383,"[2011, 2012, 2013, 2015]",Norwich City,58,48,10,4264,8,0,54,40,14,3260,4,0,112,88,24,7524,12,0,4.0,1.0,5.0,5,4,9,1,0,1,0,0,0,2020-12-27 19:15:002020-12-27 19:15:002020-12-27 19:15:002020-12-27 19:15:00
5216,81613,Wes Morgan,2446,"[2014, 2015, 2016, 2017, 2018, 2019, 2020]",Leicester City,83,79,4,7071,4,0,87,80,7,7331,4,0,170,159,11,14402,8,0,3.0,4.0,7.0,2,4,6,0,0,0,0,0,0,2020-12-27 19:15:002020-12-27 19:15:002020-12-27 19:15:002020-12-27 19:15:002020-12-27 19:15:002020-12-27 19:15:002020-12-27 19:15:00
5217,11663,Wesley,3716,[2019],Aston Villa,10,10,0,880,1,0,11,11,0,910,4,0,21,21,0,1790,5,0,0.0,0.0,0.0,1,3,4,0,0,0,0,0,0,2020-12-27 19:15:00
5218,11664,Wesley Foderingham,1040,[2020],Sheffield United,0,0,0,0,0,0,0,0,0,0,0,0,0,0,0,0,0,0,0.0,0.0,0.0,0,0,0,0,0,0,0,0,0,2020-12-27 19:15:00
5219,11665,Wesley Fofana,1037,[2020],Leicester City,6,6,0,540,0,0,5,5,0,450,0,0,11,11,0,990,0,0,0.0,0.0,0.0,0,0,0,0,0,0,0,0,0,2020-12-27 19:15:00
5220,23333,Wesley Hoedt,1914,"[2017, 2018]",Southampton FC,17,17,0,1530,0,0,24,24,0,2160,0,0,41,41,0,3690,0,0,0.0,0.0,0.0,0,0,0,0,0,0,0,0,0,2020-12-27 19:15:002020-12-27 19:15:00
5221,35007,Wilfred Bouma,2707,"[2005, 2006, 2007]",Aston Villa,40,40,0,3385,1,0,43,41,2,3601,0,0,83,81,2,6986,1,0,0.0,0.0,0.0,1,0,1,0,0,0,0,0,0,2020-12-27 19:15:002020-12-27 19:15:002020-12-27 19:15:00
5222,58365,Wilfred Ndidi,2442,"[2016, 2017, 2018, 2019, 2020]",Leicester City,64,63,1,5615,5,0,63,59,4,5362,1,0,127,122,5,10977,6,0,1.0,1.0,2.0,3,1,4,0,0,0,0,0,0,2020-12-27 19:15:002020-12-27 19:15:002020-12-27 19:15:002020-12-27 19:15:002020-12-27 19:15:00
5223,23356,Wilfried Bony,1597,"[2013, 2017]",Swansea City,24,18,6,1647,11,0,25,17,8,1527,8,0,49,35,14,3174,19,0,3.0,3.0,6.0,4,7,11,2,2,4,0,0,0,2020-12-27 19:15:002020-12-27 19:15:00
5224,23355,Wilfried Bony,1597,"[2014, 2015]",Manchester City,19,8,11,867,5,0,17,7,10,650,1,0,36,15,21,1517,6,0,0.0,0.0,0.0,2,0,2,0,0,0,0,0,0,2020-12-27 19:15:002020-12-27 19:15:00
5225,11679,Wilfried Bony,1597,[2016],Stoke City,5,5,0,374,2,0,5,4,1,316,0,0,10,9,1,690,2,0,0.0,0.0,0.0,1,0,1,0,0,0,0,0,0,2020-12-27 19:15:00
5226,11681,Wilfried Zaha,1028,[2013],Cardiff City,6,3,3,275,0,0,6,2,4,307,0,0,12,5,7,582,0,0,0.0,0.0,0.0,0,0,0,0,0,0,0,0,0,2020-12-27 19:15:00
5227,81795,Wilfried Zaha,1028,"[2014, 2015, 2016, 2017, 2018, 2019, 2020]",Crystal Palace,107,100,7,8899,17,0,107,99,8,8639,26,0,214,199,15,17538,43,0,9.0,10.0,19.0,14,17,31,1,1,2,0,0,0,2020-12-27 19:15:002020-12-27 19:15:002020-12-27 19:15:002020-12-27 19:15:002020-12-27 19:15:002020-12-27 19:15:002020-12-27 19:15:00
5228,11689,Will Atkinson,4386,[2009],Hull City,1,1,0,90,0,0,1,1,0,90,1,0,2,2,0,180,1,0,0.0,0.0,0.0,0,1,1,0,0,0,0,0,0,2020-12-27 19:15:00
5229,11690,Will Buckley,2525,[2014],Sunderland AFC,9,5,4,479,0,0,13,4,9,390,0,0,22,9,13,869,0,0,0.0,0.0,0.0,0,0,0,0,0,0,0,0,0,2020-12-27 19:15:00
5230,11691,Will Ferry,4297,[2019],Southampton FC,0,0,0,0,0,0,0,0,0,0,0,0,0,0,0,0,0,0,0.0,0.0,0.0,0,0,0,0,0,0,0,0,0,2020-12-27 19:15:00
5231,11692,Will Hoskins,3606,[2006],Watford FC,5,3,2,303,0,0,4,1,3,118,0,0,9,4,5,421,0,0,0.0,0.0,0.0,0,0,0,0,0,0,0,0,0,2020-12-27 19:15:00
5232,35082,Will Hughes,1923,"[2017, 2018, 2019]",Watford FC,38,34,4,2781,2,0,39,35,4,2913,3,0,77,69,8,5694,5,0,0.0,0.0,0.0,2,2,4,0,0,0,0,0,0,2020-12-27 19:15:002020-12-27 19:15:002020-12-27 19:15:00
5233,35091,Will Keane,2381,"[2011, 2014, 2015]",Manchester United,1,0,1,5,0,0,1,0,1,4,0,0,2,0,2,9,0,0,0.0,0.0,0.0,0,0,0,0,0,0,0,0,0,2020-12-27 19:15:002020-12-27 19:15:002020-12-27 19:15:00
5234,11699,Will Keane,2381,[2016],Hull City,2,2,0,94,0,0,3,2,1,188,0,0,5,4,1,282,0,0,0.0,0.0,0.0,0,0,0,0,0,0,0,0,0,2020-12-27 19:15:00
5235,11700,Will Norris,4332,[2018],Wolverhampton Wanderers,1,0,1,1,0,0,0,0,0,0,0,0,1,0,1,1,0,0,0.0,0.0,0.0,0,0,0,0,0,0,0,0,0,2020-12-27 19:15:00
5236,11701,Will Norris,4332,[2020],Burnley FC,0,0,0,0,0,0,0,0,0,0,0,0,0,0,0,0,0,0,0.0,0.0,0.0,0,0,0,0,0,0,0,0,0,2020-12-27 19:15:00
5237,23405,Will Smallbone,3759,"[2019, 2020]",Southampton FC,5,2,3,254,0,0,6,3,3,251,0,0,11,5,6,505,0,0,0.0,0.0,0.0,0,0,0,0,0,0,0,0,0,2020-12-27 19:15:002020-12-27 19:15:00
5238,11704,Willem Korsten,3023,[2000],Tottenham Hotspur,4,3,1,277,2,0,9,5,4,462,1,0,13,8,5,739,3,0,0.0,0.0,0.0,2,1,3,0,0,0,0,0,0,2020-12-27 19:15:00
5239,58535,William Gallas,2040,"[2001, 2002, 2003, 2004, 2005]",Chelsea FC,80,74,6,6683,10,0,77,71,6,6385,2,0,157,145,12,13068,12,0,3.0,0.0,3.0,7,1,8,0,0,0,0,0,0,2020-12-27 19:15:002020-12-27 19:15:002020-12-27 19:15:002020-12-27 19:15:002020-12-27 19:15:00
5240,46846,William Gallas,2040,"[2006, 2007, 2008, 2009]",Arsenal FC,51,51,0,4581,8,0,47,47,0,4164,4,0,98,98,0,8745,12,0,7.0,0.0,7.0,6,0,6,0,0,0,0,0,0,2020-12-27 19:15:002020-12-27 19:15:002020-12-27 19:15:002020-12-27 19:15:00
5241,35145,William Gallas,2040,"[2010, 2011, 2012]",Tottenham Hotspur,29,27,2,2409,1,0,32,30,2,2780,0,0,61,57,4,5189,1,0,0.0,0.0,0.0,1,0,1,0,0,0,0,0,0,2020-12-27 19:15:002020-12-27 19:15:002020-12-27 19:15:00
5242,11717,William Kvist,3676,[2013],Fulham FC,5,4,1,333,0,0,3,3,0,260,0,0,8,7,1,593,0,0,0.0,0.0,0.0,0,0,0,0,0,0,0,0,0,2020-12-27 19:15:00
5243,11718,Williams Martínez,4265,[2005],West Bromwich Albion,0,0,0,0,0,0,2,1,1,135,1,0,2,1,1,135,1,0,0.0,0.0,0.0,0,0,0,0,0,0,0,0,0,2020-12-27 19:15:00
5244,82054,Willian,1538,"[2013, 2014, 2015, 2016, 2017, 2018, 2019]",Chelsea FC,118,85,33,7619,17,0,116,83,33,7369,20,0,234,168,66,14988,37,0,9.0,2.0,11.0,8,9,17,3,2,5,0,0,0,2020-12-27 19:15:002020-12-27 19:15:002020-12-27 19:15:002020-12-27 19:15:002020-12-27 19:15:002020-12-27 19:15:002020-12-27 19:15:00
5245,11726,Willian,1538,[2020],Arsenal FC,5,5,0,366,0,0,7,7,0,525,0,0,12,12,0,891,0,0,0.0,0.0,0.0,0,0,0,0,0,0,0,0,0,2020-12-27 19:15:00
5246,23455,Willo Flood,3610,"[2004, 2005]",Manchester City,6,2,4,205,1,0,6,1,5,167,0,0,12,3,9,372,1,0,0.0,0.0,0.0,1,0,1,0,0,0,0,0,0,2020-12-27 19:15:002020-12-27 19:15:00
5247,35190,Willy Boly,2143,"[2018, 2019, 2020]",Wolverhampton Wanderers,34,34,0,3060,2,0,36,36,0,3240,2,0,70,70,0,6300,4,0,1.0,0.0,1.0,2,2,4,0,0,0,0,0,0,2020-12-27 19:15:002020-12-27 19:15:002020-12-27 19:15:00
5248,35199,Willy Caballero,1588,"[2014, 2015, 2016]",Manchester City,12,10,2,951,0,0,11,11,0,990,0,0,23,21,2,1941,0,0,0.0,0.0,0.0,0,0,0,0,0,0,0,0,0,2020-12-27 19:15:002020-12-27 19:15:002020-12-27 19:15:00
5249,46946,Willy Caballero,1588,"[2017, 2018, 2019, 2020]",Chelsea FC,6,6,0,540,0,0,5,5,0,450,0,0,11,11,0,990,0,0,0.0,0.0,0.0,0,0,0,0,0,0,0,0,0,2020-12-27 19:15:002020-12-27 19:15:002020-12-27 19:15:002020-12-27 19:15:00
5250,11739,Wilson Palacios,1271,[2007],Wigan Athletic,9,9,0,810,0,0,7,7,0,604,0,0,16,16,0,1414,0,0,0.0,0.0,0.0,0,0,0,0,0,0,0,0,0,2020-12-27 19:15:00
5251,35223,Wilson Palacios,1271,"[2008, 2009, 2010]",Tottenham Hotspur,29,27,2,2219,0,0,34,27,7,2335,1,0,63,54,9,4554,1,0,0.0,0.0,0.0,0,0,0,0,0,0,0,0,0,2020-12-27 19:15:002020-12-27 19:15:002020-12-27 19:15:00
5252,46978,Wilson Palacios,1271,"[2011, 2012, 2013, 2014]",Stoke City,15,2,13,283,0,0,24,13,11,1171,0,0,39,15,24,1454,0,0,0.0,0.0,0.0,0,0,0,0,0,0,0,0,0,2020-12-27 19:15:002020-12-27 19:15:002020-12-27 19:15:002020-12-27 19:15:00
5253,11747,Winston Bogarde,3056,[2000],Chelsea FC,5,1,4,143,0,0,4,1,3,174,0,0,9,2,7,317,0,0,0.0,0.0,0.0,0,0,0,0,0,0,0,0,0,2020-12-27 19:15:00
5254,94012,Winston Reid,2638,"[2010, 2012, 2013, 2014, 2015, 2016, 2017, 2019]",West Ham United,87,82,5,7345,4,0,79,75,4,6561,2,0,166,157,9,13906,6,0,6.0,0.0,6.0,3,1,4,0,0,0,0,0,0,2020-12-27 19:15:002020-12-27 19:15:002020-12-27 19:15:002020-12-27 19:15:002020-12-27 19:15:002020-12-27 19:15:002020-12-27 19:15:002020-12-27 19:15:00
5255,58790,Wojciech Szczęsny,1507,"[2010, 2011, 2012, 2013, 2014]",Arsenal FC,68,68,0,6089,0,0,63,63,0,5670,0,0,131,131,0,11759,0,0,0.0,0.0,0.0,0,0,0,0,0,0,0,0,0,2020-12-27 19:15:002020-12-27 19:15:002020-12-27 19:15:002020-12-27 19:15:002020-12-27 19:15:00
5256,23523,Won-hee Cho,3967,"[2008, 2009]",Wigan Athletic,0,0,0,0,0,0,5,2,3,171,0,0,5,2,3,171,0,0,0.0,0.0,0.0,0,0,0,0,0,0,0,0,0,2020-12-27 19:15:002020-12-27 19:15:00
5257,58825,Xabi Alonso,1891,"[2004, 2005, 2006, 2007, 2008]",Liverpool FC,75,66,9,5857,8,0,68,55,13,5219,7,0,143,121,22,11076,15,0,3.0,3.0,6.0,5,5,10,0,2,2,0,0,0,2020-12-27 19:15:002020-12-27 19:15:002020-12-27 19:15:002020-12-27 19:15:002020-12-27 19:15:00
5258,23537,Xande Silva,4058,"[2018, 2019]",West Ham United,0,0,0,0,0,0,1,0,1,17,0,0,1,0,1,17,0,0,0.0,0.0,0.0,0,0,0,0,0,0,0,0,0,2020-12-27 19:15:002020-12-27 19:15:00
5259,35313,Xherdan Shaqiri,1904,"[2015, 2016, 2017]",Stoke City,42,42,0,3221,6,0,41,41,0,3477,9,0,83,83,0,6698,15,0,4.0,1.0,5.0,5,8,13,0,0,0,0,0,0,2020-12-27 19:15:002020-12-27 19:15:002020-12-27 19:15:00
5260,35322,Xherdan Shaqiri,1904,"[2018, 2019, 2020]",Liverpool FC,16,8,8,725,6,0,17,5,12,567,1,0,33,13,20,1292,7,0,0.0,0.0,0.0,1,0,1,0,0,0,0,0,0,2020-12-27 19:15:002020-12-27 19:15:002020-12-27 19:15:00
5261,23553,Yacouba Sylla,1445,"[2012, 2013]",Aston Villa,12,7,5,672,0,0,10,5,5,473,0,0,22,12,10,1145,0,0,0.0,0.0,0.0,0,0,0,0,0,0,0,0,0,2020-12-27 19:15:002020-12-27 19:15:00
5262,23557,Yakubu Ayegbeni,1073,"[2003, 2004]",Portsmouth FC,35,33,2,2933,22,0,31,30,1,2570,7,0,66,63,3,5503,29,0,11.0,4.0,15.0,12,7,19,6,0,6,0,0,0,2020-12-27 19:15:002020-12-27 19:15:00
5263,23561,Yakubu Ayegbeni,1073,"[2005, 2006]",Middlesbrough FC,37,34,3,3048,17,0,33,30,3,2621,8,0,70,64,6,5669,25,0,6.0,0.0,6.0,13,5,18,5,2,7,0,0,0,2020-12-27 19:15:002020-12-27 19:15:00
5264,47134,Yakubu Ayegbeni,1073,"[2007, 2008, 2009, 2010]",Everton FC,41,29,12,2721,15,0,40,26,14,2255,10,0,81,55,26,4976,25,0,4.0,0.0,4.0,10,6,16,1,0,1,0,0,0,2020-12-27 19:15:002020-12-27 19:15:002020-12-27 19:15:002020-12-27 19:15:00
5265,11786,Yakubu Ayegbeni,1073,[2011],Blackburn Rovers,16,15,1,1353,11,0,14,14,0,1166,6,0,30,29,1,2519,17,0,0.0,1.0,1.0,6,4,10,2,2,4,0,0,0,2020-12-27 19:15:00
5266,35364,Yan Valery,3027,"[2018, 2019, 2020]",Southampton FC,19,17,2,1470,1,0,15,13,2,1074,1,0,34,30,4,2544,2,0,0.0,0.0,0.0,1,1,2,0,0,0,0,0,0,2020-12-27 19:15:002020-12-27 19:15:002020-12-27 19:15:00
5267,11790,Yaniv Katan,2863,[2005],West Ham United,4,1,3,66,0,0,2,1,1,82,0,0,6,2,4,148,0,0,0.0,0.0,0.0,0,0,0,0,0,0,0,0,0,2020-12-27 19:15:00
5268,11791,Yann Kermorgant,1013,[2015],AFC Bournemouth,5,0,5,121,0,0,2,0,2,47,0,0,7,0,7,168,0,0,0.0,0.0,0.0,0,0,0,0,0,0,0,0,0,2020-12-27 19:15:00
5269,11792,Yann M'Vila,2818,[2015],Sunderland AFC,19,19,0,1688,0,0,18,17,1,1501,1,0,37,36,1,3189,1,0,0.0,0.0,0.0,0,1,1,0,0,0,0,0,0,2020-12-27 19:15:00
5270,35382,Yannick Bolasie,1057,"[2013, 2014, 2015]",Crystal Palace,44,38,6,3366,3,0,45,39,6,3533,6,0,89,77,12,6899,9,0,0.0,1.0,1.0,2,2,4,0,0,0,0,0,0,2020-12-27 19:15:002020-12-27 19:15:002020-12-27 19:15:00
5271,23593,Yannick Bolasie,1057,"[2016, 2017]",Everton FC,13,12,1,949,1,0,16,11,5,934,1,0,29,23,6,1883,2,0,0.0,0.0,0.0,0,1,1,0,0,0,0,0,0,2020-12-27 19:15:002020-12-27 19:15:00
5272,23597,Yannick Sagbo,2234,"[2013, 2014]",Hull City,14,8,6,755,0,0,18,8,10,864,2,0,32,16,16,1619,2,0,0.0,0.0,0.0,0,1,1,0,0,0,0,0,0,2020-12-27 19:15:002020-12-27 19:15:00
5273,11800,Yassine El Ghanassi,1774,[2012],West Bromwich Albion,0,0,0,0,0,0,0,0,0,0,0,0,0,0,0,0,0,0,0.0,0.0,0.0,0,0,0,0,0,0,0,0,0,2020-12-27 19:15:00
5274,11801,Yaya Sanogo,3435,[2013],Arsenal FC,3,0,3,13,0,0,5,0,5,59,0,0,8,0,8,72,0,0,0.0,0.0,0.0,0,0,0,0,0,0,0,0,0,2020-12-27 19:15:00
5275,11802,Yaya Sanogo,3435,[2014],Crystal Palace,6,2,4,155,0,0,4,1,3,161,0,0,10,3,7,316,0,0,0.0,0.0,0.0,0,0,0,0,0,0,0,0,0,2020-12-27 19:15:00
5276,94452,Yaya Touré,1359,"[2010, 2011, 2012, 2013, 2014, 2015, 2016, 2017]",Manchester City,118,108,10,9348,28,0,112,103,9,8894,31,0,230,211,19,18242,59,0,12.0,7.0,19.0,10,17,27,6,5,11,0,0,0,2020-12-27 19:15:002020-12-27 19:15:002020-12-27 19:15:002020-12-27 19:15:002020-12-27 19:15:002020-12-27 19:15:002020-12-27 19:15:002020-12-27 19:15:00
5277,35436,Yerry Mina,1459,"[2018, 2019, 2020]",Everton FC,25,21,4,1919,2,0,30,27,3,2425,3,0,55,48,7,4344,5,0,3.0,0.0,3.0,2,2,4,0,0,0,0,0,0,2020-12-27 19:15:002020-12-27 19:15:002020-12-27 19:15:00
5278,47262,Yoan Gouffran,2454,"[2012, 2013, 2014, 2015]",Newcastle United,42,31,11,2635,6,0,47,40,7,3243,5,0,89,71,18,5878,11,0,0.0,6.0,6.0,5,4,9,0,0,0,0,0,0,2020-12-27 19:15:002020-12-27 19:15:002020-12-27 19:15:002020-12-27 19:15:00
5279,23637,Yoann Folly,3368,"[2003, 2004]",Southampton FC,3,3,0,270,0,0,8,6,2,599,0,0,11,9,2,869,0,0,0.0,0.0,0.0,0,0,0,0,0,0,0,0,0,2020-12-27 19:15:002020-12-27 19:15:00
5280,35463,Yohan Benalouane,2569,"[2015, 2016, 2017]",Leicester City,7,6,1,500,0,0,9,6,3,576,0,0,16,12,4,1076,0,0,0.0,0.0,0.0,0,0,0,0,0,0,0,0,0,2020-12-27 19:15:002020-12-27 19:15:002020-12-27 19:15:00
5281,35472,Yohan Cabaye,1029,"[2011, 2012, 2013]",Newcastle United,40,39,1,3195,9,0,39,37,2,3272,8,0,79,76,3,6467,17,0,3.0,3.0,6.0,6,5,11,1,0,1,0,0,0,2020-12-27 19:15:002020-12-27 19:15:002020-12-27 19:15:00
5282,35481,Yohan Cabaye,1029,"[2015, 2016, 2017]",Crystal Palace,48,44,4,3659,5,0,48,41,7,3563,4,0,96,85,11,7222,9,0,3.0,3.0,6.0,2,2,4,2,1,3,0,0,0,2020-12-27 19:15:002020-12-27 19:15:002020-12-27 19:15:00
5283,11829,Yordi,3613,[2001],Blackburn Rovers,4,2,2,173,1,0,4,3,1,236,1,0,8,5,3,409,2,0,0.0,0.0,0.0,0,1,1,0,0,0,0,0,0,2020-12-27 19:15:00
5284,23661,Yoshinori Mutō,2929,"[2018, 2019]",Newcastle United,10,3,7,279,0,0,15,4,11,445,1,0,25,7,18,724,1,0,0.0,0.0,0.0,0,0,0,0,0,0,0,0,0,2020-12-27 19:15:002020-12-27 19:15:00
5285,35504,Yossi Benayoun,1892,"[2005, 2006, 2012]",West Ham United,37,33,4,2986,6,0,31,26,5,2272,2,0,68,59,9,5258,8,0,3.0,1.0,4.0,3,1,4,0,0,0,0,0,0,2020-12-27 19:15:002020-12-27 19:15:002020-12-27 19:15:00
5286,35505,Yossi Benayoun,1892,"[2007, 2008, 2009]",Liverpool FC,49,30,19,2957,13,0,43,25,18,2366,5,0,92,55,37,5323,18,0,2.0,7.0,9.0,8,4,12,0,0,0,0,0,0,2020-12-27 19:15:002020-12-27 19:15:002020-12-27 19:15:00
5287,11837,Yossi Benayoun,1892,[2010],Chelsea FC,5,1,4,181,0,0,2,0,2,23,1,0,7,1,6,204,1,0,0.0,0.0,0.0,0,0,0,0,0,0,0,0,0,2020-12-27 19:15:00
5288,11838,Yossi Benayoun,1892,[2011],Arsenal FC,9,5,4,437,1,0,10,5,5,467,3,0,19,10,9,904,4,0,0.0,3.0,3.0,1,2,3,0,0,0,0,0,0,2020-12-27 19:15:00
5289,23681,Youl Mawéné,3355,"[2000, 2001]",Derby County,10,9,1,797,1,0,12,12,0,983,0,0,22,21,1,1780,1,0,3.0,0.0,3.0,1,0,1,0,0,0,0,0,0,2020-12-27 19:15:002020-12-27 19:15:00
5290,35529,Young-Pyo Lee,1393,"[2005, 2006, 2007]",Tottenham Hotspur,35,34,1,3035,0,0,33,32,1,2806,0,0,68,66,2,5841,0,0,0.0,0.0,0.0,0,0,0,0,0,0,0,0,0,2020-12-27 19:15:002020-12-27 19:15:002020-12-27 19:15:00
5291,82942,Younès Kaboul,2408,"[2007, 2009, 2010, 2011, 2012, 2013, 2014]",Tottenham Hotspur,52,48,4,4198,3,0,57,53,4,4789,3,0,109,101,8,8987,6,0,1.0,3.0,4.0,1,2,3,0,0,0,0,0,0,2020-12-27 19:15:002020-12-27 19:15:002020-12-27 19:15:002020-12-27 19:15:002020-12-27 19:15:002020-12-27 19:15:002020-12-27 19:15:00
5292,11846,Younès Kaboul,2408,[2008],Portsmouth FC,10,7,3,675,1,0,10,10,0,796,0,0,20,17,3,1471,1,0,0.0,0.0,0.0,1,0,1,0,0,0,0,0,0,2020-12-27 19:15:00
5293,11853,Younès Kaboul,2408,[2015],Sunderland AFC,11,10,1,962,0,0,12,12,0,1063,0,0,23,22,1,2025,0,0,0.0,0.0,0.0,0,0,0,0,0,0,0,0,0,2020-12-27 19:15:00
5294,23709,Younès Kaboul,2408,"[2016, 2017]",Watford FC,13,13,0,1035,1,0,11,11,0,942,1,0,24,24,0,1977,2,0,0.0,0.0,0.0,0,1,1,0,0,0,0,0,0,2020-12-27 19:15:002020-12-27 19:15:00
5295,35571,Youri Djorkaeff,3077,"[2001, 2002, 2003]",Bolton Wanderers,40,39,1,3394,11,0,35,33,2,2707,9,0,75,72,3,6101,20,0,1.0,4.0,5.0,7,7,14,1,0,1,0,0,0,2020-12-27 19:15:002020-12-27 19:15:002020-12-27 19:15:00
5296,11859,Youri Djorkaeff,3077,[2004],Blackburn Rovers,2,2,0,149,0,0,1,1,0,53,0,0,3,3,0,202,0,0,0.0,0.0,0.0,0,0,0,0,0,0,0,0,0,2020-12-27 19:15:00
5297,35583,Youri Tielemans,2439,"[2018, 2019, 2020]",Leicester City,34,31,3,2728,4,0,31,29,2,2548,5,0,65,60,5,5276,9,0,3.0,0.0,3.0,4,1,5,0,2,2,0,0,0,2020-12-27 19:15:002020-12-27 19:15:002020-12-27 19:15:00
5298,11863,Youssef Chippo,2104,[2000],Leeds United,1,0,1,14,0,0,0,0,0,0,0,0,1,0,1,14,0,0,0.0,0.0,0.0,0,0,0,0,0,0,0,0,0,2020-12-27 19:15:00
5299,11864,Youssef Safri,3691,[2004],Norwich City,10,7,3,634,1,0,8,6,2,449,0,0,18,13,5,1083,1,0,0.0,0.0,0.0,1,0,1,0,0,0,0,0,0,2020-12-27 19:15:00
5300,71205,Youssuf Mulumbu,1773,"[2008, 2010, 2011, 2012, 2013, 2014]",West Bromwich Albion,78,70,8,6226,6,0,79,71,8,6205,5,0,157,141,16,12431,11,0,6.0,3.0,9.0,4,4,8,0,0,0,0,0,0,2020-12-27 19:15:002020-12-27 19:15:002020-12-27 19:15:002020-12-27 19:15:002020-12-27 19:15:002020-12-27 19:15:00
5301,11871,Youssuf Mulumbu,1773,[2015],Norwich City,2,1,1,91,0,0,5,4,1,280,0,0,7,5,2,371,0,0,0.0,0.0,0.0,0,0,0,0,0,0,0,0,0,2020-12-27 19:15:00
5302,11872,Ysrael Zuñiga,3783,[2000],Coventry City,9,5,4,461,1,0,6,2,4,209,0,0,15,7,8,670,1,0,0.0,0.0,0.0,0,0,0,0,0,0,0,0,0,2020-12-27 19:15:00
5303,23747,Yuriy Zhirkov,2953,"[2009, 2010]",Chelsea FC,14,6,8,624,0,0,15,10,5,933,0,0,29,16,13,1557,0,0,0.0,0.0,0.0,0,0,0,0,0,0,0,0,0,2020-12-27 19:15:002020-12-27 19:15:00
5304,35628,Yves Bissouma,2484,"[2018, 2019, 2020]",Brighton & Hove Albion,30,20,10,1923,0,0,34,26,8,2351,2,0,64,46,18,4274,2,0,0.0,0.0,0.0,0,1,1,0,0,0,0,0,0,2020-12-27 19:15:002020-12-27 19:15:002020-12-27 19:15:00
5305,11878,Yıldıray Baştürk,4261,[2009],Blackburn Rovers,0,0,0,0,0,0,1,1,0,46,0,0,1,1,0,46,0,0,0.0,0.0,0.0,0,0,0,0,0,0,0,0,0,2020-12-27 19:15:00
5306,11879,Zachary Dearnley,3280,[2016],Manchester United,0,0,0,0,0,0,0,0,0,0,0,0,0,0,0,0,0,0,0.0,0.0,0.0,0,0,0,0,0,0,0,0,0,2020-12-27 19:15:00
5307,11880,Zack Steffen,1044,[2020],Manchester City,0,0,0,0,0,0,0,0,0,0,0,0,0,0,0,0,0,0,0.0,0.0,0.0,0,0,0,0,0,0,0,0,0,2020-12-27 19:15:00
5308,11881,Zak Whitbread,3577,[2011],Norwich City,8,8,0,663,0,0,10,10,0,777,0,0,18,18,0,1440,0,0,0.0,0.0,0.0,0,0,0,0,0,0,0,0,0,2020-12-27 19:15:00
5309,23765,Zanka,3097,"[2017, 2018]",Huddersfield Town,33,33,0,2958,1,0,29,29,0,2610,2,0,62,62,0,5568,3,0,0.0,0.0,0.0,1,1,2,0,0,0,0,0,0,2020-12-27 19:15:002020-12-27 19:15:00
5310,71319,Zat Knight,1755,"[2001, 2002, 2003, 2004, 2005, 2006]",Fulham FC,67,65,2,5849,1,0,69,62,7,5597,2,0,136,127,9,11446,3,0,0.0,0.0,0.0,0,1,1,0,0,0,0,0,0,2020-12-27 19:15:002020-12-27 19:15:002020-12-27 19:15:002020-12-27 19:15:002020-12-27 19:15:002020-12-27 19:15:00
5311,23781,Zat Knight,1755,"[2007, 2008]",Aston Villa,19,19,0,1624,2,0,20,18,2,1664,0,0,39,37,2,3288,2,0,1.0,0.0,1.0,2,0,2,0,0,0,0,0,0,2020-12-27 19:15:002020-12-27 19:15:00
5312,35679,Zat Knight,1755,"[2009, 2010, 2011]",Bolton Wanderers,49,46,3,4167,2,0,45,44,1,3961,0,0,94,90,4,8128,2,0,3.0,0.0,3.0,2,0,2,0,0,0,0,0,0,2020-12-27 19:15:002020-12-27 19:15:002020-12-27 19:15:00
5313,23791,Zavon Hines,3804,"[2009, 2010]",West Ham United,13,6,7,620,1,0,9,3,6,382,0,0,22,9,13,1002,1,0,3.0,0.0,3.0,1,0,1,0,0,0,0,0,0,2020-12-27 19:15:002020-12-27 19:15:00
5314,11897,Zdeněk Grygera,3264,[2011],Fulham FC,3,3,0,225,0,0,2,2,0,180,0,0,5,5,0,405,0,0,0.0,0.0,0.0,0,0,0,0,0,0,0,0,0,2020-12-27 19:15:00
5315,23797,Zech Medley,2513,"[2018, 2019]",Arsenal FC,0,0,0,0,0,0,0,0,0,0,0,0,0,0,0,0,0,0,0.0,0.0,0.0,0,0,0,0,0,0,0,0,0,2020-12-27 19:15:002020-12-27 19:15:00
5316,35703,Zeshan Rehman,1934,"[2003, 2004, 2005]",Fulham FC,9,8,1,765,0,0,10,8,2,792,0,0,19,16,3,1557,0,0,0.0,0.0,0.0,0,0,0,0,0,0,0,0,0,2020-12-27 19:15:002020-12-27 19:15:002020-12-27 19:15:00
5317,11903,Zhi Zheng,3538,[2006],Charlton Athletic,6,5,1,452,1,0,6,3,3,386,0,0,12,8,4,838,1,0,0.0,0.0,0.0,1,0,1,0,0,0,0,0,0,2020-12-27 19:15:00
5318,23809,Zlatan Ibrahimović,2575,"[2016, 2017]",Manchester United,19,15,4,1368,7,0,14,13,1,1172,10,0,33,28,5,2540,17,0,3.0,3.0,6.0,4,4,8,2,0,2,0,0,0,2020-12-27 19:15:002020-12-27 19:15:00
5319,59549,Zoltán Gera,1323,"[2004, 2005, 2011, 2012, 2013]",West Bromwich Albion,44,33,11,2869,7,0,41,31,10,2647,5,0,85,64,21,5516,12,0,3.0,1.0,4.0,4,5,9,0,0,0,0,0,0,2020-12-27 19:15:002020-12-27 19:15:002020-12-27 19:15:002020-12-27 19:15:002020-12-27 19:15:00
5320,35727,Zoltán Gera,1323,"[2008, 2009, 2010]",Fulham FC,42,23,19,2282,3,0,38,21,17,1974,2,0,80,44,36,4256,5,0,0.0,0.0,0.0,1,2,3,0,0,0,0,0,0,2020-12-27 19:15:002020-12-27 19:15:002020-12-27 19:15:00
5321,11914,Zoran Tošić,3329,[2008],Manchester United,0,0,0,0,0,0,2,0,2,16,0,0,2,0,2,16,0,0,0.0,0.0,0.0,0,0,0,0,0,0,0,0,0,2020-12-27 19:15:00
5322,11915,Zoumana Camara,2779,[2003],Leeds United,7,7,0,630,0,0,6,6,0,540,1,0,13,13,0,1170,1,0,0.0,0.0,0.0,0,1,1,0,0,0,0,0,0,2020-12-27 19:15:00
5323,47670,Zurab Khizanishvili,2006,"[2005, 2006, 2007, 2008]",Blackburn Rovers,30,26,4,2473,1,0,30,27,3,2428,0,0,60,53,7,4901,1,0,0.0,0.0,0.0,1,0,1,0,0,0,0,0,0,2020-12-27 19:15:002020-12-27 19:15:002020-12-27 19:15:002020-12-27 19:15:00
5324,11920,Zvonimir Vukić,3564,[2005],Portsmouth FC,4,3,1,271,0,0,5,3,2,247,1,0,9,6,3,518,1,0,0.0,0.0,0.0,0,1,1,0,0,0,0,0,0,2020-12-27 19:15:00
5325,83468,Àngel Rangel,1696,"[2011, 2012, 2013, 2014, 2015, 2016, 2017]",Swansea City,85,76,9,6811,2,0,84,67,17,6286,2,0,169,143,26,13097,4,0,0.0,3.0,3.0,1,2,3,0,0,0,0,0,0,2020-12-27 19:15:002020-12-27 19:15:002020-12-27 19:15:002020-12-27 19:15:002020-12-27 19:15:002020-12-27 19:15:002020-12-27 19:15:00
5326,23857,Ádám Bogdán,2488,"[2010, 2011]",Bolton Wanderers,11,10,1,951,0,0,13,13,0,1170,0,0,24,23,1,2121,0,0,0.0,0.0,0.0,0,0,0,0,0,0,0,0,0,2020-12-27 19:15:002020-12-27 19:15:00
5327,11930,Ádám Bogdán,2488,[2015],Liverpool FC,0,0,0,0,0,0,2,2,0,180,0,0,2,2,0,180,0,0,0.0,0.0,0.0,0,0,0,0,0,0,0,0,0,2020-12-27 19:15:00
5328,11931,Ákos Buzsáky,2171,[2011],Queens Park Rangers,9,4,5,375,2,0,9,6,3,520,0,0,18,10,8,895,2,0,0.0,0.0,0.0,0,0,0,0,0,0,0,0,0,2020-12-27 19:15:00
5329,11932,Álvaro,2942,[2013],Swansea City,5,2,3,127,0,0,7,3,4,284,0,0,12,5,7,411,0,0,0.0,0.0,0.0,0,0,0,0,0,0,0,0,0,2020-12-27 19:15:00
5330,11933,Álvaro Negredo,1360,[2013],Manchester City,18,12,6,985,7,0,14,9,5,739,2,0,32,21,11,1724,9,0,3.0,0.0,3.0,5,0,5,0,0,0,0,0,0,2020-12-27 19:15:00
5331,11934,Álvaro Negredo,1360,[2016],Middlesbrough FC,19,18,1,1571,6,0,17,15,2,1309,3,0,36,33,3,2880,9,0,1.0,0.0,1.0,5,3,8,2,0,2,0,0,0,2020-12-27 19:15:00
5332,11935,Ángel Crespo,3516,[2015],Aston Villa,1,1,0,90,0,0,0,0,0,0,0,0,1,1,0,90,0,0,0.0,0.0,0.0,0,0,0,0,0,0,0,0,0,2020-12-27 19:15:00
5333,11936,Ángel Di María,2997,[2014],Manchester United,13,10,3,791,2,0,14,10,4,855,1,0,27,20,7,1646,3,0,0.0,0.0,0.0,2,0,2,0,0,0,0,0,0,2020-12-27 19:15:00
5334,11937,Ángelo Balanta,4471,[2011],Queens Park Rangers,0,0,0,0,0,0,0,0,0,0,0,0,0,0,0,0,0,0,0.0,0.0,0.0,0,0,0,0,0,0,0,0,0,2020-12-27 19:15:00
5335,11938,Ángelo Henríquez,4116,[2012],Wigan Athletic,3,0,3,41,1,0,1,0,1,5,0,0,4,0,4,46,1,0,0.0,0.0,0.0,0,0,0,0,0,0,0,0,0,2020-12-27 19:15:00
5336,11939,Árni Arason,4204,[2003],Manchester City,0,0,0,0,0,0,0,0,0,0,0,0,0,0,0,0,0,0,0.0,0.0,0.0,0,0,0,0,0,0,0,0,0,2020-12-27 19:15:00
5337,35823,Çağlar Söyüncü,2437,"[2018, 2019, 2020]",Leicester City,23,21,2,1902,0,0,21,21,0,1890,1,0,44,42,2,3792,1,0,0.0,0.0,0.0,0,1,1,0,0,0,0,0,0,2020-12-27 19:15:002020-12-27 19:15:002020-12-27 19:15:00
5338,11943,Éder,2277,[2015],Swansea City,5,1,4,106,0,0,8,1,7,162,0,0,13,2,11,268,0,0,0.0,0.0,0.0,0,0,0,0,0,0,0,0,0,2020-12-27 19:15:00
5339,11944,Édouard Cissé,2462,[2002],West Ham United,8,5,3,457,0,0,13,9,4,736,1,0,21,14,7,1193,1,0,0.0,0.0,0.0,0,1,1,0,0,0,0,0,0,2020-12-27 19:15:00
5340,35838,Émerson Thome,1102,"[2000, 2001, 2002]",Sunderland AFC,19,18,1,1658,2,0,18,18,0,1599,0,0,37,36,1,3257,2,0,4.0,0.0,4.0,2,0,2,0,0,0,0,0,0,2020-12-27 19:15:002020-12-27 19:15:002020-12-27 19:15:00
5341,11948,Émerson Thome,1102,[2003],Bolton Wanderers,14,13,1,1190,0,0,12,12,0,1069,0,0,26,25,1,2259,0,0,0.0,0.0,0.0,0,0,0,0,0,0,0,0,0,2020-12-27 19:15:00
5342,23899,Émile Mpenza,3033,"[2006, 2007]",Manchester City,16,11,5,977,1,0,9,6,3,592,4,0,25,17,8,1569,5,0,0.0,3.0,3.0,1,2,3,0,0,0,0,0,0,2020-12-27 19:15:002020-12-27 19:15:00
5343,11951,Éric Roy,4193,[2000],Manchester City,1,0,1,45,0,0,0,0,0,0,0,0,1,0,1,45,0,0,0.0,0.0,0.0,0,0,0,0,0,0,0,0,0,2020-12-27 19:15:00
5344,95644,Érik Lamela,1168,"[2013, 2014, 2015, 2016, 2017, 2018, 2019, 2020]",Tottenham Hotspur,78,42,36,4095,7,0,82,50,32,4719,9,0,160,92,68,8814,16,0,3.0,4.0,7.0,2,6,8,0,0,0,0,0,0,2020-12-27 19:15:002020-12-27 19:15:002020-12-27 19:15:002020-12-27 19:15:002020-12-27 19:15:002020-12-27 19:15:002020-12-27 19:15:002020-12-27 19:15:00
5345,23921,Étienne Capoue,1924,"[2013, 2014]",Tottenham Hotspur,11,8,3,751,1,0,13,11,2,834,0,0,24,19,5,1585,1,0,0.0,0.0,0.0,0,0,0,0,0,0,0,0,0,2020-12-27 19:15:002020-12-27 19:15:00
5346,59820,Étienne Capoue,1924,"[2015, 2016, 2017, 2018, 2019]",Watford FC,80,77,3,6767,4,0,76,74,2,6389,5,0,156,151,5,13156,9,0,3.0,0.0,3.0,4,4,8,0,0,0,0,0,0,2020-12-27 19:15:002020-12-27 19:15:002020-12-27 19:15:002020-12-27 19:15:002020-12-27 19:15:00
5347,23935,Ívar Ingimarsson,2590,"[2006, 2007]",Reading FC,37,36,1,3259,3,0,31,31,0,2790,1,0,68,67,1,6049,4,0,3.0,0.0,3.0,3,1,4,0,0,0,0,0,0,2020-12-27 19:15:002020-12-27 19:15:00
5348,11969,Óscar Ustari,2265,[2013],Sunderland AFC,0,0,0,0,0,0,0,0,0,0,0,0,0,0,0,0,0,0,0.0,0.0,0.0,0,0,0,0,0,0,0,0,0,2020-12-27 19:15:00
5349,11970,Ørjan Nyland,2854,[2019],Aston Villa,4,4,0,360,0,0,3,1,2,177,0,0,7,5,2,537,0,0,0.0,0.0,0.0,0,0,0,0,0,0,0,0,0,2020-12-27 19:15:00
5350,23943,Øyvind Leonhardsen,2078,"[2000, 2001]",Tottenham Hotspur,16,11,5,940,2,0,14,12,2,1016,1,0,30,23,7,1956,3,0,0.0,0.0,0.0,1,1,2,0,0,0,0,0,0,2020-12-27 19:15:002020-12-27 19:15:00
5351,11973,Øyvind Leonhardsen,2078,[2002],Aston Villa,8,5,3,539,2,0,10,7,3,636,1,0,18,12,6,1175,3,0,0.0,0.0,0.0,0,1,1,0,0,0,0,0,0,2020-12-27 19:15:00
5352,11974,Þórður Guðjónsson,3375,[2000],Derby County,5,1,4,163,0,0,4,1,3,95,1,0,9,2,7,258,1,0,0.0,0.0,0.0,0,0,0,0,0,0,0,0,0,2020-12-27 19:15:00
5353,59885,İlkay Gündoğan,1200,"[2016, 2017, 2018, 2019, 2020]",Manchester City,57,38,19,3699,11,0,53,37,16,3329,6,0,110,75,35,7028,17,0,0.0,0.0,0.0,5,0,5,1,1,2,0,0,0,2020-12-27 19:15:002020-12-27 19:15:002020-12-27 19:15:002020-12-27 19:15:002020-12-27 19:15:00
5354,23961,Ľubomir Michalík,3442,"[2006, 2007]",Bolton Wanderers,4,3,1,339,0,0,7,5,2,495,1,0,11,8,3,834,1,0,0.0,0.0,0.0,0,1,1,0,0,0,0,0,0,2020-12-27 19:15:002020-12-27 19:15:00
5355,23965,Ľubomír Šatka,3754,"[2013, 2014]",Newcastle United,0,0,0,0,0,0,0,0,0,0,0,0,0,0,0,0,0,0,0.0,0.0,0.0,0,0,0,0,0,0,0,0,0,2020-12-27 19:15:002020-12-27 19:15:00
5356,83909,Łukasz Fabiański,1227,"[2007, 2008, 2009, 2010, 2011, 2012, 2013]",Arsenal FC,14,13,1,1161,0,0,18,18,0,1620,0,0,32,31,1,2781,0,0,0.0,0.0,0.0,0,0,0,0,0,0,0,0,0,2020-12-27 19:15:002020-12-27 19:15:002020-12-27 19:15:002020-12-27 19:15:002020-12-27 19:15:002020-12-27 19:15:002020-12-27 19:15:00
5357,47970,Łukasz Fabiański,1227,"[2014, 2015, 2016, 2017]",Swansea City,73,73,0,6570,0,0,76,76,0,6840,0,0,149,149,0,13410,0,0,0.0,0.0,0.0,0,0,0,0,0,0,0,0,0,2020-12-27 19:15:002020-12-27 19:15:002020-12-27 19:15:002020-12-27 19:15:00
5358,35988,Łukasz Fabiański,1227,"[2018, 2019, 2020]",West Ham United,40,40,0,3600,0,0,38,38,0,3289,0,0,78,78,0,6889,0,0,0.0,0.0,0.0,0,0,0,0,0,0,0,0,0,2020-12-27 19:15:002020-12-27 19:15:002020-12-27 19:15:00
