,Unnamed: 0,Name,ID,Season,Club,AppearancesH,StartsH,SubsH,MinsH,GoalsH,AssistsH,AppearancesA,StartsA,SubsA,MinsA,GoalsA,AssistsA,Appearances,Starts,Subs,Mins,Goals,Assists,PointsWonH,PointsWonA,PointsWon,GCGoalsH,GCGoalsA,GCGoals,PenaltiesH,PenaltiesA,Penalties,OwnGoalsH,OwnGoalsA,OwnGoals
0,0,Artur Boruc,1000,2015,AFC Bournemouth,17,17,0,1530,0,0,15,15,0,1350,0,0,32,32,0,2880,0,0,0,0,0,0,0,0,0,0,0,0,0,0
1,1,Simon Francis,1001,2015,AFC Bournemouth,19,19,0,1710,0,0,19,19,0,1710,0,0,38,38,0,3420,0,0,0,0,0,0,0,0,0,0,0,0,0,0
2,2,Steve Cook,1002,2015,AFC Bournemouth,18,18,0,1576,2,0,18,18,0,1620,2,0,36,36,0,3196,4,0,3,0,3,2,1,3,0,0,0,0,0,0
3,3,Charlie Daniels,1003,2015,AFC Bournemouth,19,19,0,1666,1,0,18,18,0,1620,2,0,37,37,0,3286,3,0,0,3,3,0,1,1,1,1,2,0,0,0
4,4,Adam Smith,1004,2015,AFC Bournemouth,15,10,5,1004,1,0,16,12,4,1091,1,0,31,22,9,2095,2,0,0,0,0,0,1,1,0,0,0,0,0,0
5,5,Dan Gosling,1005,2015,AFC Bournemouth,17,15,2,1218,1,0,17,13,4,1183,2,0,34,28,6,2401,3,0,0,0,0,1,1,2,0,0,0,0,0,0
6,6,Andrew Surman,1006,2015,AFC Bournemouth,19,19,0,1710,0,0,19,19,0,1710,0,0,38,38,0,3420,0,0,0,0,0,0,0,0,0,0,0,0,0,0
7,7,Harry Arter,1007,2015,AFC Bournemouth,10,10,0,783,1,0,11,11,0,891,0,0,21,21,0,1674,1,0,0,0,0,1,0,1,0,0,0,0,0,0
8,8,Matt Ritchie,1008,2015,AFC Bournemouth,18,15,3,1345,4,0,19,18,1,1633,0,0,37,33,4,2978,4,0,1,0,1,2,0,2,0,0,0,0,0,0
9,9,Junior Stanislas,1009,2015,AFC Bournemouth,11,10,1,820,3,0,10,7,3,620,0,0,21,17,4,1440,3,0,1,0,1,3,0,3,0,0,0,0,0,0
10,10,Glenn Murray,1010,2015,AFC Bournemouth,8,3,5,298,1,0,11,3,8,371,2,0,19,6,13,669,3,0,0,3,3,1,1,2,0,0,0,0,0,0
11,11,Eunan O'Kane,1011,2015,AFC Bournemouth,10,2,8,362,0,0,6,4,2,387,0,0,16,6,10,749,0,0,0,0,0,0,0,0,0,0,0,0,0,0
12,12,Tokelo Rantie,1012,2015,AFC Bournemouth,2,0,2,30,0,0,1,0,1,8,0,0,3,0,3,38,0,0,0,0,0,0,0,0,0,0,0,0,0,0
13,13,Yann Kermorgant,1013,2015,AFC Bournemouth,5,0,5,121,0,0,2,0,2,47,0,0,7,0,7,168,0,0,0,0,0,0,0,0,0,0,0,0,0,0
14,14,Adam Federici,1014,2015,AFC Bournemouth,2,2,0,136,0,0,4,4,0,360,0,0,6,6,0,496,0,0,0,0,0,0,0,0,0,0,0,0,0,0
15,15,Sylvain Distin,1015,2015,AFC Bournemouth,5,5,0,450,0,0,7,4,3,392,0,0,12,9,3,842,0,0,0,0,0,0,0,0,0,0,0,0,0,0
16,16,Marc Pugh,1016,2015,AFC Bournemouth,13,8,5,724,0,0,13,7,6,612,3,0,26,15,11,1336,3,0,0,0,0,0,3,3,0,0,0,0,0,0
17,17,Shaun MacDonald,1017,2015,AFC Bournemouth,0,0,0,0,0,0,3,0,3,29,0,0,3,0,3,29,0,0,0,0,0,0,0,0,0,0,0,0,0,0
18,18,Wayne Hennessey,1018,2015,Crystal Palace,15,15,0,1350,0,0,14,14,0,1260,0,0,29,29,0,2610,0,0,0,0,0,0,0,0,0,0,0,0,0,0
19,19,Joel Ward,1019,2015,Crystal Palace,16,16,0,1440,1,0,14,14,0,1252,1,0,30,30,0,2692,2,0,0,3,3,1,1,2,0,0,0,0,0,0
20,20,Scott Dann,1020,2015,Crystal Palace,19,19,0,1710,2,0,16,16,0,1440,3,0,35,35,0,3150,5,0,0,4,4,2,3,5,0,0,0,0,0,0
21,21,Pape Souaré,1021,2015,Crystal Palace,18,18,0,1576,0,0,16,16,0,1440,0,0,34,34,0,3016,0,0,0,0,0,0,0,0,0,0,0,0,0,0
22,22,Damien Delaney,1022,2015,Crystal Palace,15,15,0,1350,0,0,17,17,0,1530,2,0,32,32,0,2880,2,0,0,0,0,0,1,1,0,0,0,0,0,0
23,23,James McArthur,1023,2015,Crystal Palace,14,14,0,1152,2,0,14,12,2,1040,0,0,28,26,2,2192,2,0,0,0,0,1,0,1,0,0,0,0,0,0
24,24,Jordon Mutch,1024,2015,Crystal Palace,8,1,7,280,0,0,12,6,6,515,0,0,20,7,13,795,0,0,0,0,0,0,0,0,0,0,0,0,0,0
25,25,Joe Ledley,1025,2015,Crystal Palace,8,3,5,346,1,0,11,8,3,668,0,0,19,11,8,1014,1,0,0,0,0,1,0,1,0,0,0,0,0,0
26,26,Jason Puncheon,1026,2015,Crystal Palace,16,16,0,1351,1,0,15,15,0,1274,1,0,31,31,0,2625,2,0,3,0,3,1,0,1,0,0,0,0,0,0
27,27,Fraizer Campbell,1027,2015,Crystal Palace,5,2,3,162,0,0,6,2,4,196,0,0,11,4,7,358,0,0,0,0,0,0,0,0,0,0,0,0,0,0
28,28,Wilfried Zaha,1028,2015,Crystal Palace,18,17,1,1416,1,0,16,13,3,1081,1,0,34,30,4,2497,2,0,0,0,0,0,1,1,0,0,0,0,0,0
29,29,Yohan Cabaye,1029,2015,Crystal Palace,17,17,0,1415,3,0,16,15,1,1288,2,0,33,32,1,2703,5,0,3,3,6,2,1,3,2,1,3,0,0,0
30,30,Mile Jedinak,1030,2015,Crystal Palace,14,8,6,786,0,0,13,8,5,745,0,0,27,16,11,1531,0,0,0,0,0,0,0,0,0,0,0,0,0,0
31,31,Marouane Chamakh,1031,2015,Crystal Palace,5,1,4,106,0,0,5,0,5,145,0,0,10,1,9,251,0,0,0,0,0,0,0,0,0,0,0,0,0,0
32,32,Alex McCarthy,1032,2015,Crystal Palace,4,4,0,360,0,0,3,3,0,270,0,0,7,7,0,630,0,0,0,0,0,0,0,0,0,0,0,0,0,0
33,33,Brede Hangeland,1033,2015,Crystal Palace,4,4,0,360,0,0,3,3,0,270,0,0,7,7,0,630,0,0,0,0,0,0,0,0,0,0,0,0,0,0
34,34,Martin Kelly,1034,2015,Crystal Palace,5,4,1,404,0,0,8,7,1,638,0,0,13,11,2,1042,0,0,0,0,0,0,0,0,0,0,0,0,0,0
35,35,Connor Wickham,1035,2015,Crystal Palace,9,7,2,623,0,0,12,8,4,701,5,0,21,15,6,1324,5,0,0,0,0,0,3,3,0,1,1,0,0,0
36,36,Asmir Begović,1036,2017,AFC Bournemouth,19,19,0,1710,0,0,19,19,0,1710,0,0,38,38,0,3420,0,0,0,0,0,0,0,0,0,0,0,0,0,0
37,37,Simon Francis,1001,2017,AFC Bournemouth,17,17,0,1457,0,0,15,14,1,1294,0,0,32,31,1,2751,0,0,0,0,0,0,0,0,0,0,0,0,0,0
38,38,Steve Cook,1002,2017,AFC Bournemouth,16,15,1,1307,0,0,18,16,2,1459,2,0,34,31,3,2766,2,0,0,3,3,0,2,2,0,0,0,0,0,0
39,39,Nathan Aké,1037,2017,AFC Bournemouth,19,19,0,1710,1,0,19,18,1,1643,1,0,38,37,1,3353,2,0,0,0,0,1,0,1,0,0,0,0,0,0
40,40,Adam Smith,1004,2017,AFC Bournemouth,14,12,2,1138,1,0,13,10,3,930,0,0,27,22,5,2068,1,0,0,0,0,0,0,0,0,0,0,0,0,0
41,41,Dan Gosling,1005,2017,AFC Bournemouth,13,9,4,842,2,0,15,12,3,1101,0,0,28,21,7,1943,2,0,1,0,1,2,0,2,0,0,0,0,0,0
42,42,Lewis Cook,1038,2017,AFC Bournemouth,16,14,2,1272,0,0,13,11,2,967,0,0,29,25,4,2239,0,0,0,0,0,0,0,0,0,0,0,0,0,0
43,43,Callum Wilson,1039,2017,AFC Bournemouth,14,12,2,1050,5,0,14,11,3,940,3,0,28,23,5,1990,8,0,1,4,5,3,3,6,0,0,0,0,0,0
44,44,Joshua King,1040,2017,AFC Bournemouth,17,14,3,1241,3,0,16,13,3,1215,5,0,33,27,6,2456,8,0,1,0,1,2,5,7,0,2,2,0,0,0
45,45,Ryan Fraser,1041,2017,AFC Bournemouth,14,11,3,989,4,0,12,12,0,1020,1,0,26,23,3,2009,5,0,6,0,6,4,1,5,0,0,0,0,0,0
46,46,Jordon Ibe,1042,2017,AFC Bournemouth,15,10,5,898,2,0,17,12,5,1101,0,0,32,22,10,1999,2,0,3,0,3,2,0,2,0,0,0,0,0,0
47,47,Harry Arter,1007,2017,AFC Bournemouth,6,5,1,428,1,0,7,6,1,534,0,0,13,11,2,962,1,0,0,0,0,0,0,0,0,0,0,0,0,0
48,48,Benik Afobe,1043,2017,AFC Bournemouth,9,2,7,248,0,0,8,3,5,286,0,0,17,5,12,534,0,0,0,0,0,0,0,0,0,0,0,0,0,0
49,49,Lys Mousset,1044,2017,AFC Bournemouth,11,1,10,266,2,0,12,3,9,319,0,0,23,4,19,585,2,0,3,0,3,2,0,2,0,0,0,0,0,0
50,50,Artur Boruc,1000,2017,AFC Bournemouth,0,0,0,0,0,0,0,0,0,0,0,0,0,0,0,0,0,0,0,0,0,0,0,0,0,0,0,0,0,0
51,51,Charlie Daniels,1003,2017,AFC Bournemouth,17,16,1,1385,1,0,18,18,0,1620,0,0,35,34,1,3005,1,0,0,0,0,1,0,1,0,0,0,0,0,0
52,52,Jack Simpson,1045,2017,AFC Bournemouth,0,0,0,0,0,0,1,1,0,72,0,0,1,1,0,72,0,0,0,0,0,0,0,0,0,0,0,0,0,0
53,53,Marc Pugh,1016,2017,AFC Bournemouth,12,7,5,565,0,0,8,4,4,419,0,0,20,11,9,984,0,0,0,0,0,0,0,0,0,0,0,0,0,0
54,54,Jordan Pickford,1046,2017,Everton FC,19,19,0,1710,0,0,19,19,0,1710,0,0,38,38,0,3420,0,0,0,0,0,0,0,0,0,0,0,0,0,0
55,55,Michael Keane,1047,2017,Everton FC,15,14,1,1270,0,0,15,15,0,1291,0,0,30,29,1,2561,0,0,0,0,0,0,0,0,0,0,0,0,0,0
56,56,Phil Jagielka,1048,2017,Everton FC,10,10,0,890,0,0,15,13,2,1175,0,0,25,23,2,2065,0,0,0,0,0,0,0,0,0,0,0,0,0,0
57,57,Cuco Martina,1049,2017,Everton FC,12,11,1,1020,0,0,9,9,0,810,0,0,21,20,1,1830,0,0,0,0,0,0,0,0,0,0,0,0,0,0
58,58,Jonjoe Kenny,1050,2017,Everton FC,9,7,2,688,0,0,10,10,0,900,0,0,19,17,2,1588,0,0,0,0,0,0,0,0,0,0,0,0,0,0
59,59,Morgan Schneiderlin,1051,2017,Everton FC,15,12,3,1029,0,0,15,12,3,1101,0,0,30,24,6,2130,0,0,0,0,0,0,0,0,0,0,0,0,0,0
60,60,Aaron Lennon,1052,2017,Everton FC,6,4,2,318,0,0,9,5,4,476,0,0,15,9,6,794,0,0,0,0,0,0,0,0,0,0,0,0,0,0
61,61,James McCarthy,1053,2017,Everton FC,2,1,1,89,0,0,2,2,0,118,0,0,4,3,1,207,0,0,0,0,0,0,0,0,0,0,0,0,0,0
62,62,Idrissa Gueye,1054,2017,Everton FC,15,14,1,1234,0,0,18,18,0,1545,2,0,33,32,1,2779,2,0,0,0,0,0,1,1,0,0,0,0,0,0
63,63,Gylfi Sigurðsson,1055,2017,Everton FC,13,13,0,1157,3,0,14,12,2,1105,1,0,27,25,2,2262,4,0,0,0,0,3,1,4,0,0,0,0,0,0
64,64,Dominic Calvert-Lewin,1056,2017,Everton FC,16,9,7,940,3,0,16,9,7,933,1,0,32,18,14,1873,4,0,0,0,0,2,0,2,0,0,0,0,0,0
65,65,Yannick Bolasie,1057,2017,Everton FC,7,6,1,440,1,0,9,5,4,415,0,0,16,11,5,855,1,0,0,0,0,0,0,0,0,0,0,0,0,0
66,66,Wayne Rooney,1058,2017,Everton FC,17,15,2,1214,6,0,14,12,2,1070,4,0,31,27,4,2284,10,0,3,5,8,3,4,7,1,2,3,0,0,0
67,67,Oumar Niasse,1059,2017,Everton FC,11,5,6,550,6,0,11,5,6,531,2,0,22,10,12,1081,8,0,4,1,5,3,1,4,0,0,0,0,0,0
68,68,Joel,1060,2017,Everton FC,0,0,0,0,0,0,0,0,0,0,0,0,0,0,0,0,0,0,0,0,0,0,0,0,0,0,0,0,0,0
69,69,Ashley Williams,1061,2017,Everton FC,13,10,3,903,1,0,11,10,1,934,0,0,24,20,4,1837,1,0,0,0,0,0,0,0,0,0,0,0,0,0
70,70,Mason Holgate,1062,2017,Everton FC,7,6,1,552,0,0,8,7,1,631,0,0,15,13,2,1183,0,0,0,0,0,0,0,0,0,0,0,0,0,0
71,71,Tom Davies,1063,2017,Everton FC,18,10,8,1089,2,0,15,10,5,811,0,0,33,20,13,1900,2,0,1,0,1,1,0,1,0,0,0,0,0,0
72,72,Shaka Hislop,1064,2003,Portsmouth FC,16,16,0,1440,0,0,14,14,0,1260,0,0,30,30,0,2700,0,0,0,0,0,0,0,0,0,0,0,0,0,0
73,73,Linvoy Primus,1065,2003,Portsmouth FC,10,9,1,711,0,0,10,9,1,806,0,0,20,18,2,1517,0,0,0,0,0,0,0,0,0,0,0,0,0,0
74,74,Dejan Stefanović,1066,2003,Portsmouth FC,17,17,0,1475,3,0,14,14,0,1260,0,0,31,31,0,2735,3,0,0,0,0,3,0,3,0,0,0,0,0,0
75,75,Arjan de Zeeuw,1067,2003,Portsmouth FC,18,18,0,1620,1,0,17,17,0,1530,0,0,35,35,0,3150,1,0,0,0,0,0,0,0,0,0,0,0,0,0
76,76,Nigel Quashie,1068,2003,Portsmouth FC,12,9,3,858,0,0,9,8,1,744,1,0,21,17,4,1602,1,0,0,0,0,0,0,0,0,0,0,0,0,0
77,77,Matthew Taylor,1069,2003,Portsmouth FC,14,9,5,855,0,0,15,9,6,967,0,0,29,18,11,1822,0,0,0,0,0,0,0,0,0,0,0,0,0,0
78,78,Amdy Faye,1070,2003,Portsmouth FC,14,14,0,1232,0,0,13,13,0,1047,0,0,27,27,0,2279,0,0,0,0,0,0,0,0,0,0,0,0,0,0
79,79,Steve Stone,1071,2003,Portsmouth FC,16,15,1,1358,2,0,15,13,2,1141,0,0,31,28,3,2499,2,0,3,0,3,2,0,2,0,0,0,0,0,0
80,80,Aleksey Smertin,1072,2003,Portsmouth FC,12,12,0,1013,0,0,14,11,3,1054,0,0,26,23,3,2067,0,0,0,0,0,0,0,0,0,0,0,0,0,0
81,81,Yakubu Ayegbeni,1073,2003,Portsmouth FC,19,18,1,1606,11,0,17,16,1,1430,5,0,36,34,2,3036,16,0,3,4,7,5,5,10,2,0,2,0,0,0
82,82,Lomana LuaLua,1074,2003,Portsmouth FC,8,6,2,547,2,0,7,4,3,378,2,0,15,10,5,925,4,0,1,0,1,1,1,2,0,0,0,0,0,0
83,83,Richard Duffy,1075,2003,Portsmouth FC,1,0,1,68,0,0,0,0,0,0,0,0,1,0,1,68,0,0,0,0,0,0,0,0,0,0,0,0,0,0
84,84,Teddy Sheringham,1076,2003,Portsmouth FC,15,12,3,1104,7,0,17,13,4,1110,2,0,32,25,7,2214,9,0,0,0,0,3,2,5,1,0,1,0,0,0
85,85,Edwin van der Sar,1077,2003,Fulham FC,18,18,0,1620,0,0,17,17,0,1530,0,0,35,35,0,3150,0,0,0,0,0,0,0,0,0,0,0,0,0,0
86,86,Moritz Volz,1078,2003,Fulham FC,15,15,0,1350,0,0,17,16,1,1468,0,0,32,31,1,2818,0,0,0,0,0,0,0,0,0,0,0,0,0,0
87,87,Martin Djetou,1079,2003,Fulham FC,13,9,4,876,0,0,12,9,3,796,0,0,25,18,7,1672,0,0,0,0,0,0,0,0,0,0,0,0,0,0
88,88,Alain Goma,1080,2003,Fulham FC,11,11,0,990,0,0,12,12,0,1080,0,0,23,23,0,2070,0,0,0,0,0,0,0,0,0,0,0,0,0,0
89,89,Carlos Bocanegra,1081,2003,Fulham FC,6,6,0,540,0,0,9,9,0,797,0,0,15,15,0,1337,0,0,0,0,0,0,0,0,0,0,0,0,0,0
90,90,Ian Pearce,1082,2003,Fulham FC,7,6,1,555,0,0,6,6,0,540,0,0,13,12,1,1095,0,0,0,0,0,0,0,0,0,0,0,0,0,0
91,91,Sylvain Legwinski,1083,2003,Fulham FC,16,15,1,1377,0,0,14,13,1,1079,0,0,30,28,2,2456,0,0,0,0,0,0,0,0,0,0,0,0,0,0
92,92,Junichi Inamoto,1084,2003,Fulham FC,11,7,4,574,1,0,11,8,3,721,1,0,22,15,7,1295,2,0,0,0,0,1,0,1,0,0,0,0,0,0
93,93,Boa Morte,1085,2003,Fulham FC,15,14,1,1233,6,0,16,16,0,1394,3,0,31,30,1,2627,9,0,1,0,1,4,2,6,0,0,0,0,0,0
94,94,Steed Malbranque,1086,2003,Fulham FC,19,19,0,1694,4,0,17,17,0,1444,2,0,36,36,0,3138,6,0,0,0,0,3,1,4,2,0,2,0,0,0
95,95,Sean Davis,1087,2003,Fulham FC,12,11,1,962,3,0,10,9,1,830,2,0,22,20,2,1792,5,0,0,0,0,2,0,2,0,0,0,0,0,0
96,96,Brian McBride,1088,2003,Fulham FC,8,2,6,298,1,0,8,3,5,351,3,0,16,5,11,649,4,0,3,1,4,1,2,3,0,0,0,0,0,0
97,97,Collins John,1089,2003,Fulham FC,3,2,1,188,2,0,5,1,4,136,2,0,8,3,5,324,4,0,0,0,0,2,1,3,0,0,0,0,0,0
98,98,Thomas Sørensen,1090,2000,Sunderland AFC,14,14,0,1218,0,0,14,14,0,1260,0,0,28,28,0,2478,0,0,0,0,0,0,0,0,0,0,0,0,0,0
99,99,Stanislav Varga,1091,2000,Sunderland AFC,6,3,3,314,0,0,5,5,0,450,1,0,11,8,3,764,1,0,0,0,0,0,1,1,0,0,0,0,0,0
100,100,Michael Gray,1092,2000,Sunderland AFC,14,14,0,1260,1,0,14,14,0,1238,0,0,28,28,0,2498,1,0,3,0,3,1,0,1,0,0,0,0,0,0
101,101,Jody Craddock,1093,2000,Sunderland AFC,12,12,0,1045,0,0,15,14,1,1299,0,0,27,26,1,2344,0,0,0,0,0,0,0,0,0,0,0,0,0,0
102,102,Darren Williams,1094,2000,Sunderland AFC,12,8,4,810,0,0,11,8,3,772,0,0,23,16,7,1582,0,0,0,0,0,0,0,0,0,0,0,0,0,0
103,103,Don Hutchison,1095,2000,Sunderland AFC,11,11,0,958,3,0,14,13,1,1194,5,0,25,24,1,2152,8,0,3,0,3,3,4,7,0,0,0,0,0,0
104,104,Gavin McCann,1096,2000,Sunderland AFC,9,9,0,788,1,0,11,11,0,963,2,0,20,20,0,1751,3,0,1,1,2,1,2,3,0,0,0,0,0,0
105,105,Alex Rae,1097,2000,Sunderland AFC,7,7,0,614,1,0,8,8,0,720,1,0,15,15,0,1334,2,0,0,3,3,1,1,2,0,0,0,0,0,0
106,106,Stefan Schwarz,1098,2000,Sunderland AFC,9,7,2,581,1,0,10,9,1,796,0,0,19,16,3,1377,1,0,0,0,0,0,0,0,0,0,0,0,0,0
107,107,Niall Quinn,1099,2000,Sunderland AFC,12,12,0,870,4,0,14,12,2,1001,3,0,26,24,2,1871,7,0,3,3,6,3,2,5,0,0,0,0,0,0
108,108,Kevin Phillips,1100,2000,Sunderland AFC,12,12,0,1079,5,0,14,14,0,1258,9,0,26,26,0,2337,14,0,3,1,4,2,4,6,1,1,2,0,0,0
109,109,Chris Makin,1101,2000,Sunderland AFC,9,7,2,671,0,0,8,8,0,697,0,0,17,15,2,1368,0,0,0,0,0,0,0,0,0,0,0,0,0,0
110,110,Émerson Thome,1102,2000,Sunderland AFC,12,11,1,1028,1,0,12,12,0,1080,0,0,24,23,1,2108,1,0,3,0,3,1,0,1,0,0,0,0,0,0
111,111,Kevin Kilbane,1103,2000,Sunderland AFC,11,8,3,788,3,0,12,11,1,960,1,0,23,19,4,1748,4,0,0,3,3,3,1,4,0,0,0,0,0,0
112,112,Fabien Barthez,1104,2000,Manchester United,16,16,0,1437,0,0,14,14,0,1238,0,0,30,30,0,2675,0,0,0,0,0,0,0,0,0,0,0,0,0,0
113,113,Gary Neville,1105,2000,Manchester United,17,17,0,1499,1,0,14,14,0,1260,0,0,31,31,0,2759,1,0,0,0,0,1,0,1,0,0,0,0,0,0
114,114,Mikaël Silvestre,1106,2000,Manchester United,16,13,3,1215,1,0,13,11,2,946,0,0,29,24,5,2161,1,0,0,0,0,0,0,0,0,0,0,0,0,0
115,115,Jaap Stam,1107,2000,Manchester United,8,8,0,675,0,0,6,6,0,470,0,0,14,14,0,1145,0,0,0,0,0,0,0,0,0,0,0,0,0,0
116,116,Wes Brown,1108,2000,Manchester United,13,11,2,979,0,0,14,13,1,1195,0,0,27,24,3,2174,0,0,0,0,0,0,0,0,0,0,0,0,0,0
117,117,David Beckham,1109,2000,Manchester United,16,14,2,1313,3,0,14,14,0,1245,6,0,30,28,2,2558,9,0,0,4,4,0,4,4,0,1,1,0,0,0
118,118,Ryan Giggs,1110,2000,Manchester United,14,10,4,957,1,0,16,13,3,1171,4,0,30,23,7,2128,5,0,0,0,0,1,1,2,0,0,0,0,0,0
119,119,Roy Keane,1111,2000,Manchester United,14,14,0,1149,1,0,13,13,0,1150,1,0,27,27,0,2299,2,0,0,0,0,0,0,0,0,0,0,0,0,0
120,120,Paul Scholes,1112,2000,Manchester United,17,16,1,1390,5,0,14,11,3,970,1,0,31,27,4,2360,6,0,0,0,0,3,1,4,0,0,0,0,0,0
121,121,Andy Cole,1113,2000,Manchester United,10,9,1,754,5,0,8,5,3,507,4,0,18,14,4,1261,9,0,0,4,4,3,3,6,0,0,0,0,0,0
122,122,Teddy Sheringham,1076,2000,Manchester United,14,10,4,945,11,0,15,13,2,1062,4,0,29,23,6,2007,15,0,3,0,3,3,3,6,1,0,1,0,0,0
123,123,Phil Neville,1114,2000,Manchester United,14,12,2,1080,0,0,15,12,3,1105,1,0,29,24,5,2185,1,0,0,0,0,0,1,1,0,0,0,0,0,0
124,124,Nicky Butt,1115,2000,Manchester United,16,13,3,1097,1,0,12,11,1,944,2,0,28,24,4,2041,3,0,0,0,0,1,1,2,0,0,0,0,0,0
125,125,Ole Gunnar Solskjær,1116,2000,Manchester United,17,9,8,847,7,0,13,9,4,817,4,0,30,18,12,1664,11,0,3,3,6,4,2,6,0,0,0,0,0,0
126,126,Kasey Keller,1117,2003,Tottenham Hotspur,19,19,0,1710,0,0,19,19,0,1710,0,0,38,38,0,3420,0,0,0,0,0,0,0,0,0,0,0,0,0,0
127,127,Mauricio Taricco,1118,2003,Tottenham Hotspur,17,17,0,1319,1,0,15,14,1,1216,0,0,32,31,1,2535,1,0,0,0,0,1,0,1,0,0,0,0,0,0
128,128,Ledley King,1119,2003,Tottenham Hotspur,15,14,1,1234,0,0,14,14,0,1208,1,0,29,28,1,2442,1,0,0,0,0,0,0,0,0,0,0,0,0,0
129,129,Anthony Gardner,1120,2003,Tottenham Hotspur,16,16,0,1440,0,0,17,17,0,1530,0,0,33,33,0,2970,0,0,0,0,0,0,0,0,0,0,0,0,0,0
130,130,Stephen Kelly,1121,2003,Tottenham Hotspur,6,3,3,352,0,0,5,4,1,383,0,0,11,7,4,735,0,0,0,0,0,0,0,0,0,0,0,0,0,0
131,131,Michael Brown,1122,2003,Tottenham Hotspur,8,8,0,708,1,0,9,9,0,787,0,0,17,17,0,1495,1,0,0,0,0,1,0,1,0,0,0,0,0,0
132,132,Jamie Redknapp,1123,2003,Tottenham Hotspur,8,7,1,622,1,0,9,7,2,653,0,0,17,14,3,1275,1,0,0,0,0,0,0,0,0,0,0,0,0,0
133,133,Rohan Ricketts,1124,2003,Tottenham Hotspur,12,7,5,657,1,0,12,5,7,500,0,0,24,12,12,1157,1,0,0,0,0,1,0,1,0,0,0,0,0,0
134,134,Simon Davies,1125,2003,Tottenham Hotspur,9,9,0,778,1,0,8,8,0,694,1,0,17,17,0,1472,2,0,0,0,0,0,1,1,0,0,0,0,0,0
135,135,Robbie Keane,1126,2003,Tottenham Hotspur,17,15,2,1412,11,0,17,16,1,1467,3,0,34,31,3,2879,14,0,4,3,7,6,3,9,2,1,3,0,0,0
136,136,Jermain Defoe,1127,2003,Tottenham Hotspur,7,6,1,577,5,0,8,8,0,704,2,0,15,14,1,1281,7,0,5,0,5,5,0,5,0,0,0,0,0,0
137,137,Gustavo Poyet,1128,2003,Tottenham Hotspur,11,7,4,616,3,0,9,5,4,343,0,0,20,12,8,959,3,0,3,0,3,1,0,1,0,0,0,0,0,0
138,138,Christian Ziege,1129,2003,Tottenham Hotspur,3,2,1,203,0,0,5,5,0,363,0,0,8,7,1,566,0,0,0,0,0,0,0,0,0,0,0,0,0,0
139,139,Frédéric Kanouté,1130,2003,Tottenham Hotspur,14,10,4,968,4,0,13,9,4,866,3,0,27,19,8,1834,7,0,3,3,6,3,2,5,0,0,0,0,0,0
140,140,Peter Enckelman,1131,2003,Blackburn Rovers,1,1,0,90,0,0,1,1,0,90,0,0,2,2,0,180,0,0,0,0,0,0,0,0,0,0,0,0,0,0
141,141,Lucas Neill,1132,2003,Blackburn Rovers,16,15,1,1366,0,0,15,14,1,1218,2,0,31,29,2,2584,2,0,0,0,0,0,1,1,0,0,0,0,0,0
142,142,Craig Short,1133,2003,Blackburn Rovers,8,8,0,720,1,0,11,11,0,898,0,0,19,19,0,1618,1,0,0,0,0,0,0,0,0,0,0,0,0,0
143,143,Nils-Eric Johansson,1134,2003,Blackburn Rovers,6,4,2,335,0,0,7,2,5,336,0,0,13,6,7,671,0,0,0,0,0,0,0,0,0,0,0,0,0,0
144,144,Michael Gray,1092,2003,Blackburn Rovers,8,8,0,711,0,0,6,6,0,540,0,0,14,14,0,1251,0,0,0,0,0,0,0,0,0,0,0,0,0,0
145,145,Gary Flitcroft,1135,2003,Blackburn Rovers,15,14,1,1189,1,0,15,14,1,1116,2,0,30,28,2,2305,3,0,0,1,1,1,2,3,0,0,0,0,0,0
146,146,Tugay Kerimoğlu,1136,2003,Blackburn Rovers,18,15,3,1409,1,0,17,14,3,1289,1,0,35,29,6,2698,2,0,0,0,0,1,0,1,0,0,0,0,0,0
147,147,Martin Andresen,1137,2003,Blackburn Rovers,6,6,0,454,0,0,5,5,0,407,0,0,11,11,0,861,0,0,0,0,0,0,0,0,0,0,0,0,0,0
148,148,Jonathan Douglas,1138,2003,Blackburn Rovers,8,8,0,591,0,0,5,5,0,450,1,0,13,13,0,1041,1,0,0,0,0,0,1,1,0,0,0,0,0,0
149,149,Andy Cole,1113,2003,Blackburn Rovers,17,15,2,1406,5,0,16,11,5,1150,6,0,33,26,7,2556,11,0,1,0,1,2,4,6,0,0,0,0,0,0
150,150,Jon Stead,1139,2003,Blackburn Rovers,6,6,0,506,2,0,7,7,0,579,4,0,13,13,0,1085,6,0,4,9,13,2,3,5,0,0,0,0,0,0
151,151,Steven Reid,1140,2003,Blackburn Rovers,7,5,2,389,0,0,9,4,5,415,0,0,16,9,7,804,0,0,0,0,0,0,0,0,0,0,0,0,0,0
152,152,Brett Emerton,1141,2003,Blackburn Rovers,19,16,3,1498,1,0,17,14,3,1281,1,0,36,30,6,2779,2,0,0,0,0,0,0,0,0,0,0,0,0,0
153,153,Paul Gallagher,1142,2003,Blackburn Rovers,13,5,8,497,1,0,13,7,6,619,2,0,26,12,14,1116,3,0,0,3,3,1,1,2,0,0,0,0,0,0
154,154,Kelvin Davis,1143,2014,Southampton FC,3,2,1,256,0,0,4,4,0,360,0,0,7,6,1,616,0,0,0,0,0,0,0,0,0,0,0,0,0,0
155,155,Nathaniel Clyne,1144,2014,Southampton FC,16,16,0,1440,0,0,19,19,0,1707,2,0,35,35,0,3147,2,0,0,1,1,0,2,2,0,0,0,0,0,0
156,156,Maya Yoshida,1145,2014,Southampton FC,13,10,3,953,1,0,9,8,1,737,0,0,22,18,4,1690,1,0,0,0,0,0,0,0,0,0,0,0,0,0
157,157,José Fonte,1146,2014,Southampton FC,19,19,0,1710,0,0,18,18,0,1620,0,0,37,37,0,3330,0,0,0,0,0,0,0,0,0,0,0,0,0,0
158,158,Toby Alderweireld,1147,2014,Southampton FC,13,13,0,1170,0,0,13,13,0,1093,1,0,26,26,0,2263,1,0,0,0,0,0,0,0,0,0,0,0,0,0
159,159,Ryan Bertrand,1148,2014,Southampton FC,16,16,0,1440,1,0,18,18,0,1616,1,0,34,34,0,3056,2,0,0,0,0,1,0,1,0,0,0,0,0,0
160,160,Morgan Schneiderlin,1051,2014,Southampton FC,13,12,1,1080,1,0,13,12,1,1109,3,0,26,24,2,2189,4,0,0,0,0,0,3,3,0,0,0,0,0,0
161,161,Steven Davis,1149,2014,Southampton FC,18,18,0,1409,0,0,17,14,3,1242,0,0,35,32,3,2651,0,0,0,0,0,0,0,0,0,0,0,0,0,0
162,162,James Ward-Prowse,1150,2014,Southampton FC,12,7,5,671,1,0,13,9,4,842,0,0,25,16,9,1513,1,0,0,0,0,1,0,1,1,0,1,0,0,0
163,163,Sadio Mané,1151,2014,Southampton FC,16,13,3,1101,7,0,14,11,3,1033,3,0,30,24,6,2134,10,0,6,3,9,5,3,8,0,0,0,0,0,0
164,164,Graziano Pellè,1152,2014,Southampton FC,19,19,0,1675,11,0,19,18,1,1609,1,0,38,37,1,3284,12,0,3,0,3,5,0,5,0,0,0,0,0,0
165,165,Harrison Reed,1153,2014,Southampton FC,6,3,3,270,0,0,3,2,1,190,0,0,9,5,4,460,0,0,0,0,0,0,0,0,0,0,0,0,0,0
166,166,Shane Long,1154,2014,Southampton FC,15,7,8,709,5,0,17,9,8,831,0,0,32,16,16,1540,5,0,0,0,0,2,0,2,0,0,0,0,0,0
167,167,Eljero Elia,1155,2014,Southampton FC,7,4,3,333,0,0,9,5,4,455,2,0,16,9,7,788,2,0,0,3,3,0,2,2,0,0,0,0,0,0
168,168,Paulo Gazzaniga,1156,2014,Southampton FC,1,1,0,90,0,0,1,1,0,90,0,0,2,2,0,180,0,0,0,0,0,0,0,0,0,0,0,0,0,0
169,169,Florin Gardoş,1157,2014,Southampton FC,5,2,3,191,0,0,6,3,3,382,0,0,11,5,6,573,0,0,0,0,0,0,0,0,0,0,0,0,0,0
170,170,Matt Targett,1158,2014,Southampton FC,4,2,2,191,0,0,2,1,1,34,0,0,6,3,3,225,0,0,0,0,0,0,0,0,0,0,0,0,0,0
171,171,Dušan Tadić,1159,2014,Southampton FC,16,12,4,1057,2,0,15,12,3,1004,2,0,31,24,7,2061,4,0,0,4,4,0,2,2,0,1,1,0,0,0
172,172,Hugo Lloris,1160,2014,Tottenham Hotspur,18,18,0,1534,0,0,17,17,0,1530,0,0,35,35,0,3064,0,0,0,0,0,0,0,0,0,0,0,0,0,0
173,173,Jan Vertonghen,1161,2014,Tottenham Hotspur,16,16,0,1440,1,0,16,15,1,1370,0,0,32,31,1,2810,1,0,0,0,0,1,0,1,0,0,0,0,0,0
174,174,Eric Dier,1162,2014,Tottenham Hotspur,15,13,2,1248,1,0,13,12,1,1043,1,0,28,25,3,2291,2,0,0,3,3,0,1,1,0,0,0,0,0,0
175,175,Federico Fazio,1163,2014,Tottenham Hotspur,9,9,0,810,0,0,11,11,0,990,0,0,20,20,0,1800,0,0,0,0,0,0,0,0,0,0,0,0,0,0
176,176,Ben Davies,1164,2014,Tottenham Hotspur,7,4,3,403,0,0,7,5,2,488,0,0,14,9,5,891,0,0,0,0,0,0,0,0,0,0,0,0,0,0
177,177,Christian Eriksen,1165,2014,Tottenham Hotspur,19,18,1,1519,3,0,19,19,0,1623,7,0,38,37,1,3142,10,0,6,9,15,3,7,10,0,0,0,0,0,0
178,178,Ryan Mason,1166,2014,Tottenham Hotspur,15,15,0,1161,1,0,16,14,2,1163,0,0,31,29,2,2324,1,0,0,0,0,1,0,1,0,0,0,0,0,0
179,179,Nabil Bentaleb,1167,2014,Tottenham Hotspur,13,13,0,1108,0,0,13,12,1,1097,0,0,26,25,1,2205,0,0,0,0,0,0,0,0,0,0,0,0,0,0
180,180,Érik Lamela,1168,2014,Tottenham Hotspur,15,11,4,1029,1,0,18,14,4,1271,1,0,33,25,8,2300,2,0,3,0,3,1,1,2,0,0,0,0,0,0
181,181,Harry Kane,1169,2014,Tottenham Hotspur,17,14,3,1286,9,0,17,14,3,1298,12,0,34,28,6,2584,21,0,4,6,10,7,8,15,1,1,2,0,0,0
182,182,Nacer Chadli,1170,2014,Tottenham Hotspur,18,15,3,1321,6,0,17,13,4,1083,5,0,35,28,7,2404,11,0,0,1,1,3,5,8,0,0,0,0,0,0
183,183,Vlad Chiricheş,1171,2014,Tottenham Hotspur,4,4,0,329,0,0,6,4,2,418,0,0,10,8,2,747,0,0,0,0,0,0,0,0,0,0,0,0,0,0
184,184,Mousa Dembélé,1172,2014,Tottenham Hotspur,13,4,9,518,0,0,13,6,7,621,1,0,26,10,16,1139,1,0,0,0,0,0,1,1,0,0,0,0,0,0
185,185,Soldado,1173,2014,Tottenham Hotspur,12,3,9,382,1,0,12,4,8,413,0,0,24,7,17,795,1,0,3,0,3,1,0,1,0,0,0,0,0,0
186,186,Michel Vorm,1174,2014,Tottenham Hotspur,2,1,1,176,0,0,2,2,0,180,0,0,4,3,1,356,0,0,0,0,0,0,0,0,0,0,0,0,0,0
187,187,DeAndre Yedlin,1175,2014,Tottenham Hotspur,1,0,1,11,0,0,0,0,0,0,0,0,1,0,1,11,0,0,0,0,0,0,0,0,0,0,0,0,0,0
188,188,Andros Townsend,1176,2014,Tottenham Hotspur,9,7,2,498,2,0,8,3,5,253,0,0,17,10,7,751,2,0,0,0,0,0,0,0,1,0,1,0,0,0
189,189,Benjamin Stambouli,1177,2014,Tottenham Hotspur,5,2,3,237,0,0,7,2,5,217,0,0,12,4,8,454,0,0,0,0,0,0,0,0,0,0,0,0,0,0
190,190,Loris Karius,1178,2017,Liverpool FC,11,11,0,990,0,0,8,8,0,720,0,0,19,19,0,1710,0,0,0,0,0,0,0,0,0,0,0,0,0,0
191,191,Dejan Lovren,1179,2017,Liverpool FC,13,12,1,1074,1,0,17,13,4,1141,1,0,30,25,5,2215,2,0,0,0,0,0,0,0,0,0,0,0,0,0
192,192,Joe Gomez,1180,2017,Liverpool FC,11,10,1,910,0,0,12,11,1,991,0,0,23,21,2,1901,0,0,0,0,0,0,0,0,0,0,0,0,0,0
193,193,Andrew Robertson,1181,2017,Liverpool FC,13,13,0,1155,1,0,9,9,0,788,0,0,22,22,0,1943,1,0,0,0,0,0,0,0,0,0,0,0,0,0
194,194,Joel Matip,1182,2017,Liverpool FC,13,11,2,1004,0,0,12,11,1,991,1,0,25,22,3,1995,1,0,0,0,0,0,0,0,0,0,0,0,0,0
195,195,Georginio Wijnaldum,1183,2017,Liverpool FC,15,12,3,1084,1,0,18,15,3,1303,0,0,33,27,6,2387,1,0,0,0,0,0,0,0,0,0,0,0,0,0
196,196,Alex Oxlade-Chamberlain,1184,2017,Liverpool FC,15,7,8,745,2,0,17,7,10,739,1,0,32,14,18,1484,3,0,0,0,0,1,0,1,0,0,0,0,0,0
197,197,Emre Can,1185,2017,Liverpool FC,13,11,2,947,1,0,13,13,0,1147,2,0,26,24,2,2094,3,0,0,0,0,1,2,3,0,0,0,0,0,0
198,198,Roberto Firmino,1186,2017,Liverpool FC,18,17,1,1456,8,0,19,15,4,1322,7,0,37,32,5,2778,15,0,0,1,1,2,3,5,0,1,1,0,0,0
199,199,Mohamed Salah,1187,2017,Liverpool FC,19,18,1,1556,19,0,17,16,1,1366,13,0,36,34,2,2922,32,0,4,3,7,11,4,15,0,1,1,0,0,0
200,200,Sadio Mané,1151,2017,Liverpool FC,14,13,1,1034,6,0,15,15,0,1226,4,0,29,28,1,2260,10,0,3,0,3,2,4,6,0,0,0,0,0,0
201,201,Ragnar Klavan,1188,2017,Liverpool FC,11,8,3,729,0,0,7,7,0,630,1,0,18,15,3,1359,1,0,0,3,3,0,1,1,0,0,0,0,0,0
202,202,James Milner,1189,2017,Liverpool FC,16,8,8,866,0,0,16,8,8,896,0,0,32,16,16,1762,0,0,0,0,0,0,0,0,0,0,0,0,0,0
203,203,Adam Lallana,1190,2017,Liverpool FC,6,0,6,64,0,0,6,1,5,191,0,0,12,1,11,255,0,0,0,0,0,0,0,0,0,0,0,0,0,0
204,204,Simon Mignolet,1191,2017,Liverpool FC,8,8,0,720,0,0,11,11,0,990,0,0,19,19,0,1710,0,0,0,0,0,0,0,0,0,0,0,0,0,0
205,205,Trent Alexander-Arnold,1192,2017,Liverpool FC,10,10,0,865,1,0,9,8,1,711,0,0,19,18,1,1576,1,0,0,0,0,0,0,0,0,0,0,0,0,0
206,206,Danny Ings,1193,2017,Liverpool FC,4,1,3,90,0,0,4,2,2,175,1,0,8,3,5,265,1,0,0,0,0,0,1,1,0,0,0,0,0,0
207,207,Dominic Solanke,1194,2017,Liverpool FC,10,2,8,255,1,0,11,3,8,328,0,0,21,5,16,583,1,0,0,0,0,0,0,0,0,0,0,0,0,0
208,208,Ederson,1195,2017,Manchester City,18,18,0,1575,0,0,17,17,0,1530,0,0,35,35,0,3105,0,0,0,0,0,0,0,0,0,0,0,0,0,0
209,209,Kyle Walker,1196,2017,Manchester City,16,16,0,1440,0,0,15,15,0,1303,0,0,31,31,0,2743,0,0,0,0,0,0,0,0,0,0,0,0,0,0
210,210,John Stones,1197,2017,Manchester City,10,9,1,734,0,0,8,7,1,572,0,0,18,16,2,1306,0,0,0,0,0,0,0,0,0,0,0,0,0,0
211,211,Fabian Delph,1198,2017,Manchester City,12,11,1,953,1,0,10,10,0,793,0,0,22,21,1,1746,1,0,0,0,0,0,0,0,0,0,0,0,0,0
212,212,Nicolás Otamendi,1199,2017,Manchester City,17,17,0,1502,2,0,16,15,1,1376,2,0,33,32,1,2878,4,0,0,3,3,1,1,2,0,0,0,0,0,0
213,213,İlkay Gündoğan,1200,2017,Manchester City,13,7,6,735,2,0,16,8,8,773,2,0,29,15,14,1508,4,0,0,0,0,1,0,1,0,1,1,0,0,0
214,214,Kevin De Bruyne,1201,2017,Manchester City,18,17,1,1427,5,0,18,18,0,1568,3,0,36,35,1,2995,8,0,0,3,3,2,1,3,0,0,0,0,0,0
215,215,Fernandinho,1202,2017,Manchester City,17,16,1,1387,3,0,16,16,0,1408,2,0,33,32,1,2795,5,0,0,0,0,1,1,2,0,0,0,0,0,0
216,216,Raheem Sterling,1203,2017,Manchester City,15,14,1,1240,11,0,17,14,3,1267,7,0,32,28,4,2507,18,0,4,9,13,4,3,7,0,1,1,0,0,0
217,217,Kun Agüero,1204,2017,Manchester City,15,14,1,1190,15,0,10,8,2,779,6,0,25,22,3,1969,21,0,0,0,0,5,3,8,3,1,4,0,0,0
218,218,Leroy Sané,1205,2017,Manchester City,15,14,1,1238,5,0,16,12,4,1095,5,0,31,26,5,2333,10,0,0,0,0,1,4,5,0,0,0,0,0,0
219,219,Danilo,1206,2017,Manchester City,11,5,6,552,2,0,12,8,4,790,1,0,23,13,10,1342,3,0,0,0,0,1,1,2,0,0,0,0,0,0
220,220,Bernardo Silva,1207,2017,Manchester City,18,7,11,763,4,0,16,8,8,752,2,0,34,15,19,1515,6,0,3,0,3,2,1,3,0,0,0,0,0,0
221,221,Claudio Bravo,1208,2017,Manchester City,2,1,1,135,0,0,1,1,0,90,0,0,3,2,1,225,0,0,0,0,0,0,0,0,0,0,0,0,0,0
222,222,Eliaquim Mangala,1209,2017,Manchester City,3,2,1,199,0,0,6,2,4,284,0,0,9,4,5,483,0,0,0,0,0,0,0,0,0,0,0,0,0,0
223,223,Oleksandr Zinchenko,1210,2017,Manchester City,5,5,0,408,0,0,2,0,2,35,0,0,7,5,2,443,0,0,0,0,0,0,0,0,0,0,0,0,0,0
224,224,David Silva,1211,2017,Manchester City,16,15,1,1297,3,0,12,12,0,1050,4,0,28,27,1,2347,7,0,3,0,3,2,2,4,0,0,0,0,0,0
225,225,Brahim Díaz,1212,2017,Manchester City,3,0,3,22,0,0,2,0,2,28,0,0,5,0,5,50,0,0,0,0,0,0,0,0,0,0,0,0,0,0
226,226,Márton Fülöp,1213,2007,Sunderland AFC,1,1,0,90,0,0,0,0,0,0,0,0,1,1,0,90,0,0,0,0,0,0,0,0,0,0,0,0,0,0
227,227,Nayron Nosworthy,1214,2007,Sunderland AFC,15,15,0,1284,0,0,13,13,0,1170,0,0,28,28,0,2454,0,0,0,0,0,0,0,0,0,0,0,0,0,0
228,228,Danny Collins,1215,2007,Sunderland AFC,18,16,2,1524,0,0,17,15,2,1428,1,0,35,31,4,2952,1,0,0,0,0,0,1,1,0,0,0,0,0,0
229,229,Jonny Evans,1216,2007,Sunderland AFC,8,8,0,707,0,0,6,6,0,540,0,0,14,14,0,1247,0,0,0,0,0,0,0,0,0,0,0,0,0,0
230,230,Carlos Edwards,1217,2007,Sunderland AFC,8,6,2,500,0,0,5,5,0,351,0,0,13,11,2,851,0,0,0,0,0,0,0,0,0,0,0,0,0,0
231,231,Dean Whitehead,1218,2007,Sunderland AFC,14,14,0,1260,1,0,12,12,0,1048,0,0,26,26,0,2308,1,0,0,0,0,1,0,1,0,0,0,0,0,0
232,232,Grant Leadbitter,1219,2007,Sunderland AFC,17,8,9,955,1,0,13,9,4,903,1,0,30,17,13,1858,2,0,0,0,0,0,1,1,0,0,0,0,0,0
233,233,Andy Reid,1220,2007,Sunderland AFC,7,5,2,489,1,0,5,5,0,406,0,0,12,10,2,895,1,0,3,0,3,1,0,1,0,0,0,0,0,0
234,234,Ross Wallace,1221,2007,Sunderland AFC,10,10,0,760,1,0,11,8,3,737,1,0,21,18,3,1497,2,0,0,0,0,0,0,0,0,0,0,0,0,0
235,235,Kenwyne Jones,1222,2007,Sunderland AFC,17,17,0,1472,4,0,15,15,0,1262,3,0,32,32,0,2734,7,0,1,0,1,3,2,5,0,0,0,0,0,0
236,236,Dwight Yorke,1223,2007,Sunderland AFC,10,9,1,655,0,0,10,8,2,624,1,0,20,17,3,1279,1,0,0,0,0,0,0,0,0,0,0,0,0,0
237,237,Liam Miller,1224,2007,Sunderland AFC,11,7,4,696,0,0,12,8,4,841,1,0,23,15,8,1537,1,0,0,1,1,0,1,1,0,0,0,0,0,0
238,238,Roy O’Donovan,1225,2007,Sunderland AFC,10,2,8,247,0,0,6,2,4,177,0,0,16,4,12,424,0,0,0,0,0,0,0,0,0,0,0,0,0,0
239,239,Michael Chopra,1226,2007,Sunderland AFC,16,11,5,951,2,0,16,9,7,997,4,0,32,20,12,1948,6,0,3,3,6,2,3,5,0,1,1,0,0,0
240,240,Łukasz Fabiański,1227,2007,Arsenal FC,1,1,0,69,0,0,2,2,0,180,0,0,3,3,0,249,0,0,0,0,0,0,0,0,0,0,0,0,0,0
241,241,Philippe Senderos,1228,2007,Arsenal FC,9,7,2,622,2,0,7,6,1,575,0,0,16,13,3,1197,2,0,0,0,0,1,0,1,0,0,0,0,0,0
242,242,Johan Djourou,1229,2007,Arsenal FC,0,0,0,0,0,0,2,1,1,102,0,0,2,1,1,102,0,0,0,0,0,0,0,0,0,0,0,0,0,0
243,243,Gaël Clichy,1230,2007,Arsenal FC,18,17,1,1547,0,0,18,18,0,1604,0,0,36,35,1,3151,0,0,0,0,0,0,0,0,0,0,0,0,0,0
244,244,Emmanuel Eboué,1231,2007,Arsenal FC,12,10,2,806,0,0,11,10,1,854,0,0,23,20,3,1660,0,0,0,0,0,0,0,0,0,0,0,0,0,0
245,245,Denilson,1232,2007,Arsenal FC,7,2,5,326,0,0,6,2,4,216,0,0,13,4,9,542,0,0,0,0,0,0,0,0,0,0,0,0,0,0
246,246,Alex Song,1233,2007,Arsenal FC,5,2,3,197,0,0,4,3,1,271,0,0,9,5,4,468,0,0,0,0,0,0,0,0,0,0,0,0,0,0
247,247,Gilberto Silva,1234,2007,Arsenal FC,10,4,6,419,1,0,11,6,5,587,0,0,21,10,11,1006,1,0,0,0,0,0,0,0,0,0,0,0,0,0
248,248,Emmanuel Adebayor,1235,2007,Arsenal FC,17,16,1,1420,10,0,17,14,3,1331,14,0,34,30,4,2751,24,0,0,3,3,5,6,11,3,0,3,0,0,0
249,249,Nicklas Bendtner,1236,2007,Arsenal FC,11,2,9,347,4,0,16,5,11,599,1,0,27,7,20,946,5,0,8,0,8,4,1,5,0,0,0,0,0,0
250,250,Theo Walcott,1237,2007,Arsenal FC,14,7,7,743,0,0,11,4,7,505,4,0,25,11,14,1248,4,0,0,3,3,0,3,3,0,0,0,0,0,0
251,251,Armand Traoré,1238,2007,Arsenal FC,2,1,1,92,0,0,1,0,1,9,0,0,3,1,2,101,0,0,0,0,0,0,0,0,0,0,0,0,0,0
252,252,Mark Randall,1239,2007,Arsenal FC,0,0,0,0,0,0,1,0,1,9,0,0,1,0,1,9,0,0,0,0,0,0,0,0,0,0,0,0,0,0
253,253,Fraser Forster,1240,2016,Southampton FC,19,19,0,1710,0,0,19,19,0,1710,0,0,38,38,0,3420,0,0,0,0,0,0,0,0,0,0,0,0,0,0
254,254,José Fonte,1146,2016,Southampton FC,8,8,0,720,0,0,9,9,0,810,0,0,17,17,0,1530,0,0,0,0,0,0,0,0,0,0,0,0,0,0
255,255,Cuco Martina,1049,2016,Southampton FC,5,4,1,354,0,0,4,2,2,237,0,0,9,6,3,591,0,0,0,0,0,0,0,0,0,0,0,0,0,0
256,256,Virgil van Dijk,1241,2016,Southampton FC,11,11,0,955,1,0,10,10,0,900,0,0,21,21,0,1855,1,0,0,0,0,1,0,1,0,0,0,0,0,0
257,257,Matt Targett,1158,2016,Southampton FC,4,4,0,284,0,0,1,1,0,90,0,0,5,5,0,374,0,0,0,0,0,0,0,0,0,0,0,0,0,0
258,258,Jordy Clasie,1242,2016,Southampton FC,6,4,2,318,0,0,10,8,2,679,1,0,16,12,4,997,1,0,0,3,3,0,1,1,0,0,0,0,0,0
259,259,Steven Davis,1149,2016,Southampton FC,17,16,1,1436,0,0,15,13,2,1207,0,0,32,29,3,2643,0,0,0,0,0,0,0,0,0,0,0,0,0,0
260,260,Oriol Romeu,1243,2016,Southampton FC,18,18,0,1620,0,0,17,17,0,1452,1,0,35,35,0,3072,1,0,0,0,0,0,1,1,0,0,0,0,0,0
261,261,Nathan Redmond,1244,2016,Southampton FC,18,16,2,1492,3,0,19,16,3,1446,4,0,37,32,5,2938,7,0,1,0,1,2,2,4,0,0,0,0,0,0
262,262,Charlie Austin,1245,2016,Southampton FC,8,6,2,507,4,0,7,5,2,432,2,0,15,11,4,939,6,0,6,0,6,3,2,5,1,1,2,0,0,0
263,263,Dušan Tadić,1159,2016,Southampton FC,16,15,1,1219,1,0,17,15,2,1208,2,0,33,30,3,2427,3,0,0,0,0,0,1,1,1,0,1,0,0,0
264,264,Sam McQueen,1246,2016,Southampton FC,7,3,4,374,0,0,6,2,4,234,0,0,13,5,8,608,0,0,0,0,0,0,0,0,0,0,0,0,0,0
265,265,James Ward-Prowse,1150,2016,Southampton FC,15,12,3,976,2,0,15,10,5,908,2,0,30,22,8,1884,4,0,0,0,0,1,0,1,0,0,0,0,0,0
266,266,Jay Rodriguez,1247,2016,Southampton FC,14,5,9,489,2,0,10,4,6,395,3,0,24,9,15,884,5,0,1,0,1,1,2,3,0,0,0,0,0,0
267,267,Alex McCarthy,1032,2016,Southampton FC,0,0,0,0,0,0,0,0,0,0,0,0,0,0,0,0,0,0,0,0,0,0,0,0,0,0,0,0,0,0
268,268,Maya Yoshida,1145,2016,Southampton FC,11,11,0,990,1,0,12,12,0,1080,0,0,23,23,0,2070,1,0,0,0,0,1,0,1,0,0,0,0,0,0
269,269,Pierre-Emile Højbjerg,1248,2016,Southampton FC,11,6,5,569,0,0,11,8,3,729,0,0,22,14,8,1298,0,0,0,0,0,0,0,0,0,0,0,0,0,0
270,270,Shane Long,1154,2016,Southampton FC,15,4,11,533,1,0,17,6,11,722,2,0,32,10,22,1255,3,0,0,0,0,1,1,2,0,0,0,0,0,0
271,271,Tom Heaton,1249,2016,Burnley FC,18,18,0,1620,0,0,17,17,0,1530,0,0,35,35,0,3150,0,0,0,0,0,0,0,0,0,0,0,0,0,0
272,272,Matthew Lowton,1250,2016,Burnley FC,18,18,0,1620,0,0,18,18,0,1620,0,0,36,36,0,3240,0,0,0,0,0,0,0,0,0,0,0,0,0,0
273,273,Michael Keane,1047,2016,Burnley FC,17,17,0,1530,1,0,18,18,0,1620,1,0,35,35,0,3150,2,0,0,1,1,0,1,1,0,0,0,0,0,0
274,274,Ben Mee,1251,2016,Burnley FC,17,17,0,1486,0,0,17,17,0,1530,1,0,34,34,0,3016,1,0,0,0,0,0,0,0,0,0,0,0,0,0
275,275,Stephen Ward,1252,2016,Burnley FC,18,18,0,1613,1,0,19,19,0,1619,0,0,37,37,0,3232,1,0,0,0,0,0,0,0,0,0,0,0,0,0
276,276,Dean Marney,1253,2016,Burnley FC,12,12,0,998,1,0,9,9,0,772,0,0,21,21,0,1770,1,0,0,0,0,1,0,1,0,0,0,0,0,0
277,277,Jeff Hendrick,1254,2016,Burnley FC,15,14,1,1270,2,0,17,17,0,1509,0,0,32,31,1,2779,2,0,0,0,0,2,0,2,0,0,0,0,0,0
278,278,Steven Defour,1255,2016,Burnley FC,14,11,3,757,1,0,7,5,2,322,0,0,21,16,5,1079,1,0,0,0,0,1,0,1,0,0,0,0,0,0
279,279,Jóhann Guðmundsson,1256,2016,Burnley FC,13,6,7,621,1,0,7,4,3,374,0,0,20,10,10,995,1,0,0,0,0,0,0,0,0,0,0,0,0,0
280,280,Sam Vokes,1257,2016,Burnley FC,18,12,6,1136,7,0,19,9,10,919,3,0,37,21,16,2055,10,0,4,0,4,7,2,9,0,2,2,0,0,0
281,281,George Boyd,1258,2016,Burnley FC,17,16,1,1414,2,0,19,17,2,1431,0,0,36,33,3,2845,2,0,3,0,3,1,0,1,0,0,0,0,0,0
282,282,Michael Kightly,1259,2016,Burnley FC,2,1,1,75,0,0,3,0,3,28,0,0,5,1,4,103,0,0,0,0,0,0,0,0,0,0,0,0,0,0
283,283,Aiden O’Neill,1260,2016,Burnley FC,1,0,1,1,0,0,2,0,2,82,0,0,3,0,3,83,0,0,0,0,0,0,0,0,0,0,0,0,0,0
284,284,Patrick Bamford,1261,2016,Burnley FC,2,0,2,11,0,0,4,0,4,23,0,0,6,0,6,34,0,0,0,0,0,0,0,0,0,0,0,0,0,0
285,285,Paul Robinson,1262,2016,Burnley FC,1,1,0,90,0,0,2,2,0,180,0,0,3,3,0,270,0,0,0,0,0,0,0,0,0,0,0,0,0,0
286,286,Jon Flanagan,1263,2016,Burnley FC,3,2,1,187,0,0,3,1,2,172,0,0,6,3,3,359,0,0,0,0,0,0,0,0,0,0,0,0,0,0
287,287,James Tarkowski,1264,2016,Burnley FC,11,2,9,318,0,0,8,2,6,237,0,0,19,4,15,555,0,0,0,0,0,0,0,0,0,0,0,0,0,0
288,288,Scott Arfield,1265,2016,Burnley FC,16,10,6,1008,1,0,15,13,2,1099,0,0,31,23,8,2107,1,0,3,0,3,1,0,1,0,0,0,0,0,0
289,289,Gomes,1266,2009,Tottenham Hotspur,15,15,0,1350,0,0,14,14,0,1186,0,0,29,29,0,2536,0,0,0,0,0,0,0,0,0,0,0,0,0,0
290,290,Michael Dawson,1267,2009,Tottenham Hotspur,15,12,3,1160,0,0,12,11,1,994,2,0,27,23,4,2154,2,0,0,1,1,0,1,1,0,0,0,0,0,0
291,291,Vedran Ćorluka,1268,2009,Tottenham Hotspur,14,14,0,1239,0,0,13,13,0,1137,1,0,27,27,0,2376,1,0,0,1,1,0,1,1,0,0,0,0,0,0
292,292,Ledley King,1119,2009,Tottenham Hotspur,8,8,0,646,0,0,10,10,0,811,2,0,18,18,0,1457,2,0,0,0,0,0,2,2,0,0,0,0,0,0
293,293,Benoît Assou-Ekotto,1269,2009,Tottenham Hotspur,15,14,1,1272,1,0,14,14,0,1172,0,0,29,28,1,2444,1,0,0,0,0,1,0,1,0,0,0,0,0,0
294,294,Tom Huddlestone,1270,2009,Tottenham Hotspur,17,17,0,1474,2,0,15,15,0,1286,0,0,32,32,0,2760,2,0,3,0,3,1,0,1,0,0,0,0,0,0
295,295,Aaron Lennon,1052,2009,Tottenham Hotspur,10,9,1,808,2,0,11,10,1,905,1,0,21,19,2,1713,3,0,3,3,6,1,1,2,0,0,0,0,0,0
296,296,Wilson Palacios,1271,2009,Tottenham Hotspur,14,14,0,1144,0,0,17,13,4,1209,1,0,31,27,4,2353,1,0,0,0,0,0,0,0,0,0,0,0,0,0
297,297,Luka Modrić,1272,2009,Tottenham Hotspur,12,11,1,967,2,0,11,9,2,838,1,0,23,20,3,1805,3,0,0,0,0,1,0,1,0,0,0,0,0,0
298,298,Peter Crouch,1273,2009,Tottenham Hotspur,18,8,10,912,4,0,18,11,7,1121,4,0,36,19,17,2033,8,0,0,3,3,4,2,6,0,0,0,0,0,0
299,299,Jermain Defoe,1127,2009,Tottenham Hotspur,16,16,0,1310,10,0,16,14,2,1180,8,0,32,30,2,2490,18,0,0,0,0,3,5,8,1,0,1,0,0,0
300,300,Gareth Bale,1274,2009,Tottenham Hotspur,11,8,3,730,2,0,11,9,2,888,1,0,22,17,5,1618,3,0,0,0,0,0,1,1,0,0,0,0,0,0
301,301,Jermaine Jenas,1275,2009,Tottenham Hotspur,8,2,6,286,1,0,10,6,4,556,0,0,18,8,10,842,1,0,0,0,0,0,0,0,0,0,0,0,0,0
302,302,Niko Kranjčar,1276,2009,Tottenham Hotspur,12,9,3,826,4,0,11,9,2,760,2,0,23,18,5,1586,6,0,0,3,3,1,2,3,0,0,0,0,0,0
303,303,Robert Green,1277,2009,West Ham United,19,19,0,1694,0,0,19,19,0,1710,0,0,38,38,0,3404,0,0,0,0,0,0,0,0,0,0,0,0,0,0
304,304,Radoslav Kováč,1278,2009,West Ham United,15,12,3,1042,2,0,16,15,1,1230,0,0,31,27,4,2272,2,0,0,0,0,1,0,1,0,0,0,0,0,0
305,305,Matthew Upson,1279,2009,West Ham United,17,17,0,1465,0,0,16,16,0,1440,3,0,33,33,0,2905,3,0,0,0,0,0,2,2,0,0,0,0,0,0
306,306,Hérita Ilunga,1280,2009,West Ham United,9,9,0,684,0,0,7,7,0,527,0,0,16,16,0,1211,0,0,0,0,0,0,0,0,0,0,0,0,0,0
307,307,James Tomkins,1281,2009,West Ham United,11,10,1,927,0,0,12,12,0,1070,0,0,23,22,1,1997,0,0,0,0,0,0,0,0,0,0,0,0,0,0
308,308,Scott Parker,1282,2009,West Ham United,18,17,1,1524,1,0,13,13,0,1059,1,0,31,30,1,2583,2,0,3,0,3,1,1,2,0,0,0,0,0,0
309,309,Julien Faubert,1283,2009,West Ham United,17,16,1,1410,1,0,16,16,0,1411,0,0,33,32,1,2821,1,0,0,0,0,0,0,0,0,0,0,0,0,0
310,310,Valon Behrami,1284,2009,West Ham United,14,12,2,1032,1,0,13,12,1,1019,0,0,27,24,3,2051,1,0,0,0,0,1,0,1,0,0,0,0,0,0
311,311,Jack Collison,1285,2009,West Ham United,10,9,1,758,1,0,12,10,2,902,1,0,22,19,3,1660,2,0,0,0,0,1,0,1,0,0,0,0,0,0
312,312,Guillermo Franco,1286,2009,West Ham United,13,9,4,782,2,0,10,7,3,589,3,0,23,16,7,1371,5,0,0,0,0,0,2,2,0,0,0,0,0,0
313,313,Alessandro Diamanti,1287,2009,West Ham United,14,10,4,1005,6,0,13,8,5,810,1,0,27,18,9,1815,7,0,1,0,1,5,1,6,4,0,4,0,0,0
314,314,Jonathan Spector,1288,2009,West Ham United,14,11,3,1160,0,0,13,11,2,1077,0,0,27,22,5,2237,0,0,0,0,0,0,0,0,0,0,0,0,0,0
315,315,Luis Jiménez,1289,2009,West Ham United,6,3,3,331,1,0,5,3,2,324,0,0,11,6,5,655,1,0,0,0,0,0,0,0,1,0,1,0,0,0
316,316,Junior Stanislas,1009,2009,West Ham United,9,4,5,491,2,0,17,7,10,750,0,0,26,11,15,1241,2,0,1,0,1,1,0,1,0,0,0,0,0,0
317,317,Nigel Martyn,1290,2000,Leeds United,10,10,0,881,0,0,11,11,0,990,0,0,21,21,0,1871,0,0,0,0,0,0,0,0,0,0,0,0,0,0
318,318,Ian Harte,1291,2000,Leeds United,12,12,0,1080,2,0,14,14,0,1260,5,0,26,26,0,2340,7,0,0,3,3,1,4,5,0,2,2,0,0,0
319,319,Danny Mills,1292,2000,Leeds United,10,9,1,821,0,0,11,10,1,904,0,0,21,19,2,1725,0,0,0,0,0,0,0,0,0,0,0,0,0,0
320,320,Dominic Matteo,1293,2000,Leeds United,14,14,0,1216,0,0,15,15,0,1293,0,0,29,29,0,2509,0,0,0,0,0,0,0,0,0,0,0,0,0,0
321,321,Rio Ferdinand,1294,2000,Leeds United,9,9,0,810,0,0,12,12,0,1080,2,0,21,21,0,1890,2,0,0,0,0,0,1,1,0,0,0,0,0,0
322,322,Olivier Dacourt,1295,2000,Leeds United,13,13,0,1069,1,0,17,17,0,1432,2,0,30,30,0,2501,3,0,3,1,4,1,2,3,0,0,0,0,0,0
323,323,Harry Kewell,1296,2000,Leeds United,8,6,2,581,2,0,8,5,3,527,0,0,16,11,5,1108,2,0,0,0,0,1,0,1,0,0,0,0,0,0
324,324,Lee Bowyer,1297,2000,Leeds United,16,16,0,1404,4,0,18,18,0,1582,5,0,34,34,0,2986,9,0,0,3,3,2,3,5,0,0,0,0,0,0
325,325,Eirik Bakke,1298,2000,Leeds United,13,11,2,970,1,0,13,10,3,861,1,0,26,21,5,1831,2,0,0,0,0,0,1,1,0,0,0,0,0,0
326,326,Mark Viduka,1299,2000,Leeds United,16,16,0,1406,12,0,15,15,0,1336,5,0,31,31,0,2742,17,0,4,1,5,7,3,10,0,0,0,0,0,0
327,327,Alan Smith,1300,2000,Leeds United,15,11,4,1081,8,0,15,12,3,1078,3,0,30,23,7,2159,11,0,0,3,3,3,2,5,0,0,0,0,0,0
328,328,Jason Wilcox,1301,2000,Leeds United,5,3,2,274,0,0,10,2,8,341,0,0,15,5,10,615,0,0,0,0,0,0,0,0,0,0,0,0,0,0
329,329,Tim Flowers,1302,2000,Leicester City,12,12,0,1036,0,0,10,10,0,841,0,0,22,22,0,1877,0,0,0,0,0,0,0,0,0,0,0,0,0,0
330,330,Gary Rowett,1303,2000,Leicester City,19,19,0,1693,2,0,19,19,0,1710,0,0,38,38,0,3403,2,0,3,0,3,2,0,2,0,0,0,0,0,0
331,331,Andy Impey,1304,2000,Leicester City,16,14,2,1266,0,0,17,15,2,1341,0,0,33,29,4,2607,0,0,0,0,0,0,0,0,0,0,0,0,0,0
332,332,Frank Sinclair,1305,2000,Leicester City,9,8,1,629,0,0,8,6,2,570,0,0,17,14,3,1199,0,0,0,0,0,0,0,0,0,0,0,0,0,0
333,333,Callum Davidson,1306,2000,Leicester City,14,12,2,984,0,0,14,13,1,1089,1,0,28,25,3,2073,1,0,0,0,0,0,1,1,0,0,0,0,0,0
334,334,Junior Lewis,1307,2000,Leicester City,7,7,0,630,0,0,8,8,0,720,0,0,15,15,0,1350,0,0,0,0,0,0,0,0,0,0,0,0,0,0
335,335,Lee Marshall,1308,2000,Leicester City,4,3,1,284,0,0,5,4,1,404,0,0,9,7,2,688,0,0,0,0,0,0,0,0,0,0,0,0,0,0
336,336,Robbie Savage,1309,2000,Leicester City,18,18,0,1613,3,0,15,15,0,1328,1,0,33,33,0,2941,4,0,3,3,6,2,1,3,1,0,1,0,0,0
337,337,Matthew Jones,1310,2000,Leicester City,5,4,1,337,0,0,6,6,0,437,0,0,11,10,1,774,0,0,0,0,0,0,0,0,0,0,0,0,0,0
338,338,Ade Akinbiyi,1311,2000,Leicester City,19,17,2,1458,8,0,18,16,2,1358,1,0,37,33,4,2816,9,0,0,0,0,6,0,6,0,0,0,0,0,0
339,339,Dean Sturridge,1312,2000,Leicester City,6,6,0,466,2,0,7,6,1,422,1,0,13,12,1,888,3,0,0,0,0,2,0,2,0,0,0,0,0,0
340,340,Damien Delaney,1022,2000,Leicester City,2,1,1,99,0,0,3,2,1,192,0,0,5,3,2,291,0,0,0,0,0,0,0,0,0,0,0,0,0,0
341,341,Stefan Oakes,1313,2000,Leicester City,5,2,3,241,0,0,8,3,5,389,0,0,13,5,8,630,0,0,0,0,0,0,0,0,0,0,0,0,0,0
342,342,Trevor Benjamin,1314,2000,Leicester City,8,1,7,162,0,0,13,6,7,614,1,0,21,7,14,776,1,0,0,0,0,0,0,0,0,0,0,0,0,0
343,343,Russell Hoult,1315,2004,West Bromwich Albion,17,17,0,1530,0,0,19,19,0,1642,0,0,36,36,0,3172,0,0,0,0,0,0,0,0,0,0,0,0,0,0
344,344,Riccardo Scimeca,1316,2004,West Bromwich Albion,17,13,4,1208,0,0,16,14,2,1264,0,0,33,27,6,2472,0,0,0,0,0,0,0,0,0,0,0,0,0,0
345,345,Darren Moore,1317,2004,West Bromwich Albion,8,6,2,487,0,0,8,4,4,499,0,0,16,10,6,986,0,0,0,0,0,0,0,0,0,0,0,0,0,0
346,346,Darren Purse,1318,2004,West Bromwich Albion,11,11,0,990,0,0,12,12,0,1080,0,0,23,23,0,2070,0,0,0,0,0,0,0,0,0,0,0,0,0,0
347,347,Cosmin Contra,1319,2004,West Bromwich Albion,4,4,0,273,0,0,1,1,0,75,0,0,5,5,0,348,0,0,0,0,0,0,0,0,0,0,0,0,0,0
348,348,Neil Clement,1320,2004,West Bromwich Albion,17,17,0,1504,2,0,18,18,0,1605,1,0,35,35,0,3109,3,0,1,0,1,2,1,3,0,0,0,0,0,0
349,349,Jonathan Greening,1321,2004,West Bromwich Albion,17,17,0,1467,0,0,17,15,2,1403,0,0,34,32,2,2870,0,0,0,0,0,0,0,0,0,0,0,0,0,0
350,350,Andy Johnson,1322,2004,West Bromwich Albion,11,11,0,885,0,0,11,11,0,967,0,0,22,22,0,1852,0,0,0,0,0,0,0,0,0,0,0,0,0,0
351,351,Zoltán Gera,1323,2004,West Bromwich Albion,19,15,4,1377,4,0,19,16,3,1351,2,0,38,31,7,2728,6,0,3,0,3,2,2,4,0,0,0,0,0,0
352,352,Nwankwo Kanu,1324,2004,West Bromwich Albion,12,9,3,812,2,0,15,12,3,1108,0,0,27,21,6,1920,2,0,1,0,1,2,0,2,0,0,0,0,0,0
353,353,Robert Earnshaw,1325,2004,West Bromwich Albion,14,10,4,873,2,0,17,8,9,851,9,0,31,18,13,1724,11,0,1,2,3,2,7,9,0,2,2,0,0,0
354,354,Geoff Horsfield,1326,2004,West Bromwich Albion,16,10,6,927,1,0,13,8,5,693,2,0,29,18,11,1620,3,0,0,0,0,1,1,2,0,0,0,0,0,0
355,355,Rob Hulse,1327,2004,West Bromwich Albion,2,0,2,48,0,0,3,0,3,37,0,0,5,0,5,85,0,0,0,0,0,0,0,0,0,0,0,0,0,0
356,356,Mark Schwarzer,1328,2004,Middlesbrough FC,15,15,0,1350,0,0,16,16,0,1440,0,0,31,31,0,2790,0,0,0,0,0,0,0,0,0,0,0,0,0,0
357,357,Franck Queudrue,1329,2004,Middlesbrough FC,15,15,0,1350,1,0,16,16,0,1440,4,0,31,31,0,2790,5,0,3,3,6,1,2,3,0,0,0,0,0,0
358,358,Chris Riggott,1330,2004,Middlesbrough FC,10,9,1,788,2,0,11,11,0,990,0,0,21,20,1,1778,2,0,0,0,0,2,0,2,0,0,0,0,0,0
359,359,Gareth Southgate,1331,2004,Middlesbrough FC,18,18,0,1620,0,0,18,18,0,1620,0,0,36,36,0,3240,0,0,0,0,0,0,0,0,0,0,0,0,0,0
360,360,Tony McMahon,1332,2004,Middlesbrough FC,5,5,0,441,0,0,8,7,1,645,0,0,13,12,1,1086,0,0,0,0,0,0,0,0,0,0,0,0,0,0
361,361,George Boateng,1333,2004,Middlesbrough FC,12,12,0,1080,2,0,13,13,0,1169,1,0,25,25,0,2249,3,0,4,0,4,2,0,2,0,0,0,0,0,0
362,362,Ray Parlour,1334,2004,Middlesbrough FC,16,15,1,1315,0,0,17,17,0,1490,0,0,33,32,1,2805,0,0,0,0,0,0,0,0,0,0,0,0,0,0
363,363,Stewart Downing,1335,2004,Middlesbrough FC,18,15,3,1433,3,0,17,13,4,1264,2,0,35,28,7,2697,5,0,1,1,2,2,2,4,0,0,0,0,0,0
364,364,Boudewijn Zenden,1336,2004,Middlesbrough FC,18,18,0,1550,3,0,18,18,0,1514,2,0,36,36,0,3064,5,0,1,6,7,2,2,4,0,0,0,0,0,0
365,365,Jimmy Floyd Hasselbaink,1337,2004,Middlesbrough FC,18,18,0,1616,6,0,18,18,0,1620,7,0,36,36,0,3236,13,0,4,0,4,4,4,8,0,0,0,0,0,0
366,366,Mark Viduka,1299,2004,Middlesbrough FC,8,7,1,597,3,0,8,8,0,505,1,0,16,15,1,1102,4,0,3,0,3,3,1,4,0,0,0,0,0,0
367,367,Doriva,1338,2004,Middlesbrough FC,12,7,5,733,0,0,14,8,6,738,0,0,26,15,11,1471,0,0,0,0,0,0,0,0,0,0,0,0,0,0
368,368,Thomas Sørensen,1090,2001,Sunderland AFC,17,17,0,1530,0,0,16,16,0,1440,0,0,33,33,0,2970,0,0,0,0,0,0,0,0,0,0,0,0,0,0
369,369,Bernt Haas,1339,2001,Sunderland AFC,12,12,0,1056,0,0,14,14,0,1231,0,0,26,26,0,2287,0,0,0,0,0,0,0,0,0,0,0,0,0,0
370,370,Michael Gray,1092,2001,Sunderland AFC,17,17,0,1530,0,0,16,16,0,1385,0,0,33,33,0,2915,0,0,0,0,0,0,0,0,0,0,0,0,0,0
371,371,Jody Craddock,1093,2001,Sunderland AFC,13,13,0,1160,0,0,15,15,0,1343,1,0,28,28,0,2503,1,0,0,0,0,0,0,0,0,0,0,0,0,0
372,372,George McCartney,1340,2001,Sunderland AFC,7,6,1,465,0,0,11,6,5,649,0,0,18,12,6,1114,0,0,0,0,0,0,0,0,0,0,0,0,0,0
373,373,Gavin McCann,1096,2001,Sunderland AFC,13,13,0,1155,0,0,14,14,0,1260,0,0,27,27,0,2415,0,0,0,0,0,0,0,0,0,0,0,0,0,0
374,374,Alex Rae,1097,2001,Sunderland AFC,2,1,1,81,0,0,0,0,0,0,0,0,2,1,1,81,0,0,0,0,0,0,0,0,0,0,0,0,0,0
375,375,Stefan Schwarz,1098,2001,Sunderland AFC,9,9,0,790,1,0,9,7,2,627,0,0,18,16,2,1417,1,0,1,0,1,1,0,1,0,0,0,0,0,0
376,376,Julio Arca,1341,2001,Sunderland AFC,11,10,1,916,1,0,9,8,1,664,0,0,20,18,2,1580,1,0,0,0,0,1,0,1,0,0,0,0,0,0
377,377,Lilian Laslandes,1342,2001,Sunderland AFC,6,3,3,267,0,0,5,1,4,118,0,0,11,4,7,385,0,0,0,0,0,0,0,0,0,0,0,0,0,0
378,378,Kevin Phillips,1100,2001,Sunderland AFC,18,18,0,1620,7,0,17,17,0,1445,4,0,35,35,0,3065,11,0,7,0,7,4,4,8,1,0,1,0,0,0
379,379,Kevin Kilbane,1103,2001,Sunderland AFC,13,12,1,1008,0,0,14,11,3,1049,2,0,27,23,4,2057,2,0,0,0,0,0,1,1,0,0,0,0,0,0
380,380,Niall Quinn,1099,2001,Sunderland AFC,18,12,6,1043,3,0,18,10,8,1001,3,0,36,22,14,2044,6,0,4,3,7,2,2,4,0,0,0,0,0,0
381,381,Brad Friedel,1343,2001,Blackburn Rovers,16,16,0,1440,0,0,16,16,0,1440,0,0,32,32,0,2880,0,0,0,0,0,0,0,0,0,0,0,0,0,0
382,382,Lucas Neill,1132,2001,Blackburn Rovers,14,14,0,1207,1,0,14,14,0,1260,0,0,28,28,0,2467,1,0,1,0,1,1,0,1,0,0,0,0,0,0
383,383,Stig Inge Bjørnebye,1344,2001,Blackburn Rovers,9,9,0,779,0,0,12,12,0,892,0,0,21,21,0,1671,0,0,0,0,0,0,0,0,0,0,0,0,0,0
384,384,Martin Taylor,1345,2001,Blackburn Rovers,9,4,5,468,0,0,7,5,2,486,0,0,16,9,7,954,0,0,0,0,0,0,0,0,0,0,0,0,0,0
385,385,Henning Berg,1346,2001,Blackburn Rovers,16,16,0,1376,1,0,14,14,0,1251,0,0,30,30,0,2627,1,0,0,0,0,0,0,0,0,0,0,0,0,0
386,386,Alan Mahon,1347,2001,Blackburn Rovers,7,5,2,451,1,0,6,5,1,400,0,0,13,10,3,851,1,0,0,0,0,1,0,1,0,0,0,0,0,0
387,387,Gary Flitcroft,1135,2001,Blackburn Rovers,13,12,1,1072,1,0,15,13,2,1219,0,0,28,25,3,2291,1,0,0,0,0,1,0,1,0,0,0,0,0,0
388,388,Damien Duff,1348,2001,Blackburn Rovers,15,15,0,1273,5,0,14,13,1,1198,2,0,29,28,1,2471,7,0,0,0,0,2,2,4,0,0,0,0,0,0
389,389,Marcus Bent,1349,2001,Blackburn Rovers,4,0,4,100,0,0,4,1,3,113,0,0,8,1,7,213,0,0,0,0,0,0,0,0,0,0,0,0,0,0
390,390,Matt Jansen,1350,2001,Blackburn Rovers,16,15,1,1338,5,0,15,15,0,1251,5,0,31,30,1,2589,10,0,1,2,3,2,4,6,0,0,0,0,0,0
391,391,Keith Gillespie,1351,2001,Blackburn Rovers,14,10,4,965,2,0,15,9,6,940,1,0,29,19,10,1905,3,0,0,0,0,2,1,3,0,0,0,0,0,0
392,392,Tugay Kerimoğlu,1136,2001,Blackburn Rovers,14,14,0,1227,2,0,15,14,1,1195,1,0,29,28,1,2422,3,0,0,0,0,1,1,2,0,0,0,0,0,0
393,393,Jason McAteer,1352,2001,Blackburn Rovers,2,1,1,111,0,0,2,0,2,41,0,0,4,1,3,152,0,0,0,0,0,0,0,0,0,0,0,0,0,0
394,394,Mark Hughes,1353,2001,Blackburn Rovers,8,0,8,169,0,0,12,3,9,437,1,0,20,3,17,606,1,0,0,0,0,0,1,1,0,0,0,0,0,0
395,395,Costel Pantilimon,1354,2013,Manchester City,4,4,0,360,0,0,3,3,0,270,0,0,7,7,0,630,0,0,0,0,0,0,0,0,0,0,0,0,0,0
396,396,Pablo Zabaleta,1355,2013,Manchester City,18,18,0,1620,1,0,17,16,1,1459,0,0,35,34,1,3079,1,0,0,0,0,1,0,1,0,0,0,0,0,0
397,397,Gaël Clichy,1230,2013,Manchester City,9,7,2,670,0,0,11,11,0,990,0,0,20,18,2,1660,0,0,0,0,0,0,0,0,0,0,0,0,0,0
398,398,Martín Demichelis,1356,2013,Manchester City,13,13,0,1170,2,0,14,14,0,1260,0,0,27,27,0,2430,2,0,0,0,0,0,0,0,0,0,0,0,0,0
399,399,Matija Nastasić,1357,2013,Manchester City,7,6,1,552,1,0,6,5,1,476,0,0,13,11,2,1028,1,0,0,0,0,0,0,0,0,0,0,0,0,0
400,400,Samir Nasri,1358,2013,Manchester City,17,13,4,1208,7,0,17,16,1,1286,0,0,34,29,5,2494,7,0,1,0,1,3,0,3,0,0,0,0,0,0
401,401,David Silva,1211,2013,Manchester City,15,15,0,1182,3,0,12,11,1,990,4,0,27,26,1,2172,7,0,0,0,0,1,2,3,0,0,0,0,0,0
402,402,Fernandinho,1202,2013,Manchester City,17,15,2,1276,4,0,16,14,2,1333,1,0,33,29,4,2609,5,0,0,0,0,1,1,2,0,0,0,0,0,0
403,403,Yaya Touré,1359,2013,Manchester City,16,16,0,1422,12,0,19,19,0,1503,8,0,35,35,0,2925,20,0,3,0,3,3,3,6,4,2,6,0,0,0
404,404,Álvaro Negredo,1360,2013,Manchester City,18,12,6,985,7,0,14,9,5,739,2,0,32,21,11,1724,9,0,3,0,3,5,0,5,0,0,0,0,0,0
405,405,Kun Agüero,1204,2013,Manchester City,12,11,1,830,10,0,11,9,2,708,7,0,23,20,3,1538,17,0,0,0,0,3,6,9,0,0,0,0,0,0
406,406,James Milner,1189,2013,Manchester City,15,5,10,580,0,0,16,7,9,782,1,0,31,12,19,1362,1,0,0,0,0,0,0,0,0,0,0,0,0,0
407,407,Jesús Navas,1361,2013,Manchester City,14,10,4,966,3,0,16,8,8,810,1,0,30,18,12,1776,4,0,0,0,0,2,1,3,0,0,0,0,0,0
408,408,Edin Džeko,1362,2013,Manchester City,15,10,5,910,6,0,16,13,3,1082,10,0,31,23,8,1992,16,0,3,0,3,3,6,9,0,0,0,0,0,0
409,409,Joe Hart,1363,2013,Manchester City,15,15,0,1350,0,0,16,16,0,1440,0,0,31,31,0,2790,0,0,0,0,0,0,0,0,0,0,0,0,0,0
410,410,Micah Richards,1364,2013,Manchester City,0,0,0,0,0,0,2,2,0,161,0,0,2,2,0,161,0,0,0,0,0,0,0,0,0,0,0,0,0,0
411,411,Joleon Lescott,1365,2013,Manchester City,7,6,1,584,0,0,3,2,1,199,0,0,10,8,2,783,0,0,0,0,0,0,0,0,0,0,0,0,0,0
412,412,Aleksandar Kolarov,1366,2013,Manchester City,15,12,3,1078,0,0,15,9,6,892,1,0,30,21,9,1970,1,0,0,0,0,0,0,0,0,0,0,0,0,0
413,413,John Ruddy,1367,2013,Norwich City,19,19,0,1710,0,0,19,19,0,1710,0,0,38,38,0,3420,0,0,0,0,0,0,0,0,0,0,0,0,0,0
414,414,Russell Martin,1368,2013,Norwich City,16,16,0,1440,0,0,15,13,2,1176,0,0,31,29,2,2616,0,0,0,0,0,0,0,0,0,0,0,0,0,0
415,415,Steven Whittaker,1369,2013,Norwich City,7,5,2,452,1,0,13,11,2,971,0,0,20,16,4,1423,1,0,0,0,0,1,0,1,0,0,0,0,0,0
416,416,Sébastien Bassong,1370,2013,Norwich City,15,15,0,1298,0,0,12,12,0,1080,0,0,27,27,0,2378,0,0,0,0,0,0,0,0,0,0,0,0,0,0
417,417,Michael Turner,1371,2013,Norwich City,10,10,0,900,0,0,12,12,0,1044,0,0,22,22,0,1944,0,0,0,0,0,0,0,0,0,0,0,0,0,0
418,418,Martin Olsson,1372,2013,Norwich City,16,16,0,1430,0,0,17,17,0,1530,0,0,33,33,0,2960,0,0,0,0,0,0,0,0,0,0,0,0,0,0
419,419,Bradley Johnson,1373,2013,Norwich City,15,12,3,1097,1,0,17,16,1,1373,2,0,32,28,4,2470,3,0,0,0,0,1,1,2,0,0,0,0,0,0
420,420,Jonny Howson,1374,2013,Norwich City,13,11,2,1024,0,0,14,12,2,1062,2,0,27,23,4,2086,2,0,0,3,3,0,1,1,0,0,0,0,0,0
421,421,Leroy Fer,1375,2013,Norwich City,14,14,0,1248,1,0,15,14,1,1225,2,0,29,28,1,2473,3,0,0,0,0,0,0,0,0,0,0,0,0,0
422,422,Anthony Pilkington,1376,2013,Norwich City,7,5,2,404,1,0,8,5,3,428,0,0,15,10,5,832,1,0,0,0,0,1,0,1,0,0,0,0,0,0
423,423,Gary Hooper,1377,2013,Norwich City,17,11,6,1030,5,0,15,11,4,989,1,0,32,22,10,2019,6,0,4,0,4,4,1,5,1,0,1,0,0,0
424,424,Johan Elmander,1378,2013,Norwich City,13,9,4,712,0,0,16,7,9,774,1,0,29,16,13,1486,1,0,0,0,0,0,0,0,0,0,0,0,0,0
425,425,Josh Murphy,1379,2013,Norwich City,3,0,3,31,0,0,6,0,6,100,0,0,9,0,9,131,0,0,0,0,0,0,0,0,0,0,0,0,0,0
426,426,Mark Bunn,1380,2013,Norwich City,0,0,0,0,0,0,0,0,0,0,0,0,0,0,0,0,0,0,0,0,0,0,0,0,0,0,0,0,0,0
427,427,Javi Garrido,1381,2013,Norwich City,3,3,0,270,0,0,3,3,0,246,0,0,6,6,0,516,0,0,0,0,0,0,0,0,0,0,0,0,0,0
428,428,Ryan Bennett,1382,2013,Norwich City,7,6,1,592,1,0,8,7,1,666,0,0,15,13,2,1258,1,0,3,0,3,1,0,1,0,0,0,0,0,0
429,429,Wes Hoolahan,1383,2013,Norwich City,8,6,2,487,0,0,8,4,4,319,1,0,16,10,6,806,1,0,0,0,0,0,1,1,0,0,0,0,0,0
430,430,Luciano Becchio,1384,2013,Norwich City,4,0,4,53,0,0,1,0,1,1,0,0,5,0,5,54,0,0,0,0,0,0,0,0,0,0,0,0,0,0
431,431,David James,1385,2006,Portsmouth FC,19,19,0,1710,0,0,19,19,0,1710,0,0,38,38,0,3420,0,0,0,0,0,0,0,0,0,0,0,0,0,0
432,432,Linvoy Primus,1065,2006,Portsmouth FC,18,18,0,1576,0,0,18,18,0,1569,2,0,36,36,0,3145,2,0,0,0,0,0,1,1,0,0,0,0,0,0
433,433,Glen Johnson,1386,2006,Portsmouth FC,14,14,0,1260,0,0,12,11,1,997,0,0,26,25,1,2257,0,0,0,0,0,0,0,0,0,0,0,0,0,0
434,434,Noé Pamarot,1387,2006,Portsmouth FC,11,9,2,801,1,0,12,12,0,1008,1,0,23,21,2,1809,2,0,0,0,0,0,1,1,0,0,0,0,0,0
435,435,Sol Campbell,1388,2006,Portsmouth FC,16,16,0,1440,1,0,16,16,0,1440,0,0,32,32,0,2880,1,0,0,0,0,1,0,1,0,0,0,0,0,0
436,436,Matthew Taylor,1069,2006,Portsmouth FC,17,17,0,1404,5,0,18,13,5,1282,3,0,35,30,5,2686,8,0,0,0,0,4,2,6,1,0,1,0,0,0
437,437,Gary O'Neil,1389,2006,Portsmouth FC,17,17,0,1495,0,0,18,18,0,1597,1,0,35,35,0,3092,1,0,0,1,1,0,1,1,0,0,0,0,0,0
438,438,Sean Davis,1087,2006,Portsmouth FC,16,15,1,1288,0,0,15,14,1,1207,0,0,31,29,2,2495,0,0,0,0,0,0,0,0,0,0,0,0,0,0
439,439,Pedro Mendes,1390,2006,Portsmouth FC,14,13,1,1128,2,0,12,12,0,960,0,0,26,25,1,2088,2,0,0,0,0,1,0,1,0,0,0,0,0,0
440,440,Benjani,1391,2006,Portsmouth FC,16,13,3,1071,4,0,15,12,3,969,2,0,31,25,6,2040,6,0,3,0,3,4,0,4,0,0,0,0,0,0
441,441,Nwankwo Kanu,1324,2006,Portsmouth FC,19,17,2,1451,7,0,17,15,2,1274,3,0,36,32,4,2725,10,0,3,0,3,3,1,4,0,0,0,0,0,0
442,442,Niko Kranjčar,1276,2006,Portsmouth FC,10,2,8,387,1,0,14,9,5,896,1,0,24,11,13,1283,2,0,0,0,0,0,1,1,0,0,0,0,0,0
443,443,Andy Cole,1113,2006,Portsmouth FC,10,2,8,284,2,0,8,3,5,386,1,0,18,5,13,670,3,0,1,0,1,1,0,1,0,0,0,0,0,0
444,444,Paul Robinson,1262,2006,Tottenham Hotspur,19,19,0,1710,1,0,18,18,0,1620,0,0,37,37,0,3330,1,0,0,0,0,0,0,0,0,0,0,0,0,0
445,445,Pascal Chimbonda,1392,2006,Tottenham Hotspur,17,17,0,1477,0,0,15,15,0,1347,1,0,32,32,0,2824,1,0,0,1,1,0,1,1,0,0,0,0,0,0
446,446,Young-Pyo Lee,1393,2006,Tottenham Hotspur,11,11,0,950,0,0,10,9,1,817,0,0,21,20,1,1767,0,0,0,0,0,0,0,0,0,0,0,0,0,0
447,447,Michael Dawson,1267,2006,Tottenham Hotspur,19,19,0,1701,1,0,17,17,0,1492,0,0,36,36,0,3193,1,0,0,0,0,1,0,1,0,0,0,0,0,0
448,448,Calum Davenport,1394,2006,Tottenham Hotspur,6,4,2,368,0,0,4,4,0,360,1,0,10,8,2,728,1,0,0,0,0,0,1,1,0,0,0,0,0,0
449,449,Teemu Tainio,1395,2006,Tottenham Hotspur,10,9,1,690,1,0,11,11,0,810,1,0,21,20,1,1500,2,0,0,0,0,0,1,1,0,0,0,0,0,0
450,450,Hossam Ghaly,1396,2006,Tottenham Hotspur,9,5,4,538,1,0,11,11,0,824,0,0,20,16,4,1362,1,0,0,0,0,0,0,0,0,0,0,0,0,0
451,451,Steed Malbranque,1086,2006,Tottenham Hotspur,13,10,3,834,1,0,12,8,4,757,1,0,25,18,7,1591,2,0,0,1,1,0,1,1,0,0,0,0,0,0
452,452,Tom Huddlestone,1270,2006,Tottenham Hotspur,12,9,3,883,0,0,8,5,3,531,1,0,20,14,6,1414,1,0,0,0,0,0,0,0,0,0,0,0,0,0
453,453,Dimitar Berbatov,1397,2006,Tottenham Hotspur,16,15,1,1350,7,0,16,14,2,1275,5,0,32,29,3,2625,12,0,0,0,0,5,4,9,0,0,0,0,0,0
454,454,Jermain Defoe,1127,2006,Tottenham Hotspur,18,11,7,1029,7,0,15,9,6,886,3,0,33,20,13,1915,10,0,1,1,2,4,1,5,1,2,3,0,0,0
455,455,Anthony Gardner,1120,2006,Tottenham Hotspur,3,3,0,270,0,0,5,3,2,325,0,0,8,6,2,595,0,0,0,0,0,0,0,0,0,0,0,0,0,0
456,456,Danny Murphy,1398,2006,Tottenham Hotspur,6,2,4,246,1,0,5,3,2,312,1,0,11,5,6,558,2,0,0,0,0,1,0,1,0,0,0,0,0,0
457,457,Simon Mignolet,1191,2012,Sunderland AFC,19,19,0,1710,0,0,19,19,0,1710,0,0,38,38,0,3420,0,0,0,0,0,0,0,0,0,0,0,0,0,0
458,458,Danny Rose,1399,2012,Sunderland AFC,14,14,0,1207,0,0,13,11,2,1043,1,0,27,25,2,2250,1,0,0,0,0,0,1,1,0,0,0,0,0,0
459,459,Matt Kilgallon,1400,2012,Sunderland AFC,3,3,0,242,0,0,3,3,0,270,0,0,6,6,0,512,0,0,0,0,0,0,0,0,0,0,0,0,0,0
460,460,Carlos Cuéllar,1401,2012,Sunderland AFC,13,13,0,1107,0,0,13,13,0,1152,1,0,26,26,0,2259,1,0,0,0,0,0,1,1,0,0,0,0,0,0
461,461,Sebastian Larsson,1402,2012,Sunderland AFC,19,17,2,1526,1,0,19,19,0,1470,0,0,38,36,2,2996,1,0,0,0,0,1,0,1,0,0,0,0,0,0
462,462,Craig Gardner,1403,2012,Sunderland AFC,17,16,1,1460,3,0,16,16,0,1428,3,0,33,32,1,2888,6,0,1,0,1,1,2,3,2,2,4,0,0,0
463,463,Jack Colback,1404,2012,Sunderland AFC,18,15,3,1446,0,0,17,15,2,1367,0,0,35,30,5,2813,0,0,0,0,0,0,0,0,0,0,0,0,0,0
464,464,Adam Johnson,1405,2012,Sunderland AFC,18,18,0,1506,3,0,17,17,0,1436,2,0,35,35,0,2942,5,0,3,0,3,1,1,2,0,0,0,0,0,0
465,465,Stéphane Sessègnon,1406,2012,Sunderland AFC,17,17,0,1479,4,0,18,17,1,1440,3,0,35,34,1,2919,7,0,4,0,4,2,1,3,0,0,0,0,0,0
466,466,James McClean,1407,2012,Sunderland AFC,18,12,6,1175,2,0,18,12,6,1158,0,0,36,24,12,2333,2,0,0,0,0,1,0,1,0,0,0,0,0,0
467,467,Steven Fletcher,1408,2012,Sunderland AFC,14,14,0,1245,3,0,14,14,0,1128,8,0,28,28,0,2373,11,0,3,3,6,2,7,9,0,0,0,0,0,0
468,468,Phil Bardsley,1409,2012,Sunderland AFC,9,6,3,542,1,0,9,5,4,456,0,0,18,11,7,998,1,0,0,0,0,1,0,1,0,0,0,0,0,0
469,469,Fraizer Campbell,1027,2012,Sunderland AFC,4,0,4,66,0,0,8,1,7,187,1,0,12,1,11,253,1,0,0,0,0,0,0,0,0,0,0,0,0,0
470,470,Keiren Westwood,1410,2012,Sunderland AFC,0,0,0,0,0,0,0,0,0,0,0,0,0,0,0,0,0,0,0,0,0,0,0,0,0,0,0,0,0,0
471,471,Titus Bramble,1411,2012,Sunderland AFC,10,6,4,639,0,0,6,6,0,540,0,0,16,12,4,1179,0,0,0,0,0,0,0,0,0,0,0,0,0,0
472,472,David Vaughan,1412,2012,Sunderland AFC,10,3,7,346,0,0,13,3,10,361,1,0,23,6,17,707,1,0,0,0,0,0,0,0,0,0,0,0,0,0
473,473,Connor Wickham,1035,2012,Sunderland AFC,7,1,6,181,0,0,5,2,3,268,0,0,12,3,9,449,0,0,0,0,0,0,0,0,0,0,0,0,0,0
474,474,James McFadden,1413,2012,Sunderland AFC,1,0,1,2,0,0,2,0,2,33,0,0,3,0,3,35,0,0,0,0,0,0,0,0,0,0,0,0,0,0
475,475,Joe Hart,1363,2012,Manchester City,19,19,0,1710,0,0,19,19,0,1710,0,0,38,38,0,3420,0,0,0,0,0,0,0,0,0,0,0,0,0,0
476,476,Vincent Kompany,1414,2012,Manchester City,13,13,0,1084,1,0,13,13,0,1170,0,0,26,26,0,2254,1,0,0,0,0,0,0,0,0,0,0,0,0,0
477,477,Pablo Zabaleta,1355,2012,Manchester City,15,14,1,1301,2,0,15,15,0,1350,0,0,30,29,1,2651,2,0,0,0,0,2,0,2,0,0,0,0,0,0
478,478,Kolo Touré,1415,2012,Manchester City,7,3,4,366,0,0,8,7,1,555,0,0,15,10,5,921,0,0,0,0,0,0,0,0,0,0,0,0,0,0
479,479,Matija Nastasić,1357,2012,Manchester City,8,8,0,652,0,0,13,13,0,1170,0,0,21,21,0,1822,0,0,0,0,0,0,0,0,0,0,0,0,0,0
480,480,James Milner,1189,2012,Manchester City,11,7,4,688,1,0,15,12,3,1110,3,0,26,19,7,1798,4,0,0,0,0,0,2,2,0,0,0,0,0,0
481,481,Javi García,1416,2012,Manchester City,10,7,3,592,0,0,14,10,4,904,2,0,24,17,7,1496,2,0,0,1,1,0,1,1,0,0,0,0,0,0
482,482,David Silva,1211,2012,Manchester City,16,15,1,1287,4,0,16,14,2,1233,0,0,32,29,3,2520,4,0,0,0,0,2,0,2,0,0,0,0,0,0
483,483,Yaya Touré,1359,2012,Manchester City,16,16,0,1434,4,0,16,16,0,1396,2,0,32,32,0,2830,6,0,0,0,0,2,1,3,0,0,0,0,0,0
484,484,Kun Agüero,1204,2012,Manchester City,17,12,5,1045,7,0,13,10,3,903,5,0,30,22,8,1948,12,0,1,3,4,3,4,7,2,0,2,0,0,0
485,485,Carlos Tévez,1417,2012,Manchester City,18,14,4,1253,9,0,16,14,2,1153,2,0,34,28,6,2406,11,0,7,4,11,5,2,7,2,0,2,0,0,0
486,486,Joleon Lescott,1365,2012,Manchester City,15,12,3,1084,1,0,11,5,6,462,0,0,26,17,9,1546,1,0,0,0,0,1,0,1,0,0,0,0,0,0
487,487,Gareth Barry,1418,2012,Manchester City,14,13,1,1185,1,0,17,14,3,1214,0,0,31,27,4,2399,1,0,3,0,3,1,0,1,0,0,0,0,0,0
488,488,Edin Džeko,1362,2012,Manchester City,15,9,6,974,6,0,17,7,10,840,8,0,32,16,16,1814,14,0,6,6,12,5,4,9,0,0,0,0,0,0
489,489,Costel Pantilimon,1354,2012,Manchester City,0,0,0,0,0,0,0,0,0,0,0,0,0,0,0,0,0,0,0,0,0,0,0,0,0,0,0,0,0,0
490,490,Karim Rekik,1419,2012,Manchester City,1,1,0,84,0,0,0,0,0,0,0,0,1,1,0,84,0,0,0,0,0,0,0,0,0,0,0,0,0,0
491,491,Scott Sinclair,1420,2012,Manchester City,6,1,5,98,0,0,5,1,4,92,0,0,11,2,9,190,0,0,0,0,0,0,0,0,0,0,0,0,0,0
492,492,Abdul Razak,1421,2012,Manchester City,3,0,3,3,0,0,0,0,0,0,0,0,3,0,3,3,0,0,0,0,0,0,0,0,0,0,0,0,0,0
493,493,Simon Mignolet,1191,2013,Liverpool FC,19,19,0,1710,0,0,19,19,0,1710,0,0,38,38,0,3420,0,0,0,0,0,0,0,0,0,0,0,0,0,0
494,494,Glen Johnson,1386,2013,Liverpool FC,15,15,0,1275,0,0,14,14,0,1246,0,0,29,29,0,2521,0,0,0,0,0,0,0,0,0,0,0,0,0,0
495,495,Kolo Touré,1415,2013,Liverpool FC,9,7,2,692,0,0,11,8,3,747,0,0,20,15,5,1439,0,0,0,0,0,0,0,0,0,0,0,0,0,0
496,496,Aly Cissokho,1422,2013,Liverpool FC,7,6,1,555,0,0,8,6,2,536,0,0,15,12,3,1091,0,0,0,0,0,0,0,0,0,0,0,0,0,0
497,497,Martin Škrtel,1423,2013,Liverpool FC,18,18,0,1602,4,0,18,18,0,1620,3,0,36,36,0,3222,7,0,0,0,0,1,3,4,0,0,0,0,0,0
498,498,Steven Gerrard,1424,2013,Liverpool FC,18,17,1,1463,4,0,16,16,0,1437,9,0,34,33,1,2900,13,0,1,6,7,3,7,10,2,7,9,0,0,0
499,499,Coutinho,1425,2013,Liverpool FC,16,15,1,1285,2,0,17,13,4,1051,3,0,33,28,5,2336,5,0,3,0,3,1,3,4,0,0,0,0,0,0
500,500,Jordan Henderson,1426,2013,Liverpool FC,18,18,0,1600,3,0,17,17,0,1530,1,0,35,35,0,3130,4,0,3,0,3,1,0,1,0,0,0,0,0,0
501,501,Luis Suárez,1427,2013,Liverpool FC,16,16,0,1435,17,0,17,17,0,1530,14,0,33,33,0,2965,31,0,0,0,0,4,4,8,0,0,0,0,0,0
502,502,Daniel Sturridge,1428,2013,Liverpool FC,15,14,1,1176,12,0,14,12,2,1101,10,0,29,26,3,2277,22,0,9,5,14,5,7,12,0,0,0,0,0,0
503,503,Raheem Sterling,1203,2013,Liverpool FC,17,13,4,1205,5,0,16,11,5,1015,4,0,33,24,9,2220,9,0,0,0,0,1,1,2,0,0,0,0,0,0
504,504,Lucas Leiva,1429,2013,Liverpool FC,13,8,5,797,0,0,14,12,2,1098,0,0,27,20,7,1895,0,0,0,0,0,0,0,0,0,0,0,0,0,0
505,505,Joe Allen,1430,2013,Liverpool FC,13,6,7,668,0,0,11,9,2,773,1,0,24,15,9,1441,1,0,0,0,0,0,1,1,0,0,0,0,0,0
506,506,Brad Jones,1431,2013,Liverpool FC,0,0,0,0,0,0,0,0,0,0,0,0,0,0,0,0,0,0,0,0,0,0,0,0,0,0,0,0,0,0
507,507,Martin Kelly,1034,2013,Liverpool FC,4,0,4,92,0,0,1,0,1,16,0,0,5,0,5,108,0,0,0,0,0,0,0,0,0,0,0,0,0,0
508,508,Luis Alberto,1432,2013,Liverpool FC,6,0,6,80,0,0,3,0,3,53,0,0,9,0,9,133,0,0,0,0,0,0,0,0,0,0,0,0,0,0
509,509,Iago Aspas,1433,2013,Liverpool FC,8,4,4,255,0,0,6,1,5,123,0,0,14,5,9,378,0,0,0,0,0,0,0,0,0,0,0,0,0,0
510,510,Victor Moses,1434,2013,Liverpool FC,9,2,7,239,0,0,10,4,6,404,1,0,19,6,13,643,1,0,0,0,0,0,1,1,0,0,0,0,0,0
511,511,Brad Guzan,1435,2013,Aston Villa,19,19,0,1710,0,0,19,19,0,1710,0,0,38,38,0,3420,0,0,0,0,0,0,0,0,0,0,0,0,0,0
512,512,Ron Vlaar,1436,2013,Aston Villa,15,15,0,1350,0,0,17,17,0,1456,0,0,32,32,0,2806,0,0,0,0,0,0,0,0,0,0,0,0,0,0
513,513,Ciaran Clark,1437,2013,Aston Villa,13,10,3,1016,0,0,14,13,1,1185,0,0,27,23,4,2201,0,0,0,0,0,0,0,0,0,0,0,0,0,0
514,514,Leandro Bacuna,1438,2013,Aston Villa,18,14,4,1344,4,0,17,14,3,1252,1,0,35,28,7,2596,5,0,0,0,0,3,1,4,0,0,0,0,0,0
515,515,Ryan Bertrand,1148,2013,Aston Villa,7,7,0,614,0,0,9,9,0,777,0,0,16,16,0,1391,0,0,0,0,0,0,0,0,0,0,0,0,0,0
516,516,Karim El Ahmadi,1439,2013,Aston Villa,16,13,3,1051,1,0,15,13,2,1137,1,0,31,26,5,2188,2,0,0,0,0,1,0,1,0,0,0,0,0,0
517,517,Ashley Westwood,1440,2013,Aston Villa,17,17,0,1506,1,0,18,18,0,1574,2,0,35,35,0,3080,3,0,0,1,1,1,2,3,0,0,0,0,0,0
518,518,Fabian Delph,1198,2013,Aston Villa,16,16,0,1440,2,0,18,17,1,1563,1,0,34,33,1,3003,3,0,3,3,6,2,1,3,0,0,0,0,0,0
519,519,Andreas Weimann,1441,2013,Aston Villa,18,16,2,1313,4,0,19,15,4,1344,1,0,37,31,6,2657,5,0,3,0,3,2,1,3,0,0,0,0,0,0
520,520,Gabriel Agbonlahor,1442,2013,Aston Villa,15,15,0,1257,1,0,15,14,1,1188,3,0,30,29,1,2445,4,0,0,3,3,1,3,4,0,0,0,0,0,0
521,521,Christian Benteke,1443,2013,Aston Villa,13,12,1,1086,6,0,13,12,1,1042,4,0,26,24,2,2128,10,0,3,0,3,5,3,8,1,1,2,0,0,0
522,522,Antonio Luna,1444,2013,Aston Villa,10,10,0,833,0,0,7,6,1,549,1,0,17,16,1,1382,1,0,0,0,0,0,0,0,0,0,0,0,0,0
523,523,Yacouba Sylla,1445,2013,Aston Villa,6,3,3,331,0,0,5,2,3,218,0,0,11,5,6,549,0,0,0,0,0,0,0,0,0,0,0,0,0,0
524,524,Grant Holt,1446,2013,Aston Villa,6,1,5,169,1,0,4,2,2,207,0,0,10,3,7,376,1,0,0,0,0,1,0,1,0,0,0,0,0,0
525,525,Jed Steer,1447,2013,Aston Villa,0,0,0,0,0,0,0,0,0,0,0,0,0,0,0,0,0,0,0,0,0,0,0,0,0,0,0,0,0,0
526,526,Marc Albrighton,1448,2013,Aston Villa,11,5,6,582,0,0,8,4,4,387,0,0,19,9,10,969,0,0,0,0,0,0,0,0,0,0,0,0,0,0
527,527,Gary Gardner,1449,2013,Aston Villa,0,0,0,0,0,0,0,0,0,0,0,0,0,0,0,0,0,0,0,0,0,0,0,0,0,0,0,0,0,0
528,528,Nicklas Helenius,1450,2013,Aston Villa,2,0,2,20,0,0,1,0,1,30,0,0,3,0,3,50,0,0,0,0,0,0,0,0,0,0,0,0,0,0
529,529,Fabien Barthez,1104,2001,Manchester United,19,19,0,1690,0,0,12,12,0,1080,0,0,31,31,0,2770,0,0,0,0,0,0,0,0,0,0,0,0,0,0
530,530,Gary Neville,1105,2001,Manchester United,16,14,2,1242,0,0,17,16,1,1461,0,0,33,30,3,2703,0,0,0,0,0,0,0,0,0,0,0,0,0,0
531,531,Mikaël Silvestre,1106,2001,Manchester United,17,15,2,1382,0,0,17,15,2,1328,0,0,34,30,4,2710,0,0,0,0,0,0,0,0,0,0,0,0,0,0
532,532,Laurent Blanc,1451,2001,Manchester United,15,15,0,1324,0,0,13,13,0,1138,1,0,28,28,0,2462,1,0,0,0,0,0,0,0,0,0,0,0,0,0
533,533,Phil Neville,1114,2001,Manchester United,14,13,1,1136,2,0,13,7,6,807,0,0,27,20,7,1943,2,0,0,0,0,1,0,1,0,0,0,0,0,0
534,534,Juan Sebastián Verón,1452,2001,Manchester United,15,14,1,1151,2,0,11,10,1,892,3,0,26,24,2,2043,5,0,0,0,0,2,3,5,0,0,0,0,0,0
535,535,David Beckham,1109,2001,Manchester United,14,10,4,957,5,0,13,12,1,1081,6,0,27,22,5,2038,11,0,0,1,1,3,3,6,0,1,1,0,0,0
536,536,Roy Keane,1111,2001,Manchester United,15,15,0,1317,3,0,12,12,0,1063,0,0,27,27,0,2380,3,0,3,0,3,1,0,1,0,0,0,0,0,0
537,537,Paul Scholes,1112,2001,Manchester United,17,15,2,1365,3,0,17,14,3,1302,5,0,34,29,5,2667,8,0,0,0,0,0,5,5,0,0,0,0,0,0
538,538,Ruud van Nistelrooy,1453,2001,Manchester United,15,13,2,1166,14,0,16,15,1,1298,9,0,31,28,3,2464,23,0,6,6,12,7,5,12,3,1,4,0,0,0
539,539,Ole Gunnar Solskjær,1116,2001,Manchester United,14,11,3,957,6,0,16,12,4,1106,11,0,30,23,7,2063,17,0,1,3,4,2,4,6,0,0,0,0,0,0
540,540,Denis Irwin,1454,2001,Manchester United,5,4,1,334,0,0,7,6,1,495,0,0,12,10,2,829,0,0,0,0,0,0,0,0,0,0,0,0,0,0
541,541,Nicky Butt,1115,2001,Manchester United,12,9,3,809,0,0,12,10,2,810,1,0,24,19,5,1619,1,0,0,0,0,0,1,1,0,0,0,0,0,0
542,542,Ryan Giggs,1110,2001,Manchester United,11,7,4,693,0,0,13,10,3,898,7,0,24,17,7,1591,7,0,0,0,0,0,3,3,0,0,0,0,0,0
543,543,Nils-Eric Johansson,1134,2001,Blackburn Rovers,10,7,3,696,0,0,8,6,2,574,0,0,18,13,5,1270,0,0,0,0,0,0,0,0,0,0,0,0,0,0
544,544,Craig Hignett,1455,2001,Blackburn Rovers,9,1,8,188,2,0,8,2,6,347,2,0,17,3,14,535,4,0,0,3,3,0,2,2,0,0,0,0,0,0
545,545,David Dunn,1456,2001,Blackburn Rovers,12,11,1,955,2,0,13,11,2,908,5,0,25,22,3,1863,7,0,0,1,1,1,3,4,0,1,1,0,0,0
546,546,Andy Cole,1113,2001,Blackburn Rovers,5,5,0,450,6,0,7,7,0,630,3,0,12,12,0,1080,9,0,0,3,3,2,2,4,0,0,0,0,0,0
547,547,Corrado Grabbi,1457,2001,Blackburn Rovers,9,7,2,446,1,0,5,3,2,230,0,0,14,10,4,676,1,0,3,0,3,1,0,1,0,0,0,0,0,0
548,548,Jordan Pickford,1046,2019,Everton FC,19,19,0,1710,0,0,19,19,0,1710,0,0,38,38,0,3420,0,0,0,0,0,0,0,0,0,0,0,0,0,0
549,549,Mason Holgate,1062,2019,Everton FC,14,11,3,938,0,0,13,13,0,1116,0,0,27,24,3,2054,0,0,0,0,0,0,0,0,0,0,0,0,0,0
550,550,Lucas Digne,1458,2019,Everton FC,18,18,0,1570,0,0,17,17,0,1465,0,0,35,35,0,3035,0,0,0,0,0,0,0,0,0,0,0,0,0,0
551,551,Yerry Mina,1459,2019,Everton FC,14,12,2,1107,0,0,15,13,2,1175,2,0,29,25,4,2282,2,0,0,0,0,0,1,1,0,0,0,0,0,0
552,552,Djibril Sidibé,1460,2019,Everton FC,12,8,4,898,0,0,13,10,3,922,0,0,25,18,7,1820,0,0,0,0,0,0,0,0,0,0,0,0,0,0
553,553,Fabian Delph,1198,2019,Everton FC,8,7,1,630,0,0,8,6,2,579,0,0,16,13,3,1209,0,0,0,0,0,0,0,0,0,0,0,0,0,0
554,554,Gylfi Sigurðsson,1055,2019,Everton FC,18,13,5,1270,2,0,17,15,2,1292,0,0,35,28,7,2562,2,0,0,0,0,0,0,0,1,0,1,0,0,0
555,555,Tom Davies,1063,2019,Everton FC,16,10,6,953,0,0,14,13,1,1074,1,0,30,23,7,2027,1,0,0,0,0,0,1,1,0,0,0,0,0,0
556,556,Richarlison,1461,2019,Everton FC,18,18,0,1520,7,0,18,18,0,1560,6,0,36,36,0,3080,13,0,7,6,13,7,4,11,0,0,0,0,0,0
557,557,Dominic Calvert-Lewin,1056,2019,Everton FC,17,13,4,1195,7,0,19,17,2,1435,6,0,36,30,6,2630,13,0,3,4,7,3,6,9,0,0,0,0,0,0
558,558,Alex Iwobi,1462,2019,Everton FC,12,9,3,770,1,0,13,10,3,850,0,0,25,19,6,1620,1,0,0,0,0,1,0,1,0,0,0,0,0,0
559,559,Michael Keane,1047,2019,Everton FC,15,14,1,1278,0,0,16,14,2,1278,2,0,31,28,3,2556,2,0,0,3,3,0,1,1,0,0,0,0,0,0
560,560,Cenk Tosun,1463,2019,Everton FC,4,1,3,226,1,0,1,1,0,74,0,0,5,2,3,300,1,0,1,0,1,1,0,1,0,0,0,0,0,0
561,561,Moise Kean,1464,2019,Everton FC,13,4,9,416,2,0,16,2,14,421,0,0,29,6,23,837,2,0,0,0,0,2,0,2,0,0,0,0,0,0
562,562,Maarten Stekelenburg,1465,2019,Everton FC,0,0,0,0,0,0,0,0,0,0,0,0,0,0,0,0,0,0,0,0,0,0,0,0,0,0,0,0,0,0
563,563,Leighton Baines,1466,2019,Everton FC,3,1,2,118,0,0,5,3,2,284,0,0,8,4,4,402,0,0,0,0,0,0,0,0,0,0,0,0,0,0
564,564,Séamus Coleman,1467,2019,Everton FC,15,12,3,1026,0,0,12,9,3,847,0,0,27,21,6,1873,0,0,0,0,0,0,0,0,0,0,0,0,0,0
565,565,Bernard,1468,2019,Everton FC,15,8,7,688,3,0,12,7,5,592,0,0,27,15,12,1280,3,0,3,0,3,3,0,3,0,0,0,0,0,0
566,566,Bernd Leno,1469,2019,Arsenal FC,15,15,0,1350,0,0,15,15,0,1300,0,0,30,30,0,2650,0,0,0,0,0,0,0,0,0,0,0,0,0,0
567,567,Calum Chambers,1470,2019,Arsenal FC,7,6,1,473,1,0,7,7,0,630,0,0,14,13,1,1103,1,0,0,0,0,1,0,1,0,0,0,0,0,0
568,568,David Luiz,1471,2019,Arsenal FC,18,18,0,1620,2,0,15,14,1,1296,0,0,33,32,1,2916,2,0,3,0,3,1,0,1,0,0,0,0,0,0
569,569,Lucas Torreira,1472,2019,Arsenal FC,16,9,7,799,0,0,13,8,5,710,1,0,29,17,12,1509,1,0,0,0,0,0,0,0,0,0,0,0,0,0
570,570,Ainsley Maitland-Niles,1473,2019,Arsenal FC,10,8,2,735,0,0,10,7,3,697,0,0,20,15,5,1432,0,0,0,0,0,0,0,0,0,0,0,0,0,0
571,571,Emile Smith-Rowe,1474,2019,Arsenal FC,1,0,1,31,0,0,1,1,0,66,0,0,2,1,1,97,0,0,0,0,0,0,0,0,0,0,0,0,0,0
572,572,Granit Xhaka,1475,2019,Arsenal FC,14,14,0,1213,1,0,17,16,1,1377,0,0,31,30,1,2590,1,0,0,0,0,0,0,0,0,0,0,0,0,0
573,573,Pierre-Emerick Aubameyang,1476,2019,Arsenal FC,18,17,1,1554,13,0,18,18,0,1608,9,0,36,35,1,3162,22,0,10,6,16,11,7,18,1,1,2,0,0,0
574,574,Reiss Nelson,1477,2019,Arsenal FC,7,4,3,315,1,0,10,3,7,313,0,0,17,7,10,628,1,0,3,0,3,1,0,1,0,0,0,0,0,0
575,575,Gabriel Martinelli,1478,2019,Arsenal FC,6,2,4,257,1,0,8,4,4,399,2,0,14,6,8,656,3,0,0,0,0,1,2,3,0,0,0,0,0,0
576,576,Bukayo Saka,1479,2019,Arsenal FC,13,8,5,834,0,0,13,11,2,921,1,0,26,19,7,1755,1,0,0,0,0,0,1,1,0,0,0,0,0,0
577,577,Joe Willock,1480,2019,Arsenal FC,12,3,9,340,0,0,17,5,12,505,1,0,29,8,21,845,1,0,0,0,0,0,0,0,0,0,0,0,0,0
578,578,Alexandre Lacazette,1481,2019,Arsenal FC,15,13,2,999,8,0,15,9,6,880,2,0,30,22,8,1879,10,0,4,0,4,6,1,7,0,0,0,0,0,0
579,579,Emiliano Martínez,1482,2019,Arsenal FC,4,4,0,360,0,0,5,4,1,410,0,0,9,8,1,770,0,0,0,0,0,0,0,0,0,0,0,0,0,0
580,580,Shkodran Mustafi,1483,2019,Arsenal FC,6,5,1,473,0,0,9,8,1,733,0,0,15,13,2,1206,0,0,0,0,0,0,0,0,0,0,0,0,0,0
581,581,Konstantinos Mavropanos,1484,2019,Arsenal FC,0,0,0,0,0,0,0,0,0,0,0,0,0,0,0,0,0,0,0,0,0,0,0,0,0,0,0,0,0,0
582,582,Mattéo Guendouzi,1485,2019,Arsenal FC,11,9,2,826,0,0,13,10,3,921,0,0,24,19,5,1747,0,0,0,0,0,0,0,0,0,0,0,0,0,0
583,583,Nicolas Pépé,1486,2019,Arsenal FC,17,12,5,1130,3,0,14,10,4,882,2,0,31,22,9,2012,5,0,0,0,0,2,2,4,1,0,1,0,0,0
584,584,Tom Heaton,1249,2014,Burnley FC,19,19,0,1710,0,0,19,19,0,1710,0,0,38,38,0,3420,0,0,0,0,0,0,0,0,0,0,0,0,0,0
585,585,Kieran Trippier,1487,2014,Burnley FC,19,19,0,1710,0,0,19,19,0,1706,0,0,38,38,0,3416,0,0,0,0,0,0,0,0,0,0,0,0,0,0
586,586,Michael Duff,1488,2014,Burnley FC,11,11,0,990,0,0,10,10,0,886,0,0,21,21,0,1876,0,0,0,0,0,0,0,0,0,0,0,0,0,0
587,587,Jason Shackell,1489,2014,Burnley FC,19,19,0,1710,0,0,19,19,0,1637,0,0,38,38,0,3347,0,0,0,0,0,0,0,0,0,0,0,0,0,0
588,588,Ben Mee,1251,2014,Burnley FC,16,15,1,1358,1,0,17,17,0,1530,1,0,33,32,1,2888,2,0,0,1,1,1,1,2,0,0,0,0,0,0
589,589,David Jones,1490,2014,Burnley FC,19,19,0,1690,0,0,17,17,0,1520,0,0,36,36,0,3210,0,0,0,0,0,0,0,0,0,0,0,0,0,0
590,590,Scott Arfield,1265,2014,Burnley FC,19,18,1,1610,2,0,18,18,0,1594,0,0,37,36,1,3204,2,0,0,0,0,2,0,2,0,0,0,0,0,0
591,591,Sam Vokes,1257,2014,Burnley FC,8,3,5,321,0,0,7,2,5,242,0,0,15,5,10,563,0,0,0,0,0,0,0,0,0,0,0,0,0,0
592,592,Danny Ings,1193,2014,Burnley FC,18,18,0,1593,5,0,17,17,0,1442,6,0,35,35,0,3035,11,0,4,6,10,3,5,8,1,0,1,0,0,0
593,593,George Boyd,1258,2014,Burnley FC,17,17,0,1507,3,0,18,18,0,1507,2,0,35,35,0,3014,5,0,3,1,4,2,1,3,0,0,0,0,0,0
594,594,Ashley Barnes,1491,2014,Burnley FC,18,13,5,1182,3,0,17,15,2,1288,2,0,35,28,7,2470,5,0,6,1,7,3,2,5,0,0,0,0,0,0
595,595,Matthew Taylor,1069,2014,Burnley FC,5,4,1,309,0,0,5,3,2,260,0,0,10,7,3,569,0,0,0,0,0,0,0,0,0,0,0,0,0,0
596,596,Matt Gilks,1492,2014,Burnley FC,0,0,0,0,0,0,0,0,0,0,0,0,0,0,0,0,0,0,0,0,0,0,0,0,0,0,0,0,0,0
597,597,Stephen Ward,1252,2014,Burnley FC,5,4,1,339,0,0,4,3,1,284,0,0,9,7,2,623,0,0,0,0,0,0,0,0,0,0,0,0,0,0
598,598,Michael Keane,1047,2014,Burnley FC,8,8,0,720,0,0,13,9,4,874,0,0,21,17,4,1594,0,0,0,0,0,0,0,0,0,0,0,0,0,0
599,599,Michael Kightly,1259,2014,Burnley FC,9,4,5,436,0,0,8,6,2,516,1,0,17,10,7,952,1,0,0,0,0,0,1,1,0,0,0,0,0,0
600,600,Fredrik Ulvestad,1493,2014,Burnley FC,1,0,1,2,0,0,1,1,0,65,0,0,2,1,1,67,0,0,0,0,0,0,0,0,0,0,0,0,0,0
601,601,Lukas Jutkiewicz,1494,2014,Burnley FC,12,6,6,512,0,0,13,4,9,463,0,0,25,10,15,975,0,0,0,0,0,0,0,0,0,0,0,0,0,0
602,602,David Ospina,1495,2014,Arsenal FC,10,10,0,900,0,0,8,8,0,720,0,0,18,18,0,1620,0,0,0,0,0,0,0,0,0,0,0,0,0,0
603,603,Per Mertesacker,1496,2014,Arsenal FC,17,17,0,1530,0,0,18,18,0,1620,0,0,35,35,0,3150,0,0,0,0,0,0,0,0,0,0,0,0,0,0
604,604,Laurent Koscielny,1497,2014,Arsenal FC,13,13,0,1129,3,0,14,13,1,1160,0,0,27,26,1,2289,3,0,0,0,0,3,0,3,0,0,0,0,0,0
605,605,Nacho Monreal,1498,2014,Arsenal FC,14,13,1,1207,0,0,14,13,1,1104,0,0,28,26,2,2311,0,0,0,0,0,0,0,0,0,0,0,0,0,0
606,606,Héctor Bellerín,1499,2014,Arsenal FC,11,10,1,977,2,0,9,7,2,586,0,0,20,17,3,1563,2,0,0,0,0,1,0,1,0,0,0,0,0,0
607,607,Mesut Özil,1500,2014,Arsenal FC,12,11,1,974,2,0,10,10,0,886,2,0,22,21,1,1860,4,0,0,0,0,0,2,2,0,0,0,0,0,0
608,608,Aaron Ramsey,1501,2014,Arsenal FC,15,11,4,983,2,0,14,12,2,1035,4,0,29,23,6,2018,6,0,3,3,6,1,1,2,0,0,0,0,0,0
609,609,Santi Cazorla,1502,2014,Arsenal FC,18,15,3,1448,3,0,19,18,1,1543,4,0,37,33,4,2991,7,0,0,0,0,0,3,3,2,4,6,0,0,0
610,610,Francis Coquelin,1503,2014,Arsenal FC,11,9,2,756,0,0,11,10,1,907,0,0,22,19,3,1663,0,0,0,0,0,0,0,0,0,0,0,0,0,0
611,611,Olivier Giroud,1504,2014,Arsenal FC,15,10,5,929,7,0,12,11,1,975,7,0,27,21,6,1904,14,0,0,1,1,4,4,8,0,0,0,0,0,0
612,612,Alexis Sánchez,1505,2014,Arsenal FC,18,17,1,1503,9,0,17,17,0,1449,7,0,35,34,1,2952,16,0,3,0,3,5,4,9,0,0,0,0,0,0
613,613,Calum Chambers,1470,2014,Arsenal FC,9,6,3,557,1,0,14,11,3,1026,0,0,23,17,6,1583,1,0,0,0,0,0,0,0,0,0,0,0,0,0
614,614,Danny Welbeck,1506,2014,Arsenal FC,12,8,4,755,1,0,13,10,3,909,3,0,25,18,7,1664,4,0,1,3,4,1,1,2,0,0,0,0,0,0
615,615,Wojciech Szczęsny,1507,2014,Arsenal FC,8,8,0,689,0,0,9,9,0,810,0,0,17,17,0,1499,0,0,0,0,0,0,0,0,0,0,0,0,0,0
616,616,Kieran Gibbs,1508,2014,Arsenal FC,10,10,0,863,0,0,12,8,4,795,0,0,22,18,4,1658,0,0,0,0,0,0,0,0,0,0,0,0,0,0
617,617,Tomáš Rosický,1509,2014,Arsenal FC,6,3,3,300,2,0,9,2,7,276,0,0,15,5,10,576,2,0,0,0,0,0,0,0,0,0,0,0,0,0
618,618,Mathieu Flamini,1510,2014,Arsenal FC,11,6,5,631,1,0,12,9,3,826,0,0,23,15,8,1457,1,0,0,0,0,0,0,0,0,0,0,0,0,0
619,619,Theo Walcott,1237,2014,Arsenal FC,9,4,5,366,5,0,5,0,5,75,0,0,14,4,10,441,5,0,0,0,0,1,0,1,0,0,0,0,0,0
620,620,Kenny Cunningham,1511,2004,Birmingham City,18,18,0,1566,0,0,17,17,0,1512,0,0,35,35,0,3078,0,0,0,0,0,0,0,0,0,0,0,0,0,0
621,621,Matthew Upson,1279,2004,Birmingham City,18,18,0,1620,2,0,17,17,0,1530,0,0,35,35,0,3150,2,0,0,0,0,2,0,2,0,0,0,0,0,0
622,622,Martin Taylor,1345,2004,Birmingham City,5,5,0,446,0,0,3,2,1,180,0,0,8,7,1,626,0,0,0,0,0,0,0,0,0,0,0,0,0,0
623,623,Mario Melchiot,1512,2004,Birmingham City,18,17,1,1411,0,0,16,16,0,1431,1,0,34,33,1,2842,1,0,0,0,0,0,1,1,0,0,0,0,0,0
624,624,Jamie Clapham,1513,2004,Birmingham City,14,9,5,875,0,0,12,9,3,797,0,0,26,18,8,1672,0,0,0,0,0,0,0,0,0,0,0,0,0,0
625,625,Jermaine Pennant,1514,2004,Birmingham City,6,6,0,487,0,0,6,6,0,530,0,0,12,12,0,1017,0,0,0,0,0,0,0,0,0,0,0,0,0,0
626,626,Darren Carter,1515,2004,Birmingham City,8,6,2,539,1,0,6,5,1,411,1,0,14,11,3,950,2,0,1,0,1,1,1,2,0,0,0,0,0,0
627,627,Stephen Clemence,1516,2004,Birmingham City,11,6,5,652,0,0,11,7,4,648,0,0,22,13,9,1300,0,0,0,0,0,0,0,0,0,0,0,0,0,0
628,628,Mehdi Nafti,1517,2004,Birmingham City,6,3,3,264,0,0,4,4,0,342,0,0,10,7,3,606,0,0,0,0,0,0,0,0,0,0,0,0,0,0
629,629,Walter Pandiani,1518,2004,Birmingham City,7,7,0,557,3,0,7,6,1,485,1,0,14,13,1,1042,4,0,0,0,0,3,1,4,1,0,1,0,0,0
630,630,Emile Heskey,1519,2004,Birmingham City,18,18,0,1466,6,0,15,15,0,1322,4,0,33,33,0,2788,10,0,9,0,9,4,3,7,0,0,0,0,0,0
631,631,Olivier Tebily,1520,2004,Birmingham City,8,3,5,350,0,0,6,5,1,324,0,0,14,8,6,674,0,0,0,0,0,0,0,0,0,0,0,0,0,0
632,632,Clinton Morrison,1521,2004,Birmingham City,12,6,6,547,3,0,12,6,6,601,1,0,24,12,12,1148,4,0,0,0,0,2,1,3,0,0,0,0,0,0
633,633,Jens Lehmann,1522,2004,Arsenal FC,13,13,0,1170,0,0,14,14,0,1260,0,0,27,27,0,2430,0,0,0,0,0,0,0,0,0,0,0,0,0,0
634,634,Ashley Cole,1523,2004,Arsenal FC,16,16,0,1440,0,0,18,18,0,1620,2,0,34,34,0,3060,2,0,0,3,3,0,1,1,0,0,0,0,0,0
635,635,Philippe Senderos,1228,2004,Arsenal FC,5,5,0,450,0,0,7,6,1,548,0,0,12,11,1,998,0,0,0,0,0,0,0,0,0,0,0,0,0,0
636,636,Sol Campbell,1388,2004,Arsenal FC,8,8,0,709,0,0,8,8,0,712,1,0,16,16,0,1421,1,0,0,3,3,0,1,1,0,0,0,0,0,0
637,637,Kolo Touré,1415,2004,Arsenal FC,17,17,0,1530,0,0,17,17,0,1515,0,0,34,34,0,3045,0,0,0,0,0,0,0,0,0,0,0,0,0,0
638,638,Patrick Vieira,1524,2004,Arsenal FC,15,15,0,1283,3,0,16,16,0,1425,3,0,31,31,0,2708,6,0,0,3,3,1,2,3,0,0,0,0,0,0
639,639,Freddie Ljungberg,1525,2004,Arsenal FC,12,10,2,834,3,0,14,14,0,1170,7,0,26,24,2,2004,10,0,1,0,1,2,5,7,0,0,0,0,0,0
640,640,Cesc Fàbregas,1526,2004,Arsenal FC,18,12,6,1098,2,0,14,11,3,925,0,0,32,23,9,2023,2,0,0,0,0,0,0,0,0,0,0,0,0,0
641,641,Gilberto Silva,1234,2004,Arsenal FC,6,6,0,517,0,0,7,7,0,609,0,0,13,13,0,1126,0,0,0,0,0,0,0,0,0,0,0,0,0,0
642,642,Dennis Bergkamp,1527,2004,Arsenal FC,15,12,3,1096,5,0,14,8,6,824,3,0,29,20,9,1920,8,0,3,0,3,3,2,5,0,0,0,0,0,0
643,643,Robin van Persie,1528,2004,Arsenal FC,13,4,9,365,2,0,12,7,5,575,3,0,25,11,14,940,5,0,1,3,4,2,2,4,0,0,0,0,0,0
644,644,Mathieu Flamini,1510,2004,Arsenal FC,13,5,8,539,1,0,7,3,4,331,0,0,20,8,12,870,1,0,0,0,0,0,0,0,0,0,0,0,0,0
645,645,Edu,1529,2004,Arsenal FC,6,3,3,280,1,0,6,3,3,309,1,0,12,6,6,589,2,0,0,0,0,0,0,0,1,0,1,0,0,0
646,646,Jérémie Aliadiére,1530,2004,Arsenal FC,2,0,2,5,0,0,2,0,2,31,0,0,4,0,4,36,0,0,0,0,0,0,0,0,0,0,0,0,0,0
647,647,Petr Čech,1531,2013,Chelsea FC,17,17,0,1530,0,0,17,17,0,1530,0,0,34,34,0,3060,0,0,0,0,0,0,0,0,0,0,0,0,0,0
648,648,Branislav Ivanović,1532,2013,Chelsea FC,19,19,0,1650,1,0,17,17,0,1530,2,0,36,36,0,3180,3,0,3,3,6,1,2,3,0,0,0,0,0,0
649,649,Gary Cahill,1533,2013,Chelsea FC,16,16,0,1440,1,0,14,13,1,1183,0,0,30,29,1,2623,1,0,0,0,0,1,0,1,0,0,0,0,0,0
650,650,John Terry,1534,2013,Chelsea FC,18,18,0,1620,1,0,16,16,0,1440,1,0,34,34,0,3060,2,0,0,1,1,1,1,2,0,0,0,0,0,0
651,651,Azpilicueta,1535,2013,Chelsea FC,13,12,1,1057,0,0,16,14,2,1269,0,0,29,26,3,2326,0,0,0,0,0,0,0,0,0,0,0,0,0,0
652,652,Frank Lampard,1536,2013,Chelsea FC,15,11,4,896,3,0,11,9,2,809,3,0,26,20,6,1705,6,0,3,0,3,1,2,3,0,1,1,0,0,0
653,653,Nemanja Matić,1537,2013,Chelsea FC,9,7,2,645,0,0,8,8,0,720,0,0,17,15,2,1365,0,0,0,0,0,0,0,0,0,0,0,0,0,0
654,654,Willian,1538,2013,Chelsea FC,14,11,3,981,1,0,11,7,4,718,3,0,25,18,7,1699,4,0,0,0,0,0,0,0,0,0,0,0,0,0
655,655,Fernando Torres,1539,2013,Chelsea FC,13,5,8,631,2,0,15,11,4,950,3,0,28,16,12,1581,5,0,3,3,6,2,2,4,0,0,0,0,0,0
656,656,André Schürrle,1540,2013,Chelsea FC,13,6,7,575,2,0,17,9,8,754,6,0,30,15,15,1329,8,0,0,0,0,1,4,5,0,0,0,0,0,0
657,657,Mohamed Salah,1187,2013,Chelsea FC,5,3,2,237,2,0,5,3,2,263,0,0,10,6,4,500,2,0,0,0,0,1,0,1,0,0,0,0,0,0
658,658,Ashley Cole,1523,2013,Chelsea FC,8,6,2,612,0,0,9,9,0,774,0,0,17,15,2,1386,0,0,0,0,0,0,0,0,0,0,0,0,0,0
659,659,David Luiz,1471,2013,Chelsea FC,9,7,2,676,0,0,10,8,2,682,0,0,19,15,4,1358,0,0,0,0,0,0,0,0,0,0,0,0,0,0
660,660,Eden Hazard,1541,2013,Chelsea FC,18,16,2,1491,10,0,17,16,1,1405,4,0,35,32,3,2896,14,0,4,0,4,5,4,9,4,0,4,0,0,0
661,661,Mark Schwarzer,1328,2013,Chelsea FC,2,2,0,180,0,0,2,2,0,180,0,0,4,4,0,360,0,0,0,0,0,0,0,0,0,0,0,0,0,0
662,662,Tomáš Kalas,1542,2013,Chelsea FC,0,0,0,0,0,0,2,2,0,180,0,0,2,2,0,180,0,0,0,0,0,0,0,0,0,0,0,0,0,0
663,663,Oscar,1543,2013,Chelsea FC,17,14,3,1132,5,0,16,10,6,1004,3,0,33,24,9,2136,8,0,0,0,0,2,1,3,0,0,0,0,0,0
664,664,Demba Ba,1544,2013,Chelsea FC,9,2,7,306,3,0,10,3,7,355,2,0,19,5,14,661,5,0,0,3,3,0,2,2,0,0,0,0,0,0
665,665,Asmir Begović,1036,2013,Stoke City,17,17,0,1530,1,0,15,15,0,1350,0,0,32,32,0,2880,1,0,0,0,0,1,0,1,0,0,0,0,0,0
666,666,Erik Pieters,1545,2013,Stoke City,18,17,1,1445,1,0,18,17,1,1458,0,0,36,34,2,2903,1,0,3,0,3,1,0,1,0,0,0,0,0,0
667,667,Marc Wilson,1546,2013,Stoke City,17,16,1,1450,0,0,15,13,2,1198,0,0,32,29,3,2648,0,0,0,0,0,0,0,0,0,0,0,0,0,0
668,668,Ryan Shawcross,1547,2013,Stoke City,18,18,0,1620,1,0,19,19,0,1710,0,0,37,37,0,3330,1,0,3,0,3,1,0,1,0,0,0,0,0,0
669,669,Geoff Cameron,1548,2013,Stoke City,18,18,0,1620,0,0,19,19,0,1666,2,0,37,37,0,3286,2,0,0,0,0,0,1,1,0,0,0,0,0,0
670,670,Glenn Whelan,1549,2013,Stoke City,16,15,1,1254,0,0,16,13,3,1156,0,0,32,28,4,2410,0,0,0,0,0,0,0,0,0,0,0,0,0,0
671,671,Wilson Palacios,1271,2013,Stoke City,7,0,7,81,0,0,10,6,4,524,0,0,17,6,11,605,0,0,0,0,0,0,0,0,0,0,0,0,0,0
672,672,Steven N'Zonzi,1550,2013,Stoke City,18,17,1,1555,1,0,18,17,1,1523,1,0,36,34,2,3078,2,0,0,0,0,0,0,0,0,0,0,0,0,0
673,673,Peter Odemwingie,1551,2013,Stoke City,7,7,0,614,4,0,8,8,0,680,2,0,15,15,0,1294,6,0,3,0,3,3,2,5,0,0,0,0,0,0
674,674,Marko Arnautović,1552,2013,Stoke City,17,16,1,1357,2,0,13,11,2,899,2,0,30,27,3,2256,4,0,0,0,0,1,2,3,0,1,1,0,0,0
675,675,Peter Crouch,1273,2013,Stoke City,17,15,2,1350,4,0,17,15,2,1294,3,0,34,30,4,2644,7,0,3,1,4,3,3,6,0,0,0,0,0,0
676,676,Andy Wilkinson,1553,2013,Stoke City,2,1,1,103,0,0,3,1,2,168,0,0,5,2,3,271,0,0,0,0,0,0,0,0,0,0,0,0,0,0
677,677,Charlie Adam,1554,2013,Stoke City,16,12,4,978,6,0,15,8,7,780,2,0,31,20,11,1758,8,0,3,4,7,6,2,8,0,1,1,0,0,0
678,678,Jon Walters,1555,2013,Stoke City,15,13,2,1021,3,0,17,14,3,1231,2,0,32,27,5,2252,5,0,3,1,4,1,2,3,1,1,2,0,0,0
679,679,Thomas Sørensen,1090,2013,Stoke City,1,1,0,46,0,0,3,3,0,270,0,0,4,4,0,316,0,0,0,0,0,0,0,0,0,0,0,0,0,0
680,680,Muniesa,1556,2013,Stoke City,5,3,2,390,0,0,8,4,4,436,0,0,13,7,6,826,0,0,0,0,0,0,0,0,0,0,0,0,0,0
681,681,Matthew Etherington,1557,2013,Stoke City,4,2,2,157,0,0,7,3,4,263,0,0,11,5,6,420,0,0,0,0,0,0,0,0,0,0,0,0,0,0
682,682,John Guidetti,1558,2013,Stoke City,2,0,2,27,0,0,4,0,4,44,0,0,6,0,6,71,0,0,0,0,0,0,0,0,0,0,0,0,0,0
683,683,Antti Niemi,1559,2007,Fulham FC,12,12,0,1080,0,0,10,10,0,900,0,0,22,22,0,1980,0,0,0,0,0,0,0,0,0,0,0,0,0,0
684,684,Paul Konchesky,1560,2007,Fulham FC,16,16,0,1440,0,0,17,17,0,1530,0,0,33,33,0,2970,0,0,0,0,0,0,0,0,0,0,0,0,0,0
685,685,Dejan Stefanović,1066,2007,Fulham FC,7,7,0,630,0,0,6,6,0,540,0,0,13,13,0,1170,0,0,0,0,0,0,0,0,0,0,0,0,0,0
686,686,Aaron Hughes,1561,2007,Fulham FC,15,15,0,1350,0,0,15,14,1,1309,0,0,30,29,1,2659,0,0,0,0,0,0,0,0,0,0,0,0,0,0
687,687,Chris Baird,1562,2007,Fulham FC,9,8,1,721,0,0,9,9,0,765,0,0,18,17,1,1486,0,0,0,0,0,0,0,0,0,0,0,0,0,0
688,688,Steven Davis,1149,2007,Fulham FC,12,12,0,949,0,0,10,10,0,900,0,0,22,22,0,1849,0,0,0,0,0,0,0,0,0,0,0,0,0,0
689,689,Danny Murphy,1398,2007,Fulham FC,16,14,2,1253,3,0,17,14,3,1221,2,0,33,28,5,2474,5,0,1,3,4,3,2,5,2,0,2,0,0,0
690,690,Ki-hyeon Seol,1563,2007,Fulham FC,6,2,4,188,0,0,6,2,4,165,0,0,12,4,8,353,0,0,0,0,0,0,0,0,0,0,0,0,0,0
691,691,Diomansy Kamara,1564,2007,Fulham FC,16,9,7,899,2,0,12,8,4,714,3,0,28,17,11,1613,5,0,1,3,4,2,2,4,0,0,0,0,0,0
692,692,Clint Dempsey,1565,2007,Fulham FC,18,14,4,1331,3,0,18,15,3,1342,3,0,36,29,7,2673,6,0,1,0,1,2,2,4,0,0,0,0,0,0
693,693,Hameur Bouazza,1566,2007,Fulham FC,11,10,1,738,1,0,9,5,4,469,0,0,20,15,5,1207,1,0,0,0,0,1,0,1,0,0,0,0,0,0
694,694,Carlos Bocanegra,1081,2007,Fulham FC,11,9,2,870,0,0,11,9,2,746,1,0,22,18,4,1616,1,0,0,0,0,0,1,1,0,0,0,0,0,0
695,695,Simon Davies,1125,2007,Fulham FC,18,17,1,1507,3,0,19,19,0,1704,2,0,37,36,1,3211,5,0,0,0,0,3,2,5,0,0,0,0,0,0
696,696,David Healy,1567,2007,Fulham FC,15,6,9,623,3,0,15,9,6,737,1,0,30,15,15,1360,4,0,0,0,0,1,1,2,0,0,0,0,0,0
697,697,Stephen Bywater,1568,2007,Derby County,8,8,0,720,0,0,10,10,0,900,0,0,18,18,0,1620,0,0,0,0,0,0,0,0,0,0,0,0,0,0
698,698,Jay McEveley,1569,2007,Derby County,13,9,4,915,2,0,16,12,4,1001,0,0,29,21,8,1916,2,0,0,0,0,2,0,2,0,0,0,0,0,0
699,699,Dean Leacock,1570,2007,Derby County,12,10,2,896,0,0,14,12,2,1104,0,0,26,22,4,2000,0,0,0,0,0,0,0,0,0,0,0,0,0,0
700,700,Claude Davis,1571,2007,Derby County,10,10,0,849,0,0,9,9,0,675,0,0,19,19,0,1524,0,0,0,0,0,0,0,0,0,0,0,0,0,0
701,701,Darren Moore,1317,2007,Derby County,15,14,1,1130,0,0,16,15,1,1337,0,0,31,29,2,2467,0,0,0,0,0,0,0,0,0,0,0,0,0,0
702,702,Tyrone Mears,1572,2007,Derby County,13,12,1,1081,0,0,12,10,2,914,1,0,25,22,3,1995,1,0,0,0,0,0,1,1,0,0,0,0,0,0
703,703,Matt Oakley,1573,2007,Derby County,9,9,0,802,3,0,10,10,0,866,0,0,19,19,0,1668,3,0,0,0,0,3,0,3,0,0,0,0,0,0
704,704,Eddie Lewis,1574,2007,Derby County,13,13,0,1079,0,0,11,9,2,830,0,0,24,22,2,1909,0,0,0,0,0,0,0,0,0,0,0,0,0,0
705,705,Stephen Pearson,1575,2007,Derby County,11,11,0,919,0,0,13,12,1,1075,0,0,24,23,1,1994,0,0,0,0,0,0,0,0,0,0,0,0,0,0
706,706,Craig Fagan,1576,2007,Derby County,10,7,3,666,0,0,12,10,2,816,0,0,22,17,5,1482,0,0,0,0,0,0,0,0,0,0,0,0,0,0
707,707,Kenny Miller,1577,2007,Derby County,15,14,1,1152,2,0,15,15,0,1340,2,0,30,29,1,2492,4,0,3,0,3,2,2,4,0,0,0,0,0,0
708,708,Andy Griffin,1578,2007,Derby County,6,6,0,468,0,0,9,7,2,681,0,0,15,13,2,1149,0,0,0,0,0,0,0,0,0,0,0,0,0,0
709,709,Steve Howard,1579,2007,Derby County,10,6,4,655,0,0,10,8,2,736,1,0,20,14,6,1391,1,0,0,0,0,0,0,0,0,0,0,0,0,0
710,710,Giles Barnes,1580,2007,Derby County,10,8,2,738,0,0,11,6,5,642,1,0,21,14,7,1380,1,0,0,0,0,0,1,1,0,0,0,0,0,0
711,711,Shay Given,1581,2016,Stoke City,2,2,0,180,0,0,3,3,0,270,0,0,5,5,0,450,0,0,0,0,0,0,0,0,0,0,0,0,0,0
712,712,Phil Bardsley,1409,2016,Stoke City,7,7,0,540,0,0,8,7,1,631,0,0,15,14,1,1171,0,0,0,0,0,0,0,0,0,0,0,0,0,0
713,713,Erik Pieters,1545,2016,Stoke City,18,18,0,1620,0,0,18,17,1,1531,0,0,36,35,1,3151,0,0,0,0,0,0,0,0,0,0,0,0,0,0
714,714,Ryan Shawcross,1547,2016,Stoke City,18,18,0,1620,1,0,17,17,0,1530,0,0,35,35,0,3150,1,0,0,0,0,1,0,1,0,0,0,0,0,0
715,715,Philipp Wollscheid,1582,2016,Stoke City,1,1,0,90,0,0,1,1,0,90,0,0,2,2,0,180,0,0,0,0,0,0,0,0,0,0,0,0,0,0
716,716,Joe Allen,1430,2016,Stoke City,18,17,1,1404,5,0,18,17,1,1532,1,0,36,34,2,2936,6,0,3,1,4,3,1,4,0,0,0,0,0,0
717,717,Glenn Whelan,1549,2016,Stoke City,16,13,3,1168,0,0,14,13,1,1110,0,0,30,26,4,2278,0,0,0,0,0,0,0,0,0,0,0,0,0,0
718,718,Giannelli Imbula,1583,2016,Stoke City,5,4,1,325,0,0,7,5,2,471,0,0,12,9,3,796,0,0,0,0,0,0,0,0,0,0,0,0,0,0
719,719,Marko Arnautović,1552,2016,Stoke City,18,18,0,1559,3,0,14,14,0,1233,3,0,32,32,0,2792,6,0,0,0,0,2,1,3,0,0,0,0,0,0
720,720,Mame Diouf,1584,2016,Stoke City,11,5,6,498,0,0,16,10,6,884,1,0,27,15,12,1382,1,0,0,0,0,0,1,1,0,0,0,0,0,0
721,721,Bojan,1585,2016,Stoke City,4,3,1,269,2,0,5,2,3,206,1,0,9,5,4,475,3,0,0,1,1,1,1,2,2,0,2,0,0,0
722,722,Ramadan Sobhi,1586,2016,Stoke City,8,3,5,347,0,0,9,5,4,502,0,0,17,8,9,849,0,0,0,0,0,0,0,0,0,0,0,0,0,0
723,723,Jon Walters,1555,2016,Stoke City,12,7,5,700,3,0,11,6,5,596,1,0,23,13,10,1296,4,0,0,0,0,3,1,4,1,0,1,0,0,0
724,724,Jakob Haugaard,1587,2016,Stoke City,0,0,0,0,0,0,0,0,0,0,0,0,0,0,0,0,0,0,0,0,0,0,0,0,0,0,0,0,0,0
725,725,Muniesa,1556,2016,Stoke City,5,3,2,287,1,0,5,4,1,361,0,0,10,7,3,648,1,0,0,0,0,0,0,0,0,0,0,0,0,0
726,726,Geoff Cameron,1548,2016,Stoke City,9,9,0,810,0,0,10,9,1,818,0,0,19,18,1,1628,0,0,0,0,0,0,0,0,0,0,0,0,0,0
727,727,Charlie Adam,1554,2016,Stoke City,15,9,6,857,0,0,9,8,1,647,1,0,24,17,7,1504,1,0,0,0,0,0,1,1,0,1,1,0,0,0
728,728,Peter Crouch,1273,2016,Stoke City,13,5,8,595,4,0,14,8,6,740,3,0,27,13,14,1335,7,0,0,3,3,2,2,4,0,0,0,0,0,0
729,729,Willy Caballero,1588,2016,Manchester City,9,8,1,731,0,0,8,8,0,720,0,0,17,16,1,1451,0,0,0,0,0,0,0,0,0,0,0,0,0,0
730,730,Pablo Zabaleta,1355,2016,Manchester City,10,6,4,566,1,0,10,5,5,494,0,0,20,11,9,1060,1,0,0,0,0,1,0,1,0,0,0,0,0,0
731,731,Aleksandar Kolarov,1366,2016,Manchester City,15,14,1,1291,0,0,14,13,1,1242,1,0,29,27,2,2533,1,0,0,0,0,0,0,0,0,0,0,0,0,0
732,732,John Stones,1197,2016,Manchester City,13,9,4,825,0,0,14,14,0,1188,0,0,27,23,4,2013,0,0,0,0,0,0,0,0,0,0,0,0,0,0
733,733,Nicolás Otamendi,1199,2016,Manchester City,14,14,0,1222,1,0,16,15,1,1370,0,0,30,29,1,2592,1,0,0,0,0,0,0,0,0,0,0,0,0,0
734,734,Jesús Navas,1361,2016,Manchester City,12,5,7,452,0,0,12,7,5,607,0,0,24,12,12,1059,0,0,0,0,0,0,0,0,0,0,0,0,0,0
735,735,Kevin De Bruyne,1201,2016,Manchester City,18,18,0,1534,4,0,18,15,3,1351,2,0,36,33,3,2885,6,0,0,0,0,1,2,3,0,0,0,0,0,0
736,736,David Silva,1211,2016,Manchester City,17,15,2,1334,3,0,17,16,1,1433,1,0,34,31,3,2767,4,0,0,0,0,2,0,2,0,0,0,0,0,0
737,737,Fernandinho,1202,2016,Manchester City,15,15,0,1350,1,0,17,16,1,1463,1,0,32,31,1,2813,2,0,0,0,0,0,0,0,0,0,0,0,0,0
738,738,Raheem Sterling,1203,2016,Manchester City,15,15,0,1318,5,0,18,14,4,1199,2,0,33,29,4,2517,7,0,3,0,3,2,1,3,0,0,0,0,0,0
739,739,Kun Agüero,1204,2016,Manchester City,15,11,4,1085,5,0,16,14,2,1320,15,0,31,25,6,2405,20,0,1,3,4,3,10,13,1,3,4,0,0,0
740,740,Fabian Delph,1198,2016,Manchester City,3,1,2,117,1,0,4,1,3,103,0,0,7,2,5,220,1,0,0,0,0,0,0,0,0,0,0,0,0,0
741,741,Nolito,1589,2016,Manchester City,8,4,4,364,1,0,11,5,6,418,3,0,19,9,10,782,4,0,1,0,1,1,0,1,0,0,0,0,0,0
742,742,Kelechi Iheanacho,1590,2016,Manchester City,11,3,8,302,2,0,9,2,7,225,2,0,20,5,15,527,4,0,1,0,1,1,0,1,0,0,0,0,0,0
743,743,Joe Hart,1363,2016,Manchester City,0,0,0,0,0,0,0,0,0,0,0,0,0,0,0,0,0,0,0,0,0,0,0,0,0,0,0,0,0,0
744,744,Gaël Clichy,1230,2016,Manchester City,16,15,1,1355,1,0,9,9,0,770,0,0,25,24,1,2125,1,0,0,0,0,1,0,1,0,0,0,0,0,0
745,745,Pablo Maffeo,1591,2016,Manchester City,0,0,0,0,0,0,0,0,0,0,0,0,0,0,0,0,0,0,0,0,0,0,0,0,0,0,0,0,0,0
746,746,Fernando,1592,2016,Manchester City,7,1,6,171,0,0,8,4,4,389,0,0,15,5,10,560,0,0,0,0,0,0,0,0,0,0,0,0,0,0
747,747,Petr Čech,1531,2015,Arsenal FC,18,18,0,1620,0,0,16,16,0,1440,0,0,34,34,0,3060,0,0,0,0,0,0,0,0,0,0,0,0,0,0
748,748,Per Mertesacker,1496,2015,Arsenal FC,12,12,0,1041,0,0,12,12,0,1080,0,0,24,24,0,2121,0,0,0,0,0,0,0,0,0,0,0,0,0,0
749,749,Laurent Koscielny,1497,2015,Arsenal FC,15,15,0,1306,2,0,18,18,0,1541,2,0,33,33,0,2847,4,0,3,1,4,1,1,2,0,0,0,0,0,0
750,750,Nacho Monreal,1498,2015,Arsenal FC,19,18,1,1628,0,0,18,18,0,1620,0,0,37,36,1,3248,0,0,0,0,0,0,0,0,0,0,0,0,0,0
751,751,Héctor Bellerín,1499,2015,Arsenal FC,17,17,0,1530,1,0,19,19,0,1710,0,0,36,36,0,3240,1,0,0,0,0,0,0,0,0,0,0,0,0,0
752,752,Mesut Özil,1500,2015,Arsenal FC,19,19,0,1669,2,0,16,16,0,1380,4,0,35,35,0,3049,6,0,0,0,0,0,3,3,0,0,0,0,0,0
753,753,Aaron Ramsey,1501,2015,Arsenal FC,15,14,1,1275,1,0,16,15,1,1348,4,0,31,29,2,2623,5,0,0,0,0,0,2,2,0,0,0,0,0,0
754,754,Mathieu Flamini,1510,2015,Arsenal FC,7,5,2,498,0,0,9,7,2,590,0,0,16,12,4,1088,0,0,0,0,0,0,0,0,0,0,0,0,0,0
755,755,Olivier Giroud,1504,2015,Arsenal FC,19,15,4,1310,7,0,19,11,8,1115,9,0,38,26,12,2425,16,0,0,0,0,3,7,10,0,1,1,0,0,0
756,756,Theo Walcott,1237,2015,Arsenal FC,15,6,9,658,4,0,13,9,4,717,1,0,28,15,13,1375,5,0,0,0,0,3,1,4,0,0,0,0,0,0
757,757,Joel Campbell,1593,2015,Arsenal FC,11,6,5,452,2,0,8,5,3,435,1,0,19,11,8,887,3,0,0,0,0,2,0,2,0,0,0,0,0,0
758,758,Kieran Gibbs,1508,2015,Arsenal FC,7,1,6,151,1,0,8,2,6,230,0,0,15,3,12,381,1,0,1,0,1,1,0,1,0,0,0,0,0,0
759,759,Calum Chambers,1470,2015,Arsenal FC,6,2,4,237,0,0,6,0,6,76,0,0,12,2,10,313,0,0,0,0,0,0,0,0,0,0,0,0,0,0
760,760,Alex Oxlade-Chamberlain,1184,2015,Arsenal FC,11,6,5,534,0,0,11,3,8,387,1,0,22,9,13,921,1,0,0,0,0,0,0,0,0,0,0,0,0,0
761,761,David Ospina,1495,2015,Arsenal FC,1,1,0,90,0,0,3,3,0,270,0,0,4,4,0,360,0,0,0,0,0,0,0,0,0,0,0,0,0,0
762,762,Gabriel Paulista,1594,2015,Arsenal FC,12,10,2,1007,1,0,9,8,1,799,0,0,21,18,3,1806,1,0,0,0,0,1,0,1,0,0,0,0,0,0
763,763,Jeff Reine-Adélaïde,1595,2015,Arsenal FC,0,0,0,0,0,0,0,0,0,0,0,0,0,0,0,0,0,0,0,0,0,0,0,0,0,0,0,0,0,0
764,764,Alex Iwobi,1462,2015,Arsenal FC,5,4,1,288,1,0,8,4,4,344,1,0,13,8,5,632,2,0,0,0,0,0,0,0,0,0,0,0,0,0
765,765,Joe Hart,1363,2015,Manchester City,18,18,0,1580,0,0,17,17,0,1530,0,0,35,35,0,3110,0,0,0,0,0,0,0,0,0,0,0,0,0,0
766,766,Bacary Sagna,1596,2015,Manchester City,13,13,0,1170,0,0,15,14,1,1278,0,0,28,27,1,2448,0,0,0,0,0,0,0,0,0,0,0,0,0,0
767,767,Aleksandar Kolarov,1366,2015,Manchester City,13,12,1,1051,1,0,16,13,3,1230,2,0,29,25,4,2281,3,0,0,0,0,0,1,1,0,0,0,0,0,0
768,768,Eliaquim Mangala,1209,2015,Manchester City,12,12,0,1036,0,0,11,11,0,975,0,0,23,23,0,2011,0,0,0,0,0,0,0,0,0,0,0,0,0,0
769,769,Nicolás Otamendi,1199,2015,Manchester City,15,15,0,1322,1,0,15,15,0,1350,0,0,30,30,0,2672,1,0,0,0,0,1,0,1,0,0,0,0,0,0
770,770,Kevin De Bruyne,1201,2015,Manchester City,12,10,2,891,5,0,13,12,1,1112,2,0,25,22,3,2003,7,0,0,0,0,2,1,3,0,0,0,0,0,0
771,771,Fabian Delph,1198,2015,Manchester City,9,4,5,436,2,0,8,4,4,316,0,0,17,8,9,752,2,0,0,0,0,1,0,1,0,0,0,0,0,0
772,772,David Silva,1211,2015,Manchester City,13,11,2,903,1,0,11,11,0,897,1,0,24,22,2,1800,2,0,0,0,0,0,1,1,0,0,0,0,0,0
773,773,Fernandinho,1202,2015,Manchester City,15,14,1,1304,2,0,18,17,1,1427,0,0,33,31,2,2731,2,0,0,0,0,0,0,0,0,0,0,0,0,0
774,774,Yaya Touré,1359,2015,Manchester City,18,15,3,1260,3,0,14,13,1,1074,3,0,32,28,4,2334,6,0,3,0,3,2,1,3,1,0,1,0,0,0
775,775,Kun Agüero,1204,2015,Manchester City,15,15,0,1239,15,0,15,14,1,1136,9,0,30,29,1,2375,24,0,0,7,7,5,6,11,2,2,4,0,0,0
776,776,Jesús Navas,1361,2015,Manchester City,15,13,2,1095,0,0,19,11,8,1186,0,0,34,24,10,2281,0,0,0,0,0,0,0,0,0,0,0,0,0,0
777,777,Raheem Sterling,1203,2015,Manchester City,16,13,3,1038,6,0,15,10,5,889,0,0,31,23,8,1927,6,0,0,0,0,3,0,3,0,0,0,0,0,0
778,778,Wilfried Bony,1597,2015,Manchester City,13,6,7,630,4,0,13,7,6,592,0,0,26,13,13,1222,4,0,0,0,0,1,0,1,0,0,0,0,0,0
779,779,Willy Caballero,1588,2015,Manchester City,2,1,1,130,0,0,2,2,0,180,0,0,4,3,1,310,0,0,0,0,0,0,0,0,0,0,0,0,0,0
780,780,Gaël Clichy,1230,2015,Manchester City,8,6,2,564,0,0,6,6,0,524,0,0,14,12,2,1088,0,0,0,0,0,0,0,0,0,0,0,0,0,0
781,781,Martín Demichelis,1356,2015,Manchester City,11,6,5,596,0,0,9,4,5,418,0,0,20,10,10,1014,0,0,0,0,0,0,0,0,0,0,0,0,0,0
782,782,Kelechi Iheanacho,1590,2015,Manchester City,13,4,9,418,4,0,13,3,10,333,4,0,26,7,19,751,8,0,3,3,6,2,2,4,0,0,0,0,0,0
783,783,Paul Robinson,1262,2004,West Bromwich Albion,15,13,2,1167,0,0,15,15,0,1324,1,0,30,28,2,2491,1,0,0,1,1,0,1,1,0,0,0,0,0,0
784,784,Thomas Gaardsøe,1598,2004,West Bromwich Albion,14,13,1,1236,0,0,14,12,2,975,0,0,28,25,3,2211,0,0,0,0,0,0,0,0,0,0,0,0,0,0
785,785,Martin Albrechtsen,1599,2004,West Bromwich Albion,12,11,1,1017,0,0,12,9,3,791,0,0,24,20,4,1808,0,0,0,0,0,0,0,0,0,0,0,0,0,0
786,786,Ronnie Wallwork,1600,2004,West Bromwich Albion,9,9,0,810,1,0,11,10,1,915,0,0,20,19,1,1725,1,0,0,0,0,0,0,0,0,0,0,0,0,0
787,787,Kevin Campbell,1601,2004,West Bromwich Albion,8,8,0,683,3,0,8,8,0,627,0,0,16,16,0,1310,3,0,0,0,0,2,0,2,0,0,0,0,0,0
788,788,Lauren,1602,2004,Arsenal FC,18,17,1,1589,0,0,14,14,0,1260,1,0,32,31,1,2849,1,0,0,0,0,0,1,1,0,1,1,0,0,0
789,789,Robert Pirés,1603,2004,Arsenal FC,17,15,2,1323,10,0,16,12,4,1044,4,0,33,27,6,2367,14,0,0,3,3,6,1,7,1,0,1,0,0,0
790,790,Reyes,1604,2004,Arsenal FC,16,13,3,1079,6,0,13,10,3,808,3,0,29,23,6,1887,9,0,3,0,3,2,1,3,0,0,0,0,0,0
791,791,Matt Duke,1605,2009,Hull City,6,6,0,540,0,0,5,5,0,450,0,0,11,11,0,990,0,0,0,0,0,0,0,0,0,0,0,0,0,0
792,792,Andy Dawson,1606,2009,Hull City,18,18,0,1581,1,0,17,17,0,1487,0,0,35,35,0,3068,1,0,0,0,0,0,0,0,0,0,0,0,0,0
793,793,Paul McShane,1607,2009,Hull City,12,11,1,1001,0,0,15,15,0,1296,0,0,27,26,1,2297,0,0,0,0,0,0,0,0,0,0,0,0,0,0
794,794,Steven Mouyokolo,1608,2009,Hull City,11,10,1,857,1,0,10,9,1,817,0,0,21,19,2,1674,1,0,0,0,0,1,0,1,0,0,0,0,0,0
795,795,Ibrahima Sonko,1609,2009,Hull City,5,5,0,450,0,0,4,4,0,360,0,0,9,9,0,810,0,0,0,0,0,0,0,0,0,0,0,0,0,0
796,796,Kevin Kilbane,1103,2009,Hull City,10,6,4,541,1,0,11,9,2,809,0,0,21,15,6,1350,1,0,0,0,0,1,0,1,0,0,0,0,0,0
797,797,George Boateng,1333,2009,Hull City,15,13,2,1128,1,0,14,13,1,1198,0,0,29,26,3,2326,1,0,0,0,0,0,0,0,0,0,0,0,0,0
798,798,Jimmy Bullard,1610,2009,Hull City,7,7,0,581,3,0,7,6,1,473,1,0,14,13,1,1054,4,0,0,1,1,3,1,4,3,1,4,0,0,0
799,799,Tom Cairney,1611,2009,Hull City,6,5,1,474,0,0,5,5,0,424,1,0,11,10,1,898,1,0,0,0,0,0,1,1,0,0,0,0,0,0
800,800,Craig Fagan,1576,2009,Hull City,13,10,3,910,2,0,12,10,2,956,0,0,25,20,5,1866,2,0,0,0,0,1,0,1,1,0,1,0,0,0
801,801,Jan Vennegoor of Hesselink,1612,2009,Hull City,16,9,7,799,3,0,15,8,7,690,0,0,31,17,14,1489,3,0,3,0,3,3,0,3,0,0,0,0,0,0
802,802,Géovanni,1613,2009,Hull City,13,7,6,754,1,0,13,9,4,803,2,0,26,16,10,1557,3,0,0,0,0,0,2,2,0,0,0,0,0,0
803,803,Seyi Olofinjana,1614,2009,Hull City,11,6,5,581,1,0,8,5,3,551,0,0,19,11,8,1132,1,0,0,0,0,1,0,1,0,0,0,0,0,0
804,804,Jozy Altidore,1615,2009,Hull City,15,12,3,1031,1,0,13,4,9,479,0,0,28,16,12,1510,1,0,0,0,0,1,0,1,0,0,0,0,0,0
805,805,Brad Friedel,1343,2009,Aston Villa,19,19,0,1710,0,0,17,17,0,1530,0,0,36,36,0,3240,0,0,0,0,0,0,0,0,0,0,0,0,0,0
806,806,Stephen Warnock,1616,2009,Aston Villa,14,14,0,1198,0,0,16,16,0,1396,0,0,30,30,0,2594,0,0,0,0,0,0,0,0,0,0,0,0,0,0
807,807,Richard Dunne,1617,2009,Aston Villa,17,17,0,1512,3,0,16,16,0,1440,0,0,33,33,0,2952,3,0,0,0,0,3,0,3,0,0,0,0,0,0
808,808,Carlos Cuéllar,1401,2009,Aston Villa,19,19,0,1710,2,0,15,15,0,1350,0,0,34,34,0,3060,2,0,0,0,0,1,0,1,0,0,0,0,0,0
809,809,James Collins,1618,2009,Aston Villa,12,12,0,1080,1,0,13,12,1,1108,0,0,25,24,1,2188,1,0,3,0,3,1,0,1,0,0,0,0,0,0
810,810,Stewart Downing,1335,2009,Aston Villa,12,12,0,1048,2,0,11,9,2,848,0,0,23,21,2,1896,2,0,0,0,0,1,0,1,0,0,0,0,0,0
811,811,Ashley Young,1619,2009,Aston Villa,18,18,0,1603,2,0,17,17,0,1520,3,0,35,35,0,3123,5,0,0,3,3,2,2,4,0,1,1,0,0,0
812,812,James Milner,1189,2009,Aston Villa,19,19,0,1689,4,0,15,15,0,1306,3,0,34,34,0,2995,7,0,3,3,6,2,1,3,2,1,3,0,0,0
813,813,Stilian Petrov,1620,2009,Aston Villa,18,18,0,1595,0,0,17,17,0,1497,0,0,35,35,0,3092,0,0,0,0,0,0,0,0,0,0,0,0,0,0
814,814,John Carew,1621,2009,Aston Villa,17,11,6,1068,6,0,15,11,4,972,4,0,32,22,10,2040,10,0,5,1,6,4,4,8,1,0,1,0,0,0
815,815,Gabriel Agbonlahor,1442,2009,Aston Villa,17,17,0,1486,6,0,17,16,1,1416,7,0,34,33,1,2902,13,0,0,6,6,2,6,8,0,0,0,0,0,0
816,816,Steven Sidwell,1622,2009,Aston Villa,13,5,8,572,0,0,11,7,4,641,0,0,24,12,12,1213,0,0,0,0,0,0,0,0,0,0,0,0,0,0
817,817,Emile Heskey,1519,2009,Aston Villa,14,8,6,608,1,0,15,6,9,588,2,0,29,14,15,1196,3,0,0,1,1,0,2,2,0,0,0,0,0,0
818,818,David James,1385,2001,West Ham United,12,12,0,1080,0,0,12,12,0,1080,0,0,24,24,0,2160,0,0,0,0,0,0,0,0,0,0,0,0,0,0
819,819,Nigel Winterburn,1623,2001,West Ham United,16,16,0,1424,0,0,13,11,2,1004,0,0,29,27,2,2428,0,0,0,0,0,0,0,0,0,0,0,0,0,0
820,820,Sebastien Schemmel,1624,2001,West Ham United,15,15,0,1335,1,0,18,18,0,1547,0,0,33,33,0,2882,1,0,0,0,0,1,0,1,0,0,0,0,0,0
821,821,Tomáš Řepka,1625,2001,West Ham United,15,15,0,1350,0,0,14,14,0,1260,0,0,29,29,0,2610,0,0,0,0,0,0,0,0,0,0,0,0,0,0
822,822,Christian Dailly,1626,2001,West Ham United,17,17,0,1530,0,0,19,19,0,1665,0,0,36,36,0,3195,0,0,0,0,0,0,0,0,0,0,0,0,0,0
823,823,Ian Pearce,1082,2001,West Ham United,4,4,0,360,1,0,5,4,1,427,1,0,9,8,1,787,2,0,3,1,4,1,1,2,0,0,0,0,0,0
824,824,Michael Carrick,1627,2001,West Ham United,12,12,0,1079,1,0,16,16,0,1395,1,0,28,28,0,2474,2,0,0,0,0,1,0,1,0,0,0,0,0,0
825,825,Trevor Sinclair,1628,2001,West Ham United,15,15,0,1347,5,0,17,17,0,1485,0,0,32,32,0,2832,5,0,3,0,3,4,0,4,0,0,0,0,0,0
826,826,Steve Lomas,1629,2001,West Ham United,8,8,0,679,4,0,7,6,1,568,0,0,15,14,1,1247,4,0,0,0,0,3,0,3,0,0,0,0,0,0
827,827,Joe Cole,1630,2001,West Ham United,13,13,0,1169,0,0,15,14,1,1260,0,0,28,27,1,2429,0,0,0,0,0,0,0,0,0,0,0,0,0,0
828,828,Jermain Defoe,1127,2001,West Ham United,16,4,12,605,5,0,17,8,9,841,5,0,33,12,21,1446,10,0,1,6,7,1,4,5,0,0,0,0,0,0
829,829,Vladimír Labant,1631,2001,West Ham United,5,2,3,267,0,0,7,5,2,440,0,0,12,7,5,707,0,0,0,0,0,0,0,0,0,0,0,0,0,0
830,830,Richard García,1632,2001,West Ham United,4,0,4,24,0,0,4,2,2,161,0,0,8,2,6,185,0,0,0,0,0,0,0,0,0,0,0,0,0,0
831,831,Joachim Björklund,1633,2001,Sunderland AFC,5,4,1,405,0,0,7,7,0,583,0,0,12,11,1,988,0,0,0,0,0,0,0,0,0,0,0,0,0,0
832,832,Darren Williams,1094,2001,Sunderland AFC,14,11,3,1038,0,0,12,10,2,924,0,0,26,21,5,1962,0,0,0,0,0,0,0,0,0,0,0,0,0,0
833,833,Claudio Reyna,1634,2001,Sunderland AFC,8,8,0,648,3,0,9,9,0,773,0,0,17,17,0,1421,3,0,6,0,6,3,0,3,0,0,0,0,0,0
834,834,Paul Thirlwell,1635,2001,Sunderland AFC,7,4,3,461,0,0,7,7,0,544,0,0,14,11,3,1005,0,0,0,0,0,0,0,0,0,0,0,0,0,0
835,835,Kevin Kyle,1636,2001,Sunderland AFC,2,0,2,21,0,0,4,0,4,104,0,0,6,0,6,125,0,0,0,0,0,0,0,0,0,0,0,0,0,0
836,836,Thomas Butler,1637,2001,Sunderland AFC,3,1,2,182,0,0,4,1,3,204,0,0,7,2,5,386,0,0,0,0,0,0,0,0,0,0,0,0,0,0
837,837,De Gea,1638,2017,Manchester United,18,18,0,1620,0,0,20,20,0,1800,0,0,38,38,0,3420,0,0,0,0,0,0,0,0,0,0,0,0,0,0
838,838,Victor Lindelöf,1639,2017,Manchester United,8,7,1,674,0,0,10,7,3,699,0,0,18,14,4,1373,0,0,0,0,0,0,0,0,0,0,0,0,0,0
839,839,Chris Smalling,1640,2017,Manchester United,13,13,0,1170,1,0,17,16,1,1455,3,0,30,29,1,2625,4,0,0,3,3,1,2,3,0,0,0,0,0,0
840,840,Ashley Young,1619,2017,Manchester United,15,14,1,1222,0,0,16,14,2,1227,2,0,31,28,3,2449,2,0,0,0,0,0,1,1,0,0,0,0,0,0
841,841,Antonio Valencia,1641,2017,Manchester United,16,16,0,1440,2,0,16,16,0,1393,1,0,32,32,0,2833,3,0,0,0,0,2,1,3,0,0,0,0,0,0
842,842,Paul Pogba,1642,2017,Manchester United,13,11,2,968,3,0,15,15,0,1289,3,0,28,26,2,2257,6,0,0,0,0,1,1,2,0,0,0,0,0,0
843,843,Mata,1643,2017,Manchester United,16,15,1,1233,1,0,12,8,4,700,2,0,28,23,5,1933,3,0,0,0,0,1,2,3,0,0,0,0,0,0
844,844,Ander Herrera,1644,2017,Manchester United,10,4,6,361,0,0,17,10,7,991,0,0,27,14,13,1352,0,0,0,0,0,0,0,0,0,0,0,0,0,0
845,845,Nemanja Matić,1537,2017,Manchester United,18,18,0,1620,0,0,18,17,1,1499,1,0,36,35,1,3119,1,0,0,3,3,0,1,1,0,0,0,0,0,0
846,846,Alexis Sánchez,1505,2017,Manchester United,7,7,0,606,2,0,6,6,0,532,0,0,13,13,0,1138,2,0,0,0,0,0,0,0,0,0,0,0,0,0
847,847,Romelu Lukaku,1645,2017,Manchester United,18,18,0,1491,10,0,16,15,1,1378,6,0,34,33,1,2869,16,0,3,3,6,5,4,9,0,0,0,0,0,0
848,848,Jesse Lingard,1646,2017,Manchester United,16,7,9,731,3,0,18,14,4,1164,5,0,34,21,13,1895,8,0,4,0,4,2,0,2,0,0,0,0,0,0
849,849,Anthony Martial,1647,2017,Manchester United,15,7,8,670,5,0,15,11,4,913,4,0,30,18,12,1583,9,0,3,3,6,2,2,4,1,0,1,0,0,0
850,850,Marcus Rashford,1648,2017,Manchester United,18,10,8,1015,5,0,18,7,11,807,2,0,36,17,19,1822,7,0,3,0,3,4,1,5,0,0,0,0,0,0
851,851,Joel Pereira,1649,2017,Manchester United,0,0,0,0,0,0,0,0,0,0,0,0,0,0,0,0,0,0,0,0,0,0,0,0,0,0,0,0,0,0
852,852,Phil Jones,1650,2017,Manchester United,9,9,0,810,0,0,15,15,0,1255,0,0,24,24,0,2065,0,0,0,0,0,0,0,0,0,0,0,0,0,0
853,853,Marcos Rojo,1651,2017,Manchester United,4,4,0,272,0,0,5,4,1,370,0,0,9,8,1,642,0,0,0,0,0,0,0,0,0,0,0,0,0,0
854,854,Scott McTominay,1652,2017,Manchester United,7,5,2,458,0,0,7,3,4,262,0,0,14,8,6,720,0,0,0,0,0,0,0,0,0,0,0,0,0,0
855,855,Ben Foster,1653,2017,West Bromwich Albion,19,19,0,1710,0,0,18,18,0,1620,0,0,37,37,0,3330,0,0,0,0,0,0,0,0,0,0,0,0,0,0
856,856,Allan Nyom,1654,2017,West Bromwich Albion,15,12,3,1096,0,0,14,13,1,1212,0,0,29,25,4,2308,0,0,0,0,0,0,0,0,0,0,0,0,0,0
857,857,Kieran Gibbs,1508,2017,West Bromwich Albion,16,16,0,1367,0,0,17,16,1,1464,0,0,33,32,1,2831,0,0,0,0,0,0,0,0,0,0,0,0,0,0
858,858,Craig Dawson,1655,2017,West Bromwich Albion,14,14,0,1251,2,0,14,14,0,1260,0,0,28,28,0,2511,2,0,0,0,0,0,0,0,0,0,0,0,0,0
859,859,Ahmed Hegazy,1656,2017,West Bromwich Albion,19,19,0,1710,2,0,19,19,0,1677,0,0,38,38,0,3387,2,0,3,0,3,2,0,2,0,0,0,0,0,0
860,860,Jake Livermore,1657,2017,West Bromwich Albion,17,14,3,1299,2,0,17,16,1,1376,0,0,34,30,4,2675,2,0,3,0,3,1,0,1,0,0,0,0,0,0
861,861,Chris Brunt,1658,2017,West Bromwich Albion,15,13,2,1158,0,0,11,9,2,766,0,0,26,22,4,1924,0,0,0,0,0,0,0,0,0,0,0,0,0,0
862,862,Salomón Rondón,1659,2017,West Bromwich Albion,17,16,1,1340,5,0,19,16,3,1432,2,0,36,32,4,2772,7,0,1,0,1,3,1,4,0,0,0,0,0,0
863,863,Matt Phillips,1660,2017,West Bromwich Albion,17,15,2,1281,1,0,13,8,5,815,1,0,30,23,7,2096,2,0,0,3,3,0,1,1,0,0,0,0,0,0
864,864,James McClean,1407,2017,West Bromwich Albion,16,6,10,623,0,0,14,8,6,773,1,0,30,14,16,1396,1,0,0,0,0,0,1,1,0,0,0,0,0,0
865,865,Jay Rodriguez,1247,2017,West Bromwich Albion,18,15,3,1354,4,0,19,16,3,1470,3,0,37,31,6,2824,7,0,1,3,4,4,3,7,1,0,1,0,0,0
866,866,Claudio Yacob,1661,2017,West Bromwich Albion,8,4,4,435,0,0,8,5,3,465,0,0,16,9,7,900,0,0,0,0,0,0,0,0,0,0,0,0,0,0
867,867,Grzegorz Krychowiak,1662,2017,West Bromwich Albion,13,8,5,673,0,0,14,12,2,970,0,0,27,20,7,1643,0,0,0,0,0,0,0,0,0,0,0,0,0,0
868,868,Daniel Sturridge,1428,2017,West Bromwich Albion,2,1,1,78,0,0,4,1,3,38,0,0,6,2,4,116,0,0,0,0,0,0,0,0,0,0,0,0,0,0
869,869,Boaz Myhill,1663,2017,West Bromwich Albion,0,0,0,0,0,0,1,1,0,90,0,0,1,1,0,90,0,0,0,0,0,0,0,0,0,0,0,0,0,0
870,870,Ali Gabr,1664,2017,West Bromwich Albion,0,0,0,0,0,0,0,0,0,0,0,0,0,0,0,0,0,0,0,0,0,0,0,0,0,0,0,0,0,0
871,871,Sam Field,1665,2017,West Bromwich Albion,4,3,1,275,1,0,6,4,2,265,0,0,10,7,3,540,1,0,0,0,0,0,0,0,0,0,0,0,0,0
872,872,Oliver Burke,1666,2017,West Bromwich Albion,9,2,7,237,0,0,6,0,6,120,0,0,15,2,13,357,0,0,0,0,0,0,0,0,0,0,0,0,0,0
873,873,Denis Irwin,1454,2000,Manchester United,9,8,1,745,0,0,12,12,0,1019,0,0,21,20,1,1764,0,0,0,0,0,0,0,0,0,0,0,0,0,0
874,874,Dwight Yorke,1223,2000,Manchester United,11,8,3,749,7,0,11,7,4,724,1,0,22,15,7,1473,8,0,0,0,0,5,0,5,0,0,0,0,0,0
875,875,Saša Ilić,1667,2000,Charlton Athletic,6,6,0,540,0,0,7,7,0,630,0,0,13,13,0,1170,0,0,0,0,0,0,0,0,0,0,0,0,0,0
876,876,Radostin Kishishev,1668,2000,Charlton Athletic,12,12,0,1028,0,0,15,13,2,1075,0,0,27,25,2,2103,0,0,0,0,0,0,0,0,0,0,0,0,0,0
877,877,Chris Powell,1669,2000,Charlton Athletic,18,16,2,1444,0,0,15,15,0,1324,0,0,33,31,2,2768,0,0,0,0,0,0,0,0,0,0,0,0,0,0
878,878,Richard Rufus,1670,2000,Charlton Athletic,17,17,0,1530,1,0,15,15,0,1350,1,0,32,32,0,2880,2,0,3,0,3,1,1,2,0,0,0,0,0,0
879,879,Mark Fish,1671,2000,Charlton Athletic,13,13,0,1086,0,0,11,11,0,945,1,0,24,24,0,2031,1,0,0,0,0,0,1,1,0,0,0,0,0,0
880,880,Andy Todd,1672,2000,Charlton Athletic,13,10,3,941,1,0,10,9,1,808,0,0,23,19,4,1749,1,0,0,0,0,1,0,1,0,0,0,0,0,0
881,881,Graham Stuart,1673,2000,Charlton Athletic,17,16,1,1490,2,0,18,17,1,1449,3,0,35,33,2,2939,5,0,0,3,3,0,2,2,1,1,2,0,0,0
882,882,Scott Parker,1282,2000,Charlton Athletic,9,8,1,614,1,0,11,7,4,652,0,0,20,15,5,1266,1,0,3,0,3,1,0,1,0,0,0,0,0,0
883,883,Claus Jensen,1674,2000,Charlton Athletic,19,19,0,1616,1,0,19,18,1,1557,4,0,38,37,1,3173,5,0,0,0,0,0,0,0,1,0,1,0,0,0
884,884,Shaun Bartlett,1675,2000,Charlton Athletic,10,10,0,874,6,0,8,6,2,558,1,0,18,16,2,1432,7,0,0,3,3,3,1,4,0,0,0,0,0,0
885,885,Jonatan Johansson,1676,2000,Charlton Athletic,15,12,3,1117,6,0,16,15,1,1330,5,0,31,27,4,2447,11,0,8,1,9,6,4,10,0,0,0,0,0,0
886,886,Paul Konchesky,1560,2000,Charlton Athletic,12,5,7,459,0,0,11,6,5,624,0,0,23,11,12,1083,0,0,0,0,0,0,0,0,0,0,0,0,0,0
887,887,Mark Kinsella,1677,2000,Charlton Athletic,16,13,3,1221,2,0,16,14,2,1269,0,0,32,27,5,2490,2,0,0,0,0,1,0,1,0,0,0,0,0,0
888,888,John Robinson,1678,2000,Charlton Athletic,14,10,4,889,2,0,15,11,4,919,0,0,29,21,8,1808,2,0,1,0,1,1,0,1,0,0,0,0,0,0
889,889,Joe Hart,1363,2010,Manchester City,19,19,0,1710,0,0,19,19,0,1710,0,0,38,38,0,3420,0,0,0,0,0,0,0,0,0,0,0,0,0,0
890,890,Vincent Kompany,1414,2010,Manchester City,18,18,0,1620,0,0,19,19,0,1710,0,0,37,37,0,3330,0,0,0,0,0,0,0,0,0,0,0,0,0,0
891,891,Aleksandar Kolarov,1366,2010,Manchester City,12,9,3,820,0,0,12,11,1,910,1,0,24,20,4,1730,1,0,0,0,0,0,1,1,0,0,0,0,0,0
892,892,Joleon Lescott,1365,2010,Manchester City,13,11,2,1087,2,0,9,9,0,795,1,0,22,20,2,1882,3,0,0,0,0,0,1,1,0,0,0,0,0,0
893,893,Dedryck Boyata,1679,2010,Manchester City,4,3,1,251,0,0,3,2,1,181,0,0,7,5,2,432,0,0,0,0,0,0,0,0,0,0,0,0,0,0
894,894,Adam Johnson,1405,2010,Manchester City,14,10,4,911,3,0,17,5,12,620,1,0,31,15,16,1531,4,0,6,0,6,3,0,3,0,0,0,0,0,0
895,895,David Silva,1211,2010,Manchester City,17,15,2,1225,2,0,18,15,3,1339,2,0,35,30,5,2564,4,0,3,0,3,1,1,2,0,0,0,0,0,0
896,896,Nigel de Jong,1680,2010,Manchester City,15,14,1,1210,1,0,17,16,1,1403,0,0,32,30,2,2613,1,0,0,0,0,1,0,1,0,0,0,0,0,0
897,897,Yaya Touré,1359,2010,Manchester City,19,19,0,1568,2,0,16,16,0,1407,4,0,35,35,0,2975,6,0,0,0,0,0,2,2,0,0,0,0,0,0
898,898,Carlos Tévez,1417,2010,Manchester City,17,16,1,1372,13,0,14,14,0,1159,8,0,31,30,1,2531,21,0,6,0,6,6,5,11,5,0,5,0,0,0
899,899,Mario Balotelli,1681,2010,Manchester City,8,7,1,615,4,0,9,5,4,510,2,0,17,12,5,1125,6,0,0,0,0,2,1,3,2,0,2,0,0,0
900,900,Ryan McGivern,1682,2010,Manchester City,1,0,1,20,0,0,0,0,0,0,0,0,1,0,1,20,0,0,0,0,0,0,0,0,0,0,0,0,0,0
901,901,Shaun Wright-Phillips,1683,2010,Manchester City,4,1,3,96,0,0,3,1,2,108,0,0,7,2,5,204,0,0,0,0,0,0,0,0,0,0,0,0,0,0
902,902,Patrick Vieira,1524,2010,Manchester City,9,3,6,336,2,0,6,1,5,150,0,0,15,4,11,486,2,0,1,0,1,1,0,1,0,0,0,0,0,0
903,903,Stuart Taylor,1684,2010,Manchester City,0,0,0,0,0,0,0,0,0,0,0,0,0,0,0,0,0,0,0,0,0,0,0,0,0,0,0,0,0,0
904,904,James Milner,1189,2010,Manchester City,17,11,6,1029,0,0,15,12,3,1018,0,0,32,23,9,2047,0,0,0,0,0,0,0,0,0,0,0,0,0,0
905,905,Gareth Barry,1418,2010,Manchester City,15,13,2,1149,1,0,18,18,0,1558,1,0,33,31,2,2707,2,0,0,0,0,1,1,2,0,0,0,0,0,0
906,906,Edin Džeko,1362,2010,Manchester City,7,3,4,321,0,0,8,5,3,528,2,0,15,8,7,849,2,0,0,3,3,0,1,1,0,0,0,0,0,0
907,907,Simon Mignolet,1191,2010,Sunderland AFC,11,11,0,990,0,0,12,12,0,1080,0,0,23,23,0,2070,0,0,0,0,0,0,0,0,0,0,0,0,0,0
908,908,Phil Bardsley,1409,2010,Sunderland AFC,17,16,1,1404,2,0,17,16,1,1418,1,0,34,32,2,2822,3,0,0,3,3,2,1,3,0,0,0,0,0,0
909,909,Michael Turner,1371,2010,Sunderland AFC,8,8,0,676,0,0,7,7,0,630,0,0,15,15,0,1306,0,0,0,0,0,0,0,0,0,0,0,0,0,0
910,910,John Mensah,1685,2010,Sunderland AFC,9,8,1,557,0,0,9,7,2,648,0,0,18,15,3,1205,0,0,0,0,0,0,0,0,0,0,0,0,0,0
911,911,Anton Ferdinand,1686,2010,Sunderland AFC,14,10,4,1105,0,0,13,13,0,996,0,0,27,23,4,2101,0,0,0,0,0,0,0,0,0,0,0,0,0,0
912,912,Lee Cattermole,1687,2010,Sunderland AFC,13,12,1,1151,0,0,10,10,0,885,0,0,23,22,1,2036,0,0,0,0,0,0,0,0,0,0,0,0,0,0
913,913,Jordan Henderson,1426,2010,Sunderland AFC,18,18,0,1583,3,0,19,19,0,1637,0,0,37,37,0,3220,3,0,3,0,3,2,0,2,0,0,0,0,0,0
914,914,Sulley Ali Muntari,1688,2010,Sunderland AFC,4,3,1,201,0,0,5,4,1,336,0,0,9,7,2,537,0,0,0,0,0,0,0,0,0,0,0,0,0,0
915,915,Stéphane Sessègnon,1406,2010,Sunderland AFC,7,6,1,552,2,0,7,7,0,630,1,0,14,13,1,1182,3,0,0,0,0,1,0,1,1,0,1,0,0,0
916,916,Danny Welbeck,1506,2010,Sunderland AFC,13,11,2,902,4,0,13,10,3,864,2,0,26,21,5,1766,6,0,3,0,3,4,1,5,0,0,0,0,0,0
917,917,Asamoah Gyan,1689,2010,Sunderland AFC,14,10,4,901,6,0,17,10,7,1098,4,0,31,20,11,1999,10,0,1,1,2,4,3,7,0,0,0,0,0,0
918,918,Ahmed Elmohamady,1690,2010,Sunderland AFC,19,14,5,1359,0,0,17,12,5,1093,0,0,36,26,10,2452,0,0,0,0,0,0,0,0,0,0,0,0,0,0
919,919,Boudewijn Zenden,1336,2010,Sunderland AFC,13,3,10,386,0,0,14,7,7,728,2,0,27,10,17,1114,2,0,0,0,0,0,2,2,0,0,0,0,0,0
920,920,Jack Colback,1404,2010,Sunderland AFC,5,3,2,280,0,0,6,3,3,303,0,0,11,6,5,583,0,0,0,0,0,0,0,0,0,0,0,0,0,0
921,921,Craig Gordon,1691,2010,Sunderland AFC,8,8,0,720,0,0,7,7,0,630,0,0,15,15,0,1350,0,0,0,0,0,0,0,0,0,0,0,0,0,0
922,922,Blair Adams,1692,2010,Sunderland AFC,0,0,0,0,0,0,0,0,0,0,0,0,0,0,0,0,0,0,0,0,0,0,0,0,0,0,0,0,0,0
923,923,Steed Malbranque,1086,2010,Sunderland AFC,18,13,5,1228,0,0,17,11,6,945,0,0,35,24,11,2173,0,0,0,0,0,0,0,0,0,0,0,0,0,0
924,924,Craig Lynch,1693,2010,Sunderland AFC,2,0,2,28,0,0,0,0,0,0,0,0,2,0,2,28,0,0,0,0,0,0,0,0,0,0,0,0,0,0
925,925,Jack Wilshere,1694,2014,Arsenal FC,8,7,1,514,2,0,6,2,4,219,0,0,14,9,5,733,2,0,0,0,0,1,0,1,0,0,0,0,0,0
926,926,Gabriel Paulista,1594,2014,Arsenal FC,3,2,1,221,0,0,3,2,1,127,0,0,6,4,2,348,0,0,0,0,0,0,0,0,0,0,0,0,0,0
927,927,Łukasz Fabiański,1227,2014,Swansea City,18,18,0,1620,0,0,19,19,0,1710,0,0,37,37,0,3330,0,0,0,0,0,0,0,0,0,0,0,0,0,0
928,928,Neil Taylor,1695,2014,Swansea City,19,19,0,1687,0,0,15,15,0,1314,0,0,34,34,0,3001,0,0,0,0,0,0,0,0,0,0,0,0,0,0
929,929,Ashley Williams,1061,2014,Swansea City,19,19,0,1710,0,0,18,18,0,1620,0,0,37,37,0,3330,0,0,0,0,0,0,0,0,0,0,0,0,0,0
930,930,Àngel Rangel,1696,2014,Swansea City,13,11,2,1027,0,0,14,11,3,1016,0,0,27,22,5,2043,0,0,0,0,0,0,0,0,0,0,0,0,0,0
931,931,Federico Fernández,1697,2014,Swansea City,12,12,0,1080,0,0,16,15,1,1394,0,0,28,27,1,2474,0,0,0,0,0,0,0,0,0,0,0,0,0,0
932,932,Sung-yueng Ki,1698,2014,Swansea City,16,15,1,1347,5,0,17,15,2,1343,3,0,33,30,3,2690,8,0,1,3,4,4,3,7,0,0,0,0,0,0
933,933,Jonjo Shelvey,1699,2014,Swansea City,16,14,2,1241,1,0,15,14,1,1233,2,0,31,28,3,2474,3,0,1,3,4,1,1,2,1,0,1,0,0,0
934,934,Jefferson Montero,1700,2014,Swansea City,15,8,7,793,1,0,15,7,8,777,0,0,30,15,15,1570,1,0,0,0,0,1,0,1,0,0,0,0,0,0
935,935,Gylfi Sigurðsson,1055,2014,Swansea City,18,18,0,1528,3,0,14,14,0,1168,4,0,32,32,0,2696,7,0,3,3,6,2,2,4,0,0,0,0,0,0
936,936,Jack Cork,1701,2014,Swansea City,7,7,0,605,0,0,8,8,0,720,1,0,15,15,0,1325,1,0,0,0,0,0,0,0,0,0,0,0,0,0
937,937,Nathan Dyer,1702,2014,Swansea City,15,10,5,837,3,0,17,13,4,1031,0,0,32,23,9,1868,3,0,3,0,3,2,0,2,0,0,0,0,0,0
938,938,Jazz Richards,1703,2014,Swansea City,4,3,1,290,0,0,6,4,2,346,0,0,10,7,3,636,0,0,0,0,0,0,0,0,0,0,0,0,0,0
939,939,Bafétimbi Gomis,1704,2014,Swansea City,14,8,6,727,5,0,17,10,7,914,2,0,31,18,13,1641,7,0,6,6,12,3,2,5,0,0,0,0,0,0
940,940,Modou Barrow,1705,2014,Swansea City,7,1,6,155,0,0,4,0,4,124,0,0,11,1,10,279,0,0,0,0,0,0,0,0,0,0,0,0,0,0
941,941,Gerhard Tremmel,1706,2014,Swansea City,1,1,0,90,0,0,1,0,1,19,0,0,2,1,1,109,0,0,0,0,0,0,0,0,0,0,0,0,0,0
942,942,Leon Britton,1707,2014,Swansea City,5,3,2,239,0,0,4,4,0,298,0,0,9,7,2,537,0,0,0,0,0,0,0,0,0,0,0,0,0,0
943,943,Matt Grimes,1708,2014,Swansea City,1,0,1,1,0,0,2,0,2,41,0,0,3,0,3,42,0,0,0,0,0,0,0,0,0,0,0,0,0,0
944,944,Marvin Emnes,1709,2014,Swansea City,10,1,9,305,0,0,7,2,5,198,0,0,17,3,14,503,0,0,0,0,0,0,0,0,0,0,0,0,0,0
945,945,Jussi Jääskeläinen,1710,2006,Bolton Wanderers,19,19,0,1710,0,0,19,19,0,1710,0,0,38,38,0,3420,0,0,0,0,0,0,0,0,0,0,0,0,0,0
946,946,Nicky Hunt,1711,2006,Bolton Wanderers,17,16,1,1252,0,0,16,16,0,1381,0,0,33,32,1,2633,0,0,0,0,0,0,0,0,0,0,0,0,0,0
947,947,Abdoulaye Méïté,1712,2006,Bolton Wanderers,18,18,0,1620,0,0,17,17,0,1507,0,0,35,35,0,3127,0,0,0,0,0,0,0,0,0,0,0,0,0,0
948,948,Iván Campo,1713,2006,Bolton Wanderers,16,15,1,1397,3,0,18,16,2,1449,1,0,34,31,3,2846,4,0,0,3,3,1,1,2,0,0,0,0,0,0
949,949,Abdoulaye Faye,1714,2006,Bolton Wanderers,15,15,0,1327,2,0,17,14,3,1194,0,0,32,29,3,2521,2,0,0,0,0,2,0,2,0,0,0,0,0,0
950,950,Tal Ben Haim,1715,2006,Bolton Wanderers,17,16,1,1463,0,0,14,13,1,1133,0,0,31,29,2,2596,0,0,0,0,0,0,0,0,0,0,0,0,0,0
951,951,Gary Speed,1716,2006,Bolton Wanderers,19,19,0,1637,4,0,19,19,0,1624,4,0,38,38,0,3261,8,0,3,3,6,4,1,5,2,3,5,0,0,0
952,952,Stylianos Giannakopoulos,1717,2006,Bolton Wanderers,12,6,6,577,0,0,11,5,6,355,0,0,23,11,12,932,0,0,0,0,0,0,0,0,0,0,0,0,0,0
953,953,Kevin Davies,1718,2006,Bolton Wanderers,14,14,0,1190,6,0,16,16,0,1357,2,0,30,30,0,2547,8,0,3,1,4,5,1,6,0,0,0,0,0,0
954,954,El-Hadji Diouf,1719,2006,Bolton Wanderers,17,17,0,1417,1,0,16,15,1,1289,4,0,33,32,1,2706,5,0,0,3,3,0,4,4,0,1,1,0,0,0
955,955,Nicolas Anelka,1720,2006,Bolton Wanderers,18,18,0,1492,6,0,17,17,0,1524,5,0,35,35,0,3016,11,0,3,3,6,1,4,5,0,0,0,0,0,0
956,956,Idan Tal,1721,2006,Bolton Wanderers,8,1,7,174,0,0,9,4,5,465,0,0,17,5,12,639,0,0,0,0,0,0,0,0,0,0,0,0,0,0
957,957,Henrik Pedersen,1722,2006,Bolton Wanderers,8,4,4,393,1,0,10,6,4,529,0,0,18,10,8,922,1,0,0,0,0,1,0,1,0,0,0,0,0,0
958,958,Johann Smith,1723,2006,Bolton Wanderers,1,0,1,5,0,0,0,0,0,0,0,0,1,0,1,5,0,0,0,0,0,0,0,0,0,0,0,0,0,0
959,959,Edwin van der Sar,1077,2006,Manchester United,14,14,0,1260,0,0,18,18,0,1620,0,0,32,32,0,2880,0,0,0,0,0,0,0,0,0,0,0,0,0,0
960,960,Gary Neville,1105,2006,Manchester United,13,13,0,1034,0,0,11,11,0,946,0,0,24,24,0,1980,0,0,0,0,0,0,0,0,0,0,0,0,0,0
961,961,Patrice Evra,1724,2006,Manchester United,12,10,2,904,1,0,12,12,0,955,0,0,24,22,2,1859,1,0,0,0,0,0,0,0,0,0,0,0,0,0
962,962,Rio Ferdinand,1294,2006,Manchester United,16,16,0,1396,1,0,17,17,0,1530,0,0,33,33,0,2926,1,0,0,0,0,0,0,0,0,0,0,0,0,0
963,963,Nemanja Vidić,1725,2006,Manchester United,11,11,0,913,1,0,14,14,0,1229,2,0,25,25,0,2142,3,0,0,0,0,0,1,1,0,0,0,0,0,0
964,964,Ryan Giggs,1110,2006,Manchester United,13,10,3,914,1,0,17,15,2,1395,3,0,30,25,5,2309,4,0,3,3,6,1,2,3,0,0,0,0,0,0
965,965,Michael Carrick,1627,2006,Manchester United,16,15,1,1258,3,0,17,14,3,1254,0,0,33,29,4,2512,3,0,0,0,0,2,0,2,0,0,0,0,0,0
966,966,Paul Scholes,1112,2006,Manchester United,14,13,1,1162,2,0,16,16,0,1438,4,0,30,29,1,2600,6,0,0,0,0,2,2,4,0,0,0,0,0,0
967,967,Cristiano Ronaldo,1726,2006,Manchester United,17,15,2,1346,10,0,17,16,1,1440,7,0,34,31,3,2786,17,0,0,7,7,4,5,9,1,2,3,0,0,0
968,968,Wayne Rooney,1058,2006,Manchester United,18,18,0,1582,7,0,17,15,2,1346,7,0,35,33,2,2928,14,0,0,3,3,1,5,6,0,0,0,0,0,0
969,969,Louis Saha,1727,2006,Manchester United,9,8,1,679,4,0,15,10,5,951,4,0,24,18,6,1630,8,0,0,3,3,3,3,6,1,1,2,0,0,0
970,970,Gabriel Heinze,1728,2006,Manchester United,12,10,2,883,0,0,10,7,3,623,0,0,22,17,5,1506,0,0,0,0,0,0,0,0,0,0,0,0,0,0
971,971,John O'Shea,1729,2006,Manchester United,16,10,6,1027,1,0,16,6,10,696,3,0,32,16,16,1723,4,0,0,3,3,0,1,1,0,0,0,0,0,0
972,972,Darren Fletcher,1730,2006,Manchester United,13,8,5,762,1,0,11,8,3,666,2,0,24,16,8,1428,3,0,0,3,3,0,2,2,0,0,0,0,0,0
973,973,Ben Foster,1653,2011,West Bromwich Albion,18,18,0,1620,0,0,19,19,0,1710,0,0,37,37,0,3330,0,0,0,0,0,0,0,0,0,0,0,0,0,0
974,974,Nicky Shorey,1731,2011,West Bromwich Albion,12,10,2,918,0,0,13,12,1,1098,0,0,25,22,3,2016,0,0,0,0,0,0,0,0,0,0,0,0,0,0
975,975,Gareth McAuley,1732,2011,West Bromwich Albion,17,17,0,1530,1,0,15,15,0,1350,1,0,32,32,0,2880,2,0,3,0,3,1,1,2,0,0,0,0,0,0
976,976,Craig Dawson,1655,2011,West Bromwich Albion,3,3,0,270,0,0,5,3,2,272,0,0,8,6,2,542,0,0,0,0,0,0,0,0,0,0,0,0,0,0
977,977,Billy Jones,1733,2011,West Bromwich Albion,9,9,0,805,0,0,9,8,1,803,0,0,18,17,1,1608,0,0,0,0,0,0,0,0,0,0,0,0,0,0
978,978,Paul Scharner,1734,2011,West Bromwich Albion,13,7,6,643,0,0,16,11,5,950,3,0,29,18,11,1593,3,0,0,7,7,0,3,3,0,0,0,0,0,0
979,979,James Morrison,1735,2011,West Bromwich Albion,15,12,3,1079,1,0,15,11,4,1061,4,0,30,23,7,2140,5,0,0,1,1,0,4,4,0,0,0,0,0,0
980,980,Chris Brunt,1658,2011,West Bromwich Albion,15,13,2,1208,1,0,14,12,2,1099,1,0,29,25,4,2307,2,0,0,0,0,1,0,1,0,0,0,0,0,0
981,981,Jerome Thomas,1736,2011,West Bromwich Albion,16,15,1,1208,1,0,13,11,2,794,0,0,29,26,3,2002,1,0,0,0,0,1,0,1,0,0,0,0,0,0
982,982,Shane Long,1154,2011,West Bromwich Albion,17,11,6,1067,5,0,15,13,2,1117,3,0,32,24,8,2184,8,0,3,1,4,4,2,6,1,0,1,0,0,0
983,983,Peter Odemwingie,1551,2011,West Bromwich Albion,16,13,3,1176,3,0,14,12,2,1112,7,0,30,25,5,2288,10,0,0,9,9,1,5,6,0,0,0,0,0,0
984,984,Graham Dorrans,1737,2011,West Bromwich Albion,14,6,8,610,2,0,17,10,7,913,1,0,31,16,15,1523,3,0,3,3,6,2,1,3,0,0,0,0,0,0
985,985,Márton Fülöp,1213,2011,West Bromwich Albion,1,1,0,90,0,0,0,0,0,0,0,0,1,1,0,90,0,0,0,0,0,0,0,0,0,0,0,0,0,0
986,986,Gonzalo Jara,1738,2011,West Bromwich Albion,3,1,2,96,0,0,1,0,1,63,0,0,4,1,3,159,0,0,0,0,0,0,0,0,0,0,0,0,0,0
987,987,Somen Tchoyi,1739,2011,West Bromwich Albion,8,4,4,348,0,0,10,2,8,299,1,0,18,6,12,647,1,0,0,1,1,0,1,1,0,0,0,0,0,0
988,988,George Thorne,1740,2011,West Bromwich Albion,0,0,0,0,0,0,3,1,2,102,0,0,3,1,2,102,0,0,0,0,0,0,0,0,0,0,0,0,0,0
989,989,Simon Cox,1741,2011,West Bromwich Albion,8,2,6,281,0,0,10,5,5,478,0,0,18,7,11,759,0,0,0,0,0,0,0,0,0,0,0,0,0,0
990,990,Marc-Antoine Fortuné,1742,2011,West Bromwich Albion,10,7,3,640,2,0,7,5,2,469,0,0,17,12,5,1109,2,0,0,0,0,1,0,1,0,0,0,0,0,0
991,991,Tim Howard,1743,2011,Everton FC,19,19,0,1710,1,0,19,19,0,1710,0,0,38,38,0,3420,1,0,0,0,0,1,0,1,0,0,0,0,0,0
992,992,Tony Hibbert,1744,2011,Everton FC,16,15,1,1331,0,0,16,16,0,1422,0,0,32,31,1,2753,0,0,0,0,0,0,0,0,0,0,0,0,0,0
993,993,Leighton Baines,1466,2011,Everton FC,17,17,0,1530,2,0,16,16,0,1440,2,0,33,33,0,2970,4,0,3,1,4,2,2,4,2,1,3,0,0,0
994,994,John Heitinga,1745,2011,Everton FC,16,16,0,1404,1,0,14,13,1,1137,0,0,30,29,1,2541,1,0,0,0,0,0,0,0,0,0,0,0,0,0
995,995,Phil Jagielka,1048,2011,Everton FC,15,14,1,1220,2,0,15,15,0,1350,0,0,30,29,1,2570,2,0,0,0,0,2,0,2,0,0,0,0,0,0
996,996,Sylvain Distin,1015,2011,Everton FC,10,9,1,830,0,0,17,15,2,1387,0,0,27,24,3,2217,0,0,0,0,0,0,0,0,0,0,0,0,0,0
997,997,Phil Neville,1114,2011,Everton FC,12,11,1,988,0,0,15,13,2,1079,0,0,27,24,3,2067,0,0,0,0,0,0,0,0,0,0,0,0,0,0
998,998,Tim Cahill,1746,2011,Everton FC,17,13,4,1179,2,0,18,14,4,1171,0,0,35,27,8,2350,2,0,0,0,0,1,0,1,0,0,0,0,0,0
999,999,Leon Osman,1747,2011,Everton FC,16,16,0,1312,4,0,14,12,2,1065,0,0,30,28,2,2377,4,0,4,0,4,3,0,3,0,0,0,0,0,0
1000,1000,Jack Rodwell,1748,2011,Everton FC,8,5,3,515,0,0,6,6,0,507,2,0,14,11,3,1022,2,0,0,0,0,0,0,0,0,0,0,0,0,0
1001,1001,Louis Saha,1727,2011,Everton FC,8,7,1,588,0,0,10,8,2,700,1,0,18,15,3,1288,1,0,0,0,0,0,1,1,0,0,0,0,0,0
1002,1002,Denis Stracqualursi,1749,2011,Everton FC,13,4,9,449,1,0,8,3,5,288,0,0,21,7,14,737,1,0,0,0,0,0,0,0,0,0,0,0,0,0
1003,1003,Magaye Gueye,1750,2011,Everton FC,9,2,7,334,1,0,8,1,7,207,0,0,17,3,14,541,1,0,0,0,0,1,0,1,0,0,0,0,0,0
1004,1004,Victor Anichebe,1751,2011,Everton FC,4,1,3,131,2,0,8,4,4,313,3,0,12,5,7,444,5,0,0,5,5,0,3,3,0,0,0,0,0,0
1005,1005,Ján Mucha,1752,2011,Everton FC,0,0,0,0,0,0,0,0,0,0,0,0,0,0,0,0,0,0,0,0,0,0,0,0,0,0,0,0,0,0
1006,1006,Diniyar Bilyaletdinov,1753,2011,Everton FC,5,4,1,245,0,0,5,3,2,283,0,0,10,7,3,528,0,0,0,0,0,0,0,0,0,0,0,0,0,0
1007,1007,Ross Barkley,1754,2011,Everton FC,4,1,3,158,0,0,2,1,1,57,0,0,6,2,4,215,0,0,0,0,0,0,0,0,0,0,0,0,0,0
1008,1008,James McFadden,1413,2011,Everton FC,2,1,1,68,0,0,5,1,4,98,0,0,7,2,5,166,0,0,0,0,0,0,0,0,0,0,0,0,0,0
1009,1009,Antti Niemi,1559,2006,Fulham FC,15,15,0,1321,0,0,14,14,0,1260,0,0,29,29,0,2581,0,0,0,0,0,0,0,0,0,0,0,0,0,0
1010,1010,Moritz Volz,1078,2006,Fulham FC,13,9,4,773,0,0,14,13,1,1081,2,0,27,22,5,1854,2,0,0,1,1,0,2,2,0,0,0,0,0,0
1011,1011,Carlos Bocanegra,1081,2006,Fulham FC,15,12,3,1141,2,0,14,13,1,1101,3,0,29,25,4,2242,5,0,1,4,5,1,3,4,0,0,0,0,0,0
1012,1012,Franck Queudrue,1329,2006,Fulham FC,13,13,0,1125,0,0,14,13,1,1210,1,0,27,26,1,2335,1,0,0,1,1,0,1,1,0,0,0,0,0,0
1013,1013,Zat Knight,1755,2006,Fulham FC,9,9,0,810,0,0,13,12,1,1133,2,0,22,21,1,1943,2,0,0,0,0,0,1,1,0,0,0,0,0,0
1014,1014,Liam Rosenior,1756,2006,Fulham FC,18,18,0,1620,0,0,18,18,0,1598,0,0,36,36,0,3218,0,0,0,0,0,0,0,0,0,0,0,0,0,0
1015,1015,Ian Pearce,1082,2006,Fulham FC,10,10,0,900,1,0,11,11,0,925,0,0,21,21,0,1825,1,0,1,0,1,1,0,1,0,0,0,0,0,0
1016,1016,Michael Brown,1122,2006,Fulham FC,17,17,0,1463,0,0,15,15,0,1293,0,0,32,32,0,2756,0,0,0,0,0,0,0,0,0,0,0,0,0,0
1017,1017,Papa Bouba Diop,1757,2006,Fulham FC,12,10,2,851,0,0,11,10,1,856,0,0,23,20,3,1707,0,0,0,0,0,0,0,0,0,0,0,0,0,0
1018,1018,Wayne Routledge,1758,2006,Fulham FC,13,7,6,738,0,0,9,5,4,569,0,0,22,12,10,1307,0,0,0,0,0,0,0,0,0,0,0,0,0,0
1019,1019,Collins John,1089,2006,Fulham FC,9,3,6,321,0,0,14,6,8,608,1,0,23,9,14,929,1,0,0,0,0,0,0,0,0,0,0,0,0,0
1020,1020,Heiðar Helguson,1759,2006,Fulham FC,14,7,7,629,2,0,14,8,6,725,1,0,28,15,13,1354,3,0,0,0,0,2,1,3,1,0,1,0,0,0
1021,1021,Brian McBride,1088,2006,Fulham FC,18,17,1,1458,5,0,18,15,3,1269,4,0,36,32,4,2727,9,0,0,0,0,3,3,6,0,0,0,0,0,0
1022,1022,Petr Čech,1531,2006,Chelsea FC,9,9,0,810,0,0,11,11,0,905,0,0,20,20,0,1715,0,0,0,0,0,0,0,0,0,0,0,0,0,0
1023,1023,Ashley Cole,1523,2006,Chelsea FC,12,10,2,888,0,0,11,11,0,958,0,0,23,21,2,1846,0,0,0,0,0,0,0,0,0,0,0,0,0,0
1024,1024,Ricardo Carvalho,1760,2006,Chelsea FC,16,16,0,1291,2,0,15,15,0,1337,1,0,31,31,0,2628,3,0,6,1,7,2,1,3,0,0,0,0,0,0
1025,1025,Paulo Ferreira,1761,2006,Chelsea FC,12,9,3,853,0,0,12,9,3,855,0,0,24,18,6,1708,0,0,0,0,0,0,0,0,0,0,0,0,0,0
1026,1026,Claude Makélélé,1762,2006,Chelsea FC,14,12,2,1120,0,0,15,14,1,1161,1,0,29,26,3,2281,1,0,0,0,0,0,1,1,0,0,0,0,0,0
1027,1027,Michael Essien,1763,2006,Chelsea FC,16,16,0,1440,1,0,17,17,0,1530,1,0,33,33,0,2970,2,0,1,1,2,1,1,2,0,0,0,0,0,0
1028,1028,Frank Lampard,1536,2006,Chelsea FC,18,17,1,1547,3,0,19,19,0,1697,8,0,37,36,1,3244,11,0,0,6,6,1,7,8,0,3,3,0,0,0
1029,1029,Geremi,1764,2006,Chelsea FC,10,8,2,604,1,0,9,7,2,556,0,0,19,15,4,1160,1,0,3,0,3,1,0,1,0,0,0,0,0,0
1030,1030,Andriy Shevchenko,1765,2006,Chelsea FC,16,13,3,1020,3,0,14,9,5,788,1,0,30,22,8,1808,4,0,0,0,0,2,1,3,0,0,0,0,0,0
1031,1031,Didier Drogba,1766,2006,Chelsea FC,18,15,3,1455,16,0,18,17,1,1490,4,0,36,32,4,2945,20,0,7,3,10,11,2,13,0,0,0,0,0,0
1032,1032,Arjen Robben,1767,2006,Chelsea FC,11,7,4,656,1,0,10,9,1,706,1,0,21,16,5,1362,2,0,0,3,3,0,1,1,0,0,0,0,0,0
1033,1033,Wayne Bridge,1768,2006,Chelsea FC,11,9,2,806,0,0,11,8,3,744,0,0,22,17,5,1550,0,0,0,0,0,0,0,0,0,0,0,0,0,0
1034,1034,John Mikel Obi,1769,2006,Chelsea FC,10,5,5,426,0,0,12,5,7,549,0,0,22,10,12,975,0,0,0,0,0,0,0,0,0,0,0,0,0,0
1035,1035,Salomon Kalou,1770,2006,Chelsea FC,15,10,5,937,3,0,18,9,9,998,4,0,33,19,14,1935,7,0,0,3,3,1,1,2,0,0,0,0,0,0
1036,1036,Ben Foster,1653,2012,West Bromwich Albion,16,16,0,1440,0,0,14,14,0,1260,0,0,30,30,0,2700,0,0,0,0,0,0,0,0,0,0,0,0,0,0
1037,1037,Steven Reid,1140,2012,West Bromwich Albion,5,5,0,413,0,0,6,6,0,496,0,0,11,11,0,909,0,0,0,0,0,0,0,0,0,0,0,0,0,0
1038,1038,Jonas Olsson,1771,2012,West Bromwich Albion,18,18,0,1620,0,0,18,18,0,1620,0,0,36,36,0,3240,0,0,0,0,0,0,0,0,0,0,0,0,0,0
1039,1039,Liam Ridgewell,1772,2012,West Bromwich Albion,14,13,1,1164,0,0,16,15,1,1321,0,0,30,28,2,2485,0,0,0,0,0,0,0,0,0,0,0,0,0,0
1040,1040,Gareth McAuley,1732,2012,West Bromwich Albion,18,18,0,1620,2,0,18,18,0,1620,1,0,36,36,0,3240,3,0,0,0,0,1,1,2,0,0,0,0,0,0
1041,1041,Claudio Yacob,1661,2012,West Bromwich Albion,16,16,0,1325,0,0,14,13,1,1156,0,0,30,29,1,2481,0,0,0,0,0,0,0,0,0,0,0,0,0,0
1042,1042,James Morrison,1735,2012,West Bromwich Albion,17,16,1,1376,3,0,18,17,1,1475,2,0,35,33,2,2851,5,0,0,1,1,1,2,3,1,0,1,0,0,0
1043,1043,Youssuf Mulumbu,1773,2012,West Bromwich Albion,14,14,0,1256,2,0,14,14,0,1260,0,0,28,28,0,2516,2,0,0,0,0,0,0,0,0,0,0,0,0,0
1044,1044,Zoltán Gera,1323,2012,West Bromwich Albion,10,9,1,672,3,0,6,5,1,455,1,0,16,14,2,1127,4,0,0,0,0,2,1,3,0,0,0,0,0,0
1045,1045,Shane Long,1154,2012,West Bromwich Albion,17,13,4,1147,4,0,17,12,5,1014,4,0,34,25,9,2161,8,0,0,0,0,4,1,5,0,0,0,0,0,0
1046,1046,Peter Odemwingie,1551,2012,West Bromwich Albion,13,7,6,716,5,0,12,6,6,608,0,0,25,13,12,1324,5,0,4,0,4,3,0,3,1,0,1,0,0,0
1047,1047,Chris Brunt,1658,2012,West Bromwich Albion,16,11,5,1061,1,0,15,12,3,1117,1,0,31,23,8,2178,2,0,0,0,0,0,1,1,0,0,0,0,0,0
1048,1048,Romelu Lukaku,1645,2012,West Bromwich Albion,17,9,8,909,10,0,18,11,7,1094,7,0,35,20,15,2003,17,0,7,0,7,6,2,8,1,1,2,0,0,0
1049,1049,Marc-Antoine Fortuné,1742,2012,West Bromwich Albion,11,4,7,434,0,0,10,5,5,405,2,0,21,9,12,839,2,0,0,0,0,0,1,1,0,0,0,0,0,0
1050,1050,Boaz Myhill,1663,2012,West Bromwich Albion,3,3,0,270,0,0,5,5,0,450,0,0,8,8,0,720,0,0,0,0,0,0,0,0,0,0,0,0,0,0
1051,1051,Gonzalo Jara,1738,2012,West Bromwich Albion,1,0,1,44,0,0,0,0,0,0,0,0,1,0,1,44,0,0,0,0,0,0,0,0,0,0,0,0,0,0
1052,1052,Craig Dawson,1655,2012,West Bromwich Albion,0,0,0,0,0,0,1,1,0,90,0,0,1,1,0,90,0,0,0,0,0,0,0,0,0,0,0,0,0,0
1053,1053,Yassine El Ghanassi,1774,2012,West Bromwich Albion,0,0,0,0,0,0,0,0,0,0,0,0,0,0,0,0,0,0,0,0,0,0,0,0,0,0,0,0,0,0
1054,1054,Pepe Reina,1775,2012,Liverpool FC,15,15,0,1350,0,0,16,16,0,1440,0,0,31,31,0,2790,0,0,0,0,0,0,0,0,0,0,0,0,0,0
1055,1055,Glen Johnson,1386,2012,Liverpool FC,18,18,0,1620,0,0,18,18,0,1603,1,0,36,36,0,3223,1,0,0,0,0,0,1,1,0,0,0,0,0,0
1056,1056,Daniel Agger,1776,2012,Liverpool FC,17,17,0,1512,1,0,18,18,0,1620,2,0,35,35,0,3132,3,0,3,0,3,1,1,2,0,0,0,0,0,0
1057,1057,Martin Kelly,1034,2012,Liverpool FC,2,2,0,156,0,0,2,2,0,180,0,0,4,4,0,336,0,0,0,0,0,0,0,0,0,0,0,0,0,0
1058,1058,Martin Škrtel,1423,2012,Liverpool FC,13,12,1,1075,2,0,12,11,1,1005,0,0,25,23,2,2080,2,0,0,0,0,2,0,2,0,0,0,0,0,0
1059,1059,Steven Gerrard,1424,2012,Liverpool FC,18,18,0,1620,6,0,18,18,0,1602,3,0,36,36,0,3222,9,0,3,3,6,3,3,6,2,2,4,0,0,0
1060,1060,Stewart Downing,1335,2012,Liverpool FC,13,11,2,944,2,0,16,14,2,1250,1,0,29,25,4,2194,3,0,0,0,0,1,1,2,0,0,0,0,0,0
1061,1061,Lucas Leiva,1429,2012,Liverpool FC,13,13,0,1007,0,0,13,11,2,945,0,0,26,24,2,1952,0,0,0,0,0,0,0,0,0,0,0,0,0,0
1062,1062,Joe Allen,1430,2012,Liverpool FC,14,9,5,899,0,0,13,12,1,1020,0,0,27,21,6,1919,0,0,0,0,0,0,0,0,0,0,0,0,0,0
1063,1063,Luis Suárez,1427,2012,Liverpool FC,17,17,0,1515,11,0,16,16,0,1440,12,0,33,33,0,2955,23,0,2,2,4,5,5,10,0,0,0,0,0,0
1064,1064,Fabio Borini,1777,2012,Liverpool FC,8,3,5,297,0,0,5,2,3,213,1,0,13,5,8,510,1,0,0,0,0,0,0,0,0,0,0,0,0,0
1065,1065,Jamie Carragher,1778,2012,Liverpool FC,13,8,5,758,0,0,11,8,3,770,0,0,24,16,8,1528,0,0,0,0,0,0,0,0,0,0,0,0,0,0
1066,1066,Joe Cole,1630,2012,Liverpool FC,2,0,2,67,0,0,4,0,4,110,1,0,6,0,6,177,1,0,0,0,0,0,1,1,0,0,0,0,0,0
1067,1067,Andy Carroll,1779,2012,Liverpool FC,1,0,1,6,0,0,1,0,1,11,0,0,2,0,2,17,0,0,0,0,0,0,0,0,0,0,0,0,0,0
1068,1068,Brad Jones,1431,2012,Liverpool FC,4,4,0,360,0,0,3,3,0,270,0,0,7,7,0,630,0,0,0,0,0,0,0,0,0,0,0,0,0,0
1069,1069,Jordan Henderson,1426,2012,Liverpool FC,14,7,7,687,1,0,16,9,7,842,4,0,30,16,14,1529,5,0,0,0,0,1,1,2,0,0,0,0,0,0
1070,1070,Charlie Adam,1554,2012,Liverpool FC,0,0,0,0,0,0,0,0,0,0,0,0,0,0,0,0,0,0,0,0,0,0,0,0,0,0,0,0,0,0
1071,1071,Jonjo Shelvey,1699,2012,Liverpool FC,11,5,6,532,0,0,8,4,4,437,0,0,19,9,10,969,0,0,0,0,0,0,0,0,0,0,0,0,0,0
1072,1072,Joe Hart,1363,2009,Birmingham City,18,18,0,1620,0,0,18,18,0,1620,0,0,36,36,0,3240,0,0,0,0,0,0,0,0,0,0,0,0,0,0
1073,1073,Stephen Carr,1780,2009,Birmingham City,17,17,0,1524,0,0,18,18,0,1587,0,0,35,35,0,3111,0,0,0,0,0,0,0,0,0,0,0,0,0,0
1074,1074,Liam Ridgewell,1772,2009,Birmingham City,15,15,0,1350,3,0,16,15,1,1394,0,0,31,30,1,2744,3,0,2,0,2,3,0,3,0,0,0,0,0,0
1075,1075,Roger Johnson,1781,2009,Birmingham City,19,19,0,1710,0,0,19,19,0,1710,0,0,38,38,0,3420,0,0,0,0,0,0,0,0,0,0,0,0,0,0
1076,1076,Scott Dann,1020,2009,Birmingham City,15,15,0,1350,0,0,15,15,0,1350,0,0,30,30,0,2700,0,0,0,0,0,0,0,0,0,0,0,0,0,0
1077,1077,Lee Bowyer,1297,2009,Birmingham City,18,18,0,1566,2,0,17,16,1,1445,3,0,35,34,1,3011,5,0,6,3,9,2,2,4,0,0,0,0,0,0
1078,1078,Sebastian Larsson,1402,2009,Birmingham City,17,14,3,1278,0,0,16,12,4,1103,4,0,33,26,7,2381,4,0,0,1,1,0,2,2,0,0,0,0,0,0
1079,1079,Barry Ferguson,1782,2009,Birmingham City,19,19,0,1710,0,0,18,18,0,1620,0,0,37,37,0,3330,0,0,0,0,0,0,0,0,0,0,0,0,0,0
1080,1080,Cameron Jerome,1783,2009,Birmingham City,16,16,0,1388,4,0,16,16,0,1295,6,0,32,32,0,2683,10,0,0,3,3,2,3,5,0,0,0,0,0,0
1081,1081,Christian Benítez,1784,2009,Birmingham City,16,12,4,1087,1,0,14,9,5,848,2,0,30,21,9,1935,3,0,0,0,0,0,2,2,0,0,0,0,0,0
1082,1082,James McFadden,1413,2009,Birmingham City,18,17,1,1321,3,0,18,15,3,1330,2,0,36,32,4,2651,5,0,6,3,9,2,2,4,2,0,2,0,0,0
1083,1083,Keith Fahey,1785,2009,Birmingham City,18,9,9,909,0,0,16,9,7,788,0,0,34,18,16,1697,0,0,0,0,0,0,0,0,0,0,0,0,0,0
1084,1084,Tomasz Kuszczak,1786,2009,Manchester United,3,3,0,270,0,0,5,5,0,450,0,0,8,8,0,720,0,0,0,0,0,0,0,0,0,0,0,0,0,0
1085,1085,Patrice Evra,1724,2009,Manchester United,18,18,0,1565,0,0,19,18,1,1631,0,0,37,36,1,3196,0,0,0,0,0,0,0,0,0,0,0,0,0,0
1086,1086,Wes Brown,1108,2009,Manchester United,9,8,1,735,0,0,10,10,0,838,0,0,19,18,1,1573,0,0,0,0,0,0,0,0,0,0,0,0,0,0
1087,1087,Rafael,1787,2009,Manchester United,4,4,0,323,1,0,4,4,0,360,0,0,8,8,0,683,1,0,0,0,0,0,0,0,0,0,0,0,0,0
1088,1088,Jonny Evans,1216,2009,Manchester United,8,8,0,705,0,0,10,10,0,882,0,0,18,18,0,1587,0,0,0,0,0,0,0,0,0,0,0,0,0,0
1089,1089,Ji-Sung Park,1788,2009,Manchester United,9,5,4,530,2,0,7,4,3,378,1,0,16,9,7,908,3,0,3,0,3,1,0,1,0,0,0,0,0,0
1090,1090,Michael Carrick,1627,2009,Manchester United,13,11,2,1007,2,0,16,11,5,1104,0,0,29,22,7,2111,2,0,0,0,0,0,0,0,0,0,0,0,0,0
1091,1091,Paul Scholes,1112,2009,Manchester United,12,9,3,736,0,0,16,15,1,1243,3,0,28,24,4,1979,3,0,0,6,6,0,3,3,0,0,0,0,0,0
1092,1092,Darren Fletcher,1730,2009,Manchester United,16,15,1,1333,4,0,15,15,0,1339,0,0,31,30,1,2672,4,0,0,0,0,4,0,4,0,0,0,0,0,0
1093,1093,Antonio Valencia,1641,2009,Manchester United,16,15,1,1295,4,0,17,14,3,1290,1,0,33,29,4,2585,5,0,0,0,0,0,0,0,0,0,0,0,0,0
1094,1094,Wayne Rooney,1058,2009,Manchester United,16,16,0,1343,17,0,16,16,0,1380,9,0,32,32,0,2723,26,0,3,0,3,10,4,14,2,2,4,0,0,0
1095,1095,Ryan Giggs,1110,2009,Manchester United,9,7,2,637,3,0,15,12,3,1086,2,0,24,19,5,1723,5,0,0,0,0,1,1,2,2,0,2,0,0,0
1096,1096,Mame Diouf,1584,2009,Manchester United,3,0,3,53,1,0,2,0,2,37,0,0,5,0,5,90,1,0,0,0,0,0,0,0,0,0,0,0,0,0
1097,1097,Thomas Sørensen,1090,2004,Aston Villa,18,18,0,1620,0,0,17,17,0,1486,0,0,35,35,0,3106,0,0,0,0,0,0,0,0,0,0,0,0,0,0
1098,1098,Jlloyd Samuel,1789,2004,Aston Villa,17,17,0,1458,0,0,17,16,1,1482,0,0,34,33,1,2940,0,0,0,0,0,0,0,0,0,0,0,0,0,0
1099,1099,Olof Mellberg,1790,2004,Aston Villa,14,14,0,1260,1,0,15,15,0,1306,2,0,29,29,0,2566,3,0,0,1,1,1,2,3,0,0,0,0,0,0
1100,1100,Liam Ridgewell,1772,2004,Aston Villa,6,6,0,540,1,0,9,6,3,617,0,0,15,12,3,1157,1,0,0,0,0,1,0,1,0,0,0,0,0,0
1101,1101,Gareth Barry,1418,2004,Aston Villa,16,15,1,1355,2,0,17,17,0,1396,5,0,33,32,1,2751,7,0,0,0,0,1,1,2,0,3,3,0,0,0
1102,1102,Nolberto Solano,1791,2004,Aston Villa,17,16,1,1397,7,0,18,15,3,1300,1,0,35,31,4,2697,8,0,7,0,7,5,1,6,0,0,0,0,0,0
1103,1103,Thomas Hitzlsperger,1792,2004,Aston Villa,13,8,5,716,0,0,15,9,6,864,2,0,28,17,11,1580,2,0,0,6,6,0,2,2,0,0,0,0,0,0
1104,1104,Eric Djemba-Djemba,1793,2004,Aston Villa,3,2,1,166,0,0,3,2,1,191,0,0,6,4,2,357,0,0,0,0,0,0,0,0,0,0,0,0,0,0
1105,1105,Ulises De la Cruz,1794,2004,Aston Villa,17,15,2,1391,0,0,16,14,2,1349,0,0,33,29,4,2740,0,0,0,0,0,0,0,0,0,0,0,0,0,0
1106,1106,Juan Pablo Ángel,1795,2004,Aston Villa,16,15,1,1337,4,0,18,14,4,1291,3,0,34,29,5,2628,7,0,0,0,0,0,3,3,0,0,0,0,0,0
1107,1107,Luke Moore,1796,2004,Aston Villa,13,3,10,442,1,0,11,2,9,376,0,0,24,5,19,818,1,0,0,0,0,0,0,0,0,0,0,0,0,0
1108,1108,Lee Hendrie,1797,2004,Aston Villa,14,11,3,916,3,0,15,14,1,1146,2,0,29,25,4,2062,5,0,1,0,1,1,2,3,0,0,0,0,0,0
1109,1109,Darius Vassell,1798,2004,Aston Villa,11,9,2,757,2,0,10,8,2,646,0,0,21,17,4,1403,2,0,0,0,0,2,0,2,0,0,0,0,0,0
1110,1110,Nigel Martyn,1290,2004,Everton FC,17,17,0,1530,0,0,14,14,0,1215,0,0,31,31,0,2745,0,0,0,0,0,0,0,0,0,0,0,0,0,0
1111,1111,Alessandro Pistone,1799,2004,Everton FC,15,15,0,1275,0,0,17,16,1,1379,0,0,32,31,1,2654,0,0,0,0,0,0,0,0,0,0,0,0,0,0
1112,1112,David Weir,1800,2004,Everton FC,16,16,0,1414,1,0,17,17,0,1530,0,0,33,33,0,2944,1,0,0,0,0,1,0,1,0,0,0,0,0,0
1113,1113,Joseph Yobo,1801,2004,Everton FC,13,9,4,834,0,0,13,9,4,843,0,0,26,18,8,1677,0,0,0,0,0,0,0,0,0,0,0,0,0,0
1114,1114,Tony Hibbert,1744,2004,Everton FC,18,17,1,1574,0,0,17,17,0,1520,0,0,35,34,1,3094,0,0,0,0,0,0,0,0,0,0,0,0,0,0
1115,1115,Mikel Arteta,1802,2004,Everton FC,6,5,1,390,1,0,5,5,0,389,0,0,11,10,1,779,1,0,0,0,0,1,0,1,0,0,0,0,0,0
1116,1116,Kevin Kilbane,1103,2004,Everton FC,19,18,1,1571,0,0,18,18,0,1584,1,0,37,36,1,3155,1,0,0,0,0,0,1,1,0,0,0,0,0,0
1117,1117,Tim Cahill,1746,2004,Everton FC,16,16,0,1374,4,0,16,16,0,1247,7,0,32,32,0,2621,11,0,0,7,7,1,5,6,0,0,0,0,0,0
1118,1118,Leon Osman,1747,2004,Everton FC,15,13,2,1149,4,0,14,11,3,1014,2,0,29,24,5,2163,6,0,9,0,9,4,1,5,0,0,0,0,0,0
1119,1119,Lee Carsley,1803,2004,Everton FC,18,17,1,1477,2,0,17,17,0,1515,2,0,35,34,1,2992,4,0,3,1,4,1,2,3,0,0,0,0,0,0
1120,1120,Marcus Bent,1349,2004,Everton FC,19,15,4,1318,3,0,17,16,1,1309,3,0,36,31,5,2627,6,0,7,1,8,3,1,4,0,0,0,0,0,0
1121,1121,Gary Naysmith,1804,2004,Everton FC,5,4,1,330,0,0,6,1,5,152,0,0,11,5,6,482,0,0,0,0,0,0,0,0,0,0,0,0,0,0
1122,1122,Duncan Ferguson,1805,2004,Everton FC,18,4,14,708,5,0,16,2,14,464,1,0,34,6,28,1172,6,0,10,3,13,5,1,6,0,0,0,0,0,0
1123,1123,David James,1385,2005,Manchester City,19,19,0,1710,0,0,18,18,0,1620,0,0,37,37,0,3330,0,0,0,0,0,0,0,0,0,0,0,0,0,0
1124,1124,David Sommeil,1806,2005,Manchester City,8,7,1,621,2,0,7,6,1,485,0,0,15,13,2,1106,2,0,0,0,0,2,0,2,0,0,0,0,0,0
1125,1125,Ben Thatcher,1807,2005,Manchester City,8,8,0,719,0,0,10,10,0,856,0,0,18,18,0,1575,0,0,0,0,0,0,0,0,0,0,0,0,0,0
1126,1126,Sylvain Distin,1015,2005,Manchester City,15,15,0,1350,0,0,15,15,0,1343,0,0,30,30,0,2693,0,0,0,0,0,0,0,0,0,0,0,0,0,0
1127,1127,Jihai Sun,1808,2005,Manchester City,15,8,7,923,0,0,13,8,5,791,0,0,28,16,12,1714,0,0,0,0,0,0,0,0,0,0,0,0,0,0
1128,1128,Danny Mills,1292,2005,Manchester City,10,10,0,848,1,0,7,7,0,553,0,0,17,17,0,1401,1,0,0,0,0,1,0,1,0,0,0,0,0,0
1129,1129,Claudio Reyna,1634,2005,Manchester City,9,9,0,758,1,0,12,12,0,976,0,0,21,21,0,1734,1,0,0,0,0,1,0,1,0,0,0,0,0,0
1130,1130,Trevor Sinclair,1628,2005,Manchester City,16,14,2,1144,1,0,15,15,0,1257,2,0,31,29,2,2401,3,0,0,0,0,1,1,2,0,0,0,0,0,0
1131,1131,Stephen Ireland,1809,2005,Manchester City,14,9,5,770,0,0,9,3,6,400,0,0,23,12,11,1170,0,0,0,0,0,0,0,0,0,0,0,0,0,0
1132,1132,Antoine Sibierski,1810,2005,Manchester City,11,7,4,579,1,0,12,4,8,440,1,0,23,11,12,1019,2,0,0,0,0,0,1,1,0,0,0,0,0,0
1133,1133,Bradley Wright-Phillips,1811,2005,Manchester City,9,1,8,209,1,0,8,0,8,111,0,0,17,1,16,320,1,0,0,0,0,0,0,0,0,0,0,0,0,0
1134,1134,Lee Croft,1812,2005,Manchester City,11,3,8,380,0,0,9,1,8,238,1,0,20,4,16,618,1,0,0,0,0,0,1,1,0,0,0,0,0,0
1135,1135,Ishmael Miller,1813,2005,Manchester City,1,0,1,29,0,0,0,0,0,0,0,0,1,0,1,29,0,0,0,0,0,0,0,0,0,0,0,0,0,0
1136,1136,Georgios Samaras,1814,2005,Manchester City,7,3,4,426,3,0,7,7,0,548,1,0,14,10,4,974,4,0,0,0,0,2,0,2,0,0,0,0,0,0
1137,1137,John Filan,1815,2005,Wigan Athletic,8,8,0,675,0,0,7,7,0,630,0,0,15,15,0,1305,0,0,0,0,0,0,0,0,0,0,0,0,0,0
1138,1138,Pascal Chimbonda,1392,2005,Wigan Athletic,18,18,0,1553,1,0,19,19,0,1710,1,0,37,37,0,3263,2,0,3,0,3,1,1,2,0,0,0,0,0,0
1139,1139,Arjan de Zeeuw,1067,2005,Wigan Athletic,17,17,0,1530,0,0,14,14,0,1132,0,0,31,31,0,2662,0,0,0,0,0,0,0,0,0,0,0,0,0,0
1140,1140,Paul Scharner,1734,2005,Wigan Athletic,8,7,1,648,2,0,8,7,1,658,1,0,16,14,2,1306,3,0,1,0,1,2,1,3,0,0,0,0,0,0
1141,1141,Leighton Baines,1466,2005,Wigan Athletic,19,18,1,1528,0,0,18,17,1,1575,0,0,37,35,2,3103,0,0,0,0,0,0,0,0,0,0,0,0,0,0
1142,1142,Graham Kavanagh,1816,2005,Wigan Athletic,17,16,1,1358,0,0,18,16,2,1434,0,0,35,32,3,2792,0,0,0,0,0,0,0,0,0,0,0,0,0,0
1143,1143,Gary Teale,1817,2005,Wigan Athletic,13,12,1,1018,0,0,11,8,3,730,0,0,24,20,4,1748,0,0,0,0,0,0,0,0,0,0,0,0,0,0
1144,1144,Jimmy Bullard,1610,2005,Wigan Athletic,18,18,0,1606,2,0,18,17,1,1530,2,0,36,35,1,3136,4,0,0,3,3,1,2,3,0,0,0,0,0,0
1145,1145,Henri Camara,1818,2005,Wigan Athletic,15,13,2,1170,10,0,14,12,2,1107,2,0,29,25,4,2277,12,0,1,3,4,5,1,6,0,0,0,0,0,0
1146,1146,Lee McCulloch,1819,2005,Wigan Athletic,15,14,1,1265,4,0,15,13,2,1122,1,0,30,27,3,2387,5,0,0,3,3,2,1,3,0,0,0,0,0,0
1147,1147,Jason Roberts,1820,2005,Wigan Athletic,17,17,0,1530,4,0,17,17,0,1489,4,0,34,34,0,3019,8,0,6,0,6,3,3,6,1,0,1,0,0,0
1148,1148,Andreas Johansson,1821,2005,Wigan Athletic,7,2,5,214,1,0,9,4,5,416,3,0,16,6,10,630,4,0,0,1,1,1,3,4,0,0,0,0,0,0
1149,1149,Tim Krul,1822,2019,Norwich City,18,18,0,1620,0,0,18,18,0,1620,0,0,36,36,0,3240,0,0,0,0,0,0,0,0,0,0,0,0,0,0
1150,1150,Sam Byram,1823,2019,Norwich City,9,7,2,574,0,0,8,8,0,720,0,0,17,15,2,1294,0,0,0,0,0,0,0,0,0,0,0,0,0,0
1151,1151,Ben Godfrey,1824,2019,Norwich City,15,15,0,1350,0,0,15,15,0,1310,0,0,30,30,0,2660,0,0,0,0,0,0,0,0,0,0,0,0,0,0
1152,1152,Jamal Lewis,1825,2019,Norwich City,15,13,2,1215,1,0,13,12,1,1090,0,0,28,25,3,2305,1,0,3,0,3,1,0,1,0,0,0,0,0,0
1153,1153,Todd Cantwell,1826,2019,Norwich City,19,13,6,1126,5,0,18,17,1,1377,1,0,37,30,7,2503,6,0,0,0,0,4,1,5,0,0,0,0,0,0
1154,1154,Marco Stiepermann,1827,2019,Norwich City,10,7,3,585,0,0,14,7,7,600,0,0,24,14,10,1185,0,0,0,0,0,0,0,0,0,0,0,0,0,0
1155,1155,Kenny McLean,1828,2019,Norwich City,18,15,3,1391,1,0,19,17,2,1575,0,0,37,32,5,2966,1,0,0,0,0,1,0,1,0,0,0,0,0,0
1156,1156,Ibrahim Amadou,1829,2019,Norwich City,4,4,0,360,0,0,7,4,3,397,0,0,11,8,3,757,0,0,0,0,0,0,0,0,0,0,0,0,0,0
1157,1157,Alexander Tettey,1830,2019,Norwich City,15,14,1,1227,1,0,15,14,1,1124,0,0,30,28,2,2351,1,0,0,0,0,1,0,1,0,0,0,0,0,0
1158,1158,Emiliano Buendia,1831,2019,Norwich City,19,16,3,1408,0,0,17,12,5,1112,1,0,36,28,8,2520,1,0,0,0,0,0,1,1,0,0,0,0,0,0
1159,1159,Teemu Pukki,1832,2019,Norwich City,18,16,2,1424,7,0,18,17,1,1470,4,0,36,33,3,2894,11,0,3,0,3,4,2,6,1,1,2,0,0,0
1160,1160,Dennis Srbeny,1833,2019,Norwich City,5,0,5,33,0,0,3,0,3,8,1,0,8,0,8,41,1,0,0,0,0,0,0,0,0,0,0,0,0,0
1161,1161,Josip Drmić,1834,2019,Norwich City,10,4,6,397,1,0,11,1,10,283,0,0,21,5,16,680,1,0,0,0,0,0,0,0,0,0,0,0,0,0
1162,1162,Ralf Fährmann,1835,2019,Norwich City,0,0,0,0,0,0,1,1,0,22,0,0,1,1,0,22,0,0,0,0,0,0,0,0,0,0,0,0,0,0
1163,1163,Michael McGovern,1836,2019,Norwich City,1,1,0,90,0,0,1,0,1,68,0,0,2,1,1,158,0,0,0,0,0,0,0,0,0,0,0,0,0,0
1164,1164,Grant Hanley,1837,2019,Norwich City,8,7,1,642,0,0,7,7,0,620,0,0,15,14,1,1262,0,0,0,0,0,0,0,0,0,0,0,0,0,0
1165,1165,Philip Heise,1838,2019,Norwich City,0,0,0,0,0,0,0,0,0,0,0,0,0,0,0,0,0,0,0,0,0,0,0,0,0,0,0,0,0,0
1166,1166,Adam Idah,1839,2019,Norwich City,6,0,6,69,0,0,6,1,5,150,0,0,12,1,11,219,0,0,0,0,0,0,0,0,0,0,0,0,0,0
1167,1167,Ederson,1195,2019,Manchester City,17,17,0,1530,0,0,18,18,0,1620,0,0,35,35,0,3150,0,0,0,0,0,0,0,0,0,0,0,0,0,0
1168,1168,Kyle Walker,1196,2019,Manchester City,14,13,1,1073,1,0,15,15,0,1324,0,0,29,28,1,2397,1,0,3,0,3,1,0,1,0,0,0,0,0,0
1169,1169,John Stones,1197,2019,Manchester City,8,7,1,624,0,0,8,5,3,495,0,0,16,12,4,1119,0,0,0,0,0,0,0,0,0,0,0,0,0,0
1170,1170,Oleksandr Zinchenko,1210,2019,Manchester City,7,5,2,507,0,0,12,8,4,795,0,0,19,13,6,1302,0,0,0,0,0,0,0,0,0,0,0,0,0,0
1171,1171,Nicolás Otamendi,1199,2019,Manchester City,12,9,3,826,2,0,12,9,3,885,0,0,24,18,6,1711,2,0,0,0,0,0,0,0,0,0,0,0,0,0
1172,1172,İlkay Gündoğan,1200,2019,Manchester City,17,10,7,1057,2,0,14,11,3,958,0,0,31,21,10,2015,2,0,0,0,0,1,0,1,1,0,1,0,0,0
1173,1173,Rodri,1840,2019,Manchester City,17,13,4,1082,1,0,18,16,2,1406,2,0,35,29,6,2488,3,0,0,0,0,1,0,1,0,0,0,0,0,0
1174,1174,David Silva,1211,2019,Manchester City,16,14,2,1122,5,0,11,8,3,711,1,0,27,22,5,1833,6,0,0,0,0,2,0,2,0,0,0,0,0,0
1175,1175,Raheem Sterling,1203,2019,Manchester City,16,13,3,1215,6,0,17,17,0,1445,14,0,33,30,3,2660,20,0,0,0,0,3,4,7,0,0,0,0,0,0
1176,1176,Kun Agüero,1204,2019,Manchester City,13,10,3,834,8,0,11,8,3,623,8,0,24,18,6,1457,16,0,0,3,3,5,2,7,1,1,2,0,0,0
1177,1177,Bernardo Silva,1207,2019,Manchester City,17,11,6,972,4,0,17,12,5,1058,2,0,34,23,11,2030,6,0,0,0,0,0,0,0,0,0,0,0,0,0
1178,1178,Kevin De Bruyne,1201,2019,Manchester City,17,16,1,1403,9,0,18,16,2,1397,4,0,35,32,3,2800,13,0,0,0,0,3,3,6,2,0,2,0,0,0
1179,1179,Gabriel Jesus,1841,2019,Manchester City,17,10,7,987,6,0,17,11,6,1039,8,0,34,21,13,2026,14,0,0,3,3,3,5,8,0,0,0,0,0,0
1180,1180,Riyad Mahrez,1842,2019,Manchester City,16,10,6,942,7,0,17,11,6,999,4,0,33,21,12,1941,11,0,3,0,3,2,2,4,1,0,1,0,0,0
1181,1181,Claudio Bravo,1208,2019,Manchester City,2,2,0,180,0,0,2,1,1,166,0,0,4,3,1,346,0,0,0,0,0,0,0,0,0,0,0,0,0,0
1182,1182,João Cancelo,1843,2019,Manchester City,10,8,2,729,0,0,7,5,2,477,0,0,17,13,4,1206,0,0,0,0,0,0,0,0,0,0,0,0,0,0
1183,1183,Fernandinho,1202,2019,Manchester City,15,12,3,1168,0,0,15,14,1,1246,0,0,30,26,4,2414,0,0,0,0,0,0,0,0,0,0,0,0,0,0
1184,1184,Phil Foden,1844,2019,Manchester City,13,6,7,532,4,0,10,3,7,361,1,0,23,9,14,893,5,0,0,0,0,1,0,1,0,0,0,0,0,0
1185,1185,Willy Caballero,1588,2018,Chelsea FC,1,1,0,90,0,0,1,1,0,90,0,0,2,2,0,180,0,0,0,0,0,0,0,0,0,0,0,0,0,0
1186,1186,Antonio Rüdiger,1845,2018,Chelsea FC,15,15,0,1350,1,0,18,18,0,1524,0,0,33,33,0,2874,1,0,0,0,0,1,0,1,0,0,0,0,0,0
1187,1187,Marcos Alonso,1846,2018,Chelsea FC,15,15,0,1338,1,0,16,16,0,1423,1,0,31,31,0,2761,2,0,3,1,4,1,1,2,0,0,0,0,0,0
1188,1188,Azpilicueta,1535,2018,Chelsea FC,19,19,0,1693,0,0,19,19,0,1710,1,0,38,38,0,3403,1,0,0,0,0,0,1,1,0,0,0,0,0,0
1189,1189,David Luiz,1471,2018,Chelsea FC,19,19,0,1709,3,0,17,17,0,1530,0,0,36,36,0,3239,3,0,0,0,0,0,0,0,0,0,0,0,0,0
1190,1190,Jorginho,1847,2018,Chelsea FC,19,19,0,1621,0,0,18,18,0,1544,2,0,37,37,0,3165,2,0,0,3,3,0,1,1,0,1,1,0,0,0
1191,1191,N'Golo Kanté,1848,2018,Chelsea FC,19,19,0,1579,2,0,17,17,0,1517,2,0,36,36,0,3096,4,0,0,3,3,2,2,4,0,0,0,0,0,0
1192,1192,Mateo Kovačić,1849,2018,Chelsea FC,17,12,5,968,0,0,15,9,6,775,0,0,32,21,11,1743,0,0,0,0,0,0,0,0,0,0,0,0,0,0
1193,1193,Gonzalo Higuaín,1850,2018,Chelsea FC,6,6,0,496,4,0,8,7,1,596,1,0,14,13,1,1092,5,0,0,0,0,2,1,3,0,0,0,0,0,0
1194,1194,Eden Hazard,1541,2018,Chelsea FC,19,17,2,1527,11,0,18,15,3,1399,5,0,37,32,5,2926,16,0,1,3,4,5,4,9,2,2,4,0,0,0
1195,1195,Pedro,1851,2018,Chelsea FC,15,10,5,958,6,0,16,11,5,822,2,0,31,21,10,1780,8,0,0,0,0,5,1,6,0,0,0,0,0,0
1196,1196,Ruben Loftus-Cheek,1852,2018,Chelsea FC,12,3,9,507,3,0,12,3,9,476,3,0,24,6,18,983,6,0,0,3,3,1,2,3,0,0,0,0,0,0
1197,1197,Olivier Giroud,1504,2018,Chelsea FC,14,4,10,447,1,0,13,3,10,386,1,0,27,7,20,833,2,0,0,0,0,1,0,1,0,0,0,0,0,0
1198,1198,Willian,1538,2018,Chelsea FC,15,11,4,833,2,0,17,15,2,1275,1,0,32,26,6,2108,3,0,3,0,3,1,0,1,0,0,0,0,0,0
1199,1199,Kepa,1853,2018,Chelsea FC,18,18,0,1620,0,0,18,18,0,1620,0,0,36,36,0,3240,0,0,0,0,0,0,0,0,0,0,0,0,0,0
1200,1200,Andreas Christensen,1854,2018,Chelsea FC,4,4,0,360,0,0,4,2,2,255,0,0,8,6,2,615,0,0,0,0,0,0,0,0,0,0,0,0,0,0
1201,1201,Ross Barkley,1754,2018,Chelsea FC,11,4,7,432,1,0,16,9,7,809,2,0,27,13,14,1241,3,0,1,0,1,1,0,1,0,0,0,0,0,0
1202,1202,Callum Hudson-Odoi,1855,2018,Chelsea FC,6,3,3,267,0,0,4,1,3,129,0,0,10,4,6,396,0,0,0,0,0,0,0,0,0,0,0,0,0,0
1203,1203,Hugo Lloris,1160,2018,Tottenham Hotspur,18,18,0,1620,0,0,15,15,0,1350,0,0,33,33,0,2970,0,0,0,0,0,0,0,0,0,0,0,0,0,0
1204,1204,Kieran Trippier,1487,2018,Tottenham Hotspur,14,13,1,1188,1,0,13,13,0,1090,0,0,27,26,1,2278,1,0,0,0,0,1,0,1,0,0,0,0,0,0
1205,1205,Toby Alderweireld,1147,2018,Tottenham Hotspur,18,17,1,1549,0,0,16,16,0,1375,0,0,34,33,1,2924,0,0,0,0,0,0,0,0,0,0,0,0,0,0
1206,1206,Davinson Sánchez,1856,2018,Tottenham Hotspur,10,10,0,873,1,0,13,12,1,1070,0,0,23,22,1,1943,1,0,0,0,0,1,0,1,0,0,0,0,0,0
1207,1207,Ben Davies,1164,2018,Tottenham Hotspur,13,10,3,916,0,0,14,10,4,923,0,0,27,20,7,1839,0,0,0,0,0,0,0,0,0,0,0,0,0,0
1208,1208,Harry Winks,1857,2018,Tottenham Hotspur,13,9,4,832,0,0,13,8,5,759,1,0,26,17,9,1591,1,0,0,3,3,0,1,1,0,0,0,0,0,0
1209,1209,Moussa Sissoko,1858,2018,Tottenham Hotspur,15,14,1,1187,0,0,14,13,1,1150,0,0,29,27,2,2337,0,0,0,0,0,0,0,0,0,0,0,0,0,0
1210,1210,Christian Eriksen,1165,2018,Tottenham Hotspur,18,16,2,1457,6,0,17,14,3,1315,2,0,35,30,5,2772,8,0,7,0,7,4,0,4,0,0,0,0,0,0
1211,1211,Heung-min Son,1859,2018,Tottenham Hotspur,16,13,3,1161,8,0,15,10,5,965,4,0,31,23,8,2126,12,0,3,0,3,3,2,5,0,0,0,0,0,0
1212,1212,Harry Kane,1169,2018,Tottenham Hotspur,12,12,0,1066,6,0,16,15,1,1361,11,0,28,27,1,2427,17,0,1,0,1,3,7,10,1,3,4,0,0,0
1213,1213,Érik Lamela,1168,2018,Tottenham Hotspur,11,4,7,493,1,0,8,5,3,478,3,0,19,9,10,971,4,0,0,3,3,0,2,2,0,0,0,0,0,0
1214,1214,Danny Rose,1399,2018,Tottenham Hotspur,13,11,2,969,0,0,13,9,4,829,0,0,26,20,6,1798,0,0,0,0,0,0,0,0,0,0,0,0,0,0
1215,1215,Llorente,1860,2018,Tottenham Hotspur,11,5,6,508,1,0,9,1,8,176,0,0,20,6,14,684,1,0,3,0,3,1,0,1,0,0,0,0,0,0
1216,1216,Lucas,1861,2018,Tottenham Hotspur,15,12,3,1040,6,0,17,13,4,1087,4,0,32,25,7,2127,10,0,0,0,0,1,1,2,0,0,0,0,0,0
1217,1217,Paulo Gazzaniga,1156,2018,Tottenham Hotspur,0,0,0,0,0,0,3,3,0,270,0,0,3,3,0,270,0,0,0,0,0,0,0,0,0,0,0,0,0,0
1218,1218,Juan Foyth,1862,2018,Tottenham Hotspur,6,5,1,451,0,0,6,5,1,480,1,0,12,10,2,931,1,0,0,3,3,0,1,1,0,0,0,0,0,0
1219,1219,Serge Aurier,1863,2018,Tottenham Hotspur,2,2,0,136,0,0,6,4,2,428,0,0,8,6,2,564,0,0,0,0,0,0,0,0,0,0,0,0,0,0
1220,1220,Victor Wanyama,1864,2018,Tottenham Hotspur,9,3,6,303,1,0,4,1,3,207,0,0,13,4,9,510,1,0,0,0,0,1,0,1,0,0,0,0,0,0
1221,1221,Jack Wilshere,1694,2015,Arsenal FC,1,1,0,69,0,0,2,0,2,72,0,0,3,1,2,141,0,0,0,0,0,0,0,0,0,0,0,0,0,0
1222,1222,Santi Cazorla,1502,2015,Arsenal FC,7,7,0,584,0,0,8,8,0,720,0,0,15,15,0,1304,0,0,0,0,0,0,0,0,0,0,0,0,0,0
1223,1223,Francis Coquelin,1503,2015,Arsenal FC,14,11,3,939,0,0,12,10,2,742,0,0,26,21,5,1681,0,0,0,0,0,0,0,0,0,0,0,0,0,0
1224,1224,Alexis Sánchez,1505,2015,Arsenal FC,15,13,2,1174,6,0,15,15,0,1272,7,0,30,28,2,2446,13,0,0,2,2,4,4,8,0,0,0,0,0,0
1225,1225,Mikel Arteta,1802,2015,Arsenal FC,3,0,3,21,0,0,6,0,6,181,0,0,9,0,9,202,0,0,0,0,0,0,0,0,0,0,0,0,0,0
1226,1226,Mohamed Elneny,1865,2015,Arsenal FC,5,4,1,375,0,0,6,5,1,419,0,0,11,9,2,794,0,0,0,0,0,0,0,0,0,0,0,0,0,0
1227,1227,Mark Bunn,1380,2015,Aston Villa,5,5,0,450,0,0,5,5,0,450,0,0,10,10,0,900,0,0,0,0,0,0,0,0,0,0,0,0,0,0
1228,1228,Leandro Bacuna,1438,2015,Aston Villa,16,13,3,1179,0,0,15,14,1,1239,1,0,31,27,4,2418,1,0,0,0,0,0,0,0,0,0,0,0,0,0
1229,1229,Joleon Lescott,1365,2015,Aston Villa,15,15,0,1306,2,0,15,15,0,1325,1,0,30,30,0,2631,3,0,3,0,3,2,1,3,0,0,0,0,0,0
1230,1230,Aly Cissokho,1422,2015,Aston Villa,9,9,0,810,0,0,9,9,0,810,0,0,18,18,0,1620,0,0,0,0,0,0,0,0,0,0,0,0,0,0
1231,1231,Kevin Toner,1866,2015,Aston Villa,2,1,1,134,0,0,2,2,0,180,0,0,4,3,1,314,0,0,0,0,0,0,0,0,0,0,0,0,0,0
1232,1232,Idrissa Gueye,1054,2015,Aston Villa,18,18,0,1592,0,0,17,17,0,1484,0,0,35,35,0,3076,0,0,0,0,0,0,0,0,0,0,0,0,0,0
1233,1233,Scott Sinclair,1420,2015,Aston Villa,13,10,3,807,2,0,14,9,5,791,0,0,27,19,8,1598,2,0,0,0,0,2,0,2,1,0,1,0,0,0
1234,1234,Ashley Westwood,1440,2015,Aston Villa,15,15,0,1316,2,0,17,16,1,1403,0,0,32,31,1,2719,2,0,0,0,0,0,0,0,0,0,0,0,0,0
1235,1235,Carlos Sánchez,1867,2015,Aston Villa,10,9,1,717,0,0,10,7,3,653,0,0,20,16,4,1370,0,0,0,0,0,0,0,0,0,0,0,0,0,0
1236,1236,Jordan Lyden,1868,2015,Aston Villa,3,1,2,78,0,0,1,1,0,75,0,0,4,2,2,153,0,0,0,0,0,0,0,0,0,0,0,0,0,0
1237,1237,Jordan Ayew,1869,2015,Aston Villa,15,14,1,1254,4,0,15,13,2,1173,3,0,30,27,3,2427,7,0,1,1,2,2,2,4,1,0,1,0,0,0
1238,1238,Micah Richards,1364,2015,Aston Villa,12,12,0,1031,1,0,12,11,1,1015,0,0,24,23,1,2046,1,0,0,0,0,1,0,1,0,0,0,0,0,0
1239,1239,Jack Grealish,1870,2015,Aston Villa,7,2,5,272,0,0,9,7,2,559,1,0,16,9,7,831,1,0,0,0,0,0,1,1,0,0,0,0,0,0
1240,1240,Brad Guzan,1435,2015,Aston Villa,14,14,0,1260,0,0,14,14,0,1260,0,0,28,28,0,2520,0,0,0,0,0,0,0,0,0,0,0,0,0,0
1241,1241,Adama Traoré,1871,2015,Aston Villa,5,0,5,56,0,0,5,0,5,129,0,0,10,0,10,185,0,0,0,0,0,0,0,0,0,0,0,0,0,0
1242,1242,Carles Gil,1872,2015,Aston Villa,14,9,5,820,0,0,9,8,1,620,2,0,23,17,6,1440,2,0,0,0,0,0,1,1,0,0,0,0,0,0
1243,1243,Rushian Hepburn-Murphy,1873,2015,Aston Villa,1,0,1,1,0,0,0,0,0,0,0,0,1,0,1,1,0,0,0,0,0,0,0,0,0,0,0,0,0,0
1244,1244,Rudy Gestede,1874,2015,Aston Villa,15,7,8,808,2,0,17,7,10,856,3,0,32,14,18,1664,5,0,1,3,4,1,1,2,0,0,0,0,0,0
1245,1245,Nicky Weaver,1875,2006,Manchester City,13,13,0,1115,0,0,12,12,0,1036,0,0,25,25,0,2151,0,0,0,0,0,0,0,0,0,0,0,0,0,0
1246,1246,Micah Richards,1364,2006,Manchester City,14,14,0,1200,0,0,14,14,0,1147,1,0,28,28,0,2347,1,0,0,1,1,0,1,1,0,0,0,0,0,0
1247,1247,Ben Thatcher,1807,2006,Manchester City,6,6,0,506,0,0,5,5,0,450,0,0,11,11,0,956,0,0,0,0,0,0,0,0,0,0,0,0,0,0
1248,1248,Sylvain Distin,1015,2006,Manchester City,19,19,0,1710,0,0,18,18,0,1546,2,0,37,37,0,3256,2,0,0,0,0,0,1,1,0,0,0,0,0,0
1249,1249,Richard Dunne,1617,2006,Manchester City,19,19,0,1710,1,0,19,19,0,1710,0,0,38,38,0,3420,1,0,3,0,3,1,0,1,0,0,0,0,0,0
1250,1250,Claudio Reyna,1634,2006,Manchester City,8,6,2,486,0,0,7,6,1,474,0,0,15,12,3,960,0,0,0,0,0,0,0,0,0,0,0,0,0,0
1251,1251,Joey Barton,1876,2006,Manchester City,16,16,0,1440,3,0,17,17,0,1530,3,0,33,33,0,2970,6,0,3,0,3,1,2,3,1,0,1,0,0,0
1252,1252,DaMarcus Beasley,1877,2006,Manchester City,7,6,1,536,0,0,11,5,6,490,3,0,18,11,7,1026,3,0,0,3,3,0,2,2,0,0,0,0,0,0
1253,1253,Trevor Sinclair,1628,2006,Manchester City,10,7,3,653,0,0,8,7,1,639,0,0,18,14,4,1292,0,0,0,0,0,0,0,0,0,0,0,0,0,0
1254,1254,Paul Dickov,1878,2006,Manchester City,10,6,4,550,0,0,6,3,3,267,0,0,16,9,7,817,0,0,0,0,0,0,0,0,0,0,0,0,0,0
1255,1255,Georgios Samaras,1814,2006,Manchester City,17,10,7,918,4,0,19,6,13,778,0,0,36,16,20,1696,4,0,0,0,0,2,0,2,1,0,1,0,0,0
1256,1256,Hatem Trabelsi,1879,2006,Manchester City,11,10,1,832,0,0,9,6,3,537,1,0,20,16,4,1369,1,0,0,0,0,0,0,0,0,0,0,0,0,0
1257,1257,Darius Vassell,1798,2006,Manchester City,16,15,1,1317,0,0,16,13,3,1249,3,0,32,28,4,2566,3,0,0,0,0,0,2,2,0,0,0,0,0,0
1258,1258,Bernardo Corradi,1880,2006,Manchester City,11,8,3,635,2,0,14,11,3,979,1,0,25,19,6,1614,3,0,0,0,0,1,1,2,0,0,0,0,0,0
1259,1259,Mark Schwarzer,1328,2006,Middlesbrough FC,18,18,0,1620,0,0,17,17,0,1530,0,0,35,35,0,3150,0,0,0,0,0,0,0,0,0,0,0,0,0,0
1260,1260,Stuart Parnaby,1881,2006,Middlesbrough FC,10,4,6,475,0,0,8,5,3,380,0,0,18,9,9,855,0,0,0,0,0,0,0,0,0,0,0,0,0,0
1261,1261,Jonathan Woodgate,1882,2006,Middlesbrough FC,14,14,0,1159,0,0,15,15,0,1350,0,0,29,29,0,2509,0,0,0,0,0,0,0,0,0,0,0,0,0,0
1262,1262,Emanuel Pogatetz,1883,2006,Middlesbrough FC,17,17,0,1405,2,0,17,17,0,1509,0,0,34,34,0,2914,2,0,0,0,0,1,0,1,0,0,0,0,0,0
1263,1263,Robert Huth,1884,2006,Middlesbrough FC,7,4,3,412,0,0,4,3,1,291,1,0,11,7,4,703,1,0,0,0,0,0,1,1,0,0,0,0,0,0
1264,1264,George Boateng,1333,2006,Middlesbrough FC,18,18,0,1566,1,0,16,16,0,1398,0,0,34,34,0,2964,1,0,0,0,0,1,0,1,0,0,0,0,0,0
1265,1265,Fábio Rochemback,1885,2006,Middlesbrough FC,10,8,2,763,2,0,10,9,1,775,0,0,20,17,3,1538,2,0,0,0,0,1,0,1,0,0,0,0,0,0
1266,1266,Stewart Downing,1335,2006,Middlesbrough FC,17,17,0,1528,1,0,16,16,0,1422,1,0,33,33,0,2950,2,0,0,0,0,0,1,1,0,0,0,0,0,0
1267,1267,Lee Cattermole,1687,2006,Middlesbrough FC,15,11,4,980,0,0,15,11,4,960,1,0,30,22,8,1940,1,0,0,0,0,0,1,1,0,0,0,0,0,0
1268,1268,Jason Euell,1886,2006,Middlesbrough FC,6,5,1,412,0,0,10,3,7,314,0,0,16,8,8,726,0,0,0,0,0,0,0,0,0,0,0,0,0,0
1269,1269,Yakubu Ayegbeni,1073,2006,Middlesbrough FC,19,18,1,1599,8,0,17,17,0,1483,4,0,36,35,1,3082,12,0,4,0,4,6,2,8,3,1,4,0,0,0
1270,1270,Matthew Bates,1887,2006,Middlesbrough FC,0,0,0,0,0,0,1,0,1,68,0,0,1,0,1,68,0,0,0,0,0,0,0,0,0,0,0,0,0,0
1271,1271,James Morrison,1735,2006,Middlesbrough FC,13,5,8,586,1,0,14,10,4,891,1,0,27,15,12,1477,2,0,0,0,0,1,1,2,0,0,0,0,0,0
1272,1272,Massimo Maccarone,1888,2006,Middlesbrough FC,4,0,4,65,1,0,2,0,2,30,0,0,6,0,6,95,1,0,3,0,3,1,0,1,0,0,0,0,0,0
1273,1273,Pepe Reina,1775,2008,Liverpool FC,19,19,0,1710,0,0,19,19,0,1710,0,0,38,38,0,3420,0,0,0,0,0,0,0,0,0,0,0,0,0,0
1274,1274,Emiliano Insúa,1889,2008,Liverpool FC,3,3,0,270,0,0,7,6,1,576,0,0,10,9,1,846,0,0,0,0,0,0,0,0,0,0,0,0,0,0
1275,1275,Jamie Carragher,1778,2008,Liverpool FC,19,19,0,1710,0,0,19,19,0,1691,0,0,38,38,0,3401,0,0,0,0,0,0,0,0,0,0,0,0,0,0
1276,1276,Martin Škrtel,1423,2008,Liverpool FC,9,9,0,810,0,0,12,11,1,1001,0,0,21,20,1,1811,0,0,0,0,0,0,0,0,0,0,0,0,0,0
1277,1277,Steven Gerrard,1424,2008,Liverpool FC,15,14,1,1231,8,0,16,16,0,1400,8,0,31,30,1,2631,16,0,7,0,7,4,4,8,3,1,4,0,0,0
1278,1278,Albert Riera,1890,2008,Liverpool FC,18,16,2,1275,3,0,10,8,2,626,0,0,28,24,4,1901,3,0,0,0,0,2,0,2,0,0,0,0,0,0
1279,1279,Xabi Alonso,1891,2008,Liverpool FC,18,16,2,1439,0,0,15,11,4,1121,4,0,33,27,6,2560,4,0,0,3,3,0,3,3,0,1,1,0,0,0
1280,1280,Yossi Benayoun,1892,2008,Liverpool FC,17,12,5,1112,5,0,15,9,6,777,3,0,32,21,11,1889,8,0,1,3,4,3,2,5,0,0,0,0,0,0
1281,1281,Javier Mascherano,1893,2008,Liverpool FC,12,12,0,1032,0,0,15,15,0,1279,0,0,27,27,0,2311,0,0,0,0,0,0,0,0,0,0,0,0,0,0
1282,1282,Dirk Kuyt,1894,2008,Liverpool FC,19,19,0,1654,5,0,19,17,2,1526,7,0,38,36,2,3180,12,0,4,3,7,4,4,8,0,0,0,0,0,0
1283,1283,David N'Gog,1895,2008,Liverpool FC,8,1,7,137,2,0,6,1,5,176,0,0,14,2,12,313,2,0,0,0,0,1,0,1,0,0,0,0,0,0
1284,1284,Lucas Leiva,1429,2008,Liverpool FC,10,3,7,353,1,0,15,10,5,931,0,0,25,13,12,1284,1,0,0,0,0,0,0,0,0,0,0,0,0,0
1285,1285,Nabil El Zhar,1896,2008,Liverpool FC,9,0,9,114,0,0,6,1,5,123,0,0,15,1,14,237,0,0,0,0,0,0,0,0,0,0,0,0,0,0
1286,1286,Ryan Babel,1897,2008,Liverpool FC,14,1,13,262,1,0,13,5,8,571,2,0,27,6,21,833,3,0,3,0,3,1,0,1,0,0,0,0,0,0
1287,1287,Márton Fülöp,1213,2008,Sunderland AFC,12,12,0,1080,0,0,14,14,0,1260,0,0,26,26,0,2340,0,0,0,0,0,0,0,0,0,0,0,0,0,0
1288,1288,George McCartney,1340,2008,Sunderland AFC,7,7,0,610,0,0,9,9,0,810,0,0,16,16,0,1420,0,0,0,0,0,0,0,0,0,0,0,0,0,0
1289,1289,Danny Collins,1215,2008,Sunderland AFC,18,18,0,1592,1,0,17,17,0,1530,0,0,35,35,0,3122,1,0,0,0,0,1,0,1,0,0,0,0,0,0
1290,1290,Tal Ben Haim,1715,2008,Sunderland AFC,2,2,0,167,0,0,3,3,0,270,0,0,5,5,0,437,0,0,0,0,0,0,0,0,0,0,0,0,0,0
1291,1291,Anton Ferdinand,1686,2008,Sunderland AFC,14,14,0,1260,0,0,17,17,0,1530,0,0,31,31,0,2790,0,0,0,0,0,0,0,0,0,0,0,0,0,0
1292,1292,Dean Whitehead,1218,2008,Sunderland AFC,15,13,2,1232,0,0,19,17,2,1570,0,0,34,30,4,2802,0,0,0,0,0,0,0,0,0,0,0,0,0,0
1293,1293,Steed Malbranque,1086,2008,Sunderland AFC,17,16,1,1270,0,0,19,18,1,1418,1,0,36,34,2,2688,1,0,0,0,0,0,1,1,0,0,0,0,0,0
1294,1294,Kieran Richardson,1898,2008,Sunderland AFC,15,14,1,1210,3,0,17,17,0,1482,1,0,32,31,1,2692,4,0,3,0,3,3,1,4,0,0,0,0,0,0
1295,1295,Grant Leadbitter,1219,2008,Sunderland AFC,13,6,7,609,2,0,10,6,4,512,0,0,23,12,11,1121,2,0,0,0,0,2,0,2,0,0,0,0,0,0
1296,1296,Andy Reid,1220,2008,Sunderland AFC,18,14,4,1160,1,0,14,6,8,652,0,0,32,20,12,1812,1,0,0,0,0,0,0,0,0,0,0,0,0,0
1297,1297,Kenwyne Jones,1222,2008,Sunderland AFC,14,13,1,1194,6,0,15,12,3,1097,4,0,29,25,4,2291,10,0,3,1,4,4,3,7,0,0,0,0,0,0
1298,1298,Carlos Edwards,1217,2008,Sunderland AFC,11,3,8,407,0,0,11,3,8,372,0,0,22,6,16,779,0,0,0,0,0,0,0,0,0,0,0,0,0,0
1299,1299,Djibril Cissé,1899,2008,Sunderland AFC,17,17,0,1420,5,0,18,12,6,1099,5,0,35,29,6,2519,10,0,3,6,9,4,4,8,1,0,1,0,0,0
1300,1300,Daryl Murphy,1900,2008,Sunderland AFC,13,2,11,291,0,0,10,4,6,332,0,0,23,6,17,623,0,0,0,0,0,0,0,0,0,0,0,0,0,0
1301,1301,Jack Butland,1901,2017,Stoke City,17,17,0,1530,0,0,17,17,0,1530,0,0,34,34,0,3060,0,0,0,0,0,0,0,0,0,0,0,0,0,0
1302,1302,Erik Pieters,1545,2017,Stoke City,16,16,0,1393,0,0,15,14,1,1327,0,0,31,30,1,2720,0,0,0,0,0,0,0,0,0,0,0,0,0,0
1303,1303,Kevin Wimmer,1902,2017,Stoke City,7,6,1,577,0,0,10,8,2,744,0,0,17,14,3,1321,0,0,0,0,0,0,0,0,0,0,0,0,0,0
1304,1304,Kurt Zouma,1903,2017,Stoke City,16,14,2,1292,0,0,17,17,0,1506,1,0,33,31,2,2798,1,0,0,0,0,0,1,1,0,0,0,0,0,0
1305,1305,Geoff Cameron,1548,2017,Stoke City,8,7,1,605,0,0,11,9,2,832,0,0,19,16,3,1437,0,0,0,0,0,0,0,0,0,0,0,0,0,0
1306,1306,Joe Allen,1430,2017,Stoke City,18,18,0,1620,2,0,17,17,0,1432,0,0,35,35,0,3052,2,0,0,0,0,2,0,2,0,0,0,0,0,0
1307,1307,Xherdan Shaqiri,1904,2017,Stoke City,17,17,0,1404,4,0,18,18,0,1555,4,0,35,35,0,2959,8,0,1,0,1,4,4,8,0,0,0,0,0,0
1308,1308,Darren Fletcher,1730,2017,Stoke City,13,13,0,1050,0,0,14,12,2,1173,1,0,27,25,2,2223,1,0,0,3,3,0,1,1,0,0,0,0,0,0
1309,1309,Saido Berahino,1905,2017,Stoke City,10,1,9,274,0,0,5,2,3,210,0,0,15,3,12,484,0,0,0,0,0,0,0,0,0,0,0,0,0,0
1310,1310,Eric Maxim Choupo-Moting,1906,2017,Stoke City,14,13,1,1124,4,0,15,12,3,1045,1,0,29,25,4,2169,5,0,1,0,1,3,1,4,0,0,0,0,0,0
1311,1311,Mame Diouf,1584,2017,Stoke City,17,15,2,1341,5,0,18,15,3,1261,1,0,35,30,5,2602,6,0,3,0,3,3,0,3,0,0,0,0,0,0
1312,1312,Glen Johnson,1386,2017,Stoke City,7,6,1,454,0,0,2,1,1,96,0,0,9,7,2,550,0,0,0,0,0,0,0,0,0,0,0,0,0,0
1313,1313,Ibrahim Afellay,1907,2017,Stoke City,3,0,3,37,0,0,3,1,2,125,0,0,6,1,5,162,0,0,0,0,0,0,0,0,0,0,0,0,0,0
1314,1314,Peter Crouch,1273,2017,Stoke City,15,8,7,853,2,0,15,6,9,674,3,0,30,14,16,1527,5,0,4,4,8,2,3,5,0,0,0,0,0,0
1315,1315,Lee Grant,1908,2017,Stoke City,1,1,0,90,0,0,2,2,0,180,0,0,3,3,0,270,0,0,0,0,0,0,0,0,0,0,0,0,0,0
1316,1316,Josh Tymon,1909,2017,Stoke City,1,0,1,27,0,0,2,2,0,136,0,0,3,2,1,163,0,0,0,0,0,0,0,0,0,0,0,0,0,0
1317,1317,Charlie Adam,1554,2017,Stoke City,7,4,3,355,0,0,4,1,3,113,0,0,11,5,6,468,0,0,0,0,0,0,0,0,0,0,0,0,0,0
1318,1318,Ramadan Sobhi,1586,2017,Stoke City,10,5,5,464,1,0,13,7,6,768,1,0,23,12,11,1232,2,0,0,1,1,0,1,1,0,0,0,0,0,0
1319,1319,Fraser Forster,1240,2017,Southampton FC,11,11,0,990,0,0,9,9,0,810,0,0,20,20,0,1800,0,0,0,0,0,0,0,0,0,0,0,0,0,0
1320,1320,Cédric Soares,1910,2017,Southampton FC,16,16,0,1433,0,0,16,16,0,1364,0,0,32,32,0,2797,0,0,0,0,0,0,0,0,0,0,0,0,0,0
1321,1321,Maya Yoshida,1145,2017,Southampton FC,14,13,1,1174,1,0,10,10,0,882,1,0,24,23,1,2056,2,0,0,0,0,0,1,1,0,0,0,0,0,0
1322,1322,Virgil van Dijk,1241,2017,Southampton FC,6,6,0,540,0,0,6,5,1,453,0,0,12,11,1,993,0,0,0,0,0,0,0,0,0,0,0,0,0,0
1323,1323,Ryan Bertrand,1148,2017,Southampton FC,18,18,0,1607,0,0,17,17,0,1530,0,0,35,35,0,3137,0,0,0,0,0,0,0,0,0,0,0,0,0,0
1324,1324,Steven Davis,1149,2017,Southampton FC,15,10,5,920,1,0,8,7,1,601,2,0,23,17,6,1521,3,0,0,3,3,0,2,2,0,0,0,0,0,0
1325,1325,Dušan Tadić,1159,2017,Southampton FC,19,18,1,1511,5,0,17,16,1,1301,1,0,36,34,2,2812,6,0,3,0,3,4,0,4,1,0,1,0,0,0
1326,1326,Oriol Romeu,1243,2017,Southampton FC,17,17,0,1388,0,0,17,17,0,1515,1,0,34,34,0,2903,1,0,0,0,0,0,1,1,0,0,0,0,0,0
1327,1327,Mario Lemina,1911,2017,Southampton FC,11,10,1,844,0,0,14,10,4,879,1,0,25,20,5,1723,1,0,0,0,0,0,1,1,0,0,0,0,0,0
1328,1328,Nathan Redmond,1244,2017,Southampton FC,14,11,3,944,0,0,17,11,6,1001,1,0,31,22,9,1945,1,0,0,0,0,0,1,1,0,0,0,0,0,0
1329,1329,Shane Long,1154,2017,Southampton FC,14,6,8,647,1,0,16,9,7,930,1,0,30,15,15,1577,2,0,0,0,0,1,1,2,0,0,0,0,0,0
1330,1330,Sofiane Boufal,1912,2017,Southampton FC,14,5,9,611,1,0,12,6,6,603,1,0,26,11,15,1214,2,0,3,0,3,1,0,1,0,0,0,0,0,0
1331,1331,Charlie Austin,1245,2017,Southampton FC,14,6,8,580,5,0,10,4,6,449,2,0,24,10,14,1029,7,0,3,1,4,4,2,6,1,0,1,0,0,0
1332,1332,Manolo Gabbiadini,1913,2017,Southampton FC,15,7,8,674,3,0,13,4,9,400,2,0,28,11,17,1074,5,0,1,4,5,3,2,5,1,0,1,0,0,0
1333,1333,Alex McCarthy,1032,2017,Southampton FC,8,8,0,720,0,0,10,10,0,900,0,0,18,18,0,1620,0,0,0,0,0,0,0,0,0,0,0,0,0,0
1334,1334,Wesley Hoedt,1914,2017,Southampton FC,11,11,0,990,0,0,17,17,0,1530,0,0,28,28,0,2520,0,0,0,0,0,0,0,0,0,0,0,0,0,0
1335,1335,James Ward-Prowse,1150,2017,Southampton FC,16,10,6,856,0,0,14,10,4,861,3,0,30,20,10,1717,3,0,0,0,0,0,1,1,0,0,0,0,0,0
1336,1336,Pierre-Emile Højbjerg,1248,2017,Southampton FC,10,8,2,716,0,0,13,11,2,955,0,0,23,19,4,1671,0,0,0,0,0,0,0,0,0,0,0,0,0,0
1337,1337,Hugo Lloris,1160,2017,Tottenham Hotspur,18,18,0,1620,0,0,18,18,0,1620,0,0,36,36,0,3240,0,0,0,0,0,0,0,0,0,0,0,0,0,0
1338,1338,Kieran Trippier,1487,2017,Tottenham Hotspur,12,12,0,1073,0,0,12,9,3,841,0,0,24,21,3,1914,0,0,0,0,0,0,0,0,0,0,0,0,0,0
1339,1339,Jan Vertonghen,1161,2017,Tottenham Hotspur,18,18,0,1590,0,0,18,18,0,1615,0,0,36,36,0,3205,0,0,0,0,0,0,0,0,0,0,0,0,0,0
1340,1340,Davinson Sánchez,1856,2017,Tottenham Hotspur,16,14,2,1273,0,0,15,15,0,1300,0,0,31,29,2,2573,0,0,0,0,0,0,0,0,0,0,0,0,0,0
1341,1341,Eric Dier,1162,2017,Tottenham Hotspur,18,17,1,1485,0,0,16,15,1,1342,0,0,34,32,2,2827,0,0,0,0,0,0,0,0,0,0,0,0,0,0
1342,1342,Ben Davies,1164,2017,Tottenham Hotspur,14,12,2,1064,0,0,15,14,1,1261,2,0,29,26,3,2325,2,0,0,0,0,0,0,0,0,0,0,0,0,0
1343,1343,Mousa Dembélé,1172,2017,Tottenham Hotspur,13,10,3,895,0,0,15,11,4,990,0,0,28,21,7,1885,0,0,0,0,0,0,0,0,0,0,0,0,0,0
1344,1344,Dele Alli,1915,2017,Tottenham Hotspur,18,16,2,1415,4,0,18,18,0,1557,5,0,36,34,2,2972,9,0,0,0,0,2,3,5,0,0,0,0,0,0
1345,1345,Christian Eriksen,1165,2017,Tottenham Hotspur,19,19,0,1696,5,0,18,18,0,1530,5,0,37,37,0,3226,10,0,3,0,3,2,2,4,0,0,0,0,0,0
1346,1346,Heung-min Son,1859,2017,Tottenham Hotspur,19,16,3,1325,9,0,18,11,7,985,3,0,37,27,10,2310,12,0,4,1,5,4,2,6,0,0,0,0,0,0
1347,1347,Harry Kane,1169,2017,Tottenham Hotspur,19,19,0,1690,15,0,18,16,2,1394,15,0,37,35,2,3084,30,0,10,8,18,7,9,16,0,2,2,0,0,0
1348,1348,Victor Wanyama,1864,2017,Tottenham Hotspur,8,3,5,333,0,0,10,5,5,506,1,0,18,8,10,839,1,0,0,0,0,0,1,1,0,0,0,0,0,0
1349,1349,Moussa Sissoko,1858,2017,Tottenham Hotspur,17,6,11,651,0,0,16,9,7,744,1,0,33,15,18,1395,1,0,0,0,0,0,0,0,0,0,0,0,0,0
1350,1350,Érik Lamela,1168,2017,Tottenham Hotspur,12,3,9,343,2,0,13,4,9,489,0,0,25,7,18,832,2,0,0,0,0,1,0,1,0,0,0,0,0,0
1351,1351,Michel Vorm,1174,2017,Tottenham Hotspur,0,0,0,0,0,0,1,1,0,90,0,0,1,1,0,90,0,0,0,0,0,0,0,0,0,0,0,0,0,0
1352,1352,Toby Alderweireld,1147,2017,Tottenham Hotspur,7,6,1,547,0,0,7,7,0,630,0,0,14,13,1,1177,0,0,0,0,0,0,0,0,0,0,0,0,0,0
1353,1353,Serge Aurier,1863,2017,Tottenham Hotspur,8,7,1,656,1,0,9,9,0,792,1,0,17,16,1,1448,2,0,0,0,0,1,0,1,0,0,0,0,0,0
1354,1354,Lucas,1861,2017,Tottenham Hotspur,3,1,2,98,0,0,3,1,2,110,0,0,6,2,4,208,0,0,0,0,0,0,0,0,0,0,0,0,0,0
1355,1355,Orestis Karnezis,1916,2017,Watford FC,7,7,0,630,0,0,8,7,1,661,0,0,15,14,1,1291,0,0,0,0,0,0,0,0,0,0,0,0,0,0
1356,1356,Adrian Mariappa,1917,2017,Watford FC,13,12,1,1020,0,0,15,12,3,1188,0,0,28,24,4,2208,0,0,0,0,0,0,0,0,0,0,0,0,0,0
1357,1357,Craig Cathcart,1918,2017,Watford FC,4,2,2,268,0,0,3,3,0,270,0,0,7,5,2,538,0,0,0,0,0,0,0,0,0,0,0,0,0,0
1358,1358,Kiko Femenía,1919,2017,Watford FC,11,8,3,833,1,0,12,11,1,882,0,0,23,19,4,1715,1,0,0,0,0,1,0,1,0,0,0,0,0,0
1359,1359,José Cholevas,1920,2017,Watford FC,13,12,1,1076,0,0,15,14,1,1306,0,0,28,26,2,2382,0,0,0,0,0,0,0,0,0,0,0,0,0,0
1360,1360,Christian Kabasele,1921,2017,Watford FC,13,13,0,1144,1,0,15,14,1,1188,1,0,28,27,1,2332,2,0,0,0,0,1,0,1,0,0,0,0,0,0
1361,1361,Abdoulaye Doucouré,1922,2017,Watford FC,19,19,0,1705,4,0,18,18,0,1620,3,0,37,37,0,3325,7,0,1,0,1,2,2,4,0,0,0,0,0,0
1362,1362,Will Hughes,1923,2017,Watford FC,8,6,2,505,1,0,7,5,2,490,1,0,15,11,4,995,2,0,0,0,0,1,1,2,0,0,0,0,0,0
1363,1363,Étienne Capoue,1924,2017,Watford FC,12,9,3,807,0,0,11,9,2,735,1,0,23,18,5,1542,1,0,0,0,0,0,0,0,0,0,0,0,0,0
1364,1364,Richarlison,1461,2017,Watford FC,19,14,5,1265,1,0,19,18,1,1562,4,0,38,32,6,2827,5,0,0,4,4,0,4,4,0,0,0,0,0,0
1365,1365,Andre Gray,1925,2017,Watford FC,14,7,7,647,2,0,17,9,8,850,3,0,31,16,15,1497,5,0,0,0,0,0,1,1,0,0,0,0,0,0
1366,1366,André Carrillo,1926,2017,Watford FC,15,7,8,748,1,0,13,9,4,789,0,0,28,16,12,1537,1,0,0,0,0,1,0,1,0,0,0,0,0,0
1367,1367,Gerard Deulofeu,1927,2017,Watford FC,3,2,1,186,1,0,4,3,1,252,0,0,7,5,2,438,1,0,0,0,0,0,0,0,0,0,0,0,0,0
1368,1368,Troy Deeney,1928,2017,Watford FC,15,10,5,984,5,0,14,10,4,914,0,0,29,20,9,1898,5,0,6,0,6,4,0,4,3,0,3,0,0,0
1369,1369,Gomes,1266,2017,Watford FC,12,12,0,1080,0,0,12,12,0,1049,0,0,24,24,0,2129,0,0,0,0,0,0,0,0,0,0,0,0,0,0
1370,1370,Daryl Janmaat,1929,2017,Watford FC,12,12,0,994,1,0,11,9,2,828,2,0,23,21,2,1822,3,0,0,0,0,1,1,2,0,0,0,0,0,0
1371,1371,Miguel Britos,1930,2017,Watford FC,6,5,1,451,1,0,6,5,1,413,0,0,12,10,2,864,1,0,1,0,1,1,0,1,0,0,0,0,0,0
1372,1372,Jerome Sinclair,1931,2017,Watford FC,1,0,1,1,0,0,3,0,3,28,0,0,4,0,4,29,0,0,0,0,0,0,0,0,0,0,0,0,0,0
1373,1373,Mark Crossley,1932,2004,Fulham FC,4,3,1,297,0,0,2,2,0,180,0,0,6,5,1,477,0,0,0,0,0,0,0,0,0,0,0,0,0,0
1374,1374,Moritz Volz,1078,2004,Fulham FC,17,17,0,1516,0,0,12,12,0,1080,0,0,29,29,0,2596,0,0,0,0,0,0,0,0,0,0,0,0,0,0
1375,1375,Carlos Bocanegra,1081,2004,Fulham FC,14,13,1,1176,0,0,12,11,1,1018,1,0,26,24,2,2194,1,0,0,0,0,0,0,0,0,0,0,0,0,0
1376,1376,Zat Knight,1755,2004,Fulham FC,18,18,0,1620,1,0,15,15,0,1350,0,0,33,33,0,2970,1,0,0,0,0,0,0,0,0,0,0,0,0,0
1377,1377,Steed Malbranque,1086,2004,Fulham FC,13,12,1,1002,1,0,11,8,3,706,5,0,24,20,4,1708,6,0,0,0,0,0,2,2,0,1,1,0,0,0
1378,1378,Mark Pembridge,1933,2004,Fulham FC,13,12,1,1067,0,0,12,11,1,995,0,0,25,23,2,2062,0,0,0,0,0,0,0,0,0,0,0,0,0,0
1379,1379,Boa Morte,1085,2004,Fulham FC,16,14,2,1290,5,0,13,13,0,1134,3,0,29,27,2,2424,8,0,1,0,1,3,0,3,0,0,0,0,0,0
1380,1380,Papa Bouba Diop,1757,2004,Fulham FC,15,15,0,1334,4,0,12,12,0,1045,2,0,27,27,0,2379,6,0,4,3,7,3,2,5,0,0,0,0,0,0
1381,1381,Zeshan Rehman,1934,2004,Fulham FC,8,7,1,675,0,0,7,6,1,611,0,0,15,13,2,1286,0,0,0,0,0,0,0,0,0,0,0,0,0,0
1382,1382,Andy Cole,1113,2004,Fulham FC,16,14,2,1230,7,0,13,13,0,1104,5,0,29,27,2,2334,12,0,0,3,3,4,4,8,0,1,1,0,0,0
1383,1383,Collins John,1089,2004,Fulham FC,14,7,7,585,1,0,13,6,7,595,3,0,27,13,14,1180,4,0,0,1,1,1,3,4,0,0,0,0,0,0
1384,1384,Tomasz Radzinski,1935,2004,Fulham FC,18,13,5,1166,4,0,15,10,5,861,2,0,33,23,10,2027,6,0,3,0,3,1,1,2,0,0,0,0,0,0
1385,1385,Noureddine Naybet,1936,2004,Tottenham Hotspur,14,14,0,1219,1,0,13,13,0,1107,0,0,27,27,0,2326,1,0,0,0,0,1,0,1,0,0,0,0,0,0
1386,1386,Goran Bunjevčević,1937,2004,Tottenham Hotspur,2,1,1,97,0,0,1,1,0,90,0,0,3,2,1,187,0,0,0,0,0,0,0,0,0,0,0,0,0,0
1387,1387,Noé Pamarot,1387,2004,Tottenham Hotspur,11,11,0,971,0,0,12,12,0,981,1,0,23,23,0,1952,1,0,0,3,3,0,1,1,0,0,0,0,0,0
1388,1388,Ledley King,1119,2004,Tottenham Hotspur,19,19,0,1710,2,0,19,19,0,1710,0,0,38,38,0,3420,2,0,0,0,0,0,0,0,0,0,0,0,0,0
1389,1389,Sean Davis,1087,2004,Tottenham Hotspur,8,6,2,524,0,0,9,7,2,684,0,0,17,13,4,1208,0,0,0,0,0,0,0,0,0,0,0,0,0,0
1390,1390,Pedro Mendes,1390,2004,Tottenham Hotspur,12,10,2,935,1,0,12,12,0,1015,0,0,24,22,2,1950,1,0,0,0,0,0,0,0,0,0,0,0,0,0
1391,1391,Michael Brown,1122,2004,Tottenham Hotspur,11,10,1,834,0,0,13,10,3,859,1,0,24,20,4,1693,1,0,0,0,0,0,0,0,0,0,0,0,0,0
1392,1392,Reto Ziegler,1938,2004,Tottenham Hotspur,9,6,3,575,1,0,13,6,7,509,0,0,22,12,10,1084,1,0,0,0,0,0,0,0,0,0,0,0,0,0
1393,1393,Robbie Keane,1126,2004,Tottenham Hotspur,18,11,7,1023,8,0,17,12,5,1168,3,0,35,23,12,2191,11,0,4,3,7,3,3,6,1,0,1,0,0,0
1394,1394,Jermain Defoe,1127,2004,Tottenham Hotspur,18,15,3,1363,11,0,17,13,4,1158,2,0,35,28,7,2521,13,0,7,1,8,7,2,9,0,0,0,0,0,0
1395,1395,Simon Davies,1125,2004,Tottenham Hotspur,11,8,3,774,0,0,8,7,1,679,0,0,19,15,4,1453,0,0,0,0,0,0,0,0,0,0,0,0,0,0
1396,1396,Michael Carrick,1627,2004,Tottenham Hotspur,14,13,1,1198,0,0,15,13,2,1175,0,0,29,26,3,2373,0,0,0,0,0,0,0,0,0,0,0,0,0,0
1397,1397,Frédéric Kanouté,1130,2004,Tottenham Hotspur,16,11,5,997,6,0,16,11,5,1014,2,0,32,22,10,2011,8,0,0,3,3,2,2,4,0,0,0,0,0,0
1398,1398,Roy Carroll,1939,2005,West Ham United,9,9,0,810,0,0,10,10,0,900,0,0,19,19,0,1710,0,0,0,0,0,0,0,0,0,0,0,0,0,0
1399,1399,Tomáš Řepka,1625,2005,West Ham United,8,8,0,706,0,0,11,11,0,845,0,0,19,19,0,1551,0,0,0,0,0,0,0,0,0,0,0,0,0,0
1400,1400,Paul Konchesky,1560,2005,West Ham United,18,18,0,1620,1,0,18,18,0,1620,0,0,36,36,0,3240,1,0,0,0,0,0,0,0,0,0,0,0,0,0
1401,1401,Anton Ferdinand,1686,2005,West Ham United,18,18,0,1601,1,0,15,14,1,1283,1,0,33,32,1,2884,2,0,0,1,1,1,1,2,0,0,0,0,0,0
1402,1402,James Collins,1618,2005,West Ham United,6,6,0,495,0,0,8,7,1,639,2,0,14,13,1,1134,2,0,0,1,1,0,2,2,0,0,0,0,0,0
1403,1403,Carl Fletcher,1940,2005,West Ham United,7,4,3,372,1,0,4,1,3,206,0,0,11,5,6,578,1,0,0,0,0,1,0,1,0,0,0,0,0,0
1404,1404,Matthew Etherington,1557,2005,West Ham United,16,16,0,1341,1,0,17,17,0,1431,1,0,33,33,0,2772,2,0,0,0,0,0,0,0,0,0,0,0,0,0
1405,1405,Yossi Benayoun,1892,2005,West Ham United,18,17,1,1511,4,0,16,13,3,1192,1,0,34,30,4,2703,5,0,3,1,4,1,1,2,0,0,0,0,0,0
1406,1406,Hayden Mullins,1941,2005,West Ham United,17,17,0,1426,0,0,18,18,0,1542,0,0,35,35,0,2968,0,0,0,0,0,0,0,0,0,0,0,0,0,0
1407,1407,Marlon Harewood,1942,2005,West Ham United,19,14,5,1332,9,0,17,17,0,1490,5,0,36,31,5,2822,14,0,0,6,6,5,5,10,1,1,2,0,0,0
1408,1408,Bobby Zamora,1943,2005,West Ham United,17,8,9,807,0,0,16,8,8,747,6,0,33,16,17,1554,6,0,0,3,3,0,4,4,0,0,0,0,0,0
1409,1409,David Bellion,1944,2005,West Ham United,3,1,2,85,0,0,5,1,4,130,0,0,8,2,6,215,0,0,0,0,0,0,0,0,0,0,0,0,0,0
1410,1410,Jérémie Aliadiére,1530,2005,West Ham United,3,0,3,52,0,0,4,1,3,121,0,0,7,1,6,173,0,0,0,0,0,0,0,0,0,0,0,0,0,0
1411,1411,Shay Given,1581,2005,Newcastle United,19,19,0,1710,0,0,19,19,0,1710,0,0,38,38,0,3420,0,0,0,0,0,0,0,0,0,0,0,0,0,0
1412,1412,Robbie Elliott,1945,2005,Newcastle United,9,9,0,766,0,0,8,5,3,562,0,0,17,14,3,1328,0,0,0,0,0,0,0,0,0,0,0,0,0,0
1413,1413,Jean-Alain Boumsong,1946,2005,Newcastle United,15,14,1,1319,0,0,18,16,2,1434,0,0,33,30,3,2753,0,0,0,0,0,0,0,0,0,0,0,0,0,0
1414,1414,Titus Bramble,1411,2005,Newcastle United,12,12,0,1045,2,0,12,9,3,899,0,0,24,21,3,1944,2,0,3,0,3,2,0,2,0,0,0,0,0,0
1415,1415,Peter Ramage,1947,2005,Newcastle United,12,12,0,1080,0,0,11,11,0,945,0,0,23,23,0,2025,0,0,0,0,0,0,0,0,0,0,0,0,0,0
1416,1416,Nolberto Solano,1791,2005,Newcastle United,15,15,0,1244,6,0,14,12,2,980,0,0,29,27,2,2224,6,0,3,0,3,5,0,5,0,0,0,0,0,0
1417,1417,Amdy Faye,1070,2005,Newcastle United,11,6,5,678,0,0,11,8,3,661,0,0,22,14,8,1339,0,0,0,0,0,0,0,0,0,0,0,0,0,0
1418,1418,Scott Parker,1282,2005,Newcastle United,13,13,0,1150,0,0,13,13,0,1162,1,0,26,26,0,2312,1,0,0,0,0,0,1,1,0,0,0,0,0,0
1419,1419,Alan Shearer,1948,2005,Newcastle United,15,15,0,1336,6,0,17,16,1,1411,4,0,32,31,1,2747,10,0,0,0,0,2,2,4,3,1,4,0,0,0
1420,1420,Michael Owen,1949,2005,Newcastle United,4,4,0,360,1,0,7,6,1,524,6,0,11,10,1,884,7,0,3,0,3,1,3,4,0,0,0,0,0,0
1421,1421,Shola Ameobi,1950,2005,Newcastle United,16,13,3,1107,7,0,14,12,2,1028,2,0,30,25,5,2135,9,0,0,0,0,3,1,4,1,0,1,0,0,0
1422,1422,Lee Bowyer,1297,2005,Newcastle United,14,8,6,733,1,0,14,10,4,915,0,0,28,18,10,1648,1,0,0,0,0,1,0,1,0,0,0,0,0,0
1423,1423,Thomas Myhre,1951,2005,Charlton Athletic,10,10,0,900,0,0,10,10,0,900,0,0,20,20,0,1800,0,0,0,0,0,0,0,0,0,0,0,0,0,0
1424,1424,Luke Young,1952,2005,Charlton Athletic,16,16,0,1440,1,0,16,16,0,1395,0,0,32,32,0,2835,1,0,0,0,0,0,0,0,0,0,0,0,0,0
1425,1425,Hermann Hreiðarsson,1953,2005,Charlton Athletic,17,17,0,1530,0,0,17,17,0,1530,0,0,34,34,0,3060,0,0,0,0,0,0,0,0,0,0,0,0,0,0
1426,1426,Chris Perry,1954,2005,Charlton Athletic,13,13,0,1170,0,0,15,14,1,1267,1,0,28,27,1,2437,1,0,0,0,0,0,0,0,0,0,0,0,0,0
1427,1427,Radostin Kishishev,1668,2005,Charlton Athletic,18,17,1,1434,0,0,19,17,2,1463,0,0,37,34,3,2897,0,0,0,0,0,0,0,0,0,0,0,0,0,0
1428,1428,Jonathan Spector,1288,2005,Charlton Athletic,9,6,3,538,0,0,11,7,4,708,0,0,20,13,7,1246,0,0,0,0,0,0,0,0,0,0,0,0,0,0
1429,1429,Matt Holland,1955,2005,Charlton Athletic,13,11,2,917,0,0,10,9,1,825,1,0,23,20,3,1742,1,0,0,0,0,0,1,1,0,0,0,0,0,0
1430,1430,Darren Ambrose,1956,2005,Charlton Athletic,14,8,6,797,2,0,14,11,3,923,1,0,28,19,9,1720,3,0,0,0,0,1,1,2,0,0,0,0,0,0
1431,1431,Bryan Hughes,1957,2005,Charlton Athletic,17,11,6,1003,2,0,16,11,5,933,1,0,33,22,11,1936,3,0,0,0,0,2,0,2,0,0,0,0,0,0
1432,1432,Marcus Bent,1349,2005,Charlton Athletic,6,6,0,433,0,0,7,6,1,549,2,0,13,12,1,982,2,0,0,1,1,0,1,1,0,0,0,0,0,0
1433,1433,Darren Bent,1958,2005,Charlton Athletic,17,17,0,1497,12,0,19,19,0,1666,6,0,36,36,0,3163,18,0,9,3,12,9,3,12,2,1,3,0,0,0
1434,1434,Talal El-Karkouri,1959,2005,Charlton Athletic,6,2,4,236,0,0,4,2,2,201,0,0,10,4,6,437,0,0,0,0,0,0,0,0,0,0,0,0,0,0
1435,1435,Jason Euell,1886,2005,Charlton Athletic,3,1,2,163,0,0,7,4,3,380,1,0,10,5,5,543,1,0,0,0,0,0,1,1,0,0,0,0,0,0
1436,1436,Jay Bothroyd,1960,2005,Charlton Athletic,10,3,7,388,2,0,8,0,8,175,0,0,18,3,15,563,2,0,0,0,0,0,0,0,0,0,0,0,0,0
1437,1437,Thomas Sørensen,1090,2005,Aston Villa,18,18,0,1620,0,0,17,17,0,1530,0,0,35,35,0,3150,0,0,0,0,0,0,0,0,0,0,0,0,0,0
1438,1438,Jlloyd Samuel,1789,2005,Aston Villa,10,8,2,715,0,0,8,5,3,415,0,0,18,13,5,1130,0,0,0,0,0,0,0,0,0,0,0,0,0,0
1439,1439,Olof Mellberg,1790,2005,Aston Villa,10,10,0,900,0,0,16,16,0,1428,0,0,26,26,0,2328,0,0,0,0,0,0,0,0,0,0,0,0,0,0
1440,1440,Aaron Hughes,1561,2005,Aston Villa,16,16,0,1440,0,0,18,18,0,1490,0,0,34,34,0,2930,0,0,0,0,0,0,0,0,0,0,0,0,0,0
1441,1441,Liam Ridgewell,1772,2005,Aston Villa,16,15,1,1367,1,0,16,15,1,1362,4,0,32,30,2,2729,5,0,0,1,1,0,2,2,0,0,0,0,0,0
1442,1442,Gareth Barry,1418,2005,Aston Villa,16,16,0,1440,1,0,19,19,0,1607,2,0,35,35,0,3047,3,0,0,0,0,1,1,2,0,0,0,0,0,0
1443,1443,Gavin McCann,1096,2005,Aston Villa,14,14,0,1260,0,0,17,17,0,1521,1,0,31,31,0,2781,1,0,0,1,1,0,1,1,0,0,0,0,0,0
1444,1444,James Milner,1189,2005,Aston Villa,14,14,0,1174,1,0,13,13,0,1163,0,0,27,27,0,2337,1,0,0,0,0,1,0,1,0,0,0,0,0,0
1445,1445,Steven Davis,1149,2005,Aston Villa,16,16,0,1367,3,0,18,17,1,1503,1,0,34,33,1,2870,4,0,4,0,4,2,1,3,0,0,0,0,0,0
1446,1446,Juan Pablo Ángel,1795,2005,Aston Villa,14,4,10,632,1,0,16,7,9,777,2,0,30,11,19,1409,3,0,0,1,1,0,2,2,0,0,0,0,0,0
1447,1447,Milan Baroš,1961,2005,Aston Villa,14,13,1,1127,6,0,11,11,0,913,2,0,25,24,1,2040,8,0,6,3,9,4,1,5,0,1,1,0,0,0
1448,1448,Kevin Phillips,1100,2005,Aston Villa,12,11,1,854,1,0,10,8,2,567,3,0,22,19,3,1421,4,0,0,3,3,1,2,3,0,0,0,0,0,0
1449,1449,Luke Moore,1796,2005,Aston Villa,11,7,4,576,3,0,16,9,7,912,5,0,27,16,11,1488,8,0,1,0,1,3,3,6,0,0,0,0,0,0
1450,1450,Colin Doyle,1962,2007,Birmingham City,2,2,0,180,0,0,1,1,0,90,0,0,3,3,0,270,0,0,0,0,0,0,0,0,0,0,0,0,0,0
1451,1451,Stephen Kelly,1121,2007,Birmingham City,19,19,0,1710,0,0,19,19,0,1710,0,0,38,38,0,3420,0,0,0,0,0,0,0,0,0,0,0,0,0,0
1452,1452,Liam Ridgewell,1772,2007,Birmingham City,18,18,0,1606,1,0,17,17,0,1486,0,0,35,35,0,3092,1,0,0,0,0,1,0,1,0,0,0,0,0,0
1453,1453,Stuart Parnaby,1881,2007,Birmingham City,6,2,4,340,0,0,7,2,5,297,0,0,13,4,9,637,0,0,0,0,0,0,0,0,0,0,0,0,0,0
1454,1454,Sebastian Larsson,1402,2007,Birmingham City,18,16,2,1297,4,0,17,16,1,1374,2,0,35,32,3,2671,6,0,1,3,4,2,2,4,0,0,0,0,0,0
1455,1455,Mehdi Nafti,1517,2007,Birmingham City,13,9,4,863,0,0,13,10,3,902,0,0,26,19,7,1765,0,0,0,0,0,0,0,0,0,0,0,0,0,0
1456,1456,Olivier Kapo,1963,2007,Birmingham City,12,12,0,1032,3,0,14,10,4,986,2,0,26,22,4,2018,5,0,6,0,6,3,2,5,1,0,1,0,0,0
1457,1457,Fabrice Muamba,1964,2007,Birmingham City,19,19,0,1646,1,0,18,18,0,1552,1,0,37,37,0,3198,2,0,0,0,0,0,0,0,0,0,0,0,0,0
1458,1458,Mikael Forssell,1965,2007,Birmingham City,15,13,2,970,7,0,15,8,7,719,2,0,30,21,9,1689,9,0,0,0,0,4,1,5,0,0,0,0,0,0
1459,1459,Gary McSheffrey,1966,2007,Birmingham City,15,11,4,970,2,0,17,13,4,1079,1,0,32,24,8,2049,3,0,0,0,0,0,1,1,2,1,3,0,0,0
1460,1460,Garry O'Connor,1967,2007,Birmingham City,14,3,11,433,1,0,9,2,7,344,1,0,23,5,18,777,2,0,0,1,1,1,1,2,0,0,0,0,0,0
1461,1461,Cameron Jerome,1783,2007,Birmingham City,14,8,6,820,2,0,19,13,6,1167,5,0,33,21,12,1987,7,0,0,3,3,1,4,5,0,0,0,0,0,0
1462,1462,Craig Gordon,1691,2007,Sunderland AFC,16,16,0,1440,0,0,17,17,0,1530,0,0,33,33,0,2970,0,0,0,0,0,0,0,0,0,0,0,0,0,0
1463,1463,Paul McShane,1607,2007,Sunderland AFC,10,9,1,823,0,0,11,11,0,942,0,0,21,20,1,1765,0,0,0,0,0,0,0,0,0,0,0,0,0,0
1464,1464,Greg Halford,1968,2007,Sunderland AFC,3,3,0,270,0,0,5,5,0,430,0,0,8,8,0,700,0,0,0,0,0,0,0,0,0,0,0,0,0,0
1465,1465,Dickson Etuhu,1969,2007,Sunderland AFC,9,9,0,746,1,0,11,9,2,762,0,0,20,18,2,1508,1,0,0,0,0,1,0,1,0,0,0,0,0,0
1466,1466,David Connolly,1970,2007,Sunderland AFC,2,0,2,37,0,0,1,1,0,58,0,0,3,1,2,95,0,0,0,0,0,0,0,0,0,0,0,0,0,0
1467,1467,Stern John,1971,2007,Sunderland AFC,0,0,0,0,0,0,1,0,1,32,1,0,1,0,1,32,1,0,0,1,1,0,1,1,0,0,0,0,0,0
1468,1468,Brad Guzan,1435,2012,Aston Villa,18,18,0,1620,0,0,17,17,0,1530,0,0,35,35,0,3150,0,0,0,0,0,0,0,0,0,0,0,0,0,0
1469,1469,Ciaran Clark,1437,2012,Aston Villa,14,14,0,1260,0,0,14,13,1,1180,1,0,28,27,1,2440,1,0,0,0,0,0,1,1,0,0,0,0,0,0
1470,1470,Enda Stevens,1972,2012,Aston Villa,4,4,0,294,0,0,3,2,1,177,0,0,7,6,1,471,0,0,0,0,0,0,0,0,0,0,0,0,0,0
1471,1471,Nathan Baker,1973,2012,Aston Villa,13,13,0,1056,0,0,12,11,1,857,0,0,25,24,1,1913,0,0,0,0,0,0,0,0,0,0,0,0,0,0
1472,1472,Matthew Lowton,1250,2012,Aston Villa,18,18,0,1620,1,0,18,18,0,1557,1,0,36,36,0,3177,2,0,0,0,0,1,1,2,0,0,0,0,0,0
1473,1473,Brett Holman,1974,2012,Aston Villa,13,8,5,704,0,0,13,7,6,641,1,0,26,15,11,1345,1,0,0,0,0,0,1,1,0,0,0,0,0,0
1474,1474,Ashley Westwood,1440,2012,Aston Villa,15,14,1,1220,0,0,14,13,1,1185,0,0,29,27,2,2405,0,0,0,0,0,0,0,0,0,0,0,0,0,0
1475,1475,Barry Bannan,1975,2012,Aston Villa,12,10,2,901,0,0,11,7,4,636,0,0,23,17,6,1537,0,0,0,0,0,0,0,0,0,0,0,0,0,0
1476,1476,Gabriel Agbonlahor,1442,2012,Aston Villa,13,11,2,1001,2,0,15,13,2,1187,7,0,28,24,4,2188,9,0,0,9,9,1,6,7,0,0,0,0,0,0
1477,1477,Christian Benteke,1443,2012,Aston Villa,18,17,1,1496,11,0,15,14,1,1268,8,0,33,31,2,2764,19,0,6,0,6,6,5,11,2,1,3,0,0,0
1478,1478,Andreas Weimann,1441,2012,Aston Villa,16,13,3,1118,4,0,13,12,1,1045,3,0,29,25,4,2163,7,0,0,0,0,3,2,5,0,0,0,0,0,0
1479,1479,Eric Lichaj,1976,2012,Aston Villa,8,4,4,506,0,0,8,4,4,593,0,0,16,8,8,1099,0,0,0,0,0,0,0,0,0,0,0,0,0,0
1480,1480,Stephen Ireland,1809,2012,Aston Villa,6,3,3,304,0,0,6,6,0,444,0,0,12,9,3,748,0,0,0,0,0,0,0,0,0,0,0,0,0,0
1481,1481,Marc Albrighton,1448,2012,Aston Villa,6,2,4,249,0,0,3,2,1,179,0,0,9,4,5,428,0,0,0,0,0,0,0,0,0,0,0,0,0,0
1482,1482,Shay Given,1581,2012,Aston Villa,1,1,0,90,0,0,1,1,0,90,0,0,2,2,0,180,0,0,0,0,0,0,0,0,0,0,0,0,0,0
1483,1483,Karim El Ahmadi,1439,2012,Aston Villa,10,6,4,569,1,0,10,6,4,602,0,0,20,12,8,1171,1,0,0,0,0,0,0,0,0,0,0,0,0,0
1484,1484,Fabian Delph,1198,2012,Aston Villa,12,9,3,833,0,0,12,10,2,870,0,0,24,19,5,1703,0,0,0,0,0,0,0,0,0,0,0,0,0,0
1485,1485,Jordan Bowery,1977,2012,Aston Villa,5,2,3,177,0,0,4,1,3,109,0,0,9,3,6,286,0,0,0,0,0,0,0,0,0,0,0,0,0,0
1486,1486,Adam Federici,1014,2012,Reading FC,12,12,0,1080,0,0,9,9,0,810,0,0,21,21,0,1890,0,0,0,0,0,0,0,0,0,0,0,0,0,0
1487,1487,Nicky Shorey,1731,2012,Reading FC,6,6,0,540,0,0,11,10,1,903,0,0,17,16,1,1443,0,0,0,0,0,0,0,0,0,0,0,0,0,0
1488,1488,Adrian Mariappa,1917,2012,Reading FC,15,15,0,1350,0,0,14,14,0,1260,1,0,29,29,0,2610,1,0,0,0,0,0,0,0,0,0,0,0,0,0
1489,1489,Sean Morrison,1978,2012,Reading FC,8,8,0,720,1,0,7,7,0,605,1,0,15,15,0,1325,2,0,0,0,0,1,1,2,0,0,0,0,0,0
1490,1490,Shaun Cummings,1979,2012,Reading FC,4,4,0,360,0,0,5,5,0,450,0,0,9,9,0,810,0,0,0,0,0,0,0,0,0,0,0,0,0,0
1491,1491,Mikele Leigertwood,1980,2012,Reading FC,15,14,1,1295,1,0,15,15,0,1350,0,0,30,29,1,2645,1,0,0,0,0,1,0,1,0,0,0,0,0,0
1492,1492,Joel McAnuff,1981,2012,Reading FC,19,19,0,1625,0,0,19,19,0,1649,0,0,38,38,0,3274,0,0,0,0,0,0,0,0,0,0,0,0,0,0
1493,1493,Jay Tabb,1982,2012,Reading FC,5,5,0,429,0,0,7,7,0,591,0,0,12,12,0,1020,0,0,0,0,0,0,0,0,0,0,0,0,0,0
1494,1494,Adam Le Fondre,1983,2012,Reading FC,18,5,13,750,8,0,16,6,10,739,4,0,34,11,23,1489,12,0,5,3,8,6,3,9,3,0,3,0,0,0
1495,1495,Hal Robson-Kanu,1984,2012,Reading FC,12,6,6,618,3,0,13,7,6,658,4,0,25,13,12,1276,7,0,1,0,1,2,1,3,0,1,1,0,0,0
1496,1496,Jason Roberts,1820,2012,Reading FC,5,4,1,339,0,0,6,4,2,368,0,0,11,8,3,707,0,0,0,0,0,0,0,0,0,0,0,0,0,0
1497,1497,Noel Hunt,1985,2012,Reading FC,12,5,7,445,1,0,12,5,7,506,1,0,24,10,14,951,2,0,0,0,0,1,0,1,0,0,0,0,0,0
1498,1498,Garath McCleary,1986,2012,Reading FC,16,6,10,709,1,0,15,9,6,862,2,0,31,15,16,1571,3,0,0,0,0,1,0,1,0,0,0,0,0,0
1499,1499,Stuart Taylor,1684,2012,Reading FC,1,1,0,90,0,0,3,3,0,270,0,0,4,4,0,360,0,0,0,0,0,0,0,0,0,0,0,0,0,0
1500,1500,Alex Pearce,1987,2012,Reading FC,8,8,0,720,0,0,11,10,1,925,0,0,19,18,1,1645,0,0,0,0,0,0,0,0,0,0,0,0,0,0
1501,1501,Ian Harte,1291,2012,Reading FC,10,9,1,824,0,0,6,6,0,537,0,0,16,15,1,1361,0,0,0,0,0,0,0,0,0,0,0,0,0,0
1502,1502,Brynjar Gunnarsson,1988,2012,Reading FC,0,0,0,0,0,0,0,0,0,0,0,0,0,0,0,0,0,0,0,0,0,0,0,0,0,0,0,0,0,0
1503,1503,Pavel Pogrebnyak,1989,2012,Reading FC,16,14,2,1151,2,0,13,12,1,919,3,0,29,26,3,2070,5,0,6,0,6,2,3,5,0,0,0,0,0,0
1504,1504,Thomas Sørensen,1090,2008,Stoke City,19,19,0,1686,0,0,17,16,1,1465,0,0,36,35,1,3151,0,0,0,0,0,0,0,0,0,0,0,0,0,0
1505,1505,Andy Griffin,1578,2008,Stoke City,9,8,1,732,0,0,11,9,2,867,0,0,20,17,3,1599,0,0,0,0,0,0,0,0,0,0,0,0,0,0
1506,1506,Danny Higginbotham,1990,2008,Stoke City,15,15,0,1350,1,0,13,13,0,1114,0,0,28,28,0,2464,1,0,0,0,0,1,0,1,1,0,1,0,0,0
1507,1507,Ryan Shawcross,1547,2008,Stoke City,14,13,1,1167,1,0,15,15,0,1285,2,0,29,28,1,2452,3,0,3,0,3,1,0,1,0,0,0,0,0,0
1508,1508,Abdoulaye Faye,1714,2008,Stoke City,18,18,0,1620,1,0,17,17,0,1486,2,0,35,35,0,3106,3,0,0,1,1,1,2,3,0,0,0,0,0,0
1509,1509,Tom Soares,1991,2008,Stoke City,4,4,0,287,0,0,3,1,2,125,0,0,7,5,2,412,0,0,0,0,0,0,0,0,0,0,0,0,0,0
1510,1510,Salif Diao,1992,2008,Stoke City,11,9,2,766,0,0,9,9,0,701,0,0,20,18,2,1467,0,0,0,0,0,0,0,0,0,0,0,0,0,0
1511,1511,Amdy Faye,1070,2008,Stoke City,13,10,3,897,0,0,9,9,0,648,0,0,22,19,3,1545,0,0,0,0,0,0,0,0,0,0,0,0,0,0
1512,1512,Rory Delap,1993,2008,Stoke City,17,17,0,1485,1,0,17,17,0,1428,1,0,34,34,0,2913,2,0,3,0,3,1,1,2,0,0,0,0,0,0
1513,1513,Mamady Sidibe,1994,2008,Stoke City,12,9,3,707,2,0,10,8,2,636,1,0,22,17,5,1343,3,0,6,0,6,2,0,2,0,0,0,0,0,0
1514,1514,Dave Kitson,1995,2008,Stoke City,8,6,2,367,0,0,8,4,4,408,0,0,16,10,6,775,0,0,0,0,0,0,0,0,0,0,0,0,0,0
1515,1515,Leon Cort,1996,2008,Stoke City,6,5,1,416,0,0,5,4,1,428,0,0,11,9,2,844,0,0,0,0,0,0,0,0,0,0,0,0,0,0
1516,1516,Michael Tonge,1997,2008,Stoke City,7,0,7,160,0,0,3,1,2,108,0,0,10,1,9,268,0,0,0,0,0,0,0,0,0,0,0,0,0,0
1517,1517,Richard Cresswell,1998,2008,Stoke City,13,3,10,520,0,0,17,8,9,892,0,0,30,11,19,1412,0,0,0,0,0,0,0,0,0,0,0,0,0,0
1518,1518,Scott Carson,1999,2008,West Bromwich Albion,17,17,0,1530,0,0,18,18,0,1620,0,0,35,35,0,3150,0,0,0,0,0,0,0,0,0,0,0,0,0,0
1519,1519,Paul Robinson,1262,2008,West Bromwich Albion,16,16,0,1394,0,0,19,19,0,1678,0,0,35,35,0,3072,0,0,0,0,0,0,0,0,0,0,0,0,0,0
1520,1520,Abdoulaye Méïté,1712,2008,West Bromwich Albion,7,7,0,564,0,0,11,11,0,883,0,0,18,18,0,1447,0,0,0,0,0,0,0,0,0,0,0,0,0,0
1521,1521,Jonas Olsson,1771,2008,West Bromwich Albion,14,14,0,1260,1,0,14,14,0,1260,1,0,28,28,0,2520,2,0,0,3,3,1,1,2,0,0,0,0,0,0
1522,1522,Robert Koren,2000,2008,West Bromwich Albion,17,16,1,1440,2,0,18,18,0,1555,0,0,35,34,1,2995,2,0,0,0,0,0,0,0,0,0,0,0,0,0
1523,1523,Jonathan Greening,1321,2008,West Bromwich Albion,17,17,0,1493,1,0,17,16,1,1477,1,0,34,33,1,2970,2,0,0,0,0,1,1,2,0,0,0,0,0,0
1524,1524,Ishmael Miller,1813,2008,West Bromwich Albion,7,6,1,503,1,0,8,5,3,532,2,0,15,11,4,1035,3,0,0,0,0,1,1,2,0,0,0,0,0,0
1525,1525,Chris Brunt,1658,2008,West Bromwich Albion,17,14,3,1141,5,0,17,14,3,1234,4,0,34,28,6,2375,9,0,3,1,4,4,3,7,0,1,1,0,0,0
1526,1526,Do-heon Kim,2001,2008,West Bromwich Albion,6,3,3,320,0,0,10,6,4,443,0,0,16,9,7,763,0,0,0,0,0,0,0,0,0,0,0,0,0,0
1527,1527,Gianni Zuiverloon,2002,2008,West Bromwich Albion,16,16,0,1380,0,0,17,17,0,1517,0,0,33,33,0,2897,0,0,0,0,0,0,0,0,0,0,0,0,0,0
1528,1528,Borja Valero,2003,2008,West Bromwich Albion,15,13,2,1122,0,0,15,14,1,1179,0,0,30,27,3,2301,0,0,0,0,0,0,0,0,0,0,0,0,0,0
1529,1529,Filipe Teixeira,2004,2008,West Bromwich Albion,4,0,4,124,0,0,6,1,5,135,0,0,10,1,9,259,0,0,0,0,0,0,0,0,0,0,0,0,0,0
1530,1530,Roman Bednář,2005,2008,West Bromwich Albion,14,8,6,815,6,0,12,4,8,421,0,0,26,12,14,1236,6,0,6,0,6,5,0,5,2,0,2,0,0,0
1531,1531,Brad Friedel,1343,2005,Blackburn Rovers,19,19,0,1710,0,0,19,19,0,1710,0,0,38,38,0,3420,0,0,0,0,0,0,0,0,0,0,0,0,0,0
1532,1532,Lucas Neill,1132,2005,Blackburn Rovers,19,19,0,1710,1,0,16,16,0,1440,0,0,35,35,0,3150,1,0,0,0,0,0,0,0,1,0,1,0,0,0
1533,1533,Zurab Khizanishvili,2006,2005,Blackburn Rovers,13,11,2,1043,1,0,13,13,0,1170,0,0,26,24,2,2213,1,0,0,0,0,1,0,1,0,0,0,0,0,0
1534,1534,Ryan Nelsen,2007,2005,Blackburn Rovers,15,15,0,1305,0,0,16,16,0,1400,0,0,31,31,0,2705,0,0,0,0,0,0,0,0,0,0,0,0,0,0
1535,1535,Steven Reid,1140,2005,Blackburn Rovers,17,17,0,1512,1,0,17,14,3,1304,3,0,34,31,3,2816,4,0,3,3,6,1,2,3,0,0,0,0,0,0
1536,1536,Aaron Mokoena,2008,2005,Blackburn Rovers,11,2,9,282,0,0,11,2,9,370,0,0,22,4,18,652,0,0,0,0,0,0,0,0,0,0,0,0,0,0
1537,1537,Robbie Savage,1309,2005,Blackburn Rovers,16,16,0,1440,0,0,18,18,0,1575,1,0,34,34,0,3015,1,0,0,0,0,0,1,1,0,0,0,0,0,0
1538,1538,Morten Gamst Pedersen,2009,2005,Blackburn Rovers,18,18,0,1514,5,0,16,16,0,1299,4,0,34,34,0,2813,9,0,3,6,9,4,4,8,0,0,0,0,0,0
1539,1539,Vratislav Greško,2010,2005,Blackburn Rovers,1,1,0,76,0,0,2,0,2,68,0,0,3,1,2,144,0,0,0,0,0,0,0,0,0,0,0,0,0,0
1540,1540,David Bentley,2011,2005,Blackburn Rovers,16,13,3,1077,3,0,13,10,3,938,0,0,29,23,6,2015,3,0,0,0,0,2,0,2,0,0,0,0,0,0
1541,1541,Craig Bellamy,2012,2005,Blackburn Rovers,14,11,3,986,7,0,13,11,2,1027,6,0,27,22,5,2013,13,0,3,0,3,3,4,7,0,1,1,0,0,0
1542,1542,Tugay Kerimoğlu,1136,2005,Blackburn Rovers,15,12,3,992,1,0,12,11,1,855,0,0,27,23,4,1847,1,0,3,0,3,1,0,1,0,0,0,0,0,0
1543,1543,Shefki Kuqi,2013,2005,Blackburn Rovers,16,6,10,805,5,0,17,9,8,849,2,0,33,15,18,1654,7,0,4,0,4,3,1,4,0,0,0,0,0,0
1544,1544,Matt Jansen,1350,2005,Blackburn Rovers,2,0,2,15,0,0,2,1,1,87,0,0,4,1,3,102,0,0,0,0,0,0,0,0,0,0,0,0,0,0
1545,1545,Stephen Carr,1780,2005,Newcastle United,9,9,0,810,0,0,10,10,0,855,0,0,19,19,0,1665,0,0,0,0,0,0,0,0,0,0,0,0,0,0
1546,1546,Steven Taylor,2014,2005,Newcastle United,5,5,0,405,0,0,7,7,0,568,0,0,12,12,0,973,0,0,0,0,0,0,0,0,0,0,0,0,0,0
1547,1547,Celestine Babayaro,2015,2005,Newcastle United,13,12,1,1124,0,0,15,14,1,1221,0,0,28,26,2,2345,0,0,0,0,0,0,0,0,0,0,0,0,0,0
1548,1548,Charles N'Zogbia,2016,2005,Newcastle United,15,13,2,1147,2,0,17,14,3,1174,3,0,32,27,5,2321,5,0,1,3,4,2,1,3,0,0,0,0,0,0
1549,1549,Lee Clark,2017,2005,Newcastle United,14,3,11,414,1,0,8,5,3,471,0,0,22,8,14,885,1,0,1,0,1,1,0,1,0,0,0,0,0,0
1550,1550,Craig Gordon,1691,2008,Sunderland AFC,7,7,0,630,0,0,5,5,0,450,0,0,12,12,0,1080,0,0,0,0,0,0,0,0,0,0,0,0,0,0
1551,1551,Phil Bardsley,1409,2008,Sunderland AFC,16,15,1,1378,0,0,12,12,0,1080,0,0,28,27,1,2458,0,0,0,0,0,0,0,0,0,0,0,0,0,0
1552,1552,Calum Davenport,1394,2008,Sunderland AFC,4,4,0,343,0,0,4,3,1,344,0,0,8,7,1,687,0,0,0,0,0,0,0,0,0,0,0,0,0,0
1553,1553,Teemu Tainio,1395,2008,Sunderland AFC,11,9,2,695,0,0,10,9,1,740,0,0,21,18,3,1435,0,0,0,0,0,0,0,0,0,0,0,0,0,0
1554,1554,Paul McShane,1607,2008,Sunderland AFC,3,0,3,65,0,0,0,0,0,0,0,0,3,0,3,65,0,0,0,0,0,0,0,0,0,0,0,0,0,0
1555,1555,Dwight Yorke,1223,2008,Sunderland AFC,3,2,1,146,0,0,4,2,2,128,0,0,7,4,3,274,0,0,0,0,0,0,0,0,0,0,0,0,0,0
1556,1556,Ben Foster,1653,2008,Manchester United,0,0,0,0,0,0,2,2,0,180,0,0,2,2,0,180,0,0,0,0,0,0,0,0,0,0,0,0,0,0
1557,1557,Gary Neville,1105,2008,Manchester United,9,6,3,490,0,0,7,7,0,585,0,0,16,13,3,1075,0,0,0,0,0,0,0,0,0,0,0,0,0,0
1558,1558,Nemanja Vidić,1725,2008,Manchester United,18,17,1,1556,3,0,16,16,0,1440,1,0,34,33,1,2996,4,0,3,0,3,2,0,2,0,0,0,0,0,0
1559,1559,John O'Shea,1729,2008,Manchester United,15,8,7,955,0,0,15,12,3,1069,0,0,30,20,10,2024,0,0,0,0,0,0,0,0,0,0,0,0,0,0
1560,1560,Jonny Evans,1216,2008,Manchester United,10,9,1,793,0,0,7,7,0,630,0,0,17,16,1,1423,0,0,0,0,0,0,0,0,0,0,0,0,0,0
1561,1561,Ji-Sung Park,1788,2008,Manchester United,11,10,1,797,0,0,14,11,3,931,2,0,25,21,4,1728,2,0,0,0,0,0,1,1,0,0,0,0,0,0
1562,1562,Michael Carrick,1627,2008,Manchester United,16,13,3,1094,3,0,12,11,1,947,1,0,28,24,4,2041,4,0,0,3,3,1,1,2,0,0,0,0,0,0
1563,1563,Paul Scholes,1112,2008,Manchester United,10,5,5,561,1,0,11,9,2,778,1,0,21,14,7,1339,2,0,0,0,0,1,1,2,0,0,0,0,0,0
1564,1564,Dimitar Berbatov,1397,2008,Manchester United,15,14,1,1247,6,0,16,15,1,1297,3,0,31,29,2,2544,9,0,3,6,9,1,3,4,0,0,0,0,0,0
1565,1565,Wayne Rooney,1058,2008,Manchester United,16,12,4,1097,9,0,14,13,1,1170,3,0,30,25,5,2267,12,0,3,3,6,5,2,7,0,0,0,0,0,0
1566,1566,Carlos Tévez,1417,2008,Manchester United,14,9,5,961,1,0,15,9,6,895,4,0,29,18,11,1856,5,0,0,3,3,0,3,3,0,0,0,0,0,0
1567,1567,Anderson,2018,2008,Manchester United,8,5,3,452,0,0,9,6,3,482,0,0,17,11,6,934,0,0,0,0,0,0,0,0,0,0,0,0,0,0
1568,1568,Cristiano Ronaldo,1726,2008,Manchester United,18,18,0,1552,16,0,15,13,2,1218,2,0,33,31,2,2770,18,0,6,0,6,11,0,11,4,0,4,0,0,0
1569,1569,Federico Macheda,2019,2008,Manchester United,1,0,1,29,1,0,3,2,1,160,1,0,4,2,2,189,2,0,3,3,6,1,1,2,0,0,0,0,0,0
1570,1570,Gábor Király,2020,2004,Crystal Palace,16,16,0,1440,0,0,15,15,0,1350,0,0,31,31,0,2790,0,0,0,0,0,0,0,0,0,0,0,0,0,0
1571,1571,Danny Granville,2021,2004,Crystal Palace,19,19,0,1674,1,0,15,15,0,1350,2,0,34,34,0,3024,3,0,0,0,0,0,2,2,0,0,0,0,0,0
1572,1572,Tony Popovic,2022,2004,Crystal Palace,11,10,1,880,0,0,11,10,1,871,0,0,22,20,2,1751,0,0,0,0,0,0,0,0,0,0,0,0,0,0
1573,1573,Emmerson Boyce,2023,2004,Crystal Palace,14,13,1,1172,0,0,12,12,0,1080,0,0,26,25,1,2252,0,0,0,0,0,0,0,0,0,0,0,0,0,0
1574,1574,Fitz Hall,2024,2004,Crystal Palace,18,18,0,1576,2,0,17,17,0,1506,1,0,35,35,0,3082,3,0,0,0,0,2,1,3,0,0,0,0,0,0
1575,1575,Wayne Routledge,1758,2004,Crystal Palace,19,19,0,1570,0,0,18,18,0,1498,1,0,37,37,0,3068,1,0,0,0,0,0,1,1,0,0,0,0,0,0
1576,1576,Ben Watson,2025,2004,Crystal Palace,11,8,3,709,0,0,9,7,2,600,0,0,20,15,5,1309,0,0,0,0,0,0,0,0,0,0,0,0,0,0
1577,1577,Aki Riihilahti,2026,2004,Crystal Palace,15,14,1,1180,2,0,15,13,2,1008,1,0,30,27,3,2188,3,0,1,0,1,1,1,2,0,0,0,0,0,0
1578,1578,Michael Hughes,2027,2004,Crystal Palace,18,17,1,1532,1,0,17,16,1,1396,1,0,35,33,2,2928,2,0,0,0,0,0,1,1,0,0,0,0,0,0
1579,1579,Joonas Kolkka,2028,2004,Crystal Palace,12,10,2,897,1,0,10,9,1,720,2,0,22,19,3,1617,3,0,0,0,0,1,1,2,0,0,0,0,0,0
1580,1580,Vassilios Lakis,2029,2004,Crystal Palace,10,2,8,315,0,0,8,4,4,387,0,0,18,6,12,702,0,0,0,0,0,0,0,0,0,0,0,0,0,0
1581,1581,Dougie Freedman,2030,2004,Crystal Palace,11,6,5,587,0,0,9,4,5,301,1,0,20,10,10,888,1,0,0,0,0,0,1,1,0,0,0,0,0,0
1582,1582,Shay Given,1581,2004,Newcastle United,18,18,0,1620,0,0,17,17,0,1530,0,0,35,35,0,3150,0,0,0,0,0,0,0,0,0,0,0,0,0,0
1583,1583,Titus Bramble,1411,2004,Newcastle United,10,10,0,900,1,0,8,7,1,660,0,0,18,17,1,1560,1,0,0,0,0,0,0,0,0,0,0,0,0,0
1584,1584,Ronny Johnsen,2031,2004,Newcastle United,1,1,0,90,0,0,2,2,0,146,0,0,3,3,0,236,0,0,0,0,0,0,0,0,0,0,0,0,0,0
1585,1585,Aaron Hughes,1561,2004,Newcastle United,12,10,2,902,1,0,10,8,2,773,0,0,22,18,4,1675,1,0,0,0,0,0,0,0,0,0,0,0,0,0
1586,1586,Olivier Bernard,2032,2004,Newcastle United,10,10,0,875,0,0,11,9,2,800,0,0,21,19,2,1675,0,0,0,0,0,0,0,0,0,0,0,0,0,0
1587,1587,Jermaine Jenas,1275,2004,Newcastle United,16,14,2,1246,0,0,15,14,1,1282,1,0,31,28,3,2528,1,0,0,0,0,0,1,1,0,0,0,0,0,0
1588,1588,Kieron Dyer,2033,2004,Newcastle United,14,12,2,1064,2,0,9,8,1,705,2,0,23,20,3,1769,4,0,3,0,3,2,2,4,0,0,0,0,0,0
1589,1589,Lee Bowyer,1297,2004,Newcastle United,15,14,1,1169,3,0,12,12,0,1040,0,0,27,26,1,2209,3,0,0,0,0,2,0,2,0,0,0,0,0,0
1590,1590,Laurent Robert,2034,2004,Newcastle United,16,10,6,991,2,0,15,10,5,913,1,0,31,20,11,1904,3,0,3,0,3,2,1,3,0,0,0,0,0,0
1591,1591,Craig Bellamy,2012,2004,Newcastle United,12,12,0,1002,4,0,9,9,0,786,3,0,21,21,0,1788,7,0,3,0,3,3,2,5,0,0,0,0,0,0
1592,1592,Patrick Kluivert,2035,2004,Newcastle United,10,5,5,502,1,0,14,9,5,698,5,0,24,14,10,1200,6,0,0,0,0,1,4,5,0,0,0,0,0,0
1593,1593,Robbie Elliott,1945,2004,Newcastle United,6,6,0,496,1,0,11,9,2,831,0,0,17,15,2,1327,1,0,0,0,0,1,0,1,0,0,0,0,0,0
1594,1594,James Milner,1189,2004,Newcastle United,11,6,5,555,1,0,13,6,7,616,0,0,24,12,12,1171,1,0,0,0,0,0,0,0,0,0,0,0,0,0
1595,1595,Mark Schwarzer,1328,2008,Fulham FC,17,17,0,1530,0,0,16,16,0,1440,0,0,33,33,0,2970,0,0,0,0,0,0,0,0,0,0,0,0,0,0
1596,1596,John Paintsil,2036,2008,Fulham FC,17,17,0,1530,0,0,15,15,0,1313,0,0,32,32,0,2843,0,0,0,0,0,0,0,0,0,0,0,0,0,0
1597,1597,Brede Hangeland,1033,2008,Fulham FC,17,17,0,1530,1,0,15,15,0,1350,0,0,32,32,0,2880,1,0,3,0,3,1,0,1,0,0,0,0,0,0
1598,1598,Aaron Hughes,1561,2008,Fulham FC,17,17,0,1504,0,0,16,16,0,1440,0,0,33,33,0,2944,0,0,0,0,0,0,0,0,0,0,0,0,0,0
1599,1599,Toni Kallio,2037,2008,Fulham FC,2,1,1,87,0,0,1,1,0,90,0,0,3,2,1,177,0,0,0,0,0,0,0,0,0,0,0,0,0,0
1600,1600,Zoltán Gera,1323,2008,Fulham FC,14,10,4,776,2,0,14,7,7,669,0,0,28,17,11,1445,2,0,0,0,0,1,0,1,0,0,0,0,0,0
1601,1601,Danny Murphy,1398,2008,Fulham FC,17,17,0,1465,5,0,16,16,0,1421,0,0,33,33,0,2886,5,0,3,0,3,3,0,3,5,0,5,0,0,0
1602,1602,Jimmy Bullard,1610,2008,Fulham FC,7,7,0,623,2,0,6,6,0,480,0,0,13,13,0,1103,2,0,1,0,1,2,0,2,0,0,0,0,0,0
1603,1603,Simon Davies,1125,2008,Fulham FC,14,14,0,1249,1,0,14,14,0,1210,1,0,28,28,0,2459,2,0,0,0,0,1,1,2,0,0,0,0,0,0
1604,1604,Ki-hyeon Seol,1563,2008,Fulham FC,2,1,1,92,0,0,2,1,1,104,1,0,4,2,2,196,1,0,0,0,0,0,1,1,0,0,0,0,0,0
1605,1605,Bobby Zamora,1943,2008,Fulham FC,16,13,3,1104,2,0,15,15,0,1265,0,0,31,28,3,2369,2,0,0,0,0,1,0,1,0,0,0,0,0,0
1606,1606,Chris Baird,1562,2008,Fulham FC,5,0,5,29,0,0,5,3,2,234,0,0,10,3,7,263,0,0,0,0,0,0,0,0,0,0,0,0,0,0
1607,1607,Andranik Teymourian,2038,2008,Fulham FC,1,0,1,9,0,0,0,0,0,0,0,0,1,0,1,9,0,0,0,0,0,0,0,0,0,0,0,0,0,0
1608,1608,Clint Dempsey,1565,2008,Fulham FC,16,12,4,1136,4,0,16,13,3,1187,3,0,32,25,7,2323,7,0,1,1,2,3,2,5,0,0,0,0,0,0
1609,1609,Manuel Almunia,2039,2008,Arsenal FC,17,17,0,1518,0,0,14,14,0,1260,0,0,31,31,0,2778,0,0,0,0,0,0,0,0,0,0,0,0,0,0
1610,1610,Bacary Sagna,1596,2008,Arsenal FC,17,17,0,1457,0,0,17,16,1,1390,0,0,34,33,1,2847,0,0,0,0,0,0,0,0,0,0,0,0,0,0
1611,1611,Kolo Touré,1415,2008,Arsenal FC,16,13,3,1166,0,0,12,12,0,1036,1,0,28,25,3,2202,1,0,0,0,0,0,1,1,0,0,0,0,0,0
1612,1612,William Gallas,2040,2008,Arsenal FC,12,12,0,1080,2,0,10,10,0,900,0,0,22,22,0,1980,2,0,3,0,3,2,0,2,0,0,0,0,0,0
1613,1613,Gaël Clichy,1230,2008,Arsenal FC,16,16,0,1434,0,0,14,14,0,1213,1,0,30,30,0,2647,1,0,0,0,0,0,0,0,0,0,0,0,0,0
1614,1614,Emmanuel Eboué,1231,2008,Arsenal FC,16,8,8,756,2,0,11,8,3,696,1,0,27,16,11,1452,3,0,0,0,0,0,1,1,1,0,1,0,0,0
1615,1615,Samir Nasri,1358,2008,Arsenal FC,16,16,0,1366,4,0,12,11,1,955,2,0,28,27,1,2321,6,0,3,0,3,3,1,4,0,0,0,0,0,0
1616,1616,Denilson,1232,2008,Arsenal FC,19,18,1,1622,1,0,17,17,0,1424,2,0,36,35,1,3046,3,0,0,0,0,0,1,1,0,0,0,0,0,0
1617,1617,Robin van Persie,1528,2008,Arsenal FC,13,11,2,996,7,0,14,12,2,1126,4,0,27,23,4,2122,11,0,0,4,4,3,4,7,2,0,2,0,0,0
1618,1618,Theo Walcott,1237,2008,Arsenal FC,12,10,2,782,1,0,10,6,4,490,1,0,22,16,6,1272,2,0,0,0,0,0,1,1,0,0,0,0,0,0
1619,1619,Emmanuel Adebayor,1235,2008,Arsenal FC,14,11,3,1041,4,0,12,10,2,866,6,0,26,21,5,1907,10,0,3,0,3,2,2,4,0,1,1,0,0,0
1620,1620,Alex Song,1233,2008,Arsenal FC,12,8,4,722,0,0,18,14,4,1297,1,0,30,22,8,2019,1,0,0,0,0,0,0,0,0,0,0,0,0,0
1621,1621,Nicklas Bendtner,1236,2008,Arsenal FC,14,8,6,803,2,0,17,9,8,954,7,0,31,17,14,1757,9,0,3,0,3,1,4,5,0,1,1,0,0,0
1622,1622,Shaka Hislop,1064,2001,West Ham United,5,5,0,450,0,0,7,7,0,630,0,0,12,12,0,1080,0,0,0,0,0,0,0,0,0,0,0,0,0,0
1623,1623,Laurent Courtois,2041,2001,West Ham United,4,4,0,280,0,0,3,1,2,114,0,0,7,5,2,394,0,0,0,0,0,0,0,0,0,0,0,0,0,0
1624,1624,Don Hutchison,1095,2001,West Ham United,10,10,0,819,1,0,12,12,0,1029,0,0,22,22,0,1848,1,0,0,0,0,1,0,1,0,0,0,0,0,0
1625,1625,Paolo Di Canio,2042,2001,West Ham United,13,13,0,1146,5,0,12,12,0,1044,4,0,25,25,0,2190,9,0,3,1,4,3,4,7,1,3,4,0,0,0
1626,1626,Frédéric Kanouté,1130,2001,West Ham United,14,14,0,1123,9,0,12,12,0,993,2,0,26,26,0,2116,11,0,3,3,6,4,2,6,0,0,0,0,0,0
1627,1627,John Moncur,2043,2001,West Ham United,11,3,8,310,0,0,8,4,4,354,0,0,19,7,12,664,0,0,0,0,0,0,0,0,0,0,0,0,0,0
1628,1628,Paul Jones,2044,2001,Southampton FC,17,17,0,1530,0,0,18,18,0,1620,0,0,35,35,0,3150,0,0,0,0,0,0,0,0,0,0,0,0,0,0
1629,1629,Taher El-Khalej,2045,2001,Southampton FC,6,5,1,517,0,0,7,6,1,564,1,0,13,11,2,1081,1,0,0,1,1,0,1,1,0,0,0,0,0,0
1630,1630,Jason Dodd,2046,2001,Southampton FC,14,12,2,1142,0,0,14,13,1,1188,0,0,28,25,3,2330,0,0,0,0,0,0,0,0,0,0,0,0,0,0
1631,1631,Claus Lundekvam,2047,2001,Southampton FC,17,17,0,1412,0,0,17,17,0,1476,0,0,34,34,0,2888,0,0,0,0,0,0,0,0,0,0,0,0,0,0
1632,1632,Wayne Bridge,1768,2001,Southampton FC,18,18,0,1620,0,0,19,19,0,1710,0,0,37,37,0,3330,0,0,0,0,0,0,0,0,0,0,0,0,0,0
1633,1633,Chris Marsden,2048,2001,Southampton FC,13,13,0,1109,1,0,14,13,1,1124,2,0,27,26,1,2233,3,0,0,0,0,0,1,1,0,0,0,0,0,0
1634,1634,Mark Draper,2049,2001,Southampton FC,0,0,0,0,0,0,2,1,1,107,0,0,2,1,1,107,0,0,0,0,0,0,0,0,0,0,0,0,0,0
1635,1635,Rory Delap,1993,2001,Southampton FC,12,12,0,1005,1,0,15,11,4,1017,1,0,27,23,4,2022,2,0,1,0,1,1,1,2,0,0,0,0,0,0
1636,1636,Kevin Davies,1718,2001,Southampton FC,8,6,2,513,1,0,15,12,3,1035,1,0,23,18,5,1548,2,0,0,1,1,1,1,2,0,0,0,0,0,0
1637,1637,James Beattie,2050,2001,Southampton FC,14,12,2,1061,5,0,13,11,2,982,7,0,27,23,4,2043,12,0,3,0,3,4,3,7,2,0,2,0,0,0
1638,1638,Marians Pahars,2051,2001,Southampton FC,18,17,1,1357,8,0,17,15,2,1308,6,0,35,32,3,2665,14,0,4,3,7,3,2,5,1,0,1,0,0,0
1639,1639,Stuart Ripley,2052,2001,Southampton FC,3,1,2,111,0,0,2,0,2,52,0,0,5,1,4,163,0,0,0,0,0,0,0,0,0,0,0,0,0,0
1640,1640,Anders Svensson,2053,2001,Southampton FC,16,16,0,1318,2,0,18,17,1,1493,2,0,34,33,1,2811,4,0,0,0,0,2,1,3,0,0,0,0,0,0
1641,1641,Pepe Reina,1775,2009,Liverpool FC,19,19,0,1710,0,0,19,19,0,1710,0,0,38,38,0,3420,0,0,0,0,0,0,0,0,0,0,0,0,0,0
1642,1642,Daniel Agger,1776,2009,Liverpool FC,13,13,0,1091,0,0,10,10,0,887,0,0,23,23,0,1978,0,0,0,0,0,0,0,0,0,0,0,0,0,0
1643,1643,Fábio Aurélio,2054,2009,Liverpool FC,7,5,2,360,0,0,7,3,4,293,0,0,14,8,6,653,0,0,0,0,0,0,0,0,0,0,0,0,0,0
1644,1644,Emiliano Insúa,1889,2009,Liverpool FC,15,14,1,1312,0,0,16,16,0,1411,0,0,31,30,1,2723,0,0,0,0,0,0,0,0,0,0,0,0,0,0
1645,1645,Jamie Carragher,1778,2009,Liverpool FC,18,18,0,1587,0,0,19,19,0,1675,0,0,37,37,0,3262,0,0,0,0,0,0,0,0,0,0,0,0,0,0
1646,1646,Martin Škrtel,1423,2009,Liverpool FC,10,8,2,722,1,0,9,8,1,688,0,0,19,16,3,1410,1,0,0,0,0,1,0,1,0,0,0,0,0,0
1647,1647,Steven Gerrard,1424,2009,Liverpool FC,17,16,1,1418,4,0,16,16,0,1432,5,0,33,32,1,2850,9,0,1,3,4,3,4,7,1,1,2,0,0,0
1648,1648,Yossi Benayoun,1892,2009,Liverpool FC,15,12,3,1102,6,0,15,7,8,756,0,0,30,19,11,1858,6,0,1,0,1,3,0,3,0,0,0,0,0,0
1649,1649,Javier Mascherano,1893,2009,Liverpool FC,17,15,2,1359,0,0,17,16,1,1441,0,0,34,31,3,2800,0,0,0,0,0,0,0,0,0,0,0,0,0,0
1650,1650,Dirk Kuyt,1894,2009,Liverpool FC,18,16,2,1431,7,0,19,19,0,1582,2,0,37,35,2,3013,9,0,3,0,3,4,1,5,1,0,1,0,0,0
1651,1651,David N'Gog,1895,2009,Liverpool FC,16,7,9,638,5,0,8,3,5,374,0,0,24,10,14,1012,5,0,0,0,0,2,0,2,0,0,0,0,0,0
1652,1652,Alberto Aquilani,2055,2009,Liverpool FC,10,6,4,521,1,0,8,3,5,295,0,0,18,9,9,816,1,0,0,0,0,0,0,0,0,0,0,0,0,0
1653,1653,Lucas Leiva,1429,2009,Liverpool FC,16,14,2,1283,0,0,19,18,1,1562,0,0,35,32,3,2845,0,0,0,0,0,0,0,0,0,0,0,0,0,0
1654,1654,Fernando Torres,1539,2009,Liverpool FC,11,10,1,853,12,0,11,10,1,863,6,0,22,20,2,1716,18,0,3,6,9,7,6,13,0,0,0,0,0,0
1655,1655,Chris Kirkland,2056,2009,Wigan Athletic,16,16,0,1373,0,0,15,15,0,1306,0,0,31,31,0,2679,0,0,0,0,0,0,0,0,0,0,0,0,0,0
1656,1656,Paul Scharner,1734,2009,Wigan Athletic,18,13,5,1147,2,0,19,16,3,1287,2,0,37,29,8,2434,4,0,0,0,0,1,1,2,0,0,0,0,0,0
1657,1657,Emmerson Boyce,2023,2009,Wigan Athletic,10,10,0,887,1,0,13,12,1,1060,2,0,23,22,1,1947,3,0,0,0,0,1,1,2,0,0,0,0,0,0
1658,1658,Titus Bramble,1411,2009,Wigan Athletic,16,16,0,1401,2,0,18,18,0,1620,0,0,34,34,0,3021,2,0,0,0,0,2,0,2,0,0,0,0,0,0
1659,1659,Mario Melchiot,1512,2009,Wigan Athletic,14,14,0,1260,0,0,17,17,0,1502,0,0,31,31,0,2762,0,0,0,0,0,0,0,0,0,0,0,0,0,0
1660,1660,Maynor Figueroa,2057,2009,Wigan Athletic,17,17,0,1530,0,0,17,17,0,1468,1,0,34,34,0,2998,1,0,0,0,0,0,1,1,0,0,0,0,0,0
1661,1661,Hendry Thomas,2058,2009,Wigan Athletic,14,12,2,1072,0,0,16,14,2,1200,0,0,30,26,4,2272,0,0,0,0,0,0,0,0,0,0,0,0,0,0
1662,1662,Charles N'Zogbia,2016,2009,Wigan Athletic,16,16,0,1389,3,0,19,18,1,1559,2,0,35,34,1,2948,5,0,3,0,3,3,0,3,0,0,0,0,0,0
1663,1663,Jordi Gómez,2059,2009,Wigan Athletic,9,4,5,448,1,0,13,6,7,724,0,0,22,10,12,1172,1,0,0,0,0,0,0,0,0,0,0,0,0,0
1664,1664,Momo Diamé,2060,2009,Wigan Athletic,17,17,0,1437,0,0,17,17,0,1426,1,0,34,34,0,2863,1,0,0,0,0,0,1,1,0,0,0,0,0,0
1665,1665,Hugo Rodallega,2061,2009,Wigan Athletic,18,18,0,1598,6,0,19,19,0,1633,4,0,37,37,0,3231,10,0,13,0,13,6,4,10,1,0,1,0,0,0
1666,1666,Jason Koumas,2062,2009,Wigan Athletic,4,3,1,190,0,0,4,3,1,233,1,0,8,6,2,423,1,0,0,0,0,0,0,0,0,0,0,0,0,0
1667,1667,Jason Scotland,2063,2009,Wigan Athletic,16,8,8,816,0,0,15,5,10,645,1,0,31,13,18,1461,1,0,0,0,0,0,1,1,0,0,0,0,0,0
1668,1668,Mark Schwarzer,1328,2000,Middlesbrough FC,16,16,0,1440,0,0,14,14,0,1260,0,0,30,30,0,2700,0,0,0,0,0,0,0,0,0,0,0,0,0,0
1669,1669,Gary Pallister,2064,2000,Middlesbrough FC,4,4,0,360,0,0,4,4,0,318,0,0,8,8,0,678,0,0,0,0,0,0,0,0,0,0,0,0,0,0
1670,1670,Curtis Fleming,2065,2000,Middlesbrough FC,15,15,0,1242,0,0,14,13,1,1172,0,0,29,28,1,2414,0,0,0,0,0,0,0,0,0,0,0,0,0,0
1671,1671,Steve Vickers,2066,2000,Middlesbrough FC,15,14,1,1163,0,0,14,14,0,1260,0,0,29,28,1,2423,0,0,0,0,0,0,0,0,0,0,0,0,0,0
1672,1672,Mark Summerbell,2067,2000,Middlesbrough FC,3,3,0,270,1,0,4,2,2,213,0,0,7,5,2,483,1,0,1,0,1,1,0,1,0,0,0,0,0,0
1673,1673,Keith O'Neill,2068,2000,Middlesbrough FC,8,8,0,639,0,0,6,5,1,517,0,0,14,13,1,1156,0,0,0,0,0,0,0,0,0,0,0,0,0,0
1674,1674,Christian Karembeu,2069,2000,Middlesbrough FC,15,15,0,1237,2,0,17,16,1,1267,2,0,32,31,1,2504,4,0,6,1,7,2,2,4,0,0,0,0,0,0
1675,1675,Paul Okon,2070,2000,Middlesbrough FC,13,13,0,1093,0,0,11,10,1,879,0,0,24,23,1,1972,0,0,0,0,0,0,0,0,0,0,0,0,0,0
1676,1676,Joseph-Désiré Job,2071,2000,Middlesbrough FC,7,5,2,453,1,0,5,3,2,224,2,0,12,8,4,677,3,0,0,0,0,1,1,2,0,0,0,0,0,0
1677,1677,Brian Deane,2072,2000,Middlesbrough FC,13,5,8,642,1,0,10,7,3,707,1,0,23,12,11,1349,2,0,0,0,0,0,0,0,0,0,0,0,0,0
1678,1678,Hámilton Ricard,2073,2000,Middlesbrough FC,13,11,2,888,1,0,13,10,3,802,3,0,26,21,5,1690,4,0,0,0,0,0,2,2,1,0,1,0,0,0
1679,1679,Andy Campbell,2074,2000,Middlesbrough FC,3,1,2,84,0,0,4,4,0,316,0,0,7,5,2,400,0,0,0,0,0,0,0,0,0,0,0,0,0,0
1680,1680,Noel Whelan,2075,2000,Middlesbrough FC,13,8,5,723,0,0,14,5,9,619,0,0,27,13,14,1342,0,0,0,0,0,0,0,0,0,0,0,0,0,0
1681,1681,Neil Sullivan,2076,2000,Tottenham Hotspur,17,17,0,1530,0,0,16,16,0,1440,0,0,33,33,0,2970,0,0,0,0,0,0,0,0,0,0,0,0,0,0
1682,1682,Ben Thatcher,1807,2000,Tottenham Hotspur,7,5,2,470,0,0,5,5,0,431,0,0,12,10,2,901,0,0,0,0,0,0,0,0,0,0,0,0,0,0
1683,1683,Stephen Carr,1780,2000,Tottenham Hotspur,14,14,0,1250,2,0,13,12,1,1065,1,0,27,26,1,2315,3,0,0,0,0,2,1,3,0,0,0,0,0,0
1684,1684,Chris Perry,1954,2000,Tottenham Hotspur,15,14,1,1223,0,0,15,14,1,1231,1,0,30,28,2,2454,1,0,0,0,0,0,0,0,0,0,0,0,0,0
1685,1685,Sol Campbell,1388,2000,Tottenham Hotspur,10,10,0,900,1,0,9,9,0,810,1,0,19,19,0,1710,2,0,3,0,3,1,1,2,0,0,0,0,0,0
1686,1686,Tim Sherwood,2077,2000,Tottenham Hotspur,16,15,1,1366,2,0,16,15,1,1369,0,0,32,30,2,2735,2,0,3,0,3,2,0,2,0,0,0,0,0,0
1687,1687,Øyvind Leonhardsen,2078,2000,Tottenham Hotspur,12,10,2,849,2,0,11,11,0,880,1,0,23,21,2,1729,3,0,0,0,0,1,1,2,0,0,0,0,0,0
1688,1688,Steffen Freund,2079,2000,Tottenham Hotspur,9,7,2,632,0,0,10,10,0,877,0,0,19,17,2,1509,0,0,0,0,0,0,0,0,0,0,0,0,0,0
1689,1689,Steffen Iversen,2080,2000,Tottenham Hotspur,6,4,2,343,2,0,7,5,2,427,0,0,13,9,4,770,2,0,0,0,0,2,0,2,0,0,0,0,0,0
1690,1690,Serhiy Rebrov,2081,2000,Tottenham Hotspur,16,16,0,1397,5,0,11,10,1,859,4,0,27,26,1,2256,9,0,0,3,3,2,2,4,1,0,1,0,0,0
1691,1691,Darren Anderton,2082,2000,Tottenham Hotspur,11,11,0,911,2,0,11,10,1,930,0,0,22,21,1,1841,2,0,0,0,0,2,0,2,2,0,2,0,0,0
1692,1692,Les Ferdinand,2083,2000,Tottenham Hotspur,15,14,1,1125,10,0,11,9,2,769,0,0,26,23,3,1894,10,0,3,0,3,4,0,4,0,0,0,0,0,0
1693,1693,Alisson,2084,2018,Liverpool FC,19,19,0,1710,0,0,19,19,0,1710,0,0,38,38,0,3420,0,0,0,0,0,0,0,0,0,0,0,0,0,0
1694,1694,Virgil van Dijk,1241,2018,Liverpool FC,19,19,0,1675,2,0,19,19,0,1710,2,0,38,38,0,3385,4,0,0,0,0,0,1,1,0,0,0,0,0,0
1695,1695,Andrew Robertson,1181,2018,Liverpool FC,18,18,0,1599,0,0,18,18,0,1620,0,0,36,36,0,3219,0,0,0,0,0,0,0,0,0,0,0,0,0,0
1696,1696,Joel Matip,1182,2018,Liverpool FC,10,9,1,811,1,0,12,8,4,724,0,0,22,17,5,1535,1,0,0,0,0,0,0,0,0,0,0,0,0,0
1697,1697,Trent Alexander-Arnold,1192,2018,Liverpool FC,15,14,1,1266,0,0,14,13,1,1201,1,0,29,27,2,2467,1,0,0,0,0,0,0,0,0,0,0,0,0,0
1698,1698,Fabinho,2085,2018,Liverpool FC,14,11,3,1051,1,0,14,10,4,977,0,0,28,21,7,2028,1,0,0,0,0,0,0,0,0,0,0,0,0,0
1699,1699,Georginio Wijnaldum,1183,2018,Liverpool FC,18,17,1,1413,1,0,17,15,2,1322,2,0,35,32,3,2735,3,0,0,0,0,0,2,2,0,0,0,0,0,0
1700,1700,James Milner,1189,2018,Liverpool FC,12,7,5,647,0,0,19,12,7,1138,5,0,31,19,12,1785,5,0,0,3,3,0,4,4,0,3,3,0,0,0
1701,1701,Sadio Mané,1151,2018,Liverpool FC,19,19,0,1643,18,0,17,16,1,1443,4,0,36,35,1,3086,22,0,0,0,0,7,3,10,0,0,0,0,0,0
1702,1702,Mohamed Salah,1187,2018,Liverpool FC,19,19,0,1692,13,0,19,18,1,1570,9,0,38,37,1,3262,22,0,3,6,9,6,7,13,2,1,3,0,0,0
1703,1703,Divock Origi,2086,2018,Liverpool FC,5,2,3,176,2,0,7,2,5,191,1,0,12,4,8,367,3,0,3,3,6,1,1,2,0,0,0,0,0,0
1704,1704,Naby Keïta,2087,2018,Liverpool FC,14,8,6,730,1,0,11,8,3,664,1,0,25,16,9,1394,2,0,0,0,0,1,1,2,0,0,0,0,0,0
1705,1705,Jordan Henderson,1426,2018,Liverpool FC,16,9,7,925,0,0,16,12,4,1066,1,0,32,21,11,1991,1,0,0,0,0,0,0,0,0,0,0,0,0,0
1706,1706,Adam Lallana,1190,2018,Liverpool FC,6,2,4,189,0,0,7,3,4,276,0,0,13,5,8,465,0,0,0,0,0,0,0,0,0,0,0,0,0,0
1707,1707,Simon Mignolet,1191,2018,Liverpool FC,0,0,0,0,0,0,0,0,0,0,0,0,0,0,0,0,0,0,0,0,0,0,0,0,0,0,0,0,0,0
1708,1708,Rafael Camacho,2088,2018,Liverpool FC,1,0,1,1,0,0,0,0,0,0,0,0,1,0,1,1,0,0,0,0,0,0,0,0,0,0,0,0,0,0
1709,1709,Daniel Sturridge,1428,2018,Liverpool FC,9,1,8,153,1,0,9,3,6,346,1,0,18,4,14,499,2,0,0,1,1,0,1,1,0,0,0,0,0,0
1710,1710,Xherdan Shaqiri,1904,2018,Liverpool FC,12,6,6,539,5,0,12,5,7,520,1,0,24,11,13,1059,6,0,0,0,0,1,0,1,0,0,0,0,0,0
1711,1711,Ben Foster,1653,2018,Watford FC,19,19,0,1710,0,0,19,19,0,1710,0,0,38,38,0,3420,0,0,0,0,0,0,0,0,0,0,0,0,0,0
1712,1712,Daryl Janmaat,1929,2018,Watford FC,10,9,1,836,0,0,8,8,0,685,0,0,18,17,1,1521,0,0,0,0,0,0,0,0,0,0,0,0,0,0
1713,1713,Adrian Mariappa,1917,2018,Watford FC,12,8,4,842,0,0,14,12,2,1082,0,0,26,20,6,1924,0,0,0,0,0,0,0,0,0,0,0,0,0,0
1714,1714,Adam Masina,2089,2018,Watford FC,7,5,2,463,0,0,7,6,1,541,0,0,14,11,3,1004,0,0,0,0,0,0,0,0,0,0,0,0,0,0
1715,1715,Craig Cathcart,1918,2018,Watford FC,18,18,0,1561,1,0,18,17,1,1538,2,0,36,35,1,3099,3,0,3,0,3,1,2,3,0,0,0,0,0,0
1716,1716,Abdoulaye Doucouré,1922,2018,Watford FC,18,17,1,1566,3,0,17,17,0,1496,2,0,35,34,1,3062,5,0,1,0,1,2,1,3,0,0,0,0,0,0
1717,1717,Will Hughes,1923,2018,Watford FC,16,16,0,1251,1,0,16,15,1,1185,1,0,32,31,1,2436,2,0,0,0,0,1,0,1,0,0,0,0,0,0
1718,1718,Étienne Capoue,1924,2018,Watford FC,17,17,0,1518,0,0,16,16,0,1429,1,0,33,33,0,2947,1,0,0,0,0,0,1,1,0,0,0,0,0,0
1719,1719,Roberto Pereyra,2090,2018,Watford FC,17,17,0,1467,5,0,16,16,0,1358,1,0,33,33,0,2825,6,0,0,0,0,4,0,4,0,0,0,0,0,0
1720,1720,Gerard Deulofeu,1927,2018,Watford FC,14,12,2,949,3,0,16,14,2,1133,7,0,30,26,4,2082,10,0,0,0,0,1,2,3,0,0,0,0,0,0
1721,1721,Troy Deeney,1928,2018,Watford FC,16,15,1,1377,3,0,16,13,3,1250,6,0,32,28,4,2627,9,0,0,0,0,2,3,5,0,1,1,0,0,0
1722,1722,Tom Cleverley,2091,2018,Watford FC,4,1,3,103,0,0,9,3,6,368,1,0,13,4,9,471,1,0,0,3,3,0,1,1,0,0,0,0,0,0
1723,1723,Ken Sema,2092,2018,Watford FC,8,4,4,301,0,0,9,5,4,477,1,0,17,9,8,778,1,0,0,0,0,0,1,1,0,0,0,0,0,0
1724,1724,Andre Gray,1925,2018,Watford FC,15,8,7,809,5,0,14,5,9,549,2,0,29,13,16,1358,7,0,7,0,7,4,2,6,0,0,0,0,0,0
1725,1725,Gomes,1266,2018,Watford FC,0,0,0,0,0,0,0,0,0,0,0,0,0,0,0,0,0,0,0,0,0,0,0,0,0,0,0,0,0,0
1726,1726,Marc Navarro,2093,2018,Watford FC,0,0,0,0,0,0,2,1,1,85,0,0,2,1,1,85,0,0,0,0,0,0,0,0,0,0,0,0,0,0
1727,1727,Christian Kabasele,1921,2018,Watford FC,14,12,2,1015,0,0,7,7,0,630,0,0,21,19,2,1645,0,0,0,0,0,0,0,0,0,0,0,0,0,0
1728,1728,Domingos Quina,2094,2018,Watford FC,5,2,3,217,1,0,3,1,2,118,0,0,8,3,5,335,1,0,0,0,0,0,0,0,0,0,0,0,0,0
1729,1729,Magnus Hedman,2095,2000,Leeds United,1,1,0,90,0,0,0,0,0,0,0,0,1,1,0,90,0,0,0,0,0,0,0,0,0,0,0,0,0,0
1730,1730,Richard Shaw,2096,2000,Leeds United,1,1,0,90,0,0,0,0,0,0,0,0,1,1,0,90,0,0,0,0,0,0,0,0,0,0,0,0,0,0
1731,1731,Paul Williams,2097,2000,Leeds United,1,1,0,90,0,0,0,0,0,0,0,0,1,1,0,90,0,0,0,0,0,0,0,0,0,0,0,0,0,0
1732,1732,Gary Breen,2098,2000,Leeds United,1,1,0,90,0,0,0,0,0,0,0,0,1,1,0,90,0,0,0,0,0,0,0,0,0,0,0,0,0,0
1733,1733,Marcus Hall,2099,2000,Leeds United,1,1,0,90,0,0,0,0,0,0,0,0,1,1,0,90,0,0,0,0,0,0,0,0,0,0,0,0,0,0
1734,1734,Barry Quinn,2100,2000,Leeds United,1,1,0,51,0,0,0,0,0,0,0,0,1,1,0,51,0,0,0,0,0,0,0,0,0,0,0,0,0,0
1735,1735,John Eustace,2101,2000,Leeds United,1,1,0,90,0,0,0,0,0,0,0,0,1,1,0,90,0,0,0,0,0,0,0,0,0,0,0,0,0,0
1736,1736,David Thompson,2102,2000,Leeds United,1,1,0,76,0,0,0,0,0,0,0,0,1,1,0,76,0,0,0,0,0,0,0,0,0,0,0,0,0,0
1737,1737,Mustapha Hadji,2103,2000,Leeds United,1,1,0,90,0,0,0,0,0,0,0,0,1,1,0,90,0,0,0,0,0,0,0,0,0,0,0,0,0,0
1738,1738,Lee Carsley,1803,2000,Leeds United,1,1,0,76,0,0,0,0,0,0,0,0,1,1,0,76,0,0,0,0,0,0,0,0,0,0,0,0,0,0
1739,1739,Craig Bellamy,2012,2000,Leeds United,1,1,0,90,0,0,0,0,0,0,0,0,1,1,0,90,0,0,0,0,0,0,0,0,0,0,0,0,0,0
1740,1740,Youssef Chippo,2104,2000,Leeds United,1,0,1,14,0,0,0,0,0,0,0,0,1,0,1,14,0,0,0,0,0,0,0,0,0,0,0,0,0,0
1741,1741,Paul Telfer,2105,2000,Leeds United,1,0,1,39,0,0,0,0,0,0,0,0,1,0,1,39,0,0,0,0,0,0,0,0,0,0,0,0,0,0
1742,1742,Jay Bothroyd,1960,2000,Leeds United,1,0,1,14,0,0,0,0,0,0,0,0,1,0,1,14,0,0,0,0,0,0,0,0,0,0,0,0,0,0
1743,1743,Tim Howard,1743,2008,Everton FC,19,19,0,1710,0,0,15,15,0,1350,0,0,34,34,0,3060,0,0,0,0,0,0,0,0,0,0,0,0,0,0
1744,1744,Leighton Baines,1466,2008,Everton FC,15,13,2,1194,0,0,14,11,3,957,1,0,29,24,5,2151,1,0,0,0,0,0,1,1,0,0,0,0,0,0
1745,1745,Joseph Yobo,1801,2008,Everton FC,14,13,1,1149,1,0,11,11,0,990,0,0,25,24,1,2139,1,0,0,0,0,1,0,1,0,0,0,0,0,0
1746,1746,Joleon Lescott,1365,2008,Everton FC,17,17,0,1530,3,0,15,14,1,1304,1,0,32,31,1,2834,4,0,0,0,0,2,1,3,0,0,0,0,0,0
1747,1747,Phil Jagielka,1048,2008,Everton FC,17,17,0,1530,0,0,13,12,1,1083,0,0,30,29,1,2613,0,0,0,0,0,0,0,0,0,0,0,0,0,0
1748,1748,Phil Neville,1114,2008,Everton FC,18,18,0,1614,0,0,15,14,1,1251,0,0,33,32,1,2865,0,0,0,0,0,0,0,0,0,0,0,0,0,0
1749,1749,Nuno Valente,2106,2008,Everton FC,1,1,0,78,0,0,1,0,1,4,0,0,2,1,1,82,0,0,0,0,0,0,0,0,0,0,0,0,0,0
1750,1750,Mikel Arteta,1802,2008,Everton FC,13,13,0,1165,6,0,9,9,0,727,0,0,22,22,0,1892,6,0,0,0,0,4,0,4,2,0,2,0,0,0
1751,1751,Leon Osman,1747,2008,Everton FC,19,17,2,1557,1,0,12,12,0,1077,5,0,31,29,2,2634,6,0,0,1,1,0,4,4,0,0,0,0,0,0
1752,1752,Jack Rodwell,1748,2008,Everton FC,8,3,5,337,0,0,10,6,4,524,0,0,18,9,9,861,0,0,0,0,0,0,0,0,0,0,0,0,0,0
1753,1753,Yakubu Ayegbeni,1073,2008,Everton FC,7,7,0,621,2,0,6,6,0,444,2,0,13,13,0,1065,4,0,1,0,1,2,1,3,0,0,0,0,0,0
1754,1754,Jose Baxter,2107,2008,Everton FC,2,0,2,31,0,0,1,1,0,58,0,0,3,1,2,89,0,0,0,0,0,0,0,0,0,0,0,0,0,0
1755,1755,André Ooijer,2108,2008,Blackburn Rovers,15,14,1,1228,1,0,17,16,1,1446,1,0,32,30,2,2674,2,0,3,3,6,1,1,2,0,0,0,0,0,0
1756,1756,Christopher Samba,2109,2008,Blackburn Rovers,17,17,0,1454,1,0,17,17,0,1504,1,0,34,34,0,2958,2,0,0,0,0,1,1,2,0,0,0,0,0,0
1757,1757,Ryan Nelsen,2007,2008,Blackburn Rovers,17,17,0,1530,1,0,17,17,0,1529,0,0,34,34,0,3059,1,0,0,0,0,0,0,0,0,0,0,0,0,0
1758,1758,Aaron Mokoena,2008,2008,Blackburn Rovers,10,4,6,450,0,0,8,5,3,413,0,0,18,9,9,863,0,0,0,0,0,0,0,0,0,0,0,0,0,0
1759,1759,Steven Reid,1140,2008,Blackburn Rovers,2,2,0,180,0,0,2,2,0,180,0,0,4,4,0,360,0,0,0,0,0,0,0,0,0,0,0,0,0,0
1760,1760,Stephen Warnock,1616,2008,Blackburn Rovers,19,19,0,1710,1,0,17,17,0,1473,2,0,36,36,0,3183,3,0,0,0,0,0,2,2,0,0,0,0,0,0
1761,1761,David Dunn,1456,2008,Blackburn Rovers,6,3,3,298,0,0,9,4,5,459,1,0,15,7,8,757,1,0,0,0,0,0,1,1,0,0,0,0,0,0
1762,1762,Morten Gamst Pedersen,2009,2008,Blackburn Rovers,17,17,0,1327,1,0,15,14,1,1179,0,0,32,31,1,2506,1,0,0,0,0,1,0,1,0,0,0,0,0,0
1763,1763,Roque Santa Cruz,2110,2008,Blackburn Rovers,11,8,3,748,1,0,9,9,0,739,3,0,20,17,3,1487,4,0,0,0,0,0,2,2,0,0,0,0,0,0
1764,1764,Jason Roberts,1820,2008,Blackburn Rovers,15,13,2,1084,5,0,11,7,4,665,2,0,26,20,6,1749,7,0,0,3,3,1,1,2,0,0,0,0,0,0
1765,1765,Keith Treacy,2111,2008,Blackburn Rovers,6,1,5,140,0,0,6,1,5,156,0,0,12,2,10,296,0,0,0,0,0,0,0,0,0,0,0,0,0,0
1766,1766,Tugay Kerimoğlu,1136,2008,Blackburn Rovers,14,7,7,735,0,0,13,7,6,703,1,0,27,14,13,1438,1,0,0,0,0,0,1,1,0,0,0,0,0,0
1767,1767,Benny McCarthy,2112,2008,Blackburn Rovers,14,10,4,912,9,0,13,8,5,641,1,0,27,18,9,1553,10,0,2,0,2,7,1,8,3,1,4,0,0,0
1768,1768,Ben Foster,1653,2006,Watford FC,12,12,0,1079,0,0,16,16,0,1396,0,0,28,28,0,2475,0,0,0,0,0,0,0,0,0,0,0,0,0,0
1769,1769,Jordan Stewart,2113,2006,Watford FC,14,13,1,1151,0,0,14,14,0,1260,0,0,28,27,1,2411,0,0,0,0,0,0,0,0,0,0,0,0,0,0
1770,1770,Malky Mackay,2114,2006,Watford FC,8,8,0,720,0,0,6,5,1,506,0,0,14,13,1,1226,0,0,0,0,0,0,0,0,0,0,0,0,0,0
1771,1771,Lloyd Doyley,2115,2006,Watford FC,9,5,4,538,0,0,10,10,0,900,0,0,19,15,4,1438,0,0,0,0,0,0,0,0,0,0,0,0,0,0
1772,1772,Danny Shittu,2116,2006,Watford FC,12,10,2,869,0,0,15,14,1,1205,1,0,27,24,3,2074,1,0,0,0,0,0,1,1,0,0,0,0,0,0
1773,1773,Damien Francis,2117,2006,Watford FC,15,14,1,1174,2,0,14,11,3,1011,2,0,29,25,4,2185,4,0,0,0,0,1,1,2,0,0,0,0,0,0
1774,1774,Gavin Mahon,2118,2006,Watford FC,14,14,0,1194,1,0,17,16,1,1476,0,0,31,30,1,2670,1,0,0,0,0,1,0,1,0,0,0,0,0,0
1775,1775,Ashley Young,1619,2006,Watford FC,7,7,0,630,3,0,10,10,0,900,0,0,17,17,0,1530,3,0,1,0,1,1,0,1,0,0,0,0,0,0
1776,1776,Marlon King,2119,2006,Watford FC,6,6,0,540,3,0,7,6,1,581,1,0,13,12,1,1121,4,0,1,0,1,3,0,3,1,0,1,0,0,0
1777,1777,Darius Henderson,2120,2006,Watford FC,15,10,5,860,1,0,17,11,6,1066,2,0,32,21,11,1926,3,0,0,3,3,1,1,2,0,1,1,0,0,0
1778,1778,Tommy Smith,2121,2006,Watford FC,13,13,0,1135,1,0,16,16,0,1202,0,0,29,29,0,2337,1,0,0,0,0,1,0,1,0,0,0,0,0,0
1779,1779,Jay DeMerit,2122,2006,Watford FC,16,14,2,1318,1,0,13,12,1,1125,1,0,29,26,3,2443,2,0,3,0,3,1,1,2,0,0,0,0,0,0
1780,1780,Hameur Bouazza,1566,2006,Watford FC,15,12,3,1046,3,0,14,12,2,1039,2,0,29,24,5,2085,5,0,0,1,1,2,2,4,1,0,1,0,0,0
1781,1781,Tamás Priskin,2123,2006,Watford FC,8,2,6,298,2,0,8,5,3,455,0,0,16,7,9,753,2,0,1,0,1,1,0,1,0,0,0,0,0,0
1782,1782,Thomas Sørensen,1090,2006,Aston Villa,13,13,0,1150,0,0,15,15,0,1306,0,0,28,28,0,2456,0,0,0,0,0,0,0,0,0,0,0,0,0,0
1783,1783,Olof Mellberg,1790,2006,Aston Villa,18,18,0,1620,0,0,19,19,0,1666,1,0,37,37,0,3286,1,0,0,0,0,0,1,1,0,0,0,0,0,0
1784,1784,Martin Laursen,2124,2006,Aston Villa,5,5,0,450,0,0,9,7,2,604,0,0,14,12,2,1054,0,0,0,0,0,0,0,0,0,0,0,0,0,0
1785,1785,Liam Ridgewell,1772,2006,Aston Villa,9,8,1,721,0,0,11,10,1,954,1,0,20,18,2,1675,1,0,0,0,0,0,1,1,0,0,0,0,0,0
1786,1786,Gareth Barry,1418,2006,Aston Villa,17,17,0,1530,5,0,17,17,0,1530,3,0,34,34,0,3060,8,0,5,0,5,5,2,7,3,2,5,0,0,0
1787,1787,Gavin McCann,1096,2006,Aston Villa,15,14,1,1149,1,0,14,13,1,1184,0,0,29,27,2,2333,1,0,0,0,0,0,0,0,0,0,0,0,0,0
1788,1788,Stilian Petrov,1620,2006,Aston Villa,15,15,0,1350,0,0,15,15,0,1286,2,0,30,30,0,2636,2,0,0,0,0,0,1,1,0,0,0,0,0,0
1789,1789,Steven Davis,1149,2006,Aston Villa,11,8,3,759,0,0,16,8,8,799,0,0,27,16,11,1558,0,0,0,0,0,0,0,0,0,0,0,0,0,0
1790,1790,Juan Pablo Ángel,1795,2006,Aston Villa,11,9,2,781,3,0,11,8,3,627,1,0,22,17,5,1408,4,0,0,1,1,1,1,2,1,0,1,0,0,0
1791,1791,Gabriel Agbonlahor,1442,2006,Aston Villa,18,18,0,1613,5,0,19,18,1,1624,4,0,37,36,1,3237,9,0,2,4,6,4,2,6,0,0,0,0,0,0
1792,1792,Luke Moore,1796,2006,Aston Villa,5,2,3,216,2,0,7,4,3,335,2,0,12,6,6,551,4,0,0,1,1,1,2,3,0,0,0,0,0,0
1793,1793,Craig Gardner,1403,2006,Aston Villa,6,5,1,431,0,0,7,6,1,540,2,0,13,11,2,971,2,0,0,0,0,0,2,2,0,0,0,0,0,0
1794,1794,Milan Baroš,1961,2006,Aston Villa,9,5,4,404,0,0,8,5,3,471,1,0,17,10,7,875,1,0,0,1,1,0,1,1,0,0,0,0,0,0
1795,1795,Steve Mandanda,2125,2016,Crystal Palace,4,4,0,360,0,0,5,5,0,450,0,0,9,9,0,810,0,0,0,0,0,0,0,0,0,0,0,0,0,0
1796,1796,Joel Ward,1019,2016,Crystal Palace,19,19,0,1708,0,0,19,19,0,1710,0,0,38,38,0,3418,0,0,0,0,0,0,0,0,0,0,0,0,0,0
1797,1797,James Tomkins,1281,2016,Crystal Palace,11,11,0,934,2,0,13,12,1,1044,1,0,24,23,1,1978,3,0,0,0,0,1,0,1,0,0,0,0,0,0
1798,1798,Scott Dann,1020,2016,Crystal Palace,12,10,2,909,2,0,11,9,2,870,1,0,23,19,4,1779,3,0,1,0,1,1,1,2,0,0,0,0,0,0
1799,1799,Martin Kelly,1034,2016,Crystal Palace,15,12,3,1030,0,0,14,13,1,1100,0,0,29,25,4,2130,0,0,0,0,0,0,0,0,0,0,0,0,0,0
1800,1800,Yohan Cabaye,1029,2016,Crystal Palace,16,13,3,1087,2,0,16,12,4,1044,2,0,32,25,7,2131,4,0,0,0,0,0,1,1,0,0,0,0,0,0
1801,1801,Chung-yong Lee,2126,2016,Crystal Palace,7,3,4,279,0,0,8,1,7,187,0,0,15,4,11,466,0,0,0,0,0,0,0,0,0,0,0,0,0,0
1802,1802,Joe Ledley,1025,2016,Crystal Palace,9,6,3,593,0,0,9,7,2,569,1,0,18,13,5,1162,1,0,0,0,0,0,0,0,0,0,0,0,0,0
1803,1803,James McArthur,1023,2016,Crystal Palace,16,12,4,1032,4,0,13,12,1,978,1,0,29,24,5,2010,5,0,0,0,0,3,1,4,0,0,0,0,0,0
1804,1804,Wilfried Zaha,1028,2016,Crystal Palace,18,17,1,1544,2,0,17,17,0,1481,5,0,35,34,1,3025,7,0,0,3,3,2,5,7,0,0,0,0,0,0
1805,1805,Christian Benteke,1443,2016,Crystal Palace,18,18,0,1539,4,0,18,18,0,1599,11,0,36,36,0,3138,15,0,1,10,11,2,10,12,0,2,2,0,0,0
1806,1806,Jason Puncheon,1026,2016,Crystal Palace,18,17,1,1520,0,0,18,18,0,1576,0,0,36,35,1,3096,0,0,0,0,0,0,0,0,0,0,0,0,0,0
1807,1807,Fraizer Campbell,1027,2016,Crystal Palace,6,0,6,90,0,0,6,0,6,63,1,0,12,0,12,153,1,0,0,1,1,0,1,1,0,0,0,0,0,0
1808,1808,Andros Townsend,1176,2016,Crystal Palace,18,14,4,1229,2,0,18,16,2,1299,1,0,36,30,6,2528,3,0,0,0,0,1,0,1,0,0,0,0,0,0
1809,1809,Wayne Hennessey,1018,2016,Crystal Palace,15,15,0,1350,0,0,14,14,0,1260,0,0,29,29,0,2610,0,0,0,0,0,0,0,0,0,0,0,0,0,0
1810,1810,Ezekiel Fryers,2127,2016,Crystal Palace,3,0,3,60,0,0,5,0,5,120,0,0,8,0,8,180,0,0,0,0,0,0,0,0,0,0,0,0,0,0
1811,1811,Damien Delaney,1022,2016,Crystal Palace,15,10,5,942,0,0,15,11,4,1065,0,0,30,21,9,2007,0,0,0,0,0,0,0,0,0,0,0,0,0,0
1812,1812,Mathieu Flamini,1510,2016,Crystal Palace,4,1,3,67,0,0,6,2,4,203,0,0,10,3,7,270,0,0,0,0,0,0,0,0,0,0,0,0,0,0
1813,1813,Loris Karius,1178,2016,Liverpool FC,6,6,0,540,0,0,4,4,0,360,0,0,10,10,0,900,0,0,0,0,0,0,0,0,0,0,0,0,0,0
1814,1814,Nathaniel Clyne,1144,2016,Liverpool FC,19,19,0,1704,0,0,17,17,0,1530,0,0,36,36,0,3234,0,0,0,0,0,0,0,0,0,0,0,0,0,0
1815,1815,Dejan Lovren,1179,2016,Liverpool FC,13,13,0,1115,0,0,15,15,0,1350,2,0,28,28,0,2465,2,0,0,0,0,0,2,2,0,0,0,0,0,0
1816,1816,Alberto Moreno,2128,2016,Liverpool FC,5,0,5,28,0,0,6,1,5,179,0,0,11,1,10,207,0,0,0,0,0,0,0,0,0,0,0,0,0,0
1817,1817,Joel Matip,1182,2016,Liverpool FC,17,15,2,1376,0,0,12,12,0,1080,1,0,29,27,2,2456,1,0,0,0,0,0,1,1,0,0,0,0,0,0
1818,1818,Coutinho,1425,2016,Liverpool FC,16,15,1,1145,7,0,14,12,2,1028,6,0,30,27,3,2173,13,0,0,0,0,3,2,5,0,0,0,0,0,0
1819,1819,Jordan Henderson,1426,2016,Liverpool FC,12,12,0,1038,0,0,11,11,0,990,1,0,23,23,0,2028,1,0,0,0,0,0,0,0,0,0,0,0,0,0
1820,1820,Adam Lallana,1190,2016,Liverpool FC,15,13,2,1149,5,0,15,13,2,1127,3,0,30,26,4,2276,8,0,0,0,0,3,2,5,0,0,0,0,0,0
1821,1821,Emre Can,1185,2016,Liverpool FC,17,14,3,1290,2,0,14,12,2,1058,3,0,31,26,5,2348,5,0,3,3,6,1,2,3,0,0,0,0,0,0
1822,1822,Roberto Firmino,1186,2016,Liverpool FC,18,18,0,1590,7,0,16,15,1,1388,4,0,34,33,1,2978,11,0,0,6,6,4,3,7,0,0,0,0,0,0
1823,1823,Sadio Mané,1151,2016,Liverpool FC,14,13,1,1124,9,0,12,12,0,1033,4,0,26,25,1,2157,13,0,0,3,3,4,3,7,0,0,0,0,0,0
1824,1824,Ragnar Klavan,1188,2016,Liverpool FC,10,7,3,683,0,0,9,7,2,634,0,0,19,14,5,1317,0,0,0,0,0,0,0,0,0,0,0,0,0,0
1825,1825,Georginio Wijnaldum,1183,2016,Liverpool FC,18,16,2,1461,6,0,17,16,1,1429,0,0,35,32,3,2890,6,0,4,0,4,4,0,4,0,0,0,0,0,0
1826,1826,Divock Origi,2086,2016,Liverpool FC,15,6,9,648,4,0,18,8,10,798,3,0,33,14,19,1446,7,0,1,0,1,3,0,3,0,0,0,0,0,0
1827,1827,Simon Mignolet,1191,2016,Liverpool FC,13,13,0,1170,0,0,14,14,0,1260,0,0,27,27,0,2430,0,0,0,0,0,0,0,0,0,0,0,0,0,0
1828,1828,Connor Randall,2129,2016,Liverpool FC,0,0,0,0,0,0,0,0,0,0,0,0,0,0,0,0,0,0,0,0,0,0,0,0,0,0,0,0,0,0
1829,1829,Lucas Leiva,1429,2016,Liverpool FC,13,7,6,630,0,0,11,5,6,475,0,0,24,12,12,1105,0,0,0,0,0,0,0,0,0,0,0,0,0,0
1830,1830,Daniel Sturridge,1428,2016,Liverpool FC,8,3,5,332,1,0,12,4,8,437,2,0,20,7,13,769,3,0,0,0,0,0,2,2,0,0,0,0,0,0
1831,1831,Paul Robinson,1262,2002,Leeds United,18,18,0,1620,0,0,18,18,0,1620,0,0,36,36,0,3240,0,0,0,0,0,0,0,0,0,0,0,0,0,0
1832,1832,Raúl Bravo,2130,2002,Leeds United,3,3,0,270,0,0,2,2,0,130,0,0,5,5,0,400,0,0,0,0,0,0,0,0,0,0,0,0,0,0
1833,1833,Lucas Radebe,2131,2002,Leeds United,10,9,1,837,0,0,9,7,2,678,0,0,19,16,3,1515,0,0,0,0,0,0,0,0,0,0,0,0,0,0
1834,1834,Teddy Lučić,2132,2002,Leeds United,8,7,1,594,0,0,9,9,0,765,1,0,17,16,1,1359,1,0,0,0,0,0,1,1,0,0,0,0,0,0
1835,1835,Danny Mills,1292,2002,Leeds United,15,15,0,1303,0,0,16,16,0,1406,1,0,31,31,0,2709,1,0,0,0,0,0,1,1,0,0,0,0,0,0
1836,1836,Nick Barmby,2133,2002,Leeds United,9,7,2,554,2,0,10,9,1,794,2,0,19,16,3,1348,4,0,0,0,0,2,1,3,0,0,0,0,0,0
1837,1837,Jason Wilcox,1301,2002,Leeds United,12,11,1,940,0,0,11,10,1,904,1,0,23,21,2,1844,1,0,0,0,0,0,0,0,0,0,0,0,0,0
1838,1838,Eirik Bakke,1298,2002,Leeds United,15,14,1,1162,1,0,17,15,2,1300,0,0,32,29,3,2462,1,0,0,0,0,1,0,1,0,0,0,0,0,0
1839,1839,Paul Okon,2070,2002,Leeds United,7,7,0,599,0,0,7,7,0,596,0,0,14,14,0,1195,0,0,0,0,0,0,0,0,0,0,0,0,0,0
1840,1840,Mark Viduka,1299,2002,Leeds United,15,13,2,1174,10,0,17,15,2,1332,10,0,32,28,4,2506,20,0,1,3,4,5,4,9,1,2,3,0,0,0
1841,1841,Alan Smith,1300,2002,Leeds United,16,16,0,1397,2,0,15,15,0,1254,1,0,31,31,0,2651,3,0,0,0,0,1,0,1,0,0,0,0,0,0
1842,1842,James Milner,1189,2002,Leeds United,8,1,7,303,1,0,9,0,9,173,1,0,17,1,16,476,2,0,0,0,0,0,1,1,0,0,0,0,0,0
1843,1843,Mark Schwarzer,1328,2002,Middlesbrough FC,19,19,0,1710,0,0,17,17,0,1530,0,0,36,36,0,3240,0,0,0,0,0,0,0,0,0,0,0,0,0,0
1844,1844,Ugo Ehiogu,2134,2002,Middlesbrough FC,17,16,1,1406,3,0,13,13,0,1088,0,0,30,29,1,2494,3,0,1,0,1,3,0,3,0,0,0,0,0,0
1845,1845,Gareth Southgate,1331,2002,Middlesbrough FC,17,17,0,1530,2,0,17,17,0,1514,0,0,34,34,0,3044,2,0,4,0,4,2,0,2,0,0,0,0,0,0
1846,1846,Stuart Parnaby,1881,2002,Middlesbrough FC,10,10,0,900,0,0,10,10,0,797,0,0,20,20,0,1697,0,0,0,0,0,0,0,0,0,0,0,0,0,0
1847,1847,David Murphy,2135,2002,Middlesbrough FC,4,1,3,96,0,0,4,3,1,209,0,0,8,4,4,305,0,0,0,0,0,0,0,0,0,0,0,0,0,0
1848,1848,George Boateng,1333,2002,Middlesbrough FC,14,14,0,1260,0,0,12,12,0,1074,0,0,26,26,0,2334,0,0,0,0,0,0,0,0,0,0,0,0,0,0
1849,1849,Juninho Paulista,2136,2002,Middlesbrough FC,6,5,1,487,2,0,3,3,0,270,1,0,9,8,1,757,3,0,1,0,1,1,1,2,0,0,0,0,0,0
1850,1850,Jonathan Greening,1321,2002,Middlesbrough FC,19,19,0,1710,2,0,17,17,0,1485,0,0,36,36,0,3195,2,0,0,0,0,1,0,1,0,0,0,0,0,0
1851,1851,Geremi,1764,2002,Middlesbrough FC,17,17,0,1530,4,0,15,15,0,1348,3,0,32,32,0,2878,7,0,3,0,3,2,1,3,0,0,0,0,0,0
1852,1852,Massimo Maccarone,1888,2002,Middlesbrough FC,19,13,6,1177,7,0,14,12,2,923,2,0,33,25,8,2100,9,0,1,0,1,2,2,4,1,1,2,0,0,0
1853,1853,Malcolm Christie,2137,2002,Middlesbrough FC,5,5,0,319,3,0,6,5,1,437,1,0,11,10,1,756,4,0,1,0,1,3,0,3,0,0,0,0,0,0
1854,1854,Colin Cooper,2138,2002,Middlesbrough FC,9,7,2,639,0,0,10,6,4,670,0,0,19,13,6,1309,0,0,0,0,0,0,0,0,0,0,0,0,0,0
1855,1855,Szilárd Németh,2139,2002,Middlesbrough FC,14,9,5,874,6,0,13,5,8,525,1,0,27,14,13,1399,7,0,0,0,0,2,1,3,0,0,0,0,0,0
1856,1856,Michael Ricketts,2140,2002,Middlesbrough FC,3,2,1,225,0,0,5,3,2,302,1,0,8,5,3,527,1,0,0,0,0,0,0,0,0,0,0,0,0,0
1857,1857,Rui Patrício,2141,2018,Wolverhampton Wanderers,18,18,0,1620,0,0,19,19,0,1710,0,0,37,37,0,3330,0,0,0,0,0,0,0,0,0,0,0,0,0,0
1858,1858,Matt Doherty,2142,2018,Wolverhampton Wanderers,19,17,2,1557,1,0,19,18,1,1590,3,0,38,35,3,3147,4,0,0,6,6,0,3,3,0,0,0,0,0,0
1859,1859,Ryan Bennett,1382,2018,Wolverhampton Wanderers,19,19,0,1710,1,0,15,15,0,1350,0,0,34,34,0,3060,1,0,0,0,0,0,0,0,0,0,0,0,0,0
1860,1860,Willy Boly,2143,2018,Wolverhampton Wanderers,17,17,0,1530,2,0,19,19,0,1710,2,0,36,36,0,3240,4,0,1,0,1,2,2,4,0,0,0,0,0,0
1861,1861,Conor Coady,2144,2018,Wolverhampton Wanderers,19,19,0,1710,0,0,19,19,0,1710,0,0,38,38,0,3420,0,0,0,0,0,0,0,0,0,0,0,0,0,0
1862,1862,Jonny,2145,2018,Wolverhampton Wanderers,16,15,1,1269,1,0,17,17,0,1511,0,0,33,32,1,2780,1,0,0,0,0,0,0,0,0,0,0,0,0,0
1863,1863,Rúben Neves,2146,2018,Wolverhampton Wanderers,17,16,1,1451,3,0,18,18,0,1558,1,0,35,34,1,3009,4,0,0,0,0,2,1,3,1,1,2,0,0,0
1864,1864,João Moutinho,2147,2018,Wolverhampton Wanderers,19,18,1,1532,0,0,19,17,2,1508,1,0,38,35,3,3040,1,0,0,1,1,0,1,1,0,0,0,0,0,0
1865,1865,Raúl Jiménez,2148,2018,Wolverhampton Wanderers,19,19,0,1648,8,0,19,17,2,1477,5,0,38,36,2,3125,13,0,4,1,5,4,5,9,1,1,2,0,0,0
1866,1866,Hélder Costa,2149,2018,Wolverhampton Wanderers,11,8,3,658,0,0,14,8,6,688,1,0,25,16,9,1346,1,0,0,0,0,0,0,0,0,0,0,0,0,0
1867,1867,Diogo Jota,2150,2018,Wolverhampton Wanderers,16,15,1,1210,7,0,17,14,3,1161,2,0,33,29,4,2371,9,0,6,3,9,6,2,8,0,0,0,0,0,0
1868,1868,Ivan Cavaleiro,2151,2018,Wolverhampton Wanderers,13,3,10,331,2,0,10,3,7,351,1,0,23,6,17,682,3,0,0,0,0,1,1,2,0,0,0,0,0,0
1869,1869,Léo Bonatini,2152,2018,Wolverhampton Wanderers,4,0,4,62,0,0,3,0,3,67,0,0,7,0,7,129,0,0,0,0,0,0,0,0,0,0,0,0,0,0
1870,1870,Adama Traoré,1871,2018,Wolverhampton Wanderers,12,2,10,314,0,0,17,6,11,575,1,0,29,8,21,889,1,0,0,3,3,0,1,1,0,0,0,0,0,0
1871,1871,John Ruddy,1367,2018,Wolverhampton Wanderers,1,1,0,90,0,0,0,0,0,0,0,0,1,1,0,90,0,0,0,0,0,0,0,0,0,0,0,0,0,0
1872,1872,Romain Saïss,2153,2018,Wolverhampton Wanderers,8,6,2,544,1,0,11,6,5,600,1,0,19,12,7,1144,2,0,0,1,1,1,1,2,0,0,0,0,0,0
1873,1873,Rúben Vinagre,2154,2018,Wolverhampton Wanderers,12,5,7,516,0,0,5,2,3,189,0,0,17,7,10,705,0,0,0,0,0,0,0,0,0,0,0,0,0,0
1874,1874,Kortney Hause,2155,2018,Wolverhampton Wanderers,0,0,0,0,0,0,0,0,0,0,0,0,0,0,0,0,0,0,0,0,0,0,0,0,0,0,0,0,0,0
1875,1875,Alex McCarthy,1032,2018,Southampton FC,13,13,0,1170,0,0,12,12,0,1080,0,0,25,25,0,2250,0,0,0,0,0,0,0,0,0,0,0,0,0,0
1876,1876,Cédric Soares,1910,2018,Southampton FC,8,7,1,651,1,0,10,9,1,843,0,0,18,16,2,1494,1,0,0,0,0,0,0,0,0,0,0,0,0,0
1877,1877,Jannik Vestergaard,2156,2018,Southampton FC,13,13,0,1130,0,0,10,10,0,900,0,0,23,23,0,2030,0,0,0,0,0,0,0,0,0,0,0,0,0,0
1878,1878,Wesley Hoedt,1914,2018,Southampton FC,6,6,0,540,0,0,7,7,0,630,0,0,13,13,0,1170,0,0,0,0,0,0,0,0,0,0,0,0,0,0
1879,1879,Ryan Bertrand,1148,2018,Southampton FC,13,13,0,1170,1,0,11,11,0,990,0,0,24,24,0,2160,1,0,0,0,0,1,0,1,0,0,0,0,0,0
1880,1880,Mario Lemina,1911,2018,Southampton FC,9,9,0,763,0,0,12,9,3,852,1,0,21,18,3,1615,1,0,0,0,0,0,0,0,0,0,0,0,0,0
1881,1881,Nathan Redmond,1244,2018,Southampton FC,19,18,1,1633,4,0,19,18,1,1643,2,0,38,36,2,3276,6,0,0,0,0,4,2,6,0,0,0,0,0,0
1882,1882,Pierre-Emile Højbjerg,1248,2018,Southampton FC,16,16,0,1434,2,0,15,15,0,1348,2,0,31,31,0,2782,4,0,0,3,3,2,1,3,0,0,0,0,0,0
1883,1883,Danny Ings,1193,2018,Southampton FC,13,12,1,922,3,0,11,11,0,746,4,0,24,23,1,1668,7,0,0,0,0,2,1,3,1,2,3,0,0,0
1884,1884,Charlie Austin,1245,2018,Southampton FC,13,5,8,454,1,0,12,6,6,526,1,0,25,11,14,980,2,0,3,0,3,1,0,1,0,0,0,0,0,0
1885,1885,Mohamed Elyounoussi,2157,2018,Southampton FC,8,4,4,393,0,0,8,4,4,397,0,0,16,8,8,790,0,0,0,0,0,0,0,0,0,0,0,0,0,0
1886,1886,Stuart Armstrong,2158,2018,Southampton FC,11,5,6,469,1,0,18,11,7,963,2,0,29,16,13,1432,3,0,0,0,0,1,2,3,0,0,0,0,0,0
1887,1887,Manolo Gabbiadini,1913,2018,Southampton FC,6,2,4,253,1,0,6,2,4,217,0,0,12,4,8,470,1,0,0,0,0,1,0,1,0,0,0,0,0,0
1888,1888,Angus Gunn,2159,2018,Southampton FC,6,6,0,540,0,0,6,6,0,540,0,0,12,12,0,1080,0,0,0,0,0,0,0,0,0,0,0,0,0,0
1889,1889,Maya Yoshida,1145,2018,Southampton FC,9,9,0,800,0,0,8,8,0,720,0,0,17,17,0,1520,0,0,0,0,0,0,0,0,0,0,0,0,0,0
1890,1890,Matt Targett,1158,2018,Southampton FC,7,5,2,483,1,0,9,8,1,702,0,0,16,13,3,1185,1,0,0,0,0,1,0,1,0,0,0,0,0,0
1891,1891,Steven Davis,1149,2018,Southampton FC,2,0,2,7,0,0,1,1,0,90,0,0,3,1,2,97,0,0,0,0,0,0,0,0,0,0,0,0,0,0
1892,1892,Oriol Romeu,1243,2018,Southampton FC,16,13,3,1110,1,0,15,12,3,1030,0,0,31,25,6,2140,1,0,0,0,0,1,0,1,0,0,0,0,0,0
1893,1893,Shay Given,1581,2001,Newcastle United,19,19,0,1710,0,0,18,18,0,1620,0,0,37,37,0,3330,0,0,0,0,0,0,0,0,0,0,0,0,0,0
1894,1894,Andy O'Brien,2160,2001,Newcastle United,19,18,1,1601,1,0,15,13,2,1167,1,0,34,31,3,2768,2,0,0,0,0,1,1,2,0,0,0,0,0,0
1895,1895,Aaron Hughes,1561,2001,Newcastle United,16,16,0,1422,0,0,17,17,0,1530,0,0,33,33,0,2952,0,0,0,0,0,0,0,0,0,0,0,0,0,0
1896,1896,Nikolaos Dabizas,2161,2001,Newcastle United,16,14,2,1281,1,0,18,18,0,1556,2,0,34,32,2,2837,3,0,0,3,3,0,2,2,0,0,0,0,0,0
1897,1897,Olivier Bernard,2032,2001,Newcastle United,7,2,5,251,3,0,9,2,7,322,0,0,16,4,12,573,3,0,0,0,0,1,0,1,0,0,0,0,0,0
1898,1898,Nolberto Solano,1791,2001,Newcastle United,19,19,0,1624,3,0,17,17,0,1452,4,0,36,36,0,3076,7,0,3,6,9,1,3,4,0,0,0,0,0,0
1899,1899,Kieron Dyer,2033,2001,Newcastle United,9,7,2,675,2,0,8,7,1,604,1,0,17,14,3,1279,3,0,0,0,0,2,1,3,0,0,0,0,0,0
1900,1900,Gary Speed,1716,2001,Newcastle United,15,14,1,1245,3,0,13,13,0,1116,2,0,28,27,1,2361,5,0,3,0,3,2,1,3,0,0,0,0,0,0
1901,1901,Laurent Robert,2034,2001,Newcastle United,18,18,0,1575,4,0,17,15,2,1371,4,0,35,33,2,2946,8,0,0,0,0,3,0,3,0,0,0,0,0,0
1902,1902,Alan Shearer,1948,2001,Newcastle United,19,18,1,1632,12,0,17,17,0,1504,11,0,36,35,1,3136,23,0,4,1,5,8,7,15,2,3,5,0,0,0
1903,1903,Lomana LuaLua,1074,2001,Newcastle United,10,2,8,299,2,0,10,2,8,271,1,0,20,4,16,570,3,0,0,3,3,1,1,2,0,0,0,0,0,0
1904,1904,Sylvain Distin,1015,2001,Newcastle United,14,11,3,1032,0,0,13,8,5,820,0,0,27,19,8,1852,0,0,0,0,0,0,0,0,0,0,0,0,0,0
1905,1905,Jermaine Jenas,1275,2001,Newcastle United,7,3,4,300,0,0,5,3,2,318,0,0,12,6,6,618,0,0,0,0,0,0,0,0,0,0,0,0,0,0
1906,1906,Carl Cort,2162,2001,Newcastle United,5,3,2,233,1,0,3,3,0,218,0,0,8,6,2,451,1,0,0,0,0,1,0,1,0,0,0,0,0,0
1907,1907,Paddy Kenny,2163,2011,Queens Park Rangers,17,17,0,1530,0,0,16,16,0,1440,0,0,33,33,0,2970,0,0,0,0,0,0,0,0,0,0,0,0,0,0
1908,1908,Fitz Hall,2024,2011,Queens Park Rangers,7,5,2,485,0,0,7,6,1,438,0,0,14,11,3,923,0,0,0,0,0,0,0,0,0,0,0,0,0,0
1909,1909,Armand Traoré,1238,2011,Queens Park Rangers,11,9,2,760,0,0,12,9,3,858,0,0,23,18,5,1618,0,0,0,0,0,0,0,0,0,0,0,0,0,0
1910,1910,Luke Young,1952,2011,Queens Park Rangers,12,12,0,1055,0,0,11,11,0,977,2,0,23,23,0,2032,2,0,0,0,0,0,2,2,0,0,0,0,0,0
1911,1911,Anton Ferdinand,1686,2011,Queens Park Rangers,16,16,0,1440,0,0,15,15,0,1310,0,0,31,31,0,2750,0,0,0,0,0,0,0,0,0,0,0,0,0,0
1912,1912,Shaun Derry,2164,2011,Queens Park Rangers,14,13,1,1124,1,0,15,15,0,1189,0,0,29,28,1,2313,1,0,0,0,0,0,0,0,0,0,0,0,0,0
1913,1913,Adel Taarabt,2165,2011,Queens Park Rangers,16,13,3,1203,2,0,11,11,0,823,0,0,27,24,3,2026,2,0,3,0,3,2,0,2,0,0,0,0,0,0
1914,1914,Alejandro Faurlín,2166,2011,Queens Park Rangers,10,10,0,900,0,0,10,10,0,900,1,0,20,20,0,1800,1,0,0,0,0,0,0,0,0,0,0,0,0,0
1915,1915,Joey Barton,1876,2011,Queens Park Rangers,18,18,0,1592,2,0,13,13,0,1170,1,0,31,31,0,2762,3,0,0,0,0,2,1,3,0,0,0,0,0,0
1916,1916,Shaun Wright-Phillips,1683,2011,Queens Park Rangers,16,12,4,1059,0,0,16,12,4,1155,0,0,32,24,8,2214,0,0,0,0,0,0,0,0,0,0,0,0,0,0
1917,1917,Jay Bothroyd,1960,2011,Queens Park Rangers,9,6,3,483,1,0,12,6,6,620,1,0,21,12,9,1103,2,0,0,0,0,1,0,1,0,0,0,0,0,0
1918,1918,DJ Campbell,2167,2011,Queens Park Rangers,6,2,4,201,0,0,5,0,5,121,1,0,11,2,9,322,1,0,0,0,0,0,0,0,0,0,0,0,0,0
1919,1919,Tommy Smith,2121,2011,Queens Park Rangers,7,1,6,162,1,0,10,3,7,378,1,0,17,4,13,540,2,0,0,3,3,0,1,1,0,0,0,0,0,0
1920,1920,Heiðar Helguson,1759,2011,Queens Park Rangers,10,8,2,714,6,0,6,5,1,440,2,0,16,13,3,1154,8,0,3,0,3,5,1,6,2,0,2,0,0,0
1921,1921,Brian Murphy,2168,2011,Queens Park Rangers,0,0,0,0,0,0,0,0,0,0,0,0,0,0,0,0,0,0,0,0,0,0,0,0,0,0,0,0,0,0
1922,1922,Bradley Orr,2169,2011,Queens Park Rangers,1,0,1,83,0,0,5,2,3,245,0,0,6,2,4,328,0,0,0,0,0,0,0,0,0,0,0,0,0,0
1923,1923,Matthew Connolly,2170,2011,Queens Park Rangers,3,2,1,219,0,0,3,3,0,270,0,0,6,5,1,489,0,0,0,0,0,0,0,0,0,0,0,0,0,0
1924,1924,Ákos Buzsáky,2171,2011,Queens Park Rangers,9,4,5,375,2,0,9,6,3,520,0,0,18,10,8,895,2,0,0,0,0,0,0,0,0,0,0,0,0,0
1925,1925,Shay Given,1581,2011,Aston Villa,16,16,0,1388,0,0,16,16,0,1440,0,0,32,32,0,2828,0,0,0,0,0,0,0,0,0,0,0,0,0,0
1926,1926,Alan Hutton,2172,2011,Aston Villa,16,14,2,1256,0,0,15,15,0,1338,0,0,31,29,2,2594,0,0,0,0,0,0,0,0,0,0,0,0,0,0
1927,1927,Stephen Warnock,1616,2011,Aston Villa,17,17,0,1490,1,0,18,17,1,1565,1,0,35,34,1,3055,2,0,0,0,0,1,0,1,0,0,0,0,0,0
1928,1928,Richard Dunne,1617,2011,Aston Villa,14,14,0,1260,0,0,14,14,0,1260,1,0,28,28,0,2520,1,0,0,0,0,0,1,1,0,0,0,0,0,0
1929,1929,James Collins,1618,2011,Aston Villa,16,15,1,1340,1,0,16,16,0,1440,0,0,32,31,1,2780,1,0,0,0,0,0,0,0,0,0,0,0,0,0
1930,1930,Stephen Ireland,1809,2011,Aston Villa,13,10,3,848,0,0,11,9,2,742,1,0,24,19,5,1590,1,0,0,0,0,0,1,1,0,0,0,0,0,0
1931,1931,Charles N'Zogbia,2016,2011,Aston Villa,16,13,3,1151,1,0,14,11,3,929,1,0,30,24,6,2080,2,0,1,0,1,1,1,2,0,0,0,0,0,0
1932,1932,Fabian Delph,1198,2011,Aston Villa,5,5,0,435,0,0,6,5,1,419,0,0,11,10,1,854,0,0,0,0,0,0,0,0,0,0,0,0,0,0
1933,1933,Stilian Petrov,1620,2011,Aston Villa,14,13,1,1165,0,0,13,13,0,1163,4,0,27,26,1,2328,4,0,0,0,0,0,3,3,0,0,0,0,0,0
1934,1934,Barry Bannan,1975,2011,Aston Villa,15,6,9,660,0,0,13,4,9,586,1,0,28,10,18,1246,1,0,0,0,0,0,1,1,0,1,1,0,0,0
1935,1935,Gabriel Agbonlahor,1442,2011,Aston Villa,15,14,1,1189,4,0,18,18,0,1576,1,0,33,32,1,2765,5,0,0,1,1,4,1,5,0,0,0,0,0,0
1936,1936,Marc Albrighton,1448,2011,Aston Villa,14,8,6,819,1,0,12,7,5,672,1,0,26,15,11,1491,2,0,0,0,0,1,1,2,0,0,0,0,0,0
1937,1937,Andreas Weimann,1441,2011,Aston Villa,8,4,4,422,2,0,6,1,5,132,0,0,14,5,9,554,2,0,3,0,3,2,0,2,0,0,0,0,0,0
1938,1938,Brad Guzan,1435,2011,Aston Villa,4,3,1,322,0,0,3,3,0,270,0,0,7,6,1,592,0,0,0,0,0,0,0,0,0,0,0,0,0,0
1939,1939,Habib Beye,2173,2011,Aston Villa,0,0,0,0,0,0,0,0,0,0,0,0,0,0,0,0,0,0,0,0,0,0,0,0,0,0,0,0,0,0
1940,1940,Shane Lowry,2174,2011,Aston Villa,0,0,0,0,0,0,0,0,0,0,0,0,0,0,0,0,0,0,0,0,0,0,0,0,0,0,0,0,0,0
1941,1941,Gary Gardner,1449,2011,Aston Villa,4,2,2,212,0,0,10,3,7,393,0,0,14,5,9,605,0,0,0,0,0,0,0,0,0,0,0,0,0,0
1942,1942,Nathan Delfouneso,2175,2011,Aston Villa,5,1,4,119,0,0,1,0,1,44,0,0,6,1,5,163,0,0,0,0,0,0,0,0,0,0,0,0,0,0
1943,1943,Max Aarons,2176,2019,Norwich City,18,18,0,1620,0,0,18,18,0,1620,0,0,36,36,0,3240,0,0,0,0,0,0,0,0,0,0,0,0,0,0
1944,1944,Christoph Zimmermann,2177,2019,Norwich City,8,7,1,674,0,0,9,9,0,756,0,0,17,16,1,1430,0,0,0,0,0,0,0,0,0,0,0,0,0,0
1945,1945,Tom Trybull,2178,2019,Norwich City,7,6,1,511,0,0,9,8,1,627,0,0,16,14,2,1138,0,0,0,0,0,0,0,0,0,0,0,0,0,0
1946,1946,Mario Vrančić,2179,2019,Norwich City,12,4,8,404,1,0,8,2,6,224,0,0,20,6,14,628,1,0,0,0,0,1,0,1,0,0,0,0,0,0
1947,1947,Onel Hernandez,2180,2019,Norwich City,12,8,4,732,1,0,14,6,8,648,0,0,26,14,12,1380,1,0,0,0,0,0,0,0,0,0,0,0,0,0
1948,1948,Rui Patrício,2141,2019,Wolverhampton Wanderers,19,19,0,1710,0,0,19,19,0,1710,0,0,38,38,0,3420,0,0,0,0,0,0,0,0,0,0,0,0,0,0
1949,1949,Matt Doherty,2142,2019,Wolverhampton Wanderers,19,17,2,1532,3,0,17,15,2,1309,1,0,36,32,4,2841,4,0,4,0,4,3,1,4,0,0,0,0,0,0
1950,1950,Conor Coady,2144,2019,Wolverhampton Wanderers,19,19,0,1710,0,0,19,19,0,1710,0,0,38,38,0,3420,0,0,0,0,0,0,0,0,0,0,0,0,0,0
1951,1951,Jonny,2145,2019,Wolverhampton Wanderers,18,18,0,1593,1,0,17,15,2,1298,1,0,35,33,2,2891,2,0,0,1,1,0,1,1,0,0,0,0,0,0
1952,1952,Romain Saïss,2153,2019,Wolverhampton Wanderers,14,14,0,1260,0,0,19,17,2,1463,2,0,33,31,2,2723,2,0,0,0,0,0,2,2,0,0,0,0,0,0
1953,1953,Rúben Neves,2146,2019,Wolverhampton Wanderers,19,18,1,1540,2,0,19,17,2,1521,0,0,38,35,3,3061,2,0,1,0,1,2,0,2,0,0,0,0,0,0
1954,1954,João Moutinho,2147,2019,Wolverhampton Wanderers,19,17,2,1516,0,0,19,17,2,1592,1,0,38,34,4,3108,1,0,0,0,0,0,1,1,0,0,0,0,0,0
1955,1955,Leander Dendoncker,2181,2019,Wolverhampton Wanderers,19,17,2,1499,3,0,19,15,4,1296,1,0,38,32,6,2795,4,0,1,3,4,2,1,3,0,0,0,0,0,0
1956,1956,Raúl Jiménez,2148,2019,Wolverhampton Wanderers,19,19,0,1644,8,0,19,18,1,1608,9,0,38,37,1,3252,17,0,5,10,15,6,8,14,3,1,4,0,0,0
1957,1957,Diogo Jota,2150,2019,Wolverhampton Wanderers,17,12,5,1086,3,0,17,15,2,1212,4,0,34,27,7,2298,7,0,0,2,2,1,4,5,0,0,0,0,0,0
1958,1958,Adama Traoré,1871,2019,Wolverhampton Wanderers,19,13,6,1253,2,0,18,14,4,1351,2,0,37,27,10,2604,4,0,0,0,0,1,1,2,0,0,0,0,0,0
1959,1959,Pedro Neto,2182,2019,Wolverhampton Wanderers,14,5,9,483,0,0,15,4,11,445,3,0,29,9,20,928,3,0,0,0,0,0,0,0,0,0,0,0,0,0
1960,1960,Patrick Cutrone,2183,2019,Wolverhampton Wanderers,6,1,5,124,2,0,6,2,4,170,0,0,12,3,9,294,2,0,0,0,0,0,0,0,0,0,0,0,0,0
1961,1961,John Ruddy,1367,2019,Wolverhampton Wanderers,0,0,0,0,0,0,0,0,0,0,0,0,0,0,0,0,0,0,0,0,0,0,0,0,0,0,0,0,0,0
1962,1962,Jesús Vallejo,2184,2019,Wolverhampton Wanderers,2,1,1,162,0,0,0,0,0,0,0,0,2,1,1,162,0,0,0,0,0,0,0,0,0,0,0,0,0,0
1963,1963,Ryan Bennett,1382,2019,Wolverhampton Wanderers,6,3,3,204,0,0,5,4,1,401,0,0,11,7,4,605,0,0,0,0,0,0,0,0,0,0,0,0,0,0
1964,1964,Rúben Vinagre,2154,2019,Wolverhampton Wanderers,4,1,3,122,0,0,12,5,7,524,0,0,16,6,10,646,0,0,0,0,0,0,0,0,0,0,0,0,0,0
1965,1965,Max Kilman,2185,2019,Wolverhampton Wanderers,1,1,0,90,0,0,2,1,1,94,0,0,3,2,1,184,0,0,0,0,0,0,0,0,0,0,0,0,0,0
1966,1966,De Gea,1638,2015,Manchester United,17,17,0,1530,0,0,17,17,0,1530,0,0,34,34,0,3060,0,0,0,0,0,0,0,0,0,0,0,0,0,0
1967,1967,Chris Smalling,1640,2015,Manchester United,17,17,0,1530,0,0,18,18,0,1620,0,0,35,35,0,3150,0,0,0,0,0,0,0,0,0,0,0,0,0,0
1968,1968,Daley Blind,2186,2015,Manchester United,18,18,0,1587,1,0,17,17,0,1530,0,0,35,35,0,3117,1,0,0,0,0,1,0,1,0,0,0,0,0,0
1969,1969,Matteo Darmian,2187,2015,Manchester United,13,10,3,901,1,0,15,14,1,1030,0,0,28,24,4,1931,1,0,0,0,0,0,0,0,0,0,0,0,0,0
1970,1970,Cameron Borthwick-Jackson,2188,2015,Manchester United,5,3,2,300,0,0,5,3,2,392,0,0,10,6,4,692,0,0,0,0,0,0,0,0,0,0,0,0,0,0
1971,1971,Mata,1643,2015,Manchester United,19,17,2,1524,3,0,19,17,2,1441,3,0,38,34,4,2965,6,0,3,3,6,1,2,3,1,0,1,0,0,0
1972,1972,Michael Carrick,1627,2015,Manchester United,13,10,3,876,0,0,15,12,3,1098,0,0,28,22,6,1974,0,0,0,0,0,0,0,0,0,0,0,0,0,0
1973,1973,Marouane Fellaini,2189,2015,Manchester United,9,7,2,558,0,0,9,5,4,510,1,0,18,12,6,1068,1,0,0,0,0,0,1,1,0,0,0,0,0,0
1974,1974,Jesse Lingard,1646,2015,Manchester United,12,9,3,824,2,0,13,10,3,810,2,0,25,19,6,1634,4,0,0,0,0,2,1,3,0,0,0,0,0,0
1975,1975,Anthony Martial,1647,2015,Manchester United,16,14,2,1281,6,0,15,15,0,1350,5,0,31,29,2,2631,11,0,3,0,3,3,5,8,0,0,0,0,0,0
1976,1976,Wayne Rooney,1058,2015,Manchester United,14,14,0,1217,4,0,14,13,1,1192,4,0,28,27,1,2409,8,0,3,3,6,2,3,5,0,1,1,0,0,0
1977,1977,Ander Herrera,1644,2015,Manchester United,15,7,8,766,2,0,12,10,2,768,1,0,27,17,10,1534,3,0,0,0,0,0,0,0,1,0,1,0,0,0
1978,1978,Andreas Pereira,2190,2015,Manchester United,1,0,1,2,0,0,3,0,3,78,0,0,4,0,4,80,0,0,0,0,0,0,0,0,0,0,0,0,0,0
1979,1979,Memphis Depay,2191,2015,Manchester United,14,8,6,727,1,0,15,8,7,750,1,0,29,16,13,1477,2,0,0,0,0,1,1,2,0,0,0,0,0,0
1980,1980,Sergio Romero,2192,2015,Manchester United,2,2,0,180,0,0,2,2,0,180,0,0,4,4,0,360,0,0,0,0,0,0,0,0,0,0,0,0,0,0
1981,1981,Guillermo Varela,2193,2015,Manchester United,3,2,1,224,0,0,1,1,0,90,0,0,4,3,1,314,0,0,0,0,0,0,0,0,0,0,0,0,0,0
1982,1982,Paddy McNair,2194,2015,Manchester United,4,1,3,89,0,0,4,2,2,222,0,0,8,3,5,311,0,0,0,0,0,0,0,0,0,0,0,0,0,0
1983,1983,Morgan Schneiderlin,1051,2015,Manchester United,14,13,1,1142,0,0,15,12,3,1063,1,0,29,25,4,2205,1,0,0,0,0,0,1,1,0,0,0,0,0,0
1984,1984,Jack Butland,1901,2015,Stoke City,15,15,0,1350,0,0,16,16,0,1440,0,0,31,31,0,2790,0,0,0,0,0,0,0,0,0,0,0,0,0,0
1985,1985,Erik Pieters,1545,2015,Stoke City,18,18,0,1576,0,0,17,17,0,1522,0,0,35,35,0,3098,0,0,0,0,0,0,0,0,0,0,0,0,0,0
1986,1986,Muniesa,1556,2015,Stoke City,6,4,2,428,0,0,9,8,1,684,0,0,15,12,3,1112,0,0,0,0,0,0,0,0,0,0,0,0,0,0
1987,1987,Glen Johnson,1386,2015,Stoke City,12,12,0,1053,0,0,13,13,0,1133,0,0,25,25,0,2186,0,0,0,0,0,0,0,0,0,0,0,0,0,0
1988,1988,Philipp Wollscheid,1582,2015,Stoke City,16,15,1,1394,0,0,15,15,0,1290,0,0,31,30,1,2684,0,0,0,0,0,0,0,0,0,0,0,0,0,0
1989,1989,Glenn Whelan,1549,2015,Stoke City,19,19,0,1606,0,0,18,18,0,1568,0,0,37,37,0,3174,0,0,0,0,0,0,0,0,0,0,0,0,0,0
1990,1990,Ibrahim Afellay,1907,2015,Stoke City,15,13,2,1140,1,0,16,11,5,1030,1,0,31,24,7,2170,2,0,0,0,0,1,0,1,0,0,0,0,0,0
1991,1991,Marko Arnautović,1552,2015,Stoke City,18,17,1,1471,8,0,16,16,0,1349,3,0,34,33,1,2820,11,0,3,6,9,4,2,6,1,2,3,0,0,0
1992,1992,Jon Walters,1555,2015,Stoke City,14,9,5,865,3,0,13,9,4,859,2,0,27,18,9,1724,5,0,0,0,0,2,2,4,0,0,0,0,0,0
1993,1993,Peter Crouch,1273,2015,Stoke City,6,1,5,175,0,0,5,3,2,282,0,0,11,4,7,457,0,0,0,0,0,0,0,0,0,0,0,0,0,0
1994,1994,Bojan,1585,2015,Stoke City,14,12,2,997,4,0,13,10,3,712,3,0,27,22,5,1709,7,0,0,6,6,3,3,6,1,1,2,0,0,0
1995,1995,Phil Bardsley,1409,2015,Stoke City,5,4,1,306,0,0,6,5,1,510,0,0,11,9,2,816,0,0,0,0,0,0,0,0,0,0,0,0,0,0
1996,1996,Stephen Ireland,1809,2015,Stoke City,4,0,4,57,0,0,9,0,9,174,0,0,13,0,13,231,0,0,0,0,0,0,0,0,0,0,0,0,0,0
1997,1997,Jakob Haugaard,1587,2015,Stoke City,2,2,0,180,0,0,3,2,1,224,0,0,5,4,1,404,0,0,0,0,0,0,0,0,0,0,0,0,0,0
1998,1998,Xherdan Shaqiri,1904,2015,Stoke City,14,14,0,974,1,0,13,13,0,1056,2,0,27,27,0,2030,3,0,3,0,3,1,2,3,0,0,0,0,0,0
1999,1999,Peter Odemwingie,1551,2015,Stoke City,4,0,4,82,0,0,1,0,1,19,0,0,5,0,5,101,0,0,0,0,0,0,0,0,0,0,0,0,0,0
2000,2000,Joselu,2195,2015,Stoke City,9,5,4,492,1,0,13,5,8,597,3,0,22,10,12,1089,4,0,0,0,0,1,1,2,0,0,0,0,0,0
2001,2001,Mame Diouf,1584,2015,Stoke City,13,4,9,503,2,0,13,8,5,766,3,0,26,12,14,1269,5,0,6,2,8,2,3,5,0,0,0,0,0,0
2002,2002,Erik Edman,2196,2009,Wigan Athletic,1,1,0,78,0,0,2,1,1,109,0,0,3,2,1,187,0,0,0,0,0,0,0,0,0,0,0,0,0,0
2003,2003,Scott Sinclair,1420,2009,Wigan Athletic,8,0,8,138,0,0,10,1,9,205,1,0,18,1,17,343,1,0,0,0,0,0,0,0,0,0,0,0,0,0
2004,2004,Mark Schwarzer,1328,2009,Fulham FC,16,16,0,1440,0,0,19,19,0,1710,0,0,35,35,0,3150,0,0,0,0,0,0,0,0,0,0,0,0,0,0
2005,2005,Paul Konchesky,1560,2009,Fulham FC,13,13,0,1170,1,0,12,12,0,1017,0,0,25,25,0,2187,1,0,0,0,0,1,0,1,0,0,0,0,0,0
2006,2006,John Paintsil,2036,2009,Fulham FC,11,11,0,964,0,0,10,10,0,846,0,0,21,21,0,1810,0,0,0,0,0,0,0,0,0,0,0,0,0,0
2007,2007,Brede Hangeland,1033,2009,Fulham FC,15,15,0,1350,1,0,16,16,0,1369,0,0,31,31,0,2719,1,0,3,0,3,1,0,1,0,0,0,0,0,0
2008,2008,Aaron Hughes,1561,2009,Fulham FC,16,16,0,1440,0,0,16,16,0,1440,0,0,32,32,0,2880,0,0,0,0,0,0,0,0,0,0,0,0,0,0
2009,2009,Chris Baird,1562,2009,Fulham FC,14,12,2,1092,0,0,16,15,1,1385,0,0,30,27,3,2477,0,0,0,0,0,0,0,0,0,0,0,0,0,0
2010,2010,Damien Duff,1348,2009,Fulham FC,16,16,0,1228,4,0,14,12,2,1135,2,0,30,28,2,2363,6,0,4,0,4,3,0,3,0,0,0,0,0,0
2011,2011,Jonathan Greening,1321,2009,Fulham FC,10,6,4,600,1,0,13,9,4,900,0,0,23,15,8,1500,1,0,3,0,3,1,0,1,0,0,0,0,0,0
2012,2012,Erik Nevland,2197,2009,Fulham FC,12,5,7,531,2,0,11,7,4,635,1,0,23,12,11,1166,3,0,0,0,0,2,1,3,0,0,0,0,0,0
2013,2013,Clint Dempsey,1565,2009,Fulham FC,13,12,1,1114,4,0,15,14,1,1191,3,0,28,26,2,2305,7,0,0,2,2,1,2,3,0,1,1,0,0,0
2014,2014,Bobby Zamora,1943,2009,Fulham FC,13,13,0,1053,6,0,12,12,0,996,2,0,25,25,0,2049,8,0,6,3,9,4,2,6,0,0,0,0,0,0
2015,2015,Zoltán Gera,1323,2009,Fulham FC,13,7,6,809,0,0,12,10,2,879,2,0,25,17,8,1688,2,0,0,0,0,0,2,2,0,0,0,0,0,0
2016,2016,Dickson Etuhu,1969,2009,Fulham FC,10,8,2,728,0,0,9,5,4,515,0,0,19,13,6,1243,0,0,0,0,0,0,0,0,0,0,0,0,0,0
2017,2017,David Martin,2198,2019,West Ham United,1,1,0,90,0,0,4,3,1,345,0,0,5,4,1,435,0,0,0,0,0,0,0,0,0,0,0,0,0,0
2018,2018,Aaron Cresswell,2199,2019,West Ham United,16,16,0,1395,1,0,15,15,0,1335,2,0,31,31,0,2730,3,0,0,4,4,0,2,2,0,0,0,0,0,0
2019,2019,Fabián Balbuena,2200,2019,West Ham United,8,6,2,542,1,0,9,7,2,634,0,0,17,13,4,1176,1,0,0,0,0,0,0,0,0,0,0,0,0,0
2020,2020,Angelo Ogbonna,2201,2019,West Ham United,14,14,0,1260,2,0,17,17,0,1527,0,0,31,31,0,2787,2,0,0,0,0,1,0,1,0,0,0,0,0,0
2021,2021,Ryan Fredericks,2202,2019,West Ham United,14,12,2,1097,0,0,13,13,0,1140,0,0,27,25,2,2237,0,0,0,0,0,0,0,0,0,0,0,0,0,0
2022,2022,Felipe Anderson,2203,2019,West Ham United,13,11,2,815,1,0,12,9,3,692,0,0,25,20,5,1507,1,0,0,0,0,0,0,0,0,0,0,0,0,0
2023,2023,Mark Noble,2204,2019,West Ham United,15,15,0,1286,2,0,18,17,1,1400,2,0,33,32,1,2686,4,0,0,0,0,1,1,2,1,2,3,0,0,0
2024,2024,Pablo Fornals,2205,2019,West Ham United,18,11,7,1046,1,0,18,13,5,1131,1,0,36,24,12,2177,2,0,0,0,0,1,1,2,0,0,0,0,0,0
2025,2025,Declan Rice,2206,2019,West Ham United,19,19,0,1710,1,0,19,19,0,1710,0,0,38,38,0,3420,1,0,0,0,0,0,0,0,0,0,0,0,0,0
2026,2026,Robert Snodgrass,2207,2019,West Ham United,13,8,5,786,4,0,11,9,2,727,1,0,24,17,7,1513,5,0,0,0,0,1,1,2,0,0,0,0,0,0
2027,2027,Michail Antonio,2208,2019,West Ham United,11,9,2,785,4,0,13,10,3,985,6,0,24,19,5,1770,10,0,0,0,0,2,3,5,0,1,1,0,0,0
2028,2028,Arthur Masuaku,2209,2019,West Ham United,7,3,4,362,0,0,10,7,3,594,0,0,17,10,7,956,0,0,0,0,0,0,0,0,0,0,0,0,0,0
2029,2029,Sébastien Haller,2210,2019,West Ham United,17,13,4,1245,4,0,15,11,4,1017,3,0,32,24,8,2262,7,0,0,3,3,3,2,5,0,0,0,0,0,0
2030,2030,Nathan Holland,2211,2019,West Ham United,1,0,1,12,0,0,1,0,1,19,0,0,2,0,2,31,0,0,0,0,0,0,0,0,0,0,0,0,0,0
2031,2031,Roberto,2212,2019,West Ham United,4,4,0,360,0,0,4,3,1,326,0,0,8,7,1,686,0,0,0,0,0,0,0,0,0,0,0,0,0,0
2032,2032,Pablo Zabaleta,1355,2019,West Ham United,5,3,2,268,0,0,5,3,2,321,0,0,10,6,4,589,0,0,0,0,0,0,0,0,0,0,0,0,0,0
2033,2033,Issa Diop,2213,2019,West Ham United,17,17,0,1504,2,0,15,14,1,1262,1,0,32,31,1,2766,3,0,0,0,0,2,1,3,0,0,0,0,0,0
2034,2034,Carlos Sánchez,1867,2019,West Ham United,3,1,2,93,0,0,3,0,3,20,0,0,6,1,5,113,0,0,0,0,0,0,0,0,0,0,0,0,0,0
2035,2035,Kieran Tierney,2214,2019,Arsenal FC,8,7,1,630,1,0,7,5,2,362,0,0,15,12,3,992,1,0,0,0,0,0,0,0,0,0,0,0,0,0
2036,2036,Sokratis Papastathopoulos,2215,2019,Arsenal FC,11,11,0,990,2,0,8,8,0,707,0,0,19,19,0,1697,2,0,0,0,0,1,0,1,0,0,0,0,0,0
2037,2037,Mesut Özil,1500,2019,Arsenal FC,10,10,0,846,1,0,8,8,0,603,0,0,18,18,0,1449,1,0,0,0,0,0,0,0,0,0,0,0,0,0
2038,2038,Sead Kolašinac,2216,2019,Arsenal FC,14,9,5,724,0,0,12,10,2,975,0,0,26,19,7,1699,0,0,0,0,0,0,0,0,0,0,0,0,0,0
2039,2039,Edwin van der Sar,1077,2008,Manchester United,17,17,0,1530,0,0,16,16,0,1382,0,0,33,33,0,2912,0,0,0,0,0,0,0,0,0,0,0,0,0,0
2040,2040,Rafael,1787,2008,Manchester United,10,8,2,686,0,0,6,4,2,368,1,0,16,12,4,1054,1,0,0,0,0,0,0,0,0,0,0,0,0,0
2041,2041,Darren Fletcher,1730,2008,Manchester United,15,14,1,1123,1,0,11,11,0,936,2,0,26,25,1,2059,3,0,1,3,4,1,2,3,0,0,0,0,0,0
2042,2042,Ryan Giggs,1110,2008,Manchester United,13,7,6,677,0,0,15,8,7,822,2,0,28,15,13,1499,2,0,0,3,3,0,2,2,0,0,0,0,0,0
2043,2043,Ross Turnbull,2217,2008,Middlesbrough FC,10,10,0,900,0,0,12,12,0,1080,0,0,22,22,0,1980,0,0,0,0,0,0,0,0,0,0,0,0,0,0
2044,2044,Chris Riggott,1330,2008,Middlesbrough FC,7,7,0,630,0,0,10,10,0,785,0,0,17,17,0,1415,0,0,0,0,0,0,0,0,0,0,0,0,0,0
2045,2045,Emanuel Pogatetz,1883,2008,Middlesbrough FC,13,13,0,1126,1,0,14,14,0,1206,0,0,27,27,0,2332,1,0,0,0,0,0,0,0,0,0,0,0,0,0
2046,2046,Matthew Bates,1887,2008,Middlesbrough FC,8,7,1,655,1,0,9,8,1,740,0,0,17,15,2,1395,1,0,0,0,0,1,0,1,0,0,0,0,0,0
2047,2047,David Wheater,2218,2008,Middlesbrough FC,17,17,0,1486,1,0,15,14,1,1299,0,0,32,31,1,2785,1,0,0,0,0,1,0,1,0,0,0,0,0,0
2048,2048,Gary O'Neil,1389,2008,Middlesbrough FC,12,12,0,1037,1,0,17,16,1,1437,3,0,29,28,1,2474,4,0,0,0,0,0,3,3,0,0,0,0,0,0
2049,2049,Stewart Downing,1335,2008,Middlesbrough FC,19,19,0,1636,0,0,18,18,0,1620,0,0,37,37,0,3256,0,0,0,0,0,0,0,0,0,0,0,0,0,0
2050,2050,Julio Arca,1341,2008,Middlesbrough FC,11,8,3,724,0,0,7,6,1,438,0,0,18,14,4,1162,0,0,0,0,0,0,0,0,0,0,0,0,0,0
2051,2051,Jérémie Aliadiére,1530,2008,Middlesbrough FC,16,15,1,1239,1,0,13,12,1,1031,1,0,29,27,2,2270,2,0,1,3,4,1,1,2,0,0,0,0,0,0
2052,2052,Afonso Alves,2219,2008,Middlesbrough FC,16,11,5,1047,3,0,15,13,2,1123,1,0,31,24,7,2170,4,0,0,0,0,3,1,4,1,0,1,0,0,0
2053,2053,Tuncay Şanlı,2220,2008,Middlesbrough FC,17,16,1,1378,4,0,16,14,2,1294,3,0,33,30,3,2672,7,0,3,3,6,3,3,6,0,0,0,0,0,0
2054,2054,Marvin Emnes,1709,2008,Middlesbrough FC,7,1,6,157,0,0,8,2,6,224,0,0,15,3,12,381,0,0,0,0,0,0,0,0,0,0,0,0,0,0
2055,2055,Allan McGregor,2221,2014,Hull City,13,13,0,1170,0,0,13,13,0,1170,0,0,26,26,0,2340,0,0,0,0,0,0,0,0,0,0,0,0,0,0
2056,2056,Alex Bruce,2222,2014,Hull City,9,7,2,568,0,0,13,10,3,883,0,0,22,17,5,1451,0,0,0,0,0,0,0,0,0,0,0,0,0,0
2057,2057,James Chester,2223,2014,Hull City,10,10,0,880,0,0,13,13,0,1072,2,0,23,23,0,1952,2,0,0,3,3,0,2,2,0,0,0,0,0,0
2058,2058,Curtis Davies,2224,2014,Hull City,10,10,0,888,0,0,11,11,0,928,0,0,21,21,0,1816,0,0,0,0,0,0,0,0,0,0,0,0,0,0
2059,2059,Andrew Robertson,1181,2014,Hull City,14,10,4,866,0,0,10,7,3,659,0,0,24,17,7,1525,0,0,0,0,0,0,0,0,0,0,0,0,0,0
2060,2060,Ahmed Elmohamady,1690,2014,Hull City,19,19,0,1710,2,0,19,19,0,1710,0,0,38,38,0,3420,2,0,0,0,0,1,0,1,0,0,0,0,0,0
2061,2061,David Meyler,2225,2014,Hull City,14,10,4,939,0,0,14,9,5,825,1,0,28,19,9,1764,1,0,0,0,0,0,1,1,0,0,0,0,0,0
2062,2062,Jake Livermore,1657,2014,Hull City,18,18,0,1503,1,0,17,17,0,1530,0,0,35,35,0,3033,1,0,0,0,0,1,0,1,0,0,0,0,0,0
2063,2063,Gastón Ramírez,2226,2014,Hull City,12,6,6,550,0,0,10,5,5,476,1,0,22,11,11,1026,1,0,0,0,0,0,1,1,0,0,0,0,0,0
2064,2064,Abel Hernández,2227,2014,Hull City,15,9,6,861,3,0,10,6,4,451,1,0,25,15,10,1312,4,0,0,0,0,3,1,4,1,0,1,0,0,0
2065,2065,Nikica Jelavić,2228,2014,Hull City,16,12,4,1121,5,0,10,9,1,689,3,0,26,21,5,1810,8,0,0,0,0,3,1,4,0,0,0,0,0,0
2066,2066,Liam Rosenior,1756,2014,Hull City,8,3,5,377,0,0,5,2,3,233,0,0,13,5,8,610,0,0,0,0,0,0,0,0,0,0,0,0,0,0
2067,2067,Harry Maguire,2229,2014,Hull City,2,0,2,46,0,0,1,0,1,44,0,0,3,0,3,90,0,0,0,0,0,0,0,0,0,0,0,0,0,0
2068,2068,Robbie Brady,2230,2014,Hull City,15,9,6,939,0,0,12,8,4,817,0,0,27,17,10,1756,0,0,0,0,0,0,0,0,0,0,0,0,0,0
2069,2069,Steve Harper,2231,2014,Hull City,5,5,0,450,0,0,5,5,0,403,0,0,10,10,0,853,0,0,0,0,0,0,0,0,0,0,0,0,0,0
2070,2070,Tom Ince,2232,2014,Hull City,3,1,2,108,0,0,4,2,2,192,0,0,7,3,4,300,0,0,0,0,0,0,0,0,0,0,0,0,0,0
2071,2071,Sone Aluko,2233,2014,Hull City,11,5,6,482,0,0,14,8,6,760,1,0,25,13,12,1242,1,0,0,1,1,0,1,1,0,0,0,0,0,0
2072,2072,Yannick Sagbo,2234,2014,Hull City,1,0,1,8,0,0,3,0,3,47,0,0,4,0,4,55,0,0,0,0,0,0,0,0,0,0,0,0,0,0
2073,2073,Joel,1060,2014,Everton FC,4,3,1,314,0,0,3,3,0,270,0,0,7,6,1,584,0,0,0,0,0,0,0,0,0,0,0,0,0,0
2074,2074,Leighton Baines,1466,2014,Everton FC,16,16,0,1424,1,0,15,15,0,1350,1,0,31,31,0,2774,2,0,0,1,1,0,1,1,1,1,2,0,0,0
2075,2075,Phil Jagielka,1048,2014,Everton FC,19,19,0,1666,2,0,18,18,0,1620,2,0,37,37,0,3286,4,0,3,1,4,2,1,3,0,0,0,0,0,0
2076,2076,Séamus Coleman,1467,2014,Everton FC,18,18,0,1620,2,0,17,16,1,1446,1,0,35,34,1,3066,3,0,0,0,0,1,1,2,0,0,0,0,0,0
2077,2077,Antolín Alcaráz,2235,2014,Everton FC,5,3,2,260,0,0,3,3,0,270,0,0,8,6,2,530,0,0,0,0,0,0,0,0,0,0,0,0,0,0
2078,2078,Muhamed Bešić,2236,2014,Everton FC,13,6,7,618,0,0,10,9,1,667,0,0,23,15,8,1285,0,0,0,0,0,0,0,0,0,0,0,0,0,0
2079,2079,Gareth Barry,1418,2014,Everton FC,15,15,0,1322,0,0,18,18,0,1507,0,0,33,33,0,2829,0,0,0,0,0,0,0,0,0,0,0,0,0,0
2080,2080,Ross Barkley,1754,2014,Everton FC,16,14,2,1147,2,0,13,8,5,819,0,0,29,22,7,1966,2,0,0,0,0,1,0,1,0,0,0,0,0,0
2081,2081,Arouna Koné,2237,2014,Everton FC,6,3,3,255,0,0,6,4,2,347,1,0,12,7,5,602,1,0,0,0,0,0,1,1,0,0,0,0,0,0
2082,2082,Kevin Mirallas,2238,2014,Everton FC,15,10,5,817,4,0,14,8,6,607,3,0,29,18,11,1424,7,0,3,0,3,1,1,2,0,0,0,0,0,0
2083,2083,Steven Naismith,2239,2014,Everton FC,16,11,5,1029,5,0,15,11,4,1026,2,0,31,22,9,2055,7,0,1,0,1,2,2,4,0,0,0,0,0,0
2084,2084,Bryan Oviedo,2240,2014,Everton FC,2,1,1,134,0,0,4,1,3,182,0,0,6,2,4,316,0,0,0,0,0,0,0,0,0,0,0,0,0,0
2085,2085,Romelu Lukaku,1645,2014,Everton FC,18,16,2,1442,5,0,18,16,2,1430,5,0,36,32,4,2872,10,0,0,6,6,3,4,7,1,1,2,0,0,0
2086,2086,Russell Griffiths,2241,2014,Everton FC,0,0,0,0,0,0,0,0,0,0,0,0,0,0,0,0,0,0,0,0,0,0,0,0,0,0,0,0,0,0
2087,2087,Sylvain Distin,1015,2014,Everton FC,7,6,1,540,0,0,6,6,0,540,0,0,13,12,1,1080,0,0,0,0,0,0,0,0,0,0,0,0,0,0
2088,2088,Aiden McGeady,2242,2014,Everton FC,7,4,3,317,0,0,9,6,3,570,1,0,16,10,6,887,1,0,0,0,0,0,1,1,0,0,0,0,0,0
2089,2089,Samuel Eto'o,2243,2014,Everton FC,7,2,5,261,1,0,7,6,1,521,2,0,14,8,6,782,3,0,0,0,0,0,1,1,0,0,0,0,0,0
2090,2090,Christian Atsu,2244,2014,Everton FC,5,1,4,112,0,0,0,0,0,0,0,0,5,1,4,112,0,0,0,0,0,0,0,0,0,0,0,0,0,0
2091,2091,Robert Green,1277,2007,West Ham United,19,19,0,1710,0,0,18,18,0,1620,0,0,37,37,0,3330,0,0,0,0,0,0,0,0,0,0,0,0,0,0
2092,2092,Lucas Neill,1132,2007,West Ham United,17,17,0,1530,0,0,17,17,0,1530,0,0,34,34,0,3060,0,0,0,0,0,0,0,0,0,0,0,0,0,0
2093,2093,George McCartney,1340,2007,West Ham United,19,19,0,1639,1,0,18,18,0,1500,0,0,37,37,0,3139,1,0,0,0,0,1,0,1,0,0,0,0,0,0
2094,2094,Anton Ferdinand,1686,2007,West Ham United,12,10,2,898,2,0,12,11,1,991,0,0,24,21,3,1889,2,0,3,0,3,2,0,2,0,0,0,0,0,0
2095,2095,Jonathan Spector,1288,2007,West Ham United,10,6,4,599,0,0,15,6,9,627,0,0,25,12,13,1226,0,0,0,0,0,0,0,0,0,0,0,0,0,0
2096,2096,Freddie Ljungberg,1525,2007,West Ham United,13,12,1,996,1,0,12,10,2,862,1,0,25,22,3,1858,2,0,0,0,0,1,1,2,0,0,0,0,0,0
2097,2097,Scott Parker,1282,2007,West Ham United,10,9,1,742,0,0,7,7,0,597,1,0,17,16,1,1339,1,0,0,3,3,0,1,1,0,0,0,0,0,0
2098,2098,Nolberto Solano,1791,2007,West Ham United,12,8,4,646,2,0,11,6,5,606,2,0,23,14,9,1252,4,0,0,3,3,2,1,3,0,0,0,0,0,0
2099,2099,Hayden Mullins,1941,2007,West Ham United,16,14,2,1255,0,0,17,17,0,1464,0,0,33,31,2,2719,0,0,0,0,0,0,0,0,0,0,0,0,0,0
2100,2100,Dean Ashton,2245,2007,West Ham United,16,10,6,1062,5,0,14,9,5,844,5,0,30,19,11,1906,10,0,1,4,5,3,4,7,0,0,0,0,0,0
2101,2101,Bobby Zamora,1943,2007,West Ham United,8,7,1,555,1,0,4,3,1,291,0,0,12,10,2,846,1,0,0,0,0,1,0,1,0,0,0,0,0,0
2102,2102,John Paintsil,2036,2007,West Ham United,7,2,5,281,0,0,6,2,4,324,0,0,13,4,9,605,0,0,0,0,0,0,0,0,0,0,0,0,0,0
2103,2103,Mark Noble,2204,2007,West Ham United,16,13,3,1185,2,0,15,12,3,1100,1,0,31,25,6,2285,3,0,3,3,6,2,1,3,1,1,2,0,0,0
2104,2104,Freddie Sears,2246,2007,West Ham United,4,1,3,131,1,0,2,0,2,55,0,0,6,1,5,186,1,0,3,0,3,1,0,1,0,0,0,0,0,0
2105,2105,Brad Friedel,1343,2007,Blackburn Rovers,19,19,0,1710,0,0,17,17,0,1530,0,0,36,36,0,3240,0,0,0,0,0,0,0,0,0,0,0,0,0,0
2106,2106,André Ooijer,2108,2007,Blackburn Rovers,14,12,2,1068,0,0,12,10,2,879,0,0,26,22,4,1947,0,0,0,0,0,0,0,0,0,0,0,0,0,0
2107,2107,Christopher Samba,2109,2007,Blackburn Rovers,17,17,0,1530,0,0,15,15,0,1347,2,0,32,32,0,2877,2,0,0,3,3,0,2,2,0,0,0,0,0,0
2108,2108,Steven Reid,1140,2007,Blackburn Rovers,12,9,3,873,0,0,10,9,1,811,0,0,22,18,4,1684,0,0,0,0,0,0,0,0,0,0,0,0,0,0
2109,2109,Stephen Warnock,1616,2007,Blackburn Rovers,19,19,0,1674,0,0,16,16,0,1431,1,0,35,35,0,3105,1,0,0,1,1,0,1,1,0,0,0,0,0,0
2110,2110,Brett Emerton,1141,2007,Blackburn Rovers,17,15,2,1420,0,0,14,14,0,1186,1,0,31,29,2,2606,1,0,0,0,0,0,1,1,0,0,0,0,0,0
2111,2111,David Bentley,2011,2007,Blackburn Rovers,18,18,0,1611,4,0,17,17,0,1530,2,0,35,35,0,3141,6,0,0,3,3,3,2,5,0,0,0,0,0,0
2112,2112,Morten Gamst Pedersen,2009,2007,Blackburn Rovers,19,16,3,1426,3,0,17,15,2,1360,1,0,36,31,5,2786,4,0,1,0,1,2,1,3,0,0,0,0,0,0
2113,2113,David Dunn,1456,2007,Blackburn Rovers,15,14,1,1012,1,0,15,11,4,984,0,0,30,25,5,1996,1,0,1,0,1,1,0,1,0,0,0,0,0,0
2114,2114,Roque Santa Cruz,2110,2007,Blackburn Rovers,19,19,0,1646,6,0,16,15,1,1368,13,0,35,34,1,3014,19,0,0,4,4,3,9,12,0,0,0,0,0,0
2115,2115,Jason Roberts,1820,2007,Blackburn Rovers,12,5,7,563,2,0,13,6,7,680,1,0,25,11,14,1243,3,0,0,3,3,2,1,3,0,0,0,0,0,0
2116,2116,Zurab Khizanishvili,2006,2007,Blackburn Rovers,6,5,1,486,0,0,6,4,2,377,0,0,12,9,3,863,0,0,0,0,0,0,0,0,0,0,0,0,0,0
2117,2117,Benny McCarthy,2112,2007,Blackburn Rovers,15,10,5,843,7,0,14,9,5,692,1,0,29,19,10,1535,8,0,6,0,6,5,1,6,5,0,5,0,0,0
2118,2118,Matt Derbyshire,2247,2007,Blackburn Rovers,11,2,9,357,1,0,11,2,9,257,2,0,22,4,18,614,3,0,1,6,7,1,2,3,0,0,0,0,0,0
2119,2119,Jonny Evans,1216,2017,West Bromwich Albion,13,12,1,1093,2,0,15,14,1,1180,0,0,28,26,2,2273,2,0,0,0,0,1,0,1,0,0,0,0,0,0
2120,2120,Gareth Barry,1418,2017,West Bromwich Albion,13,12,1,1020,1,0,12,10,2,906,0,0,25,22,3,1926,1,0,0,0,0,0,0,0,0,0,0,0,0,0
2121,2121,Hal Robson-Kanu,1984,2017,West Bromwich Albion,10,3,7,366,1,0,11,5,6,462,1,0,21,8,13,828,2,0,0,3,3,1,1,2,0,0,0,0,0,0
2122,2122,Gareth McAuley,1732,2017,West Bromwich Albion,4,3,1,254,0,0,5,2,3,202,0,0,9,5,4,456,0,0,0,0,0,0,0,0,0,0,0,0,0,0
2123,2123,Max Melbourne,2248,2017,West Bromwich Albion,0,0,0,0,0,0,0,0,0,0,0,0,0,0,0,0,0,0,0,0,0,0,0,0,0,0,0,0,0,0
2124,2124,Julian Speroni,2249,2017,Crystal Palace,6,6,0,540,0,0,5,5,0,450,0,0,11,11,0,990,0,0,0,0,0,0,0,0,0,0,0,0,0,0
2125,2125,Joel Ward,1019,2017,Crystal Palace,9,9,0,780,0,0,10,10,0,836,0,0,19,19,0,1616,0,0,0,0,0,0,0,0,0,0,0,0,0,0
2126,2126,Mamadou Sakho,2250,2017,Crystal Palace,9,8,1,700,1,0,10,10,0,900,0,0,19,18,1,1600,1,0,3,0,3,1,0,1,0,0,0,0,0,0
2127,2127,Martin Kelly,1034,2017,Crystal Palace,7,5,2,514,0,0,8,7,1,680,0,0,15,12,3,1194,0,0,0,0,0,0,0,0,0,0,0,0,0,0
2128,2128,Luka Milivojević,2251,2017,Crystal Palace,19,18,1,1565,4,0,17,17,0,1517,6,0,36,35,1,3082,10,0,1,3,4,3,3,6,4,3,7,0,0,0
2129,2129,Ruben Loftus-Cheek,1852,2017,Crystal Palace,12,11,1,962,2,0,12,10,2,914,0,0,24,21,3,1876,2,0,0,0,0,1,0,1,0,0,0,0,0,0
2130,2130,Jeffrey Schlupp,2252,2017,Crystal Palace,10,9,1,792,0,0,14,12,2,956,0,0,24,21,3,1748,0,0,0,0,0,0,0,0,0,0,0,0,0,0
2131,2131,James McArthur,1023,2017,Crystal Palace,16,13,3,1131,3,0,17,14,3,1303,2,0,33,27,6,2434,5,0,3,0,3,2,2,4,0,0,0,0,0,0
2132,2132,Andros Townsend,1176,2017,Crystal Palace,18,17,1,1527,2,0,18,18,0,1601,0,0,36,35,1,3128,2,0,0,0,0,2,0,2,0,0,0,0,0,0
2133,2133,Wilfried Zaha,1028,2017,Crystal Palace,15,15,0,1350,7,0,14,13,1,1200,2,0,29,28,1,2550,9,0,4,0,4,6,1,7,0,0,0,0,0,0
2134,2134,Christian Benteke,1443,2017,Crystal Palace,17,12,5,1184,1,0,14,12,2,1052,2,0,31,24,7,2236,3,0,0,0,0,0,2,2,1,0,1,0,0,0
2135,2135,Bakary Sako,2253,2017,Crystal Palace,6,1,5,183,2,0,10,3,7,284,1,0,16,4,12,467,3,0,3,0,3,2,0,2,0,0,0,0,0,0
2136,2136,Patrick van Aanholt,2254,2017,Crystal Palace,14,13,1,1062,3,0,14,12,2,1123,2,0,28,25,3,2185,5,0,0,3,3,0,1,1,0,0,0,0,0,0
2137,2137,Timothy Fosu-Mensah,2255,2017,Crystal Palace,13,9,4,874,0,0,8,8,0,720,0,0,21,17,4,1594,0,0,0,0,0,0,0,0,0,0,0,0,0,0
2138,2138,Jaïro Riedewald,2256,2017,Crystal Palace,7,4,3,384,0,0,5,0,5,51,0,0,12,4,8,435,0,0,0,0,0,0,0,0,0,0,0,0,0,0
2139,2139,Jason Puncheon,1026,2017,Crystal Palace,6,3,3,305,0,0,4,3,1,265,0,0,10,6,4,570,0,0,0,0,0,0,0,0,0,0,0,0,0,0
2140,2140,De Gea,1638,2013,Manchester United,19,19,0,1710,0,0,18,18,0,1620,0,0,37,37,0,3330,0,0,0,0,0,0,0,0,0,0,0,0,0,0
2141,2141,Patrice Evra,1724,2013,Manchester United,16,16,0,1419,0,0,17,17,0,1466,1,0,33,33,0,2885,1,0,0,0,0,0,1,1,0,0,0,0,0,0
2142,2142,Phil Jones,1650,2013,Manchester United,14,14,0,1192,0,0,12,12,0,983,1,0,26,26,0,2175,1,0,0,0,0,0,1,1,0,0,0,0,0,0
2143,2143,Rio Ferdinand,1294,2013,Manchester United,7,6,1,543,0,0,7,6,1,584,0,0,14,12,2,1127,0,0,0,0,0,0,0,0,0,0,0,0,0,0
2144,2144,Nemanja Vidić,1725,2013,Manchester United,13,12,1,1104,0,0,12,11,1,993,0,0,25,23,2,2097,0,0,0,0,0,0,0,0,0,0,0,0,0,0
2145,2145,Mata,1643,2013,Manchester United,7,6,1,537,3,0,8,8,0,692,3,0,15,14,1,1229,6,0,0,1,1,0,2,2,0,0,0,0,0,0
2146,2146,Michael Carrick,1627,2013,Manchester United,15,14,1,1275,1,0,14,12,2,1136,0,0,29,26,3,2411,1,0,0,0,0,1,0,1,0,0,0,0,0,0
2147,2147,Ashley Young,1619,2013,Manchester United,9,5,4,457,2,0,11,8,3,569,0,0,20,13,7,1026,2,0,0,0,0,0,0,0,0,0,0,0,0,0
2148,2148,Darren Fletcher,1730,2013,Manchester United,4,4,0,332,0,0,8,5,3,448,0,0,12,9,3,780,0,0,0,0,0,0,0,0,0,0,0,0,0,0
2149,2149,Javier Hernández,2257,2013,Manchester United,13,3,10,422,2,0,11,3,8,423,2,0,24,6,18,845,4,0,3,0,3,1,0,1,0,0,0,0,0,0
2150,2150,Nani,2258,2013,Manchester United,6,5,1,368,0,0,5,2,3,190,0,0,11,7,4,558,0,0,0,0,0,0,0,0,0,0,0,0,0,0
2151,2151,Adnan Januzaj,2259,2013,Manchester United,15,7,8,821,1,0,12,8,4,820,3,0,27,15,12,1641,4,0,0,3,3,0,2,2,0,0,0,0,0,0
2152,2152,Danny Welbeck,1506,2013,Manchester United,10,7,3,574,3,0,15,8,7,883,6,0,25,15,10,1457,9,0,0,3,3,1,2,3,0,0,0,0,0,0
2153,2153,Robin van Persie,1528,2013,Manchester United,12,9,3,848,7,0,9,9,0,733,5,0,21,18,3,1581,12,0,3,0,3,6,3,9,1,1,2,0,0,0
2154,2154,Ben Amos,2260,2013,Manchester United,0,0,0,0,0,0,0,0,0,0,0,0,0,0,0,0,0,0,0,0,0,0,0,0,0,0,0,0,0,0
2155,2155,Chris Smalling,1640,2013,Manchester United,10,9,1,770,0,0,15,12,3,1166,1,0,25,21,4,1936,1,0,0,0,0,0,0,0,0,0,0,0,0,0
2156,2156,Antonio Valencia,1641,2013,Manchester United,14,10,4,949,1,0,15,10,5,991,1,0,29,20,9,1940,2,0,0,0,0,1,1,2,0,0,0,0,0,0
2157,2157,Marouane Fellaini,2189,2013,Manchester United,9,6,3,544,0,0,7,6,1,562,0,0,16,12,4,1106,0,0,0,0,0,0,0,0,0,0,0,0,0,0
2158,2158,Vito Mannone,2261,2013,Sunderland AFC,14,14,0,1260,0,0,15,14,1,1307,0,0,29,28,1,2567,0,0,0,0,0,0,0,0,0,0,0,0,0,0
2159,2159,Wes Brown,1108,2013,Sunderland AFC,13,13,0,1170,0,0,12,11,1,1034,0,0,25,24,1,2204,0,0,0,0,0,0,0,0,0,0,0,0,0,0
2160,2160,John O'Shea,1729,2013,Sunderland AFC,17,17,0,1493,1,0,16,16,0,1440,0,0,33,33,0,2933,1,0,0,0,0,1,0,1,0,0,0,0,0,0
2161,2161,Santiago Vergini,2262,2013,Sunderland AFC,5,4,1,438,0,0,6,6,0,540,0,0,11,10,1,978,0,0,0,0,0,0,0,0,0,0,0,0,0,0
2162,2162,Marcos Alonso,1846,2013,Sunderland AFC,8,8,0,720,0,0,8,8,0,720,0,0,16,16,0,1440,0,0,0,0,0,0,0,0,0,0,0,0,0,0
2163,2163,Sebastian Larsson,1402,2013,Sunderland AFC,15,12,3,1070,0,0,16,12,4,1148,1,0,31,24,7,2218,1,0,0,3,3,0,1,1,0,0,0,0,0,0
2164,2164,Adam Johnson,1405,2013,Sunderland AFC,19,15,4,1333,4,0,17,13,4,1110,4,0,36,28,8,2443,8,0,4,0,4,3,1,4,0,1,1,0,0,0
2165,2165,Jack Colback,1404,2013,Sunderland AFC,16,15,1,1296,1,0,17,13,4,1128,2,0,33,28,5,2424,3,0,0,1,1,1,1,2,0,0,0,0,0,0
2166,2166,Lee Cattermole,1687,2013,Sunderland AFC,11,10,1,776,0,0,13,11,2,1027,1,0,24,21,3,1803,1,0,0,0,0,0,1,1,0,0,0,0,0,0
2167,2167,Connor Wickham,1035,2013,Sunderland AFC,9,5,4,470,2,0,6,5,1,380,3,0,15,10,5,850,5,0,0,0,0,1,3,4,0,0,0,0,0,0
2168,2168,Fabio Borini,1777,2013,Sunderland AFC,16,11,5,1023,5,0,16,14,2,1121,2,0,32,25,7,2144,7,0,3,3,6,1,2,3,1,2,3,0,0,0
2169,2169,Emanuele Giaccherini,2263,2013,Sunderland AFC,10,7,3,592,2,0,14,9,5,762,2,0,24,16,8,1354,4,0,0,0,0,0,1,1,0,0,0,0,0,0
2170,2170,Liam Bridcutt,2264,2013,Sunderland AFC,6,4,2,380,0,0,6,5,1,466,0,0,12,9,3,846,0,0,0,0,0,0,0,0,0,0,0,0,0,0
2171,2171,Jozy Altidore,1615,2013,Sunderland AFC,16,11,5,1044,1,0,15,8,7,733,0,0,31,19,12,1777,1,0,0,0,0,1,0,1,0,0,0,0,0,0
2172,2172,Óscar Ustari,2265,2013,Sunderland AFC,0,0,0,0,0,0,0,0,0,0,0,0,0,0,0,0,0,0,0,0,0,0,0,0,0,0,0,0,0,0
2173,2173,Phil Bardsley,1409,2013,Sunderland AFC,13,13,0,1086,2,0,13,13,0,1161,0,0,26,26,0,2247,2,0,3,0,3,1,0,1,0,0,0,0,0,0
2174,2174,El-Hadji Ba,2266,2013,Sunderland AFC,1,0,1,19,0,0,0,0,0,0,0,0,1,0,1,19,0,0,0,0,0,0,0,0,0,0,0,0,0,0
2175,2175,Ignacio Scocco,2267,2013,Sunderland AFC,2,0,2,18,0,0,4,0,4,75,0,0,6,0,6,93,0,0,0,0,0,0,0,0,0,0,0,0,0,0
2176,2176,Petr Čech,1531,2008,Chelsea FC,17,17,0,1530,0,0,17,17,0,1530,0,0,34,34,0,3060,0,0,0,0,0,0,0,0,0,0,0,0,0,0
2177,2177,Ashley Cole,1523,2008,Chelsea FC,18,18,0,1567,0,0,15,14,1,1285,1,0,33,32,1,2852,1,0,0,0,0,0,0,0,0,0,0,0,0,0
2178,2178,Bosingwa,2268,2008,Chelsea FC,15,15,0,1282,0,0,18,18,0,1544,2,0,33,33,0,2826,2,0,0,0,0,0,2,2,0,0,0,0,0,0
2179,2179,John Terry,1534,2008,Chelsea FC,16,16,0,1440,1,0,18,18,0,1615,0,0,34,34,0,3055,1,0,0,0,0,1,0,1,0,0,0,0,0,0
2180,2180,Alex,2269,2008,Chelsea FC,10,9,1,844,1,0,13,12,1,1038,1,0,23,21,2,1882,2,0,0,0,0,1,1,2,0,0,0,0,0,0
2181,2181,Michael Essien,1763,2008,Chelsea FC,4,4,0,286,1,0,6,5,1,395,0,0,10,9,1,681,1,0,3,0,3,1,0,1,0,0,0,0,0,0
2182,2182,Frank Lampard,1536,2008,Chelsea FC,18,18,0,1596,6,0,18,18,0,1603,6,0,36,36,0,3199,12,0,6,0,6,2,5,7,2,0,2,0,0,0
2183,2183,John Mikel Obi,1769,2008,Chelsea FC,16,15,1,1310,0,0,17,17,0,1485,0,0,33,32,1,2795,0,0,0,0,0,0,0,0,0,0,0,0,0,0
2184,2184,Florent Malouda,2270,2008,Chelsea FC,15,10,5,851,2,0,15,13,2,1081,4,0,30,23,7,1932,6,0,0,0,0,2,0,2,0,0,0,0,0,0
2185,2185,Didier Drogba,1766,2008,Chelsea FC,11,6,5,653,4,0,12,8,4,804,1,0,23,14,9,1457,5,0,0,3,3,1,1,2,0,0,0,0,0,0
2186,2186,Nicolas Anelka,1720,2008,Chelsea FC,18,17,1,1462,8,0,18,15,3,1373,11,0,36,32,4,2835,19,0,1,3,4,2,4,6,0,0,0,0,0,0
2187,2187,Branislav Ivanović,1532,2008,Chelsea FC,7,6,1,584,0,0,9,5,4,512,0,0,16,11,5,1096,0,0,0,0,0,0,0,0,0,0,0,0,0,0
2188,2188,Michael Ballack,2271,2008,Chelsea FC,15,13,2,1093,1,0,14,9,5,936,0,0,29,22,7,2029,1,0,0,0,0,1,0,1,0,0,0,0,0,0
2189,2189,Franco Di Santo,2272,2008,Chelsea FC,6,0,6,126,0,0,2,0,2,28,0,0,8,0,8,154,0,0,0,0,0,0,0,0,0,0,0,0,0,0
2190,2190,Paul Konchesky,1560,2008,Fulham FC,16,16,0,1432,0,0,15,15,0,1350,1,0,31,31,0,2782,1,0,0,0,0,0,1,1,0,0,0,0,0,0
2191,2191,Dickson Etuhu,1969,2008,Fulham FC,11,10,1,897,0,0,10,9,1,805,1,0,21,19,2,1702,1,0,0,0,0,0,1,1,0,0,0,0,0,0
2192,2192,Erik Nevland,2197,2008,Fulham FC,11,2,9,298,3,0,10,2,8,164,1,0,21,4,17,462,4,0,3,0,3,1,1,2,0,0,0,0,0,0
2193,2193,Olivier Dacourt,1295,2008,Fulham FC,5,0,5,62,0,0,4,0,4,83,0,0,9,0,9,145,0,0,0,0,0,0,0,0,0,0,0,0,0,0
2194,2194,Diomansy Kamara,1564,2008,Fulham FC,7,2,5,269,2,0,5,1,4,158,2,0,12,3,9,427,4,0,0,3,3,1,1,2,0,0,0,0,0,0
2195,2195,Łukasz Fabiański,1227,2015,Swansea City,18,18,0,1620,0,0,19,19,0,1710,0,0,37,37,0,3330,0,0,0,0,0,0,0,0,0,0,0,0,0,0
2196,2196,Neil Taylor,1695,2015,Swansea City,17,17,0,1530,0,0,17,16,1,1417,0,0,34,33,1,2947,0,0,0,0,0,0,0,0,0,0,0,0,0,0
2197,2197,Ashley Williams,1061,2015,Swansea City,18,18,0,1620,1,0,18,18,0,1620,1,0,36,36,0,3240,2,0,3,3,6,1,1,2,0,0,0,0,0,0
2198,2198,Kyle Naughton,2273,2015,Swansea City,14,8,6,802,0,0,13,11,2,1014,0,0,27,19,8,1816,0,0,0,0,0,0,0,0,0,0,0,0,0,0
2199,2199,Federico Fernández,1697,2015,Swansea City,16,16,0,1440,1,0,16,16,0,1440,0,0,32,32,0,2880,1,0,3,0,3,1,0,1,0,0,0,0,0,0
2200,2200,Jonjo Shelvey,1699,2015,Swansea City,9,7,2,643,1,0,7,7,0,578,0,0,16,14,2,1221,1,0,1,0,1,1,0,1,1,0,1,0,0,0
2201,2201,Jefferson Montero,1700,2015,Swansea City,11,9,2,776,0,0,12,5,7,579,0,0,23,14,9,1355,0,0,0,0,0,0,0,0,0,0,0,0,0,0
2202,2202,Gylfi Sigurðsson,1055,2015,Swansea City,18,16,2,1442,4,0,18,16,2,1473,7,0,36,32,4,2915,11,0,6,0,6,4,5,9,1,2,3,0,0,0
2203,2203,Jack Cork,1701,2015,Swansea City,17,13,4,1183,1,0,18,15,3,1361,0,0,35,28,7,2544,1,0,0,0,0,0,0,0,0,0,0,0,0,0
2204,2204,André Ayew,2274,2015,Swansea City,18,18,0,1543,8,0,16,16,0,1397,4,0,34,34,0,2940,12,0,1,6,7,5,3,8,0,0,0,0,0,0
2205,2205,Bafétimbi Gomis,1704,2015,Swansea City,17,9,8,874,2,0,16,9,7,822,4,0,33,18,15,1696,6,0,3,1,4,2,3,5,0,1,1,0,0,0
2206,2206,Leon Britton,1707,2015,Swansea City,14,11,3,896,0,0,11,8,3,631,0,0,25,19,6,1527,0,0,0,0,0,0,0,0,0,0,0,0,0,0
2207,2207,Nathan Dyer,1702,2015,Swansea City,1,0,1,18,0,0,0,0,0,0,0,0,1,0,1,18,0,0,0,0,0,0,0,0,0,0,0,0,0,0
2208,2208,Wayne Routledge,1758,2015,Swansea City,14,11,3,807,0,0,14,11,3,876,2,0,28,22,6,1683,2,0,0,0,0,0,2,2,0,0,0,0,0,0
2209,2209,Kristoffer Nordfeldt,2275,2015,Swansea City,1,1,0,90,0,0,0,0,0,0,0,0,1,1,0,90,0,0,0,0,0,0,0,0,0,0,0,0,0,0
2210,2210,Àngel Rangel,1696,2015,Swansea City,12,11,1,991,0,0,11,9,2,831,0,0,23,20,3,1822,0,0,0,0,0,0,0,0,0,0,0,0,0,0
2211,2211,Kyle Bartley,2276,2015,Swansea City,3,2,1,181,0,0,2,1,1,103,0,0,5,3,2,284,0,0,0,0,0,0,0,0,0,0,0,0,0,0
2212,2212,Éder,2277,2015,Swansea City,5,1,4,106,0,0,8,1,7,162,0,0,13,2,11,268,0,0,0,0,0,0,0,0,0,0,0,0,0,0
2213,2213,Tim Krul,1822,2015,Newcastle United,4,4,0,360,0,0,4,4,0,360,0,0,8,8,0,720,0,0,0,0,0,0,0,0,0,0,0,0,0,0
2214,2214,Fabricio Coloccini,2278,2015,Newcastle United,13,13,0,1170,1,0,13,13,0,1168,0,0,26,26,0,2338,1,0,0,0,0,1,0,1,0,0,0,0,0,0
2215,2215,Chancel Mbemba,2279,2015,Newcastle United,17,17,0,1530,0,0,16,16,0,1394,0,0,33,33,0,2924,0,0,0,0,0,0,0,0,0,0,0,0,0,0
2216,2216,Massadio Haïdara,2280,2015,Newcastle United,4,3,1,285,0,0,3,3,0,270,0,0,7,6,1,555,0,0,0,0,0,0,0,0,0,0,0,0,0,0
2217,2217,Daryl Janmaat,1929,2015,Newcastle United,16,16,0,1414,2,0,16,16,0,1390,0,0,32,32,0,2804,2,0,0,0,0,0,0,0,0,0,0,0,0,0
2218,2218,Jack Colback,1404,2015,Newcastle United,16,16,0,1354,0,0,13,12,1,1042,1,0,29,28,1,2396,1,0,0,1,1,0,1,1,0,0,0,0,0,0
2219,2219,Georginio Wijnaldum,1183,2015,Newcastle United,19,18,1,1579,11,0,19,18,1,1589,0,0,38,36,2,3168,11,0,0,0,0,4,0,4,1,0,1,0,0,0
2220,2220,Moussa Sissoko,1858,2015,Newcastle United,19,19,0,1671,1,0,18,18,0,1552,0,0,37,37,0,3223,1,0,0,0,0,0,0,0,0,0,0,0,0,0
2221,2221,Vurnon Anita,2281,2015,Newcastle United,14,11,3,1051,1,0,14,13,1,1056,0,0,28,24,4,2107,1,0,1,0,1,1,0,1,0,0,0,0,0,0
2222,2222,Papiss Demba Cissé,2282,2015,Newcastle United,11,7,4,499,1,0,10,7,3,572,2,0,21,14,7,1071,3,0,0,0,0,1,1,2,0,0,0,0,0,0
2223,2223,Gabriel Obertan,2283,2015,Newcastle United,3,1,2,128,0,0,2,2,0,151,0,0,5,3,2,279,0,0,0,0,0,0,0,0,0,0,0,0,0,0
2224,2224,Steven Taylor,2014,2015,Newcastle United,3,3,0,270,0,0,7,6,1,540,0,0,10,9,1,810,0,0,0,0,0,0,0,0,0,0,0,0,0,0
2225,2225,Rolando Aarons,2284,2015,Newcastle United,5,1,4,136,1,0,5,2,3,240,0,0,10,3,7,376,1,0,0,0,0,0,0,0,0,0,0,0,0,0
2226,2226,Aleksandar Mitrović,2285,2015,Newcastle United,17,11,6,1134,5,0,17,11,6,1077,4,0,34,22,12,2211,9,0,4,0,4,3,4,7,1,1,2,0,0,0
2227,2227,Karl Darlow,2286,2015,Newcastle United,4,4,0,360,0,0,5,5,0,450,0,0,9,9,0,810,0,0,0,0,0,0,0,0,0,0,0,0,0,0
2228,2228,Mike Williamson,2287,2015,Newcastle United,0,0,0,0,0,0,0,0,0,0,0,0,0,0,0,0,0,0,0,0,0,0,0,0,0,0,0,0,0,0
2229,2229,Ayoze Pérez,2288,2015,Newcastle United,17,11,6,1068,4,0,17,11,6,980,2,0,34,22,12,2048,6,0,0,6,6,2,2,4,0,0,0,0,0,0
2230,2230,Cheick Tioté,2289,2015,Newcastle United,10,9,1,642,0,0,10,7,3,586,0,0,20,16,4,1228,0,0,0,0,0,0,0,0,0,0,0,0,0,0
2231,2231,Paul Robinson,1262,2003,Leeds United,16,16,0,1440,0,0,16,16,0,1440,0,0,32,32,0,2880,0,0,0,0,0,0,0,0,0,0,0,0,0,0
2232,2232,Gary Kelly,2290,2003,Leeds United,15,15,0,1333,0,0,18,18,0,1620,0,0,33,33,0,2953,0,0,0,0,0,0,0,0,0,0,0,0,0,0
2233,2233,Ian Harte,1291,2003,Leeds United,11,9,2,849,1,0,9,9,0,791,0,0,20,18,2,1640,1,0,0,0,0,0,0,0,1,0,1,0,0,0
2234,2234,Dominic Matteo,1293,2003,Leeds United,13,13,0,1099,2,0,16,16,0,1440,0,0,29,29,0,2539,2,0,3,0,3,2,0,2,0,0,0,0,0,0
2235,2235,Michael Duberry,2291,2003,Leeds United,8,8,0,720,2,0,8,8,0,720,1,0,16,16,0,1440,3,0,0,0,0,2,1,3,0,0,0,0,0,0
2236,2236,Matt Kilgallon,1400,2003,Leeds United,4,4,0,360,1,0,4,3,1,271,1,0,8,7,1,631,2,0,0,0,0,1,0,1,0,0,0,0,0,0
2237,2237,Jermaine Pennant,1514,2003,Leeds United,14,14,0,1233,2,0,18,16,2,1373,0,0,32,30,2,2606,2,0,0,0,0,2,0,2,0,0,0,0,0,0
2238,2238,Eirik Bakke,1298,2003,Leeds United,5,4,1,330,1,0,5,4,1,390,0,0,10,8,2,720,1,0,0,0,0,1,0,1,0,0,0,0,0,0
2239,2239,Seth Johnson,2292,2003,Leeds United,10,9,1,800,2,0,13,13,0,1060,0,0,23,22,1,1860,2,0,0,0,0,1,0,1,0,0,0,0,0,0
2240,2240,James Milner,1189,2003,Leeds United,12,10,2,912,2,0,14,13,1,1108,1,0,26,23,3,2020,3,0,1,3,4,1,1,2,0,0,0,0,0,0
2241,2241,Alan Smith,1300,2003,Leeds United,14,14,0,1252,5,0,17,17,0,1530,4,0,31,31,0,2782,9,0,3,1,4,3,4,7,1,0,1,0,0,0
2242,2242,Scott Carson,1999,2003,Leeds United,1,0,1,1,0,0,2,2,0,180,0,0,3,2,1,181,0,0,0,0,0,0,0,0,0,0,0,0,0,0
2243,2243,Jody Morris,2293,2003,Leeds United,6,5,1,424,0,0,6,6,0,515,0,0,12,11,1,939,0,0,0,0,0,0,0,0,0,0,0,0,0,0
2244,2244,Michael Bridges,2294,2003,Leeds United,5,1,4,159,0,0,5,0,5,118,0,0,10,1,9,277,0,0,0,0,0,0,0,0,0,0,0,0,0,0
2245,2245,Mark Schwarzer,1328,2003,Middlesbrough FC,18,18,0,1620,0,0,18,18,0,1620,0,0,36,36,0,3240,0,0,0,0,0,0,0,0,0,0,0,0,0,0
2246,2246,Franck Queudrue,1329,2003,Middlesbrough FC,15,15,0,1276,0,0,15,15,0,1333,0,0,30,30,0,2609,0,0,0,0,0,0,0,0,0,0,0,0,0,0
2247,2247,Chris Riggott,1330,2003,Middlesbrough FC,7,6,1,525,0,0,9,7,2,657,0,0,16,13,3,1182,0,0,0,0,0,0,0,0,0,0,0,0,0,0
2248,2248,Gareth Southgate,1331,2003,Middlesbrough FC,12,12,0,1080,1,0,14,14,0,1260,0,0,26,26,0,2340,1,0,0,0,0,0,0,0,0,0,0,0,0,0
2249,2249,Andrew Davies,2295,2003,Middlesbrough FC,5,3,2,308,0,0,5,5,0,413,0,0,10,8,2,721,0,0,0,0,0,0,0,0,0,0,0,0,0,0
2250,2250,George Boateng,1333,2003,Middlesbrough FC,16,16,0,1440,0,0,18,18,0,1589,0,0,34,34,0,3029,0,0,0,0,0,0,0,0,0,0,0,0,0,0
2251,2251,Juninho Paulista,2136,2003,Middlesbrough FC,15,12,3,1083,4,0,15,13,2,1124,4,0,30,25,5,2207,8,0,0,0,0,3,3,6,0,0,0,0,0,0
2252,2252,Mendieta,2296,2003,Middlesbrough FC,16,15,1,1351,2,0,15,15,0,1310,0,0,31,30,1,2661,2,0,0,0,0,2,0,2,0,0,0,0,0,0
2253,2253,Doriva,1338,2003,Middlesbrough FC,9,9,0,714,0,0,12,10,2,843,0,0,21,19,2,1557,0,0,0,0,0,0,0,0,0,0,0,0,0,0
2254,2254,Boudewijn Zenden,1336,2003,Middlesbrough FC,14,14,0,1210,0,0,16,16,0,1440,4,0,30,30,0,2650,4,0,0,0,0,0,3,3,0,0,0,0,0,0
2255,2255,Massimo Maccarone,1888,2003,Middlesbrough FC,13,8,5,715,5,0,10,5,5,509,1,0,23,13,10,1224,6,0,0,0,0,1,0,1,0,1,1,0,0,0
2256,2256,Stuart Parnaby,1881,2003,Middlesbrough FC,5,3,2,303,0,0,8,5,3,527,0,0,13,8,5,830,0,0,0,0,0,0,0,0,0,0,0,0,0,0
2257,2257,Joseph-Désiré Job,2071,2003,Middlesbrough FC,9,8,1,626,3,0,14,10,4,865,3,0,23,18,5,1491,6,0,3,4,7,3,2,5,0,0,0,0,0,0
2258,2258,Michael Ricketts,2140,2003,Middlesbrough FC,11,4,7,387,0,0,13,4,9,478,2,0,24,8,16,865,2,0,0,0,0,0,0,0,0,2,2,0,0,0
2259,2259,Tim Howard,1743,2013,Everton FC,18,18,0,1620,0,0,19,19,0,1710,0,0,37,37,0,3330,0,0,0,0,0,0,0,0,0,0,0,0,0,0
2260,2260,Leighton Baines,1466,2013,Everton FC,16,16,0,1400,2,0,16,16,0,1440,3,0,32,32,0,2840,5,0,0,1,1,2,3,5,2,1,3,0,0,0
2261,2261,Phil Jagielka,1048,2013,Everton FC,12,12,0,1056,0,0,14,14,0,1260,0,0,26,26,0,2316,0,0,0,0,0,0,0,0,0,0,0,0,0,0
2262,2262,Séamus Coleman,1467,2013,Everton FC,18,18,0,1620,4,0,18,18,0,1609,2,0,36,36,0,3229,6,0,3,0,3,3,2,5,0,0,0,0,0,0
2263,2263,John Stones,1197,2013,Everton FC,14,9,5,819,0,0,7,6,1,551,0,0,21,15,6,1370,0,0,0,0,0,0,0,0,0,0,0,0,0,0
2264,2264,Antolín Alcaráz,2235,2013,Everton FC,3,2,1,224,0,0,3,3,0,270,0,0,6,5,1,494,0,0,0,0,0,0,0,0,0,0,0,0,0,0
2265,2265,James McCarthy,1053,2013,Everton FC,17,15,2,1389,0,0,17,16,1,1466,1,0,34,31,3,2855,1,0,0,0,0,0,1,1,0,0,0,0,0,0
2266,2266,Ross Barkley,1754,2013,Everton FC,17,12,5,1157,3,0,17,13,4,1129,3,0,34,25,9,2286,6,0,0,3,3,1,3,4,0,0,0,0,0,0
2267,2267,Leon Osman,1747,2013,Everton FC,19,15,4,1116,1,0,19,12,7,1057,2,0,38,27,11,2173,3,0,0,0,0,1,0,1,0,0,0,0,0,0
2268,2268,Steven Naismith,2239,2013,Everton FC,14,6,8,670,4,0,17,7,10,739,1,0,31,13,18,1409,5,0,3,0,3,3,0,3,0,0,0,0,0,0
2269,2269,Romelu Lukaku,1645,2013,Everton FC,16,15,1,1340,10,0,15,14,1,1222,5,0,31,29,2,2562,15,0,6,3,9,6,3,9,0,0,0,0,0,0
2270,2270,Aiden McGeady,2242,2013,Everton FC,8,3,5,295,0,0,8,1,7,173,0,0,16,4,12,468,0,0,0,0,0,0,0,0,0,0,0,0,0,0
2271,2271,Gerard Deulofeu,1927,2013,Everton FC,12,5,7,449,2,0,13,4,9,446,1,0,25,9,16,895,3,0,0,1,1,2,1,3,0,0,0,0,0,0
2272,2272,Joel,1060,2013,Everton FC,2,1,1,156,0,0,0,0,0,0,0,0,2,1,1,156,0,0,0,0,0,0,0,0,0,0,0,0,0,0
2273,2273,Tony Hibbert,1744,2013,Everton FC,1,0,1,2,0,0,0,0,0,0,0,0,1,0,1,2,0,0,0,0,0,0,0,0,0,0,0,0,0,0
2274,2274,Sylvain Distin,1015,2013,Everton FC,17,17,0,1486,0,0,16,16,0,1440,0,0,33,33,0,2926,0,0,0,0,0,0,0,0,0,0,0,0,0,0
2275,2275,Luke Garbutt,2297,2013,Everton FC,0,0,0,0,0,0,1,0,1,1,0,0,1,0,1,1,0,0,0,0,0,0,0,0,0,0,0,0,0,0
2276,2276,Ryan Ledson,2298,2013,Everton FC,0,0,0,0,0,0,0,0,0,0,0,0,0,0,0,0,0,0,0,0,0,0,0,0,0,0,0,0,0,0
2277,2277,Vincent Kompany,1414,2013,Manchester City,14,14,0,1185,2,0,14,14,0,1260,2,0,28,28,0,2445,4,0,0,0,0,1,0,1,0,0,0,0,0,0
2278,2278,Javi García,1416,2013,Manchester City,13,6,7,653,0,0,16,8,8,876,0,0,29,14,15,1529,0,0,0,0,0,0,0,0,0,0,0,0,0,0
2279,2279,Stevan Jovetić,2299,2013,Manchester City,7,0,7,179,2,0,6,2,4,203,1,0,13,2,11,382,3,0,0,0,0,0,0,0,0,0,0,0,0,0
2280,2280,David James,1385,2002,West Ham United,17,17,0,1530,0,0,17,17,0,1530,0,0,34,34,0,3060,0,0,0,0,0,0,0,0,0,0,0,0,0,0
2281,2281,Nigel Winterburn,1623,2002,West Ham United,10,10,0,790,0,0,6,4,2,442,0,0,16,14,2,1232,0,0,0,0,0,0,0,0,0,0,0,0,0,0
2282,2282,Tomáš Řepka,1625,2002,West Ham United,16,16,0,1395,0,0,14,14,0,1180,0,0,30,30,0,2575,0,0,0,0,0,0,0,0,0,0,0,0,0,0
2283,2283,Ian Pearce,1082,2002,West Ham United,12,8,4,760,1,0,14,14,0,1231,1,0,26,22,4,1991,2,0,0,0,0,1,1,2,0,0,0,0,0,0
2284,2284,Glen Johnson,1386,2002,West Ham United,6,6,0,540,0,0,8,7,1,657,0,0,14,13,1,1197,0,0,0,0,0,0,0,0,0,0,0,0,0,0
2285,2285,Lee Bowyer,1297,2002,West Ham United,5,5,0,422,0,0,5,5,0,445,0,0,10,10,0,867,0,0,0,0,0,0,0,0,0,0,0,0,0,0
2286,2286,Michael Carrick,1627,2002,West Ham United,15,14,1,1262,1,0,12,11,1,1000,0,0,27,25,2,2262,1,0,0,0,0,0,0,0,0,0,0,0,0,0
2287,2287,Steve Lomas,1629,2002,West Ham United,13,11,2,960,0,0,15,15,0,1282,0,0,28,26,2,2242,0,0,0,0,0,0,0,0,0,0,0,0,0,0
2288,2288,Joe Cole,1630,2002,West Ham United,17,17,0,1499,3,0,15,15,0,1343,1,0,32,32,0,2842,4,0,0,0,0,3,1,4,0,0,0,0,0,0
2289,2289,Les Ferdinand,2083,2002,West Ham United,6,5,1,305,1,0,7,6,1,480,1,0,13,11,2,785,2,0,0,0,0,1,1,2,0,0,0,0,0,0
2290,2290,Paolo Di Canio,2042,2002,West Ham United,9,8,1,709,4,0,6,5,1,386,5,0,15,13,2,1095,9,0,3,7,10,3,4,7,2,1,3,0,0,0
2291,2291,Trevor Sinclair,1628,2002,West Ham United,17,16,1,1411,4,0,17,16,1,1434,5,0,34,32,2,2845,9,0,4,6,10,3,4,7,1,0,1,0,0,0
2292,2292,Jermain Defoe,1127,2002,West Ham United,17,13,4,1228,4,0,17,12,5,1224,4,0,34,25,9,2452,8,0,4,2,6,4,4,8,0,0,0,0,0,0
2293,2293,Frédéric Kanouté,1130,2002,West Ham United,10,7,3,714,3,0,7,5,2,436,2,0,17,12,5,1150,5,0,1,3,4,1,2,3,0,0,0,0,0,0
2294,2294,Brad Friedel,1343,2002,Blackburn Rovers,19,19,0,1710,0,0,18,18,0,1620,0,0,37,37,0,3330,0,0,0,0,0,0,0,0,0,0,0,0,0,0
2295,2295,Lucas Neill,1132,2002,Blackburn Rovers,17,17,0,1530,0,0,17,17,0,1479,0,0,34,34,0,3009,0,0,0,0,0,0,0,0,0,0,0,0,0,0
2296,2296,Andy Todd,1672,2002,Blackburn Rovers,6,3,3,338,0,0,6,4,2,412,1,0,12,7,5,750,1,0,0,0,0,0,0,0,0,0,0,0,0,0
2297,2297,Martin Taylor,1345,2002,Blackburn Rovers,16,14,2,1308,2,0,17,15,2,1383,0,0,33,29,4,2691,2,0,0,0,0,1,0,1,0,0,0,0,0,0
2298,2298,Jay McEveley,1569,2002,Blackburn Rovers,4,4,0,279,0,0,5,5,0,339,0,0,9,9,0,618,0,0,0,0,0,0,0,0,0,0,0,0,0,0
2299,2299,Tugay Kerimoğlu,1136,2002,Blackburn Rovers,19,17,2,1490,1,0,18,15,3,1344,0,0,37,32,5,2834,1,0,0,0,0,0,0,0,0,0,0,0,0,0
2300,2300,Gary Flitcroft,1135,2002,Blackburn Rovers,16,16,0,1416,2,0,17,17,0,1400,0,0,33,33,0,2816,2,0,6,0,6,2,0,2,0,0,0,0,0,0
2301,2301,David Thompson,2102,2002,Blackburn Rovers,11,11,0,990,2,0,12,12,0,1012,2,0,23,23,0,2002,4,0,3,0,3,2,2,4,0,0,0,0,0,0
2302,2302,Andy Cole,1113,2002,Blackburn Rovers,16,16,0,1378,1,0,18,16,2,1497,6,0,34,32,2,2875,7,0,0,2,2,1,4,5,0,0,0,0,0,0
2303,2303,Keith Gillespie,1351,2002,Blackburn Rovers,13,6,7,704,0,0,12,4,8,487,0,0,25,10,15,1191,0,0,0,0,0,0,0,0,0,0,0,0,0,0
2304,2304,Dwight Yorke,1223,2002,Blackburn Rovers,15,11,4,964,2,0,18,14,4,1361,6,0,33,25,8,2325,8,0,3,6,9,2,6,8,0,1,1,0,0,0
2305,2305,Nils-Eric Johansson,1134,2002,Blackburn Rovers,16,11,5,1155,0,0,14,9,5,882,0,0,30,20,10,2037,0,0,0,0,0,0,0,0,0,0,0,0,0,0
2306,2306,Matt Jansen,1350,2002,Blackburn Rovers,2,0,2,41,0,0,5,0,5,43,0,0,7,0,7,84,0,0,0,0,0,0,0,0,0,0,0,0,0,0
2307,2307,Egil Østenstad,2300,2002,Blackburn Rovers,9,5,4,446,1,0,8,3,5,309,0,0,17,8,9,755,1,0,0,0,0,1,0,1,0,0,0,0,0,0
2308,2308,Boaz Myhill,1663,2013,West Bromwich Albion,7,7,0,630,0,0,7,7,0,630,0,0,14,14,0,1260,0,0,0,0,0,0,0,0,0,0,0,0,0,0
2309,2309,Steven Reid,1140,2013,West Bromwich Albion,8,8,0,645,0,0,8,8,0,662,0,0,16,16,0,1307,0,0,0,0,0,0,0,0,0,0,0,0,0,0
2310,2310,Jonas Olsson,1771,2013,West Bromwich Albion,16,16,0,1379,0,0,16,16,0,1440,1,0,32,32,0,2819,1,0,0,1,1,0,1,1,0,0,0,0,0,0
2311,2311,Liam Ridgewell,1772,2013,West Bromwich Albion,16,16,0,1385,1,0,17,17,0,1486,0,0,33,33,0,2871,1,0,0,0,0,0,0,0,0,0,0,0,0,0
2312,2312,Gareth McAuley,1732,2013,West Bromwich Albion,17,17,0,1530,1,0,15,15,0,1330,1,0,32,32,0,2860,2,0,0,1,1,0,1,1,0,0,0,0,0,0
2313,2313,Claudio Yacob,1661,2013,West Bromwich Albion,15,11,4,968,1,0,12,11,1,875,0,0,27,22,5,1843,1,0,0,0,0,1,0,1,0,0,0,0,0,0
2314,2314,James Morrison,1735,2013,West Bromwich Albion,15,11,4,1028,0,0,17,12,5,1183,1,0,32,23,9,2211,1,0,0,0,0,0,0,0,0,1,1,0,0,0
2315,2315,Chris Brunt,1658,2013,West Bromwich Albion,15,14,1,1238,1,0,13,11,2,1006,2,0,28,25,3,2244,3,0,0,0,0,0,2,2,0,0,0,0,0,0
2316,2316,Morgan Amalfitano,2301,2013,West Bromwich Albion,14,14,0,1139,2,0,14,12,2,1014,2,0,28,26,2,2153,4,0,0,3,3,1,2,3,0,0,0,0,0,0
2317,2317,Shane Long,1154,2013,West Bromwich Albion,8,6,2,572,2,0,7,5,2,463,1,0,15,11,4,1035,3,0,0,0,0,1,1,2,0,0,0,0,0,0
2318,2318,Saido Berahino,1905,2013,West Bromwich Albion,17,7,10,870,3,0,15,4,11,535,2,0,32,11,21,1405,5,0,6,4,10,3,2,5,1,0,1,0,0,0
2319,2319,Zoltán Gera,1323,2013,West Bromwich Albion,8,3,5,328,0,0,6,2,4,162,0,0,14,5,9,490,0,0,0,0,0,0,0,0,0,0,0,0,0,0
2320,2320,Victor Anichebe,1751,2013,West Bromwich Albion,11,2,9,395,3,0,13,9,4,821,0,0,24,11,13,1216,3,0,2,0,2,2,0,2,0,0,0,0,0,0
2321,2321,Matěj Vydra,2302,2013,West Bromwich Albion,13,4,9,367,3,0,10,3,7,301,0,0,23,7,16,668,3,0,2,0,2,3,0,3,0,0,0,0,0,0
2322,2322,Luke Daniels,2303,2013,West Bromwich Albion,0,0,0,0,0,0,1,0,1,12,0,0,1,0,1,12,0,0,0,0,0,0,0,0,0,0,0,0,0,0
2323,2323,Goran Popov,2304,2013,West Bromwich Albion,1,1,0,82,0,0,1,0,1,1,0,0,2,1,1,83,0,0,0,0,0,0,0,0,0,0,0,0,0,0
2324,2324,Diego Lugano,2305,2013,West Bromwich Albion,3,2,1,229,1,0,6,5,1,429,0,0,9,7,2,658,1,0,1,0,1,1,0,1,0,0,0,0,0,0
2325,2325,Stéphane Sessègnon,1406,2013,West Bromwich Albion,12,11,1,911,3,0,14,12,2,1051,2,0,26,23,3,1962,5,0,0,0,0,2,2,4,0,0,0,0,0,0
2326,2326,Jack Rodwell,1748,2013,Manchester City,2,0,2,17,0,0,3,1,2,93,0,0,5,1,4,110,0,0,0,0,0,0,0,0,0,0,0,0,0,0
2327,2327,Alisson,2084,2019,Liverpool FC,14,14,0,1209,0,0,15,15,0,1350,0,0,29,29,0,2559,0,0,0,0,0,0,0,0,0,0,0,0,0,0
2328,2328,Virgil van Dijk,1241,2019,Liverpool FC,19,19,0,1710,4,0,19,19,0,1710,1,0,38,38,0,3420,5,0,0,0,0,2,1,3,0,0,0,0,0,0
2329,2329,Joe Gomez,1180,2019,Liverpool FC,15,12,3,1095,0,0,13,10,3,905,0,0,28,22,6,2000,0,0,0,0,0,0,0,0,0,0,0,0,0,0
2330,2330,Andrew Robertson,1181,2019,Liverpool FC,18,17,1,1553,1,0,18,17,1,1560,1,0,36,34,2,3113,2,0,0,0,0,1,1,2,0,0,0,0,0,0
2331,2331,Trent Alexander-Arnold,1192,2019,Liverpool FC,19,18,1,1618,2,0,19,17,2,1558,2,0,38,35,3,3176,4,0,0,0,0,1,1,2,0,0,0,0,0,0
2332,2332,Fabinho,2085,2019,Liverpool FC,14,13,1,1148,2,0,14,9,5,926,0,0,28,22,6,2074,2,0,0,0,0,1,0,1,0,0,0,0,0,0
2333,2333,Georginio Wijnaldum,1183,2019,Liverpool FC,19,18,1,1520,3,0,18,17,1,1428,1,0,37,35,2,2948,4,0,0,3,3,1,1,2,0,0,0,0,0,0
2334,2334,Jordan Henderson,1426,2019,Liverpool FC,14,11,3,992,2,0,16,15,1,1252,2,0,30,26,4,2244,4,0,0,0,0,1,1,2,0,0,0,0,0,0
2335,2335,Roberto Firmino,1186,2019,Liverpool FC,19,16,3,1463,1,0,19,18,1,1541,8,0,38,34,4,3004,9,0,0,9,9,0,4,4,0,0,0,0,0,0
2336,2336,Sadio Mané,1151,2019,Liverpool FC,18,17,1,1505,11,0,17,14,3,1250,7,0,35,31,4,2755,18,0,9,6,15,7,5,12,0,0,0,0,0,0
2337,2337,Mohamed Salah,1187,2019,Liverpool FC,18,18,0,1580,15,0,16,15,1,1308,4,0,34,33,1,2888,19,0,3,0,3,5,2,7,2,1,3,0,0,0
2338,2338,Neco Williams,2306,2019,Liverpool FC,3,1,2,86,0,0,3,2,1,145,0,0,6,3,3,231,0,0,0,0,0,0,0,0,0,0,0,0,0,0
2339,2339,Naby Keïta,2087,2019,Liverpool FC,7,3,4,275,1,0,11,6,5,539,1,0,18,9,9,814,2,0,0,0,0,1,0,1,0,0,0,0,0,0
2340,2340,Alex Oxlade-Chamberlain,1184,2019,Liverpool FC,13,6,7,560,2,0,17,11,6,930,2,0,30,17,13,1490,4,0,0,0,0,1,1,2,0,0,0,0,0,0
2341,2341,Takumi Minamino,2307,2019,Liverpool FC,3,0,3,28,0,0,7,2,5,215,0,0,10,2,8,243,0,0,0,0,0,0,0,0,0,0,0,0,0,0
2342,2342,Harvey Elliott,2308,2019,Liverpool FC,2,0,2,7,0,0,0,0,0,0,0,0,2,0,2,7,0,0,0,0,0,0,0,0,0,0,0,0,0,0
2343,2343,Adrián,2309,2019,Liverpool FC,7,5,2,513,0,0,4,4,0,360,0,0,11,9,2,873,0,0,0,0,0,0,0,0,0,0,0,0,0,0
2344,2344,Dejan Lovren,1179,2019,Liverpool FC,5,5,0,450,0,0,5,4,1,327,0,0,10,9,1,777,0,0,0,0,0,0,0,0,0,0,0,0,0,0
2345,2345,Curtis Jones,2310,2019,Liverpool FC,3,1,2,98,1,0,3,0,3,24,0,0,6,1,5,122,1,0,0,0,0,0,0,0,0,0,0,0,0,0
2346,2346,Divock Origi,2086,2019,Liverpool FC,13,4,9,300,3,0,15,3,12,405,1,0,28,7,21,705,4,0,0,0,0,1,1,2,0,0,0,0,0,0
2347,2347,Wayne Hennessey,1018,2019,Crystal Palace,1,1,0,90,0,0,2,2,0,180,0,0,3,3,0,270,0,0,0,0,0,0,0,0,0,0,0,0,0,0
2348,2348,Joel Ward,1019,2019,Crystal Palace,15,14,1,1268,0,0,14,13,1,1114,0,0,29,27,2,2382,0,0,0,0,0,0,0,0,0,0,0,0,0,0
2349,2349,Patrick van Aanholt,2254,2019,Crystal Palace,15,15,0,1258,1,0,14,14,0,1253,2,0,29,29,0,2511,3,0,3,3,6,1,2,3,0,1,1,0,0,0
2350,2350,Mamadou Sakho,2250,2019,Crystal Palace,6,4,2,453,0,0,8,7,1,550,0,0,14,11,3,1003,0,0,0,0,0,0,0,0,0,0,0,0,0,0
2351,2351,Gary Cahill,1533,2019,Crystal Palace,13,13,0,1088,0,0,12,12,0,1080,0,0,25,25,0,2168,0,0,0,0,0,0,0,0,0,0,0,0,0,0
2352,2352,Cheikhou Kouyaté,2311,2019,Crystal Palace,17,16,1,1293,1,0,18,13,5,1243,0,0,35,29,6,2536,1,0,0,0,0,1,0,1,0,0,0,0,0,0
2353,2353,James McArthur,1023,2019,Crystal Palace,19,19,0,1607,0,0,18,18,0,1498,0,0,37,37,0,3105,0,0,0,0,0,0,0,0,0,0,0,0,0,0
2354,2354,James McCarthy,1053,2019,Crystal Palace,15,7,8,787,0,0,18,9,9,882,0,0,33,16,17,1669,0,0,0,0,0,0,0,0,0,0,0,0,0,0
2355,2355,Jordan Ayew,1869,2019,Crystal Palace,19,19,0,1624,4,0,18,18,0,1538,5,0,37,37,0,3162,9,0,10,7,17,4,4,8,0,0,0,0,0,0
2356,2356,Andros Townsend,1176,2019,Crystal Palace,11,6,5,567,1,0,13,8,5,723,0,0,24,14,10,1290,1,0,0,0,0,0,0,0,0,0,0,0,0,0
2357,2357,Wilfried Zaha,1028,2019,Crystal Palace,19,18,1,1645,3,0,19,19,0,1635,1,0,38,37,1,3280,4,0,1,0,1,2,1,3,0,0,0,0,0,0
2358,2358,Jaïro Riedewald,2256,2019,Crystal Palace,7,3,4,279,0,0,10,4,6,484,0,0,17,7,10,763,0,0,0,0,0,0,0,0,0,0,0,0,0,0
2359,2359,Luka Milivojević,2251,2019,Crystal Palace,16,14,2,1270,1,0,15,14,1,1244,2,0,31,28,3,2514,3,0,0,0,0,1,1,2,1,1,2,0,0,0
2360,2360,Max Meyer,2312,2019,Crystal Palace,10,3,7,325,0,0,7,3,4,325,0,0,17,6,11,650,0,0,0,0,0,0,0,0,0,0,0,0,0,0
2361,2361,Brandon Pierrick,2313,2019,Crystal Palace,0,0,0,0,0,0,2,0,2,13,0,0,2,0,2,13,0,0,0,0,0,0,0,0,0,0,0,0,0,0
2362,2362,Stephen Henderson,2314,2019,Crystal Palace,0,0,0,0,0,0,0,0,0,0,0,0,0,0,0,0,0,0,0,0,0,0,0,0,0,0,0,0,0,0
2363,2363,Scott Dann,1020,2019,Crystal Palace,9,8,1,727,0,0,7,6,1,538,0,0,16,14,2,1265,0,0,0,0,0,0,0,0,0,0,0,0,0,0
2364,2364,Nikola Tavares,2315,2019,Crystal Palace,0,0,0,0,0,0,0,0,0,0,0,0,0,0,0,0,0,0,0,0,0,0,0,0,0,0,0,0,0,0
2365,2365,Tyrick Mitchell,2316,2019,Crystal Palace,2,1,1,96,0,0,2,1,1,97,0,0,4,2,2,193,0,0,0,0,0,0,0,0,0,0,0,0,0,0
2366,2366,Allan McGregor,2221,2013,Hull City,14,14,0,1216,0,0,12,12,0,1080,0,0,26,26,0,2296,0,0,0,0,0,0,0,0,0,0,0,0,0,0
2367,2367,Maynor Figueroa,2057,2013,Hull City,17,17,0,1411,0,0,15,14,1,1304,0,0,32,31,1,2715,0,0,0,0,0,0,0,0,0,0,0,0,0,0
2368,2368,Alex Bruce,2222,2013,Hull City,7,7,0,606,0,0,13,12,1,985,0,0,20,19,1,1591,0,0,0,0,0,0,0,0,0,0,0,0,0,0
2369,2369,James Chester,2223,2013,Hull City,11,10,1,891,1,0,13,12,1,978,0,0,24,22,2,1869,1,0,0,0,0,1,0,1,0,0,0,0,0,0
2370,2370,Curtis Davies,2224,2013,Hull City,19,19,0,1706,2,0,18,18,0,1620,0,0,37,37,0,3326,2,0,0,0,0,1,0,1,0,0,0,0,0,0
2371,2371,Ahmed Elmohamady,1690,2013,Hull City,19,19,0,1672,1,0,19,19,0,1658,1,0,38,38,0,3330,2,0,0,0,0,1,1,2,0,0,0,0,0,0
2372,2372,David Meyler,2225,2013,Hull City,14,12,2,936,2,0,16,15,1,1201,0,0,30,27,3,2137,2,0,0,0,0,1,0,1,0,0,0,0,0,0
2373,2373,Tom Huddlestone,1270,2013,Hull City,18,18,0,1620,1,0,18,17,1,1526,1,0,36,35,1,3146,2,0,0,0,0,0,1,1,0,0,0,0,0,0
2374,2374,Jake Livermore,1657,2013,Hull City,18,18,0,1576,1,0,18,16,2,1479,2,0,36,34,2,3055,3,0,0,0,0,1,1,2,0,0,0,0,0,0
2375,2375,Danny Graham,2317,2013,Hull City,9,5,4,501,0,0,9,7,2,499,1,0,18,12,6,1000,1,0,0,0,0,0,1,1,0,0,0,0,0,0
2376,2376,Yannick Sagbo,2234,2013,Hull City,13,8,5,747,0,0,15,8,7,817,2,0,28,16,12,1564,2,0,0,0,0,0,1,1,0,0,0,0,0,0
2377,2377,Steve Harper,2231,2013,Hull City,6,5,1,494,0,0,7,6,1,605,0,0,13,11,2,1099,0,0,0,0,0,0,0,0,0,0,0,0,0,0
2378,2378,Robert Koren,2000,2013,Hull City,14,5,9,623,2,0,8,5,3,509,0,0,22,10,12,1132,2,0,0,0,0,0,0,0,0,0,0,0,0,0
2379,2379,George Boyd,1258,2013,Hull City,15,6,9,703,2,0,14,3,11,496,0,0,29,9,20,1199,2,0,3,0,3,1,0,1,0,0,0,0,0,0
2380,2380,Liam Rosenior,1756,2013,Hull City,15,10,5,972,1,0,15,12,3,1018,0,0,30,22,8,1990,1,0,0,0,0,1,0,1,0,0,0,0,0,0
2381,2381,Paul McShane,1607,2013,Hull City,6,5,1,325,0,0,4,4,0,360,0,0,10,9,1,685,0,0,0,0,0,0,0,0,0,0,0,0,0,0
2382,2382,Abdoulaye Faye,1714,2013,Hull City,2,2,0,180,0,0,1,1,0,90,0,0,3,3,0,270,0,0,0,0,0,0,0,0,0,0,0,0,0,0
2383,2383,Matty Fryatt,2318,2013,Hull City,5,0,5,124,1,0,4,0,4,90,1,0,9,0,9,214,2,0,0,0,0,0,0,0,0,0,0,0,0,0
2384,2384,Rafael,1787,2013,Manchester United,10,10,0,788,0,0,9,8,1,633,0,0,19,18,1,1421,0,0,0,0,0,0,0,0,0,0,0,0,0,0
2385,2385,Jonny Evans,1216,2013,Manchester United,8,8,0,720,0,0,9,9,0,657,0,0,17,17,0,1377,0,0,0,0,0,0,0,0,0,0,0,0,0,0
2386,2386,Tom Cleverley,2091,2013,Manchester United,10,7,3,595,0,0,12,11,1,986,1,0,22,18,4,1581,1,0,0,0,0,0,0,0,0,0,0,0,0,0
2387,2387,Wayne Rooney,1058,2013,Manchester United,15,14,1,1269,7,0,14,13,1,1180,10,0,29,27,2,2449,17,0,0,1,1,5,5,10,2,1,3,0,0,0
2388,2388,Anders Lindegaard,2319,2013,Manchester United,0,0,0,0,0,0,1,1,0,90,0,0,1,1,0,90,0,0,0,0,0,0,0,0,0,0,0,0,0,0
2389,2389,Fábio,2320,2013,Manchester United,1,1,0,90,0,0,0,0,0,0,0,0,1,1,0,90,0,0,0,0,0,0,0,0,0,0,0,0,0,0
2390,2390,Shinji Kagawa,2321,2013,Manchester United,10,8,2,658,0,0,8,6,2,512,0,0,18,14,4,1170,0,0,0,0,0,0,0,0,0,0,0,0,0,0
2391,2391,Boaz Myhill,1663,2008,Hull City,14,14,0,1260,0,0,14,14,0,1260,0,0,28,28,0,2520,0,0,0,0,0,0,0,0,0,0,0,0,0,0
2392,2392,Andy Dawson,1606,2008,Hull City,12,12,0,1035,1,0,13,13,0,1006,0,0,25,25,0,2041,1,0,0,0,0,0,0,0,0,0,0,0,0,0
2393,2393,Michael Turner,1371,2008,Hull City,19,19,0,1710,3,0,19,19,0,1710,1,0,38,38,0,3420,4,0,3,0,3,3,1,4,0,0,0,0,0,0
2394,2394,Kamil Zayatte,2322,2008,Hull City,15,15,0,1324,0,0,17,16,1,1418,1,0,32,31,1,2742,1,0,0,0,0,0,1,1,0,0,0,0,0,0
2395,2395,Ian Ashbee,2323,2008,Hull City,16,16,0,1440,1,0,15,15,0,1254,0,0,31,31,0,2694,1,0,0,0,0,0,0,0,0,0,0,0,0,0
2396,2396,Géovanni,1613,2008,Hull City,16,14,2,1156,4,0,18,18,0,1383,4,0,34,32,2,2539,8,0,1,3,4,3,2,5,0,1,1,0,0,0
2397,2397,George Boateng,1333,2008,Hull City,11,10,1,819,0,0,12,11,1,868,0,0,23,21,2,1687,0,0,0,0,0,0,0,0,0,0,0,0,0,0
2398,2398,Dean Marney,1253,2008,Hull City,13,12,1,1048,0,0,18,14,4,1370,0,0,31,26,5,2418,0,0,0,0,0,0,0,0,0,0,0,0,0,0
2399,2399,Marlon King,2119,2008,Hull City,9,8,1,706,1,0,11,11,0,929,4,0,20,19,1,1635,5,0,3,0,3,1,2,3,1,1,2,0,0,0
2400,2400,Daniel Cousin,2324,2008,Hull City,15,10,5,848,2,0,12,8,4,735,2,0,27,18,9,1583,4,0,0,3,3,2,2,4,0,0,0,0,0,0
2401,2401,Péter Halmosi,2325,2008,Hull City,9,3,6,325,0,0,9,1,8,225,0,0,18,4,14,550,0,0,0,0,0,0,0,0,0,0,0,0,0,0
2402,2402,Bryan Hughes,1957,2008,Hull City,2,0,2,23,0,0,4,1,3,105,0,0,6,1,5,128,0,0,0,0,0,0,0,0,0,0,0,0,0,0
2403,2403,Richard García,1632,2008,Hull City,14,9,5,734,0,0,9,4,5,428,1,0,23,13,10,1162,1,0,0,1,1,0,1,1,0,0,0,0,0,0
2404,2404,Robert Green,1277,2008,West Ham United,19,19,0,1710,0,0,18,18,0,1620,0,0,37,37,0,3330,0,0,0,0,0,0,0,0,0,0,0,0,0,0
2405,2405,Lucas Neill,1132,2008,West Ham United,17,17,0,1530,0,0,16,16,0,1396,1,0,33,33,0,2926,1,0,0,0,0,0,1,1,0,0,0,0,0,0
2406,2406,Hérita Ilunga,1280,2008,West Ham United,17,17,0,1501,0,0,17,17,0,1530,0,0,34,34,0,3031,0,0,0,0,0,0,0,0,0,0,0,0,0,0
2407,2407,Matthew Upson,1279,2008,West Ham United,19,19,0,1577,0,0,17,17,0,1530,0,0,36,36,0,3107,0,0,0,0,0,0,0,0,0,0,0,0,0,0
2408,2408,Scott Parker,1282,2008,West Ham United,15,15,0,1218,0,0,12,12,0,1078,1,0,27,27,0,2296,1,0,0,0,0,0,0,0,0,0,0,0,0,0
2409,2409,Matthew Etherington,1557,2008,West Ham United,7,4,3,421,1,0,5,3,2,230,1,0,12,7,5,651,2,0,0,0,0,0,0,0,0,0,0,0,0,0
2410,2410,Mark Noble,2204,2008,West Ham United,14,13,1,1120,1,0,14,14,0,1198,2,0,28,27,1,2318,3,0,0,0,0,1,2,3,1,0,1,0,0,0
2411,2411,Julien Faubert,1283,2008,West Ham United,11,8,3,716,0,0,8,6,2,575,0,0,19,14,5,1291,0,0,0,0,0,0,0,0,0,0,0,0,0,0
2412,2412,Valon Behrami,1284,2008,West Ham United,12,12,0,997,0,0,11,11,0,919,1,0,23,23,0,1916,1,0,0,3,3,0,1,1,0,0,0,0,0,0
2413,2413,Craig Bellamy,2012,2008,West Ham United,7,5,2,508,1,0,8,8,0,708,4,0,15,13,2,1216,5,0,0,0,0,0,2,2,0,0,0,0,0,0
2414,2414,Carlton Cole,2326,2008,West Ham United,14,14,0,1230,6,0,12,11,1,972,4,0,26,25,1,2202,10,0,0,3,3,2,4,6,0,0,0,0,0,0
2415,2415,David Di Michele,2327,2008,West Ham United,15,12,3,1002,4,0,14,9,5,827,0,0,29,21,8,1829,4,0,0,0,0,3,0,3,0,0,0,0,0,0
2416,2416,Freddie Sears,2246,2008,West Ham United,9,3,6,308,0,0,8,1,7,182,0,0,17,4,13,490,0,0,0,0,0,0,0,0,0,0,0,0,0,0
2417,2417,James Ward-Prowse,1150,2018,Southampton FC,13,10,3,942,5,0,13,11,2,1000,2,0,26,21,5,1942,7,0,4,0,4,4,2,6,0,1,1,0,0,0
2418,2418,Michael Obafemi,2328,2018,Southampton FC,2,1,1,65,0,0,4,0,4,95,1,0,6,1,5,160,1,0,0,0,0,0,0,0,0,0,0,0,0,0
2419,2419,Jack Stephens,2329,2018,Southampton FC,10,9,1,816,1,0,14,10,4,882,0,0,24,19,5,1698,1,0,0,0,0,1,0,1,0,0,0,0,0,0
2420,2420,Kiko Femenía,1919,2018,Watford FC,14,11,3,1011,1,0,15,11,4,1034,0,0,29,22,7,2045,1,0,0,0,0,0,0,0,0,0,0,0,0,0
2421,2421,José Cholevas,1920,2018,Watford FC,15,14,1,1266,2,0,13,13,0,1170,1,0,28,27,1,2436,3,0,0,1,1,0,1,1,0,0,0,0,0,0
2422,2422,Nathaniel Chalobah,2330,2018,Watford FC,3,1,2,68,0,0,6,2,4,199,0,0,9,3,6,267,0,0,0,0,0,0,0,0,0,0,0,0,0,0
2423,2423,Isaac Success,2331,2018,Watford FC,15,3,12,462,1,0,15,6,9,577,0,0,30,9,21,1039,1,0,0,0,0,0,0,0,0,0,0,0,0,0
2424,2424,Ben Wilmot,2332,2018,Watford FC,0,0,0,0,0,0,2,0,2,26,0,0,2,0,2,26,0,0,0,0,0,0,0,0,0,0,0,0,0,0
2425,2425,Stefano Okaka,2333,2018,Watford FC,1,0,1,9,0,0,1,0,1,13,0,0,2,0,2,22,0,0,0,0,0,0,0,0,0,0,0,0,0,0
2426,2426,Dean Kiely,2334,2000,Charlton Athletic,13,13,0,1125,0,0,12,12,0,1080,0,0,25,25,0,2205,0,0,0,0,0,0,0,0,0,0,0,0,0,0
2427,2427,Mathias Svensson,2335,2000,Charlton Athletic,13,9,4,733,5,0,9,9,0,700,1,0,22,18,4,1433,6,0,6,0,6,5,1,6,0,0,0,0,0,0
2428,2428,John Salako,2336,2000,Charlton Athletic,9,3,6,309,0,0,7,1,6,144,0,0,16,4,12,453,0,0,0,0,0,0,0,0,0,0,0,0,0,0
2429,2429,Kevin Lisbie,2337,2000,Charlton Athletic,9,2,7,261,0,0,9,3,6,283,0,0,18,5,13,544,0,0,0,0,0,0,0,0,0,0,0,0,0,0
2430,2430,Craig Forrest,2338,2000,West Ham United,1,0,1,45,0,0,2,2,0,180,0,0,3,2,1,225,0,0,0,0,0,0,0,0,0,0,0,0,0,0
2431,2431,Nigel Winterburn,1623,2000,West Ham United,9,9,0,785,0,0,14,14,0,1177,1,0,23,23,0,1962,1,0,0,3,3,0,1,1,0,0,0,0,0,0
2432,2432,Sebastien Schemmel,1624,2000,West Ham United,3,1,2,142,0,0,7,7,0,533,0,0,10,8,2,675,0,0,0,0,0,0,0,0,0,0,0,0,0,0
2433,2433,Hannu Tihinen,2339,2000,West Ham United,2,1,1,78,0,0,4,2,2,232,0,0,6,3,3,310,0,0,0,0,0,0,0,0,0,0,0,0,0,0
2434,2434,Christian Dailly,1626,2000,West Ham United,3,3,0,240,0,0,7,6,1,584,0,0,10,9,1,824,0,0,0,0,0,0,0,0,0,0,0,0,0,0
2435,2435,Rigobert Song,2340,2000,West Ham United,8,8,0,720,0,0,9,8,1,755,0,0,17,16,1,1475,0,0,0,0,0,0,0,0,0,0,0,0,0,0
2436,2436,Michael Carrick,1627,2000,West Ham United,9,9,0,810,1,0,14,13,1,1242,0,0,23,22,1,2052,1,0,0,0,0,1,0,1,0,0,0,0,0,0
2437,2437,Frank Lampard,1536,2000,West Ham United,8,8,0,675,2,0,14,14,0,1250,5,0,22,22,0,1925,7,0,0,4,4,0,3,3,0,1,1,0,0,0
2438,2438,Joe Cole,1630,2000,West Ham United,10,8,2,693,4,0,12,8,4,792,1,0,22,16,6,1485,5,0,0,0,0,3,0,3,0,0,0,0,0,0
2439,2439,Paolo Di Canio,2042,2000,West Ham United,12,12,0,1076,5,0,9,9,0,809,4,0,21,21,0,1885,9,0,4,2,6,2,4,6,3,0,3,0,0,0
2440,2440,Frédéric Kanouté,1130,2000,West Ham United,10,10,0,786,5,0,13,13,0,1064,6,0,23,23,0,1850,11,0,3,1,4,2,4,6,0,0,0,0,0,0
2441,2441,John Moncur,2043,2000,West Ham United,7,2,5,229,0,0,7,3,4,264,0,0,14,5,9,493,0,0,0,0,0,0,0,0,0,0,0,0,0,0
2442,2442,Chris Kirkland,2056,2007,Blackburn Rovers,0,0,0,0,0,0,1,1,0,90,0,0,1,1,0,90,0,0,0,0,0,0,0,0,0,0,0,0,0,0
2443,2443,Ryan Taylor,2341,2007,Blackburn Rovers,0,0,0,0,0,0,1,1,0,89,0,0,1,1,0,89,0,0,0,0,0,0,0,0,0,0,0,0,0,0
2444,2444,Emmerson Boyce,2023,2007,Blackburn Rovers,0,0,0,0,0,0,1,1,0,90,0,0,1,1,0,90,0,0,0,0,0,0,0,0,0,0,0,0,0,0
2445,2445,Paul Scharner,1734,2007,Blackburn Rovers,0,0,0,0,0,0,1,1,0,90,0,0,1,1,0,90,0,0,0,0,0,0,0,0,0,0,0,0,0,0
2446,2446,Titus Bramble,1411,2007,Blackburn Rovers,0,0,0,0,0,0,1,1,0,90,0,0,1,1,0,90,0,0,0,0,0,0,0,0,0,0,0,0,0,0
2447,2447,Kevin Kilbane,1103,2007,Blackburn Rovers,0,0,0,0,0,0,1,1,0,90,0,0,1,1,0,90,0,0,0,0,0,0,0,0,0,0,0,0,0,0
2448,2448,Michael Brown,1122,2007,Blackburn Rovers,0,0,0,0,0,0,1,1,0,90,0,0,1,1,0,90,0,0,0,0,0,0,0,0,0,0,0,0,0,0
2449,2449,Denny Landzaat,2342,2007,Blackburn Rovers,0,0,0,0,0,0,1,1,0,90,0,0,1,1,0,90,0,0,0,0,0,0,0,0,0,0,0,0,0,0
2450,2450,Antonio Valencia,1641,2007,Blackburn Rovers,0,0,0,0,0,0,1,1,0,90,0,0,1,1,0,90,0,0,0,0,0,0,0,0,0,0,0,0,0,0
2451,2451,Emile Heskey,1519,2007,Blackburn Rovers,0,0,0,0,0,0,1,1,0,38,0,0,1,1,0,38,0,0,0,0,0,0,0,0,0,0,0,0,0,0
2452,2452,Marcus Bent,1349,2007,Blackburn Rovers,0,0,0,0,0,0,1,1,0,90,0,0,1,1,0,90,0,0,0,0,0,0,0,0,0,0,0,0,0,0
2453,2453,Andreas Granqvist,2343,2007,Blackburn Rovers,0,0,0,0,0,0,1,0,1,1,0,0,1,0,1,1,0,0,0,0,0,0,0,0,0,0,0,0,0,0
2454,2454,Salomon Olembé,2344,2007,Blackburn Rovers,0,0,0,0,0,0,1,0,1,1,0,0,1,0,1,1,0,0,0,0,0,0,0,0,0,0,0,0,0,0
2455,2455,Julius Aghahowa,2345,2007,Blackburn Rovers,0,0,0,0,0,0,1,0,1,52,0,0,1,0,1,52,0,0,0,0,0,0,0,0,0,0,0,0,0,0
2456,2456,Nick Pope,2346,2019,Burnley FC,19,19,0,1710,0,0,19,19,0,1710,0,0,38,38,0,3420,0,0,0,0,0,0,0,0,0,0,0,0,0,0
2457,2457,Charlie Taylor,2347,2019,Burnley FC,12,11,1,911,0,0,12,11,1,1034,0,0,24,22,2,1945,0,0,0,0,0,0,0,0,0,0,0,0,0,0
2458,2458,James Tarkowski,1264,2019,Burnley FC,19,19,0,1710,1,0,19,19,0,1710,1,0,38,38,0,3420,2,0,0,0,0,1,0,1,0,0,0,0,0,0
2459,2459,Ben Mee,1251,2019,Burnley FC,16,16,0,1440,0,0,16,16,0,1440,1,0,32,32,0,2880,1,0,0,3,3,0,1,1,0,0,0,0,0,0
2460,2460,Phil Bardsley,1409,2019,Burnley FC,12,12,0,1080,0,0,9,9,0,810,0,0,21,21,0,1890,0,0,0,0,0,0,0,0,0,0,0,0,0,0
2461,2461,Jack Cork,1701,2019,Burnley FC,15,15,0,1347,0,0,15,15,0,1272,0,0,30,30,0,2619,0,0,0,0,0,0,0,0,0,0,0,0,0,0
2462,2462,Jeff Hendrick,1254,2019,Burnley FC,12,12,0,1042,1,0,12,10,2,893,1,0,24,22,2,1935,2,0,3,1,4,1,1,2,0,0,0,0,0,0
2463,2463,Ashley Westwood,1440,2019,Burnley FC,17,17,0,1530,1,0,18,18,0,1620,1,0,35,35,0,3150,2,0,3,0,3,1,1,2,0,0,0,0,0,0
2464,2464,Chris Wood,2348,2019,Burnley FC,16,15,1,1335,9,0,16,14,2,1111,5,0,32,29,3,2446,14,0,4,1,5,6,5,11,1,0,1,0,0,0
2465,2465,Ashley Barnes,1491,2019,Burnley FC,11,10,1,750,3,0,8,7,1,612,3,0,19,17,2,1362,6,0,0,0,0,2,2,4,0,1,1,0,0,0
2466,2466,Dwight McNeil,2349,2019,Burnley FC,19,19,0,1678,2,0,19,19,0,1667,0,0,38,38,0,3345,2,0,0,0,0,0,0,0,0,0,0,0,0,0
2467,2467,Robbie Brady,2230,2019,Burnley FC,10,2,8,170,1,0,7,3,4,280,0,0,17,5,12,450,1,0,0,0,0,0,0,0,0,0,0,0,0,0
2468,2468,Jay Rodriguez,1247,2019,Burnley FC,19,9,10,927,3,0,17,11,6,1080,5,0,36,20,16,2007,8,0,3,7,10,1,4,5,1,0,1,0,0,0
2469,2469,Joe Hart,1363,2019,Burnley FC,0,0,0,0,0,0,0,0,0,0,0,0,0,0,0,0,0,0,0,0,0,0,0,0,0,0,0,0,0,0
2470,2470,Matthew Lowton,1250,2019,Burnley FC,7,7,0,630,0,0,10,10,0,900,0,0,17,17,0,1530,0,0,0,0,0,0,0,0,0,0,0,0,0,0
2471,2471,Erik Pieters,1545,2019,Burnley FC,12,10,2,928,0,0,12,11,1,951,0,0,24,21,3,1879,0,0,0,0,0,0,0,0,0,0,0,0,0,0
2472,2472,Kevin Long,2350,2019,Burnley FC,3,3,0,270,0,0,5,3,2,292,0,0,8,6,2,562,0,0,0,0,0,0,0,0,0,0,0,0,0,0
2473,2473,Aaron Lennon,1052,2019,Burnley FC,9,2,7,226,0,0,7,2,5,260,0,0,16,4,12,486,0,0,0,0,0,0,0,0,0,0,0,0,0,0
2474,2474,Manuel Lanzini,2351,2019,West Ham United,13,7,6,680,0,0,11,7,4,697,0,0,24,14,10,1377,0,0,0,0,0,0,0,0,0,0,0,0,0,0
2475,2475,Andrey Yarmolenko,2352,2019,West Ham United,11,7,4,566,4,0,12,3,9,421,1,0,23,10,13,987,5,0,4,0,4,3,1,4,0,0,0,0,0,0
2476,2476,Albian Ajeti,2353,2019,West Ham United,5,0,5,78,0,0,4,0,4,53,0,0,9,0,9,131,0,0,0,0,0,0,0,0,0,0,0,0,0,0
2477,2477,David Seaman,2354,2002,Arsenal FC,13,13,0,1170,0,0,14,14,0,1260,0,0,27,27,0,2430,0,0,0,0,0,0,0,0,0,0,0,0,0,0
2478,2478,Ashley Cole,1523,2002,Arsenal FC,13,13,0,1167,1,0,16,15,1,1356,0,0,29,28,1,2523,1,0,0,0,0,1,0,1,0,0,0,0,0,0
2479,2479,Martin Keown,2355,2002,Arsenal FC,12,11,1,1013,0,0,10,9,1,761,0,0,22,20,2,1774,0,0,0,0,0,0,0,0,0,0,0,0,0,0
2480,2480,Lauren,1602,2002,Arsenal FC,11,10,1,909,1,0,15,15,0,1301,1,0,26,25,1,2210,2,0,0,0,0,0,0,0,0,0,0,0,0,0
2481,2481,Sol Campbell,1388,2002,Arsenal FC,16,16,0,1440,1,0,16,16,0,1440,1,0,32,32,0,2880,2,0,0,0,0,1,0,1,0,0,0,0,0,0
2482,2482,Patrick Vieira,1524,2002,Arsenal FC,12,12,0,1001,2,0,11,11,0,990,1,0,23,23,0,1991,3,0,3,0,3,1,0,1,0,0,0,0,0,0
2483,2483,Robert Pirés,1603,2002,Arsenal FC,13,10,3,865,8,0,11,9,2,762,6,0,24,19,5,1627,14,0,3,1,4,4,2,6,0,1,1,0,0,0
2484,2484,Gilberto Silva,1234,2002,Arsenal FC,17,15,2,1420,0,0,16,15,1,1417,0,0,33,30,3,2837,0,0,0,0,0,0,0,0,0,0,0,0,0,0
2485,2485,Sylvain Wiltord,2356,2002,Arsenal FC,16,13,3,1100,6,0,16,12,4,1103,4,0,32,25,7,2203,10,0,3,1,4,2,3,5,0,0,0,0,0,0
2486,2486,Thierry Henry,2357,2002,Arsenal FC,18,18,0,1592,14,0,17,17,0,1529,10,0,35,35,0,3121,24,0,4,3,7,10,5,15,3,0,3,0,0,0
2487,2487,Nwankwo Kanu,1324,2002,Arsenal FC,8,6,2,496,3,0,8,3,5,360,2,0,16,9,7,856,5,0,3,0,3,2,1,3,0,0,0,0,0,0
2488,2488,Giovanni van Bronckhorst,2358,2002,Arsenal FC,10,5,5,523,1,0,9,3,6,344,0,0,19,8,11,867,1,0,0,0,0,0,0,0,0,0,0,0,0,0
2489,2489,Francis Jeffers,2359,2002,Arsenal FC,7,1,6,177,1,0,9,1,8,174,1,0,16,2,14,351,2,0,0,0,0,1,1,2,0,0,0,0,0,0
2490,2490,Dennis Bergkamp,1527,2002,Arsenal FC,15,11,4,897,1,0,13,12,1,889,3,0,28,23,5,1786,4,0,0,0,0,1,3,4,0,0,0,0,0,0
2491,2491,Chris Kirkland,2056,2002,Liverpool FC,3,3,0,270,0,0,4,4,0,360,0,0,7,7,0,630,0,0,0,0,0,0,0,0,0,0,0,0,0,0
2492,2492,Stéphane Henchoz,2360,2002,Liverpool FC,11,11,0,895,0,0,7,7,0,630,0,0,18,18,0,1525,0,0,0,0,0,0,0,0,0,0,0,0,0,0
2493,2493,Sami Hyypiä,2361,2002,Liverpool FC,19,19,0,1710,2,0,16,16,0,1440,1,0,35,35,0,3150,3,0,0,0,0,1,1,2,0,0,0,0,0,0
2494,2494,John Arne Riise,2362,2002,Liverpool FC,18,15,3,1385,4,0,18,15,3,1424,2,0,36,30,6,2809,6,0,1,3,4,3,2,5,0,0,0,0,0,0
2495,2495,Jamie Carragher,1778,2002,Liverpool FC,17,17,0,1507,0,0,17,16,1,1414,0,0,34,33,1,2921,0,0,0,0,0,0,0,0,0,0,0,0,0,0
2496,2496,Danny Murphy,1398,2002,Liverpool FC,18,18,0,1579,4,0,17,17,0,1501,3,0,35,35,0,3080,7,0,0,3,3,2,3,5,1,1,2,0,0,0
2497,2497,Steven Gerrard,1424,2002,Liverpool FC,17,16,1,1408,3,0,16,15,1,1372,2,0,33,31,2,2780,5,0,3,0,3,1,0,1,0,0,0,0,0,0
2498,2498,Salif Diao,1992,2002,Liverpool FC,12,5,7,499,0,0,14,8,6,747,1,0,26,13,13,1246,1,0,0,3,3,0,1,1,0,0,0,0,0,0
2499,2499,Bruno Cheyrou,2363,2002,Liverpool FC,10,3,7,320,0,0,9,5,4,440,0,0,19,8,11,760,0,0,0,0,0,0,0,0,0,0,0,0,0,0
2500,2500,Milan Baroš,1961,2002,Liverpool FC,12,5,7,596,2,0,15,12,3,941,7,0,27,17,10,1537,9,0,0,0,0,2,4,6,0,0,0,0,0,0
2501,2501,Michael Owen,1949,2002,Liverpool FC,19,19,0,1692,9,0,15,12,3,1054,10,0,34,31,3,2746,19,0,6,0,6,5,4,9,2,0,2,0,0,0
2502,2502,Djimi Traoré,2364,2002,Liverpool FC,15,14,1,1253,0,0,16,15,1,1331,0,0,31,29,2,2584,0,0,0,0,0,0,0,0,0,0,0,0,0,0
2503,2503,Igor Bišćan,2365,2002,Liverpool FC,1,0,1,25,0,0,5,3,2,249,0,0,6,3,3,274,0,0,0,0,0,0,0,0,0,0,0,0,0,0
2504,2504,El-Hadji Diouf,1719,2002,Liverpool FC,14,10,4,856,3,0,14,10,4,934,0,0,28,20,8,1790,3,0,0,0,0,2,0,2,0,0,0,0,0,0
2505,2505,Sebastian Prödl,2366,2017,Watford FC,11,9,2,781,0,0,10,8,2,787,0,0,21,17,4,1568,0,0,0,0,0,0,0,0,0,0,0,0,0,0
2506,2506,Roberto Pereyra,2090,2017,Watford FC,17,10,7,889,4,0,15,8,7,732,1,0,32,18,14,1621,5,0,0,0,0,3,1,4,0,0,0,0,0,0
2507,2507,Stefano Okaka,2333,2017,Watford FC,10,3,7,380,1,0,5,0,5,65,0,0,15,3,12,445,1,0,0,0,0,1,0,1,0,0,0,0,0,0
2508,2508,Didier Ndong,2367,2017,Watford FC,0,0,0,0,0,0,0,0,0,0,0,0,0,0,0,0,0,0,0,0,0,0,0,0,0,0,0,0,0,0
2509,2509,Dodi Lukebakio,2368,2017,Watford FC,0,0,0,0,0,0,1,0,1,15,0,0,1,0,1,15,0,0,0,0,0,0,0,0,0,0,0,0,0,0
2510,2510,Junior Stanislas,1009,2017,AFC Bournemouth,8,7,1,594,2,0,11,10,1,702,3,0,19,17,2,1296,5,0,3,0,3,2,1,3,0,1,1,0,0,0
2511,2511,Andrew Surman,1006,2017,AFC Bournemouth,12,11,1,985,1,0,13,9,4,867,1,0,25,20,5,1852,2,0,0,0,0,1,1,2,0,0,0,0,0,0
2512,2512,Jermain Defoe,1127,2017,AFC Bournemouth,13,7,6,641,1,0,11,4,7,443,3,0,24,11,13,1084,4,0,3,2,5,1,3,4,0,0,0,0,0,0
2513,2513,Brad Smith,2369,2017,AFC Bournemouth,0,0,0,0,0,0,0,0,0,0,0,0,0,0,0,0,0,0,0,0,0,0,0,0,0,0,0,0,0,0
2514,2514,Carlo Cudicini,2370,2003,Chelsea FC,12,12,0,1080,0,0,14,14,0,1260,0,0,26,26,0,2340,0,0,0,0,0,0,0,0,0,0,0,0,0,0
2515,2515,Glen Johnson,1386,2003,Chelsea FC,9,8,1,713,2,0,10,9,1,793,1,0,19,17,2,1506,3,0,0,3,3,1,1,2,0,0,0,0,0,0
2516,2516,William Gallas,2040,2003,Chelsea FC,14,13,1,1126,0,0,14,9,5,876,0,0,28,22,6,2002,0,0,0,0,0,0,0,0,0,0,0,0,0,0
2517,2517,Wayne Bridge,1768,2003,Chelsea FC,15,15,0,1344,1,0,17,17,0,1530,0,0,32,32,0,2874,1,0,0,0,0,1,0,1,0,0,0,0,0,0
2518,2518,John Terry,1534,2003,Chelsea FC,14,14,0,1255,0,0,18,18,0,1620,2,0,32,32,0,2875,2,0,0,0,0,0,2,2,0,0,0,0,0,0
2519,2519,Claude Makélélé,1762,2003,Chelsea FC,13,10,3,914,0,0,16,15,1,1395,0,0,29,25,4,2309,0,0,0,0,0,0,0,0,0,0,0,0,0,0
2520,2520,Frank Lampard,1536,2003,Chelsea FC,18,18,0,1603,7,0,19,19,0,1685,3,0,37,37,0,3288,10,0,3,0,3,3,3,6,2,0,2,0,0,0
2521,2521,Damien Duff,1348,2003,Chelsea FC,11,7,4,680,2,0,12,10,2,784,3,0,23,17,6,1464,5,0,3,1,4,1,1,2,0,0,0,0,0,0
2522,2522,Juan Sebastián Verón,1452,2003,Chelsea FC,6,4,2,393,0,0,1,1,0,90,1,0,7,5,2,483,1,0,0,0,0,0,1,1,0,0,0,0,0,0
2523,2523,Adrian Mutu,2371,2003,Chelsea FC,13,12,1,990,4,0,11,8,3,677,2,0,24,20,4,1667,6,0,3,3,6,3,1,4,0,0,0,0,0,0
2524,2524,Hernán Crespo,2372,2003,Chelsea FC,7,6,1,412,2,0,12,7,5,732,8,0,19,13,6,1144,10,0,0,6,6,1,4,5,0,0,0,0,0,0
2525,2525,Robert Huth,1884,2003,Chelsea FC,7,3,4,301,0,0,9,5,4,505,0,0,16,8,8,806,0,0,0,0,0,0,0,0,0,0,0,0,0,0
2526,2526,Joe Cole,1630,2003,Chelsea FC,17,9,8,788,0,0,17,9,8,850,1,0,34,18,16,1638,1,0,0,0,0,0,1,1,0,0,0,0,0,0
2527,2527,Eiður Guðjohnsen,2373,2003,Chelsea FC,11,7,4,706,3,0,14,9,5,804,3,0,25,16,9,1510,6,0,0,3,3,2,2,4,0,0,0,0,0,0
2528,2528,Shay Given,1581,2003,Newcastle United,17,17,0,1530,0,0,17,17,0,1530,0,0,34,34,0,3060,0,0,0,0,0,0,0,0,0,0,0,0,0,0
2529,2529,Andy O'Brien,2160,2003,Newcastle United,11,10,1,945,1,0,14,14,0,1260,0,0,25,24,1,2205,1,0,0,0,0,1,0,1,0,0,0,0,0,0
2530,2530,Titus Bramble,1411,2003,Newcastle United,14,12,2,1137,0,0,11,11,0,990,0,0,25,23,2,2127,0,0,0,0,0,0,0,0,0,0,0,0,0,0
2531,2531,Aaron Hughes,1561,2003,Newcastle United,15,15,0,1260,0,0,15,15,0,1344,0,0,30,30,0,2604,0,0,0,0,0,0,0,0,0,0,0,0,0,0
2532,2532,Olivier Bernard,2032,2003,Newcastle United,15,15,0,1350,0,0,17,17,0,1512,1,0,32,32,0,2862,1,0,0,0,0,0,1,1,0,0,0,0,0,0
2533,2533,Jermaine Jenas,1275,2003,Newcastle United,13,11,2,1021,2,0,15,12,3,1093,0,0,28,23,5,2114,2,0,0,0,0,0,0,0,0,0,0,0,0,0
2534,2534,Gary Speed,1716,2003,Newcastle United,17,17,0,1499,2,0,17,16,1,1439,1,0,34,33,1,2938,3,0,0,0,0,1,1,2,0,0,0,0,0,0
2535,2535,Lee Bowyer,1297,2003,Newcastle United,9,3,6,312,1,0,12,11,1,941,1,0,21,14,7,1253,2,0,0,0,0,1,1,2,0,0,0,0,0,0
2536,2536,Laurent Robert,2034,2003,Newcastle United,16,15,1,1288,4,0,16,14,2,1146,2,0,32,29,3,2434,6,0,1,0,1,2,1,3,0,0,0,0,0,0
2537,2537,Hugo Viana,2374,2003,Newcastle United,10,3,7,321,0,0,6,2,4,222,0,0,16,5,11,543,0,0,0,0,0,0,0,0,0,0,0,0,0,0
2538,2538,Shola Ameobi,1950,2003,Newcastle United,13,10,3,850,4,0,11,6,5,575,3,0,24,16,8,1425,7,0,0,3,3,3,3,6,0,0,0,0,0,0
2539,2539,Steven Caldwell,2375,2003,Newcastle United,1,1,0,90,0,0,2,1,1,135,0,0,3,2,1,225,0,0,0,0,0,0,0,0,0,0,0,0,0,0
2540,2540,Nick Pope,2346,2017,Burnley FC,18,17,1,1584,0,0,17,17,0,1530,0,0,35,34,1,3114,0,0,0,0,0,0,0,0,0,0,0,0,0,0
2541,2541,James Tarkowski,1264,2017,Burnley FC,16,16,0,1440,0,0,15,15,0,1350,0,0,31,31,0,2790,0,0,0,0,0,0,0,0,0,0,0,0,0,0
2542,2542,Stephen Ward,1252,2017,Burnley FC,15,15,0,1292,0,0,13,13,0,1170,1,0,28,28,0,2462,1,0,0,0,0,0,0,0,0,0,0,0,0,0
2543,2543,Phil Bardsley,1409,2017,Burnley FC,6,6,0,496,0,0,7,7,0,630,0,0,13,13,0,1126,0,0,0,0,0,0,0,0,0,0,0,0,0,0
2544,2544,Kevin Long,2350,2017,Burnley FC,9,9,0,810,1,0,7,7,0,630,0,0,16,16,0,1440,1,0,0,0,0,0,0,0,0,0,0,0,0,0
2545,2545,Jack Cork,1701,2017,Burnley FC,19,19,0,1710,1,0,19,19,0,1710,1,0,38,38,0,3420,2,0,0,3,3,1,1,2,0,0,0,0,0,0
2546,2546,Jeff Hendrick,1254,2017,Burnley FC,17,15,2,1164,1,0,17,14,3,1178,1,0,34,29,5,2342,2,0,3,3,6,1,1,2,0,0,0,0,0,0
2547,2547,Steven Defour,1255,2017,Burnley FC,12,12,0,1046,0,0,12,12,0,963,1,0,24,24,0,2009,1,0,0,0,0,0,0,0,0,0,0,0,0,0
2548,2548,Jóhann Guðmundsson,1256,2017,Burnley FC,19,17,2,1566,2,0,16,15,1,1273,0,0,35,32,3,2839,2,0,1,0,1,2,0,2,0,0,0,0,0,0
2549,2549,Scott Arfield,1265,2017,Burnley FC,7,7,0,556,1,0,11,8,3,780,1,0,18,15,3,1336,2,0,3,0,3,1,1,2,0,0,0,0,0,0
2550,2550,Chris Wood,2348,2017,Burnley FC,12,10,2,807,5,0,12,10,2,826,5,0,24,20,4,1633,10,0,7,1,8,5,2,7,0,0,0,0,0,0
2551,2551,Charlie Taylor,2347,2017,Burnley FC,5,4,1,409,0,0,6,6,0,540,0,0,11,10,1,949,0,0,0,0,0,0,0,0,0,0,0,0,0,0
2552,2552,Sam Vokes,1257,2017,Burnley FC,13,3,10,429,0,0,17,4,13,550,4,0,30,7,23,979,4,0,0,3,3,0,3,3,0,0,0,0,0,0
2553,2553,Ashley Barnes,1491,2017,Burnley FC,18,11,7,1150,5,0,18,10,8,1007,4,0,36,21,15,2157,9,0,3,1,4,4,4,8,0,0,0,0,0,0
2554,2554,Anders Lindegaard,2319,2017,Burnley FC,0,0,0,0,0,0,0,0,0,0,0,0,0,0,0,0,0,0,0,0,0,0,0,0,0,0,0,0,0,0
2555,2555,Ashley Westwood,1440,2017,Burnley FC,9,6,3,554,0,0,10,6,4,553,0,0,19,12,7,1107,0,0,0,0,0,0,0,0,0,0,0,0,0,0
2556,2556,Fredrik Ulvestad,1493,2017,Burnley FC,0,0,0,0,0,0,0,0,0,0,0,0,0,0,0,0,0,0,0,0,0,0,0,0,0,0,0,0,0,0
2557,2557,Nahki Wells,2376,2017,Burnley FC,5,0,5,22,0,0,4,0,4,24,0,0,9,0,9,46,0,0,0,0,0,0,0,0,0,0,0,0,0,0
2558,2558,Ryan Shawcross,1547,2017,Stoke City,14,14,0,1260,0,0,13,13,0,1112,1,0,27,27,0,2372,1,0,0,0,0,0,0,0,0,0,0,0,0,0
2559,2559,Tom Edwards,2377,2017,Stoke City,2,2,0,180,0,0,4,4,0,303,0,0,6,6,0,483,0,0,0,0,0,0,0,0,0,0,0,0,0,0
2560,2560,De Gea,1638,2014,Manchester United,19,19,0,1693,0,0,18,18,0,1620,0,0,37,37,0,3313,0,0,0,0,0,0,0,0,0,0,0,0,0,0
2561,2561,Marcos Rojo,1651,2014,Manchester United,12,11,1,989,0,0,10,9,1,776,0,0,22,20,2,1765,0,0,0,0,0,0,0,0,0,0,0,0,0,0
2562,2562,Chris Smalling,1640,2014,Manchester United,11,10,1,985,4,0,14,11,3,944,0,0,25,21,4,1929,4,0,0,0,0,3,0,3,0,0,0,0,0,0
2563,2563,Mata,1643,2014,Manchester United,17,14,3,1236,5,0,16,13,3,1072,4,0,33,27,6,2308,9,0,6,0,6,2,3,5,0,1,1,0,0,0
2564,2564,Michael Carrick,1627,2014,Manchester United,9,9,0,778,1,0,9,7,2,678,0,0,18,16,2,1456,1,0,0,0,0,0,0,0,0,0,0,0,0,0
2565,2565,Ashley Young,1619,2014,Manchester United,11,11,0,970,1,0,15,12,3,1099,1,0,26,23,3,2069,2,0,0,3,3,1,1,2,0,0,0,0,0,0
2566,2566,Ander Herrera,1644,2014,Manchester United,14,10,4,1033,4,0,12,9,3,837,2,0,26,19,7,1870,6,0,0,0,0,2,1,3,0,0,0,0,0,0
2567,2567,Antonio Valencia,1641,2014,Manchester United,16,14,2,1249,0,0,16,15,1,1334,0,0,32,29,3,2583,0,0,0,0,0,0,0,0,0,0,0,0,0,0
2568,2568,Marouane Fellaini,2189,2014,Manchester United,14,10,4,947,3,0,13,9,4,895,3,0,27,19,8,1842,6,0,0,3,3,3,3,6,0,0,0,0,0,0
2569,2569,Robin van Persie,1528,2014,Manchester United,14,13,1,1128,7,0,13,12,1,986,3,0,27,25,2,2114,10,0,1,3,4,2,3,5,1,0,1,0,0,0
2570,2570,James Wilson,2378,2014,Manchester United,8,2,6,260,0,0,5,0,5,89,1,0,13,2,11,349,1,0,0,0,0,0,0,0,0,0,0,0,0,0
2571,2571,Adnan Januzaj,2259,2014,Manchester United,8,4,4,452,0,0,10,3,7,398,0,0,18,7,11,850,0,0,0,0,0,0,0,0,0,0,0,0,0,0
2572,2572,Darren Fletcher,1730,2014,Manchester United,6,1,5,165,0,0,5,3,2,201,0,0,11,4,7,366,0,0,0,0,0,0,0,0,0,0,0,0,0,0
2573,2573,Radamel Falcao,2379,2014,Manchester United,15,7,8,585,2,0,11,7,4,698,2,0,26,14,12,1283,4,0,3,2,5,1,2,3,0,0,0,0,0,0
2574,2574,Anders Lindegaard,2319,2014,Manchester United,0,0,0,0,0,0,0,0,0,0,0,0,0,0,0,0,0,0,0,0,0,0,0,0,0,0,0,0,0,0
2575,2575,Paddy McNair,2194,2014,Manchester United,8,6,2,557,0,0,8,6,2,471,0,0,16,12,4,1028,0,0,0,0,0,0,0,0,0,0,0,0,0,0
2576,2576,Tyler Blackett,2380,2014,Manchester United,5,2,3,241,0,0,6,4,2,414,0,0,11,6,5,655,0,0,0,0,0,0,0,0,0,0,0,0,0,0
2577,2577,Will Keane,2381,2014,Manchester United,0,0,0,0,0,0,0,0,0,0,0,0,0,0,0,0,0,0,0,0,0,0,0,0,0,0,0,0,0,0
2578,2578,Asmir Begović,1036,2014,Stoke City,18,18,0,1620,0,0,17,17,0,1530,0,0,35,35,0,3150,0,0,0,0,0,0,0,0,0,0,0,0,0,0
2579,2579,Phil Bardsley,1409,2014,Stoke City,12,11,1,993,0,0,13,13,0,1089,0,0,25,24,1,2082,0,0,0,0,0,0,0,0,0,0,0,0,0,0
2580,2580,Erik Pieters,1545,2014,Stoke City,15,15,0,1344,0,0,16,14,2,1220,0,0,31,29,2,2564,0,0,0,0,0,0,0,0,0,0,0,0,0,0
2581,2581,Marc Wilson,1546,2014,Stoke City,11,9,2,834,0,0,16,16,0,1296,0,0,27,25,2,2130,0,0,0,0,0,0,0,0,0,0,0,0,0,0
2582,2582,Ryan Shawcross,1547,2014,Stoke City,16,16,0,1392,1,0,16,16,0,1440,1,0,32,32,0,2832,2,0,0,1,1,1,1,2,0,0,0,0,0,0
2583,2583,Geoff Cameron,1548,2014,Stoke City,14,12,2,1157,0,0,13,9,4,978,0,0,27,21,6,2135,0,0,0,0,0,0,0,0,0,0,0,0,0,0
2584,2584,Stephen Ireland,1809,2014,Stoke City,9,7,2,542,0,0,8,4,4,393,0,0,17,11,6,935,0,0,0,0,0,0,0,0,0,0,0,0,0,0
2585,2585,Steven N'Zonzi,1550,2014,Stoke City,19,19,0,1710,2,0,19,19,0,1666,1,0,38,38,0,3376,3,0,0,0,0,0,1,1,0,0,0,0,0,0
2586,2586,Mame Diouf,1584,2014,Stoke City,18,15,3,1198,9,0,16,13,3,1237,3,0,34,28,6,2435,12,0,0,3,3,4,3,7,0,0,0,0,0,0
2587,2587,Oussama Assaidi,2382,2014,Stoke City,5,0,5,50,0,0,4,1,3,174,0,0,9,1,8,224,0,0,0,0,0,0,0,0,0,0,0,0,0,0
2588,2588,Bojan,1585,2014,Stoke City,7,7,0,591,1,0,9,7,2,618,3,0,16,14,2,1209,4,0,0,6,6,0,3,3,0,1,1,0,0,0
2589,2589,Marko Arnautović,1552,2014,Stoke City,14,11,3,1054,0,0,15,9,6,864,1,0,29,20,9,1918,1,0,0,1,1,0,1,1,0,0,0,0,0,0
2590,2590,Peter Crouch,1273,2014,Stoke City,17,10,7,948,5,0,16,7,9,729,3,0,33,17,16,1677,8,0,6,2,8,4,3,7,0,0,0,0,0,0
2591,2591,Jack Butland,1901,2014,Stoke City,1,1,0,90,0,0,2,2,0,180,0,0,3,3,0,270,0,0,0,0,0,0,0,0,0,0,0,0,0,0
2592,2592,Muniesa,1556,2014,Stoke City,11,9,2,818,0,0,8,5,3,568,0,0,19,14,5,1386,0,0,0,0,0,0,0,0,0,0,0,0,0,0
2593,2593,Wilson Palacios,1271,2014,Stoke City,0,0,0,0,0,0,0,0,0,0,0,0,0,0,0,0,0,0,0,0,0,0,0,0,0,0,0,0,0,0
2594,2594,Charlie Adam,1554,2014,Stoke City,17,7,10,761,5,0,12,8,4,743,2,0,29,15,14,1504,7,0,4,0,4,4,2,6,1,0,1,0,0,0
2595,2595,Oliver Shenton,2383,2014,Stoke City,1,0,1,1,0,0,0,0,0,0,0,0,1,0,1,1,0,0,0,0,0,0,0,0,0,0,0,0,0,0
2596,2596,Bernt Haas,1339,2004,West Bromwich Albion,4,4,0,333,0,0,6,5,1,423,0,0,10,9,1,756,0,0,0,0,0,0,0,0,0,0,0,0,0,0
2597,2597,Jason Koumas,2062,2004,West Bromwich Albion,6,2,4,278,0,0,4,3,1,249,0,0,10,5,5,527,0,0,0,0,0,0,0,0,0,0,0,0,0,0
2598,2598,Robert Green,1277,2004,Norwich City,18,18,0,1620,0,0,19,19,0,1683,0,0,37,37,0,3303,0,0,0,0,0,0,0,0,0,0,0,0,0,0
2599,2599,Adam Drury,2384,2004,Norwich City,15,14,1,1324,1,0,17,16,1,1402,0,0,32,30,2,2726,1,0,0,0,0,0,0,0,0,0,0,0,0,0
2600,2600,Craig Fleming,2385,2004,Norwich City,18,18,0,1620,1,0,19,19,0,1710,0,0,37,37,0,3330,1,0,0,0,0,1,0,1,0,0,0,0,0,0
2601,2601,Marc Edworthy,2386,2004,Norwich City,13,12,1,1099,0,0,14,14,0,1241,0,0,27,26,1,2340,0,0,0,0,0,0,0,0,0,0,0,0,0,0
2602,2602,Gary Holt,2387,2004,Norwich City,13,9,4,865,0,0,14,12,2,1051,0,0,27,21,6,1916,0,0,0,0,0,0,0,0,0,0,0,0,0,0
2603,2603,David Bentley,2011,2004,Norwich City,12,10,2,911,0,0,13,11,2,1000,2,0,25,21,4,1911,2,0,0,0,0,0,1,1,0,0,0,0,0,0
2604,2604,Simon Charlton,2388,2004,Norwich City,11,10,1,791,1,0,12,11,1,997,0,0,23,21,2,1788,1,0,1,0,1,1,0,1,0,0,0,0,0,0
2605,2605,Damien Francis,2117,2004,Norwich City,15,15,0,1338,5,0,16,16,0,1438,2,0,31,31,0,2776,7,0,6,1,7,5,2,7,0,0,0,0,0,0
2606,2606,Darren Huckerby,2389,2004,Norwich City,17,16,1,1419,4,0,19,19,0,1681,2,0,36,35,1,3100,6,0,0,1,1,3,1,4,2,0,2,0,0,0
2607,2607,Mattias Jonson,2390,2004,Norwich City,15,11,4,802,0,0,13,8,5,739,0,0,28,19,9,1541,0,0,0,0,0,0,0,0,0,0,0,0,0,0
2608,2608,Leon McKenzie,2391,2004,Norwich City,17,13,4,1182,5,0,19,10,9,1142,2,0,36,23,13,2324,7,0,1,0,1,2,1,3,0,0,0,0,0,0
2609,2609,Thomas Helveg,2392,2004,Norwich City,10,10,0,855,0,0,10,6,4,483,0,0,20,16,4,1338,0,0,0,0,0,0,0,0,0,0,0,0,0,0
2610,2610,Paul McVeigh,2393,2004,Norwich City,10,1,9,260,0,0,7,2,5,211,1,0,17,3,14,471,1,0,0,0,0,0,0,0,0,0,0,0,0,0
2611,2611,Mathias Svensson,2335,2004,Norwich City,11,4,7,422,4,0,10,5,5,417,0,0,21,9,12,839,4,0,6,0,6,4,0,4,0,0,0,0,0,0
2612,2612,Steve Harper,2231,2010,Newcastle United,7,7,0,630,0,0,10,10,0,845,0,0,17,17,0,1475,0,0,0,0,0,0,0,0,0,0,0,0,0,0
2613,2613,Fabricio Coloccini,2278,2010,Newcastle United,16,16,0,1440,2,0,18,18,0,1566,0,0,34,34,0,3006,2,0,1,0,1,2,0,2,0,0,0,0,0,0
2614,2614,José Enrique,2394,2010,Newcastle United,17,17,0,1483,0,0,18,18,0,1553,0,0,35,35,0,3036,0,0,0,0,0,0,0,0,0,0,0,0,0,0
2615,2615,Mike Williamson,2287,2010,Newcastle United,13,12,1,1124,0,0,15,15,0,1350,0,0,28,27,1,2474,0,0,0,0,0,0,0,0,0,0,0,0,0,0
2616,2616,Danny Simpson,2395,2010,Newcastle United,15,15,0,1350,0,0,15,15,0,1336,0,0,30,30,0,2686,0,0,0,0,0,0,0,0,0,0,0,0,0,0
2617,2617,Kevin Nolan,2396,2010,Newcastle United,14,14,0,1257,10,0,15,15,0,1310,2,0,29,29,0,2567,12,0,0,0,0,5,2,7,1,0,1,0,0,0
2618,2618,Joey Barton,1876,2010,Newcastle United,14,14,0,1259,4,0,17,17,0,1530,0,0,31,31,0,2789,4,0,0,0,0,2,0,2,2,0,2,0,0,0
2619,2619,Danny Guthrie,2397,2010,Newcastle United,8,7,1,560,0,0,6,4,2,394,0,0,14,11,3,954,0,0,0,0,0,0,0,0,0,0,0,0,0,0
2620,2620,Jonás Gutiérrez,2398,2010,Newcastle United,17,16,1,1404,1,0,19,17,2,1498,2,0,36,33,3,2902,3,0,0,0,0,0,2,2,0,0,0,0,0,0
2621,2621,Leon Best,2399,2010,Newcastle United,6,5,1,413,5,0,5,4,1,339,1,0,11,9,2,752,6,0,0,0,0,2,0,2,0,0,0,0,0,0
2622,2622,Shola Ameobi,1950,2010,Newcastle United,13,9,4,806,5,0,14,12,2,941,1,0,27,21,6,1747,6,0,0,3,3,1,1,2,2,0,2,0,0,0
2623,2623,James Perch,2400,2010,Newcastle United,5,3,2,316,0,0,7,5,2,468,0,0,12,8,4,784,0,0,0,0,0,0,0,0,0,0,0,0,0,0
2624,2624,Peter Løvenkrands,2401,2010,Newcastle United,12,10,2,786,3,0,13,8,5,672,3,0,25,18,7,1458,6,0,0,0,0,0,2,2,0,0,0,0,0,0
2625,2625,Nile Ranger,2402,2010,Newcastle United,14,0,14,257,0,0,10,1,9,304,0,0,24,1,23,561,0,0,0,0,0,0,0,0,0,0,0,0,0,0
2626,2626,Tim Krul,1822,2010,Newcastle United,11,11,0,990,0,0,10,9,1,865,0,0,21,20,1,1855,0,0,0,0,0,0,0,0,0,0,0,0,0,0
2627,2627,Sol Campbell,1388,2010,Newcastle United,2,2,0,180,0,0,5,2,3,226,0,0,7,4,3,406,0,0,0,0,0,0,0,0,0,0,0,0,0,0
2628,2628,Shane Ferguson,2403,2010,Newcastle United,4,2,2,172,0,0,3,1,2,137,0,0,7,3,4,309,0,0,0,0,0,0,0,0,0,0,0,0,0,0
2629,2629,Francisco Xisco,2404,2010,Newcastle United,0,0,0,0,0,0,1,0,1,9,0,0,1,0,1,9,0,0,0,0,0,0,0,0,0,0,0,0,0,0
2630,2630,Carlo Cudicini,2370,2010,Tottenham Hotspur,3,3,0,270,0,0,5,5,0,450,0,0,8,8,0,720,0,0,0,0,0,0,0,0,0,0,0,0,0,0
2631,2631,Alan Hutton,2172,2010,Tottenham Hotspur,11,9,2,805,1,0,10,10,0,900,1,0,21,19,2,1705,2,0,0,0,0,0,0,0,0,0,0,0,0,0
2632,2632,William Gallas,2040,2010,Tottenham Hotspur,13,12,1,1081,0,0,14,14,0,1258,0,0,27,26,1,2339,0,0,0,0,0,0,0,0,0,0,0,0,0,0
2633,2633,Michael Dawson,1267,2010,Tottenham Hotspur,13,13,0,1170,0,0,11,11,0,990,1,0,24,24,0,2160,1,0,0,0,0,0,1,1,0,0,0,0,0,0
2634,2634,Gareth Bale,1274,2010,Tottenham Hotspur,17,17,0,1460,4,0,13,12,1,990,3,0,30,29,1,2450,7,0,3,3,6,2,2,4,0,0,0,0,0,0
2635,2635,Aaron Lennon,1052,2010,Tottenham Hotspur,16,11,5,1102,2,0,18,14,4,1258,1,0,34,25,9,2360,3,0,3,1,4,2,1,3,0,0,0,0,0,0
2636,2636,Jermaine Jenas,1275,2010,Tottenham Hotspur,6,4,2,411,0,0,13,10,3,907,0,0,19,14,5,1318,0,0,0,0,0,0,0,0,0,0,0,0,0,0
2637,2637,Rafael van der Vaart,2405,2010,Tottenham Hotspur,15,15,0,1176,8,0,13,13,0,1063,5,0,28,28,0,2239,13,0,5,0,5,8,4,12,3,1,4,0,0,0
2638,2638,Luka Modrić,1272,2010,Tottenham Hotspur,16,16,0,1427,1,0,16,16,0,1372,2,0,32,32,0,2799,3,0,0,0,0,0,1,1,0,1,1,0,0,0
2639,2639,Steven Pienaar,2406,2010,Tottenham Hotspur,1,0,1,44,0,0,7,5,2,449,0,0,8,5,3,493,0,0,0,0,0,0,0,0,0,0,0,0,0,0
2640,2640,Jermain Defoe,1127,2010,Tottenham Hotspur,10,8,2,758,2,0,12,8,4,783,2,0,22,16,6,1541,4,0,1,0,1,2,2,4,0,0,0,0,0,0
2641,2641,Sébastien Bassong,1370,2010,Tottenham Hotspur,4,2,2,258,0,0,8,5,3,566,1,0,12,7,5,824,1,0,0,0,0,0,1,1,0,0,0,0,0,0
2642,2642,Niko Kranjčar,1276,2010,Tottenham Hotspur,4,0,4,63,1,0,9,2,7,306,1,0,13,2,11,369,2,0,3,3,6,1,1,2,0,0,0,0,0,0
2643,2643,Peter Crouch,1273,2010,Tottenham Hotspur,18,12,6,1090,3,0,16,8,8,846,1,0,34,20,14,1936,4,0,0,3,3,1,1,2,0,0,0,0,0,0
2644,2644,Stipe Pletikosa,2407,2010,Tottenham Hotspur,0,0,0,0,0,0,0,0,0,0,0,0,0,0,0,0,0,0,0,0,0,0,0,0,0,0,0,0,0,0
2645,2645,Younès Kaboul,2408,2010,Tottenham Hotspur,12,11,1,934,0,0,9,8,1,722,1,0,21,19,2,1656,1,0,0,3,3,0,1,1,0,0,0,0,0,0
2646,2646,Vedran Ćorluka,1268,2010,Tottenham Hotspur,6,5,1,456,0,0,9,8,1,710,0,0,15,13,2,1166,0,0,0,0,0,0,0,0,0,0,0,0,0,0
2647,2647,Sandro,2409,2010,Tottenham Hotspur,10,3,7,413,0,0,9,8,1,662,1,0,19,11,8,1075,1,0,0,0,0,0,1,1,0,0,0,0,0,0
2648,2648,Jussi Jääskeläinen,1710,2008,Bolton Wanderers,18,18,0,1620,0,0,19,19,0,1710,0,0,37,37,0,3330,0,0,0,0,0,0,0,0,0,0,0,0,0,0
2649,2649,Jlloyd Samuel,1789,2008,Bolton Wanderers,18,18,0,1569,0,0,19,19,0,1666,0,0,37,37,0,3235,0,0,0,0,0,0,0,0,0,0,0,0,0,0
2650,2650,Gary Cahill,1533,2008,Bolton Wanderers,15,15,0,1350,1,0,17,17,0,1530,2,0,32,32,0,2880,3,0,0,0,0,1,1,2,0,0,0,0,0,0
2651,2651,Grétar Steinsson,2410,2008,Bolton Wanderers,18,18,0,1606,2,0,18,18,0,1584,1,0,36,36,0,3190,3,0,0,0,0,2,1,3,0,0,0,0,0,0
2652,2652,Andy O'Brien,2160,2008,Bolton Wanderers,16,14,2,1276,0,0,17,15,2,1401,1,0,33,29,4,2677,1,0,0,0,0,0,0,0,0,0,0,0,0,0
2653,2653,Kevin Nolan,2396,2008,Bolton Wanderers,9,9,0,784,0,0,10,10,0,900,0,0,19,19,0,1684,0,0,0,0,0,0,0,0,0,0,0,0,0,0
2654,2654,Fabrice Muamba,1964,2008,Bolton Wanderers,18,14,4,1160,0,0,19,18,1,1590,0,0,37,32,5,2750,0,0,0,0,0,0,0,0,0,0,0,0,0,0
2655,2655,Ricardo Gardner,2411,2008,Bolton Wanderers,14,9,5,993,4,0,15,9,6,853,0,0,29,18,11,1846,4,0,3,0,3,2,0,2,0,0,0,0,0,0
2656,2656,Gavin McCann,1096,2008,Bolton Wanderers,16,14,2,1304,0,0,17,16,1,1468,0,0,33,30,3,2772,0,0,0,0,0,0,0,0,0,0,0,0,0,0
2657,2657,Johan Elmander,1378,2008,Bolton Wanderers,13,13,0,1098,1,0,16,16,0,1178,4,0,29,29,0,2276,5,0,0,0,0,0,1,1,0,0,0,0,0,0
2658,2658,Kevin Davies,1718,2008,Bolton Wanderers,18,18,0,1620,7,0,19,18,1,1664,4,0,37,36,1,3284,11,0,3,0,3,4,1,5,0,0,0,0,0,0
2659,2659,Matthew Taylor,1069,2008,Bolton Wanderers,16,16,0,1422,3,0,17,16,1,1333,7,0,33,32,1,2755,10,0,0,3,3,2,4,6,0,0,0,0,0,0
2660,2660,Joey O'Brien,2412,2008,Bolton Wanderers,4,3,1,179,0,0,3,2,1,185,0,0,7,5,2,364,0,0,0,0,0,0,0,0,0,0,0,0,0,0
2661,2661,Aymeric Laporte,2413,2019,Manchester City,7,6,1,460,0,0,8,8,0,644,1,0,15,14,1,1104,1,0,0,0,0,0,0,0,0,0,0,0,0,0
2662,2662,José Angeliño,2414,2019,Manchester City,4,2,2,241,0,0,2,2,0,180,0,0,6,4,2,421,0,0,0,0,0,0,0,0,0,0,0,0,0,0
2663,2663,Mathew Ryan,2415,2019,Brighton & Hove Albion,19,19,0,1710,0,0,19,19,0,1710,0,0,38,38,0,3420,0,0,0,0,0,0,0,0,0,0,0,0,0,0
2664,2664,Lewis Dunk,2416,2019,Brighton & Hove Albion,18,18,0,1611,1,0,18,18,0,1620,2,0,36,36,0,3231,3,0,0,0,0,1,0,1,0,0,0,0,0,0
2665,2665,Adam Webster,2417,2019,Brighton & Hove Albion,14,14,0,1206,0,0,17,17,0,1464,3,0,31,31,0,2670,3,0,0,0,0,0,3,3,0,0,0,0,0,0
2666,2666,Martín Montoya,2418,2019,Brighton & Hove Albion,14,12,2,1007,0,0,13,11,2,895,0,0,27,23,4,1902,0,0,0,0,0,0,0,0,0,0,0,0,0,0
2667,2667,Bernardo,2419,2019,Brighton & Hove Albion,4,2,2,257,0,0,10,5,5,421,0,0,14,7,7,678,0,0,0,0,0,0,0,0,0,0,0,0,0,0
2668,2668,Dan Burn,2420,2019,Brighton & Hove Albion,18,17,1,1441,0,0,16,16,0,1440,0,0,34,33,1,2881,0,0,0,0,0,0,0,0,0,0,0,0,0,0
2669,2669,Dale Stephens,2421,2019,Brighton & Hove Albion,16,13,3,1185,0,0,17,15,2,1344,0,0,33,28,5,2529,0,0,0,0,0,0,0,0,0,0,0,0,0,0
2670,2670,Solly March,2422,2019,Brighton & Hove Albion,9,6,3,566,0,0,10,5,5,577,0,0,19,11,8,1143,0,0,0,0,0,0,0,0,0,0,0,0,0,0
2671,2671,Davy Pröpper,2423,2019,Brighton & Hove Albion,18,17,1,1453,1,0,17,15,2,1377,0,0,35,32,3,2830,1,0,0,0,0,1,0,1,0,0,0,0,0,0
2672,2672,Neal Maupay,2424,2019,Brighton & Hove Albion,19,15,4,1442,5,0,18,15,3,1327,5,0,37,30,7,2769,10,0,3,4,7,5,4,9,1,0,1,0,0,0
2673,2673,Leandro Trossard,2425,2019,Brighton & Hove Albion,17,14,3,1257,4,0,14,8,6,757,1,0,31,22,9,2014,5,0,1,3,4,3,1,4,0,0,0,0,0,0
2674,2674,Pascal Groß,2426,2019,Brighton & Hove Albion,14,12,2,845,1,0,15,10,5,958,1,0,29,22,7,1803,2,0,0,0,0,1,0,1,0,0,0,0,0,0
2675,2675,Glenn Murray,1010,2019,Brighton & Hove Albion,13,3,10,395,0,0,10,4,6,393,1,0,23,7,16,788,1,0,0,1,1,0,1,1,0,0,0,0,0,0
2676,2676,Aaron Connolly,2427,2019,Brighton & Hove Albion,11,6,5,592,2,0,13,8,5,670,1,0,24,14,10,1262,3,0,0,3,3,0,1,1,0,0,0,0,0,0
2677,2677,David Button,2428,2019,Brighton & Hove Albion,0,0,0,0,0,0,0,0,0,0,0,0,0,0,0,0,0,0,0,0,0,0,0,0,0,0,0,0,0,0
2678,2678,Shane Duffy,2429,2019,Brighton & Hove Albion,9,7,2,688,1,0,10,5,5,544,0,0,19,12,7,1232,1,0,0,0,0,0,0,0,0,0,0,0,0,0
2679,2679,Aaron Mooy,2430,2019,Brighton & Hove Albion,16,12,4,1010,1,0,15,13,2,1135,1,0,31,25,6,2145,2,0,0,0,0,0,0,0,0,0,0,0,0,0
2680,2680,Alireza Jahanbakhsh,2431,2019,Brighton & Hove Albion,6,1,5,177,2,0,4,2,2,131,0,0,10,3,7,308,2,0,1,0,1,2,0,2,0,0,0,0,0,0
2681,2681,Carlo Cudicini,2370,2007,Chelsea FC,6,6,0,540,0,0,4,4,0,360,0,0,10,10,0,900,0,0,0,0,0,0,0,0,0,0,0,0,0,0
2682,2682,Ashley Cole,1523,2007,Chelsea FC,12,12,0,1064,0,0,15,15,0,1350,1,0,27,27,0,2414,1,0,0,0,0,0,0,0,0,0,0,0,0,0
2683,2683,Ricardo Carvalho,1760,2007,Chelsea FC,11,11,0,929,1,0,10,10,0,830,0,0,21,21,0,1759,1,0,3,0,3,1,0,1,0,0,0,0,0,0
2684,2684,John Terry,1534,2007,Chelsea FC,11,11,0,869,0,0,12,12,0,1029,1,0,23,23,0,1898,1,0,0,3,3,0,1,1,0,0,0,0,0,0
2685,2685,Claude Makélélé,1762,2007,Chelsea FC,9,7,2,554,0,0,9,8,1,670,0,0,18,15,3,1224,0,0,0,0,0,0,0,0,0,0,0,0,0,0
2686,2686,Michael Essien,1763,2007,Chelsea FC,13,12,1,1076,4,0,14,11,3,1020,2,0,27,23,4,2096,6,0,3,3,6,4,2,6,0,0,0,0,0,0
2687,2687,Frank Lampard,1536,2007,Chelsea FC,11,11,0,907,6,0,13,12,1,1104,4,0,24,23,1,2011,10,0,3,1,4,2,4,6,2,2,4,0,0,0
2688,2688,Joe Cole,1630,2007,Chelsea FC,18,16,2,1409,3,0,15,12,3,1073,4,0,33,28,5,2482,7,0,3,3,6,1,2,3,0,0,0,0,0,0
2689,2689,Michael Ballack,2271,2007,Chelsea FC,11,10,1,882,4,0,7,6,1,531,3,0,18,16,2,1413,7,0,6,3,9,4,2,6,1,1,2,0,0,0
2690,2690,Didier Drogba,1766,2007,Chelsea FC,11,9,2,849,5,0,8,8,0,694,3,0,19,17,2,1543,8,0,3,3,6,3,3,6,0,0,0,0,0,0
2691,2691,Salomon Kalou,1770,2007,Chelsea FC,15,13,2,1178,3,0,15,11,4,956,4,0,30,24,6,2134,7,0,3,3,6,1,3,4,0,0,0,0,0,0
2692,2692,Belletti,2432,2007,Chelsea FC,14,11,3,1112,1,0,9,9,0,806,1,0,23,20,3,1918,2,0,0,0,0,1,0,1,0,0,0,0,0,0
2693,2693,John Mikel Obi,1769,2007,Chelsea FC,15,9,6,876,0,0,14,12,2,1129,0,0,29,21,8,2005,0,0,0,0,0,0,0,0,0,0,0,0,0,0
2694,2694,Nicolas Anelka,1720,2007,Chelsea FC,8,4,4,448,0,0,6,6,0,516,1,0,14,10,4,964,1,0,0,0,0,0,1,1,0,0,0,0,0,0
2695,2695,Manuel Almunia,2039,2007,Arsenal FC,15,15,0,1350,0,0,13,13,0,1170,0,0,28,28,0,2520,0,0,0,0,0,0,0,0,0,0,0,0,0,0
2696,2696,Bacary Sagna,1596,2007,Arsenal FC,13,13,0,1041,0,0,14,14,0,1241,1,0,27,27,0,2282,1,0,0,0,0,0,1,1,0,0,0,0,0,0
2697,2697,Kolo Touré,1415,2007,Arsenal FC,15,15,0,1300,2,0,15,14,1,1268,0,0,30,29,1,2568,2,0,1,0,1,2,0,2,0,0,0,0,0,0
2698,2698,William Gallas,2040,2007,Arsenal FC,14,14,0,1260,3,0,15,15,0,1284,1,0,29,29,0,2544,4,0,4,0,4,3,0,3,0,0,0,0,0,0
2699,2699,Cesc Fàbregas,1526,2007,Arsenal FC,16,16,0,1421,5,0,14,14,0,1259,2,0,30,30,0,2680,7,0,3,1,4,2,2,4,0,0,0,0,0,0
2700,2700,Aliaksandr Hleb,2433,2007,Arsenal FC,15,13,2,1118,1,0,14,14,0,1139,1,0,29,27,2,2257,2,0,3,0,3,1,0,1,0,0,0,0,0,0
2701,2701,Mathieu Flamini,1510,2007,Arsenal FC,15,15,0,1316,1,0,13,13,0,1168,2,0,28,28,0,2484,3,0,0,0,0,0,2,2,0,0,0,0,0,0
2702,2702,Robin van Persie,1528,2007,Arsenal FC,7,6,1,504,3,0,8,7,1,575,4,0,15,13,2,1079,7,0,3,3,6,3,4,7,1,1,2,0,0,0
2703,2703,Abou Diaby,2434,2007,Arsenal FC,8,4,4,314,1,0,7,5,2,460,0,0,15,9,6,774,1,0,0,0,0,1,0,1,0,0,0,0,0,0
2704,2704,Kasper Schmeichel,2435,2019,Leicester City,19,19,0,1710,0,0,19,19,0,1710,0,0,38,38,0,3420,0,0,0,0,0,0,0,0,0,0,0,0,0,0
2705,2705,Ben Chilwell,2436,2019,Leicester City,15,15,0,1306,1,0,12,12,0,1070,2,0,27,27,0,2376,3,0,0,0,0,1,2,3,0,0,0,0,0,0
2706,2706,Çağlar Söyüncü,2437,2019,Leicester City,17,17,0,1530,0,0,17,17,0,1530,1,0,34,34,0,3060,1,0,0,0,0,0,1,1,0,0,0,0,0,0
2707,2707,Jonny Evans,1216,2019,Leicester City,19,19,0,1710,0,0,19,19,0,1676,1,0,38,38,0,3386,1,0,0,0,0,0,0,0,0,0,0,0,0,0
2708,2708,Ricardo Pereira,2438,2019,Leicester City,15,15,0,1350,3,0,13,13,0,1170,0,0,28,28,0,2520,3,0,0,0,0,2,0,2,0,0,0,0,0,0
2709,2709,Youri Tielemans,2439,2019,Leicester City,19,16,3,1433,2,0,18,16,2,1401,1,0,37,32,5,2834,3,0,3,0,3,2,0,2,0,0,0,0,0,0
2710,2710,James Maddison,2440,2019,Leicester City,15,15,0,1315,3,0,16,14,2,1313,3,0,31,29,2,2628,6,0,3,0,3,1,1,2,0,0,0,0,0,0
2711,2711,Harvey Barnes,2441,2019,Leicester City,19,13,6,1151,4,0,17,11,6,940,2,0,36,24,12,2091,6,0,0,3,3,3,2,5,0,0,0,0,0,0
2712,2712,Wilfred Ndidi,2442,2019,Leicester City,16,15,1,1399,1,0,16,14,2,1275,1,0,32,29,3,2674,2,0,0,1,1,0,1,1,0,0,0,0,0,0
2713,2713,Jamie Vardy,2443,2019,Leicester City,19,18,1,1594,12,0,16,16,0,1440,11,0,35,34,1,3034,23,0,0,1,1,5,5,10,2,2,4,0,0,0
2714,2714,Ayoze Pérez,2288,2019,Leicester City,16,12,4,923,3,0,17,14,3,1097,5,0,33,26,7,2020,8,0,0,0,0,1,2,3,1,0,1,0,0,0
2715,2715,Marc Albrighton,1448,2019,Leicester City,8,4,4,388,0,0,12,5,7,475,0,0,20,9,11,863,0,0,0,0,0,0,0,0,0,0,0,0,0,0
2716,2716,Kelechi Iheanacho,1590,2019,Leicester City,10,6,4,452,2,0,10,6,4,510,3,0,20,12,8,962,5,0,3,0,3,2,1,3,0,0,0,0,0,0
2717,2717,Danny Ward,2444,2019,Leicester City,0,0,0,0,0,0,0,0,0,0,0,0,0,0,0,0,0,0,0,0,0,0,0,0,0,0,0,0,0,0
2718,2718,James Justin,2445,2019,Leicester City,6,5,1,460,0,0,7,6,1,550,0,0,13,11,2,1010,0,0,0,0,0,0,0,0,0,0,0,0,0,0
2719,2719,Wes Morgan,2446,2019,Leicester City,4,2,2,198,0,0,7,2,5,232,0,0,11,4,7,430,0,0,0,0,0,0,0,0,0,0,0,0,0,0
2720,2720,Hamza Choudhury,2447,2019,Leicester City,11,4,7,405,0,0,9,6,3,498,1,0,20,10,10,903,1,0,0,0,0,0,0,0,0,0,0,0,0,0
2721,2721,Dennis Praet,2448,2019,Leicester City,13,6,7,588,1,0,14,6,8,544,0,0,27,12,15,1132,1,0,0,0,0,1,0,1,0,0,0,0,0,0
2722,2722,Morgan Schneiderlin,1051,2019,Everton FC,6,6,0,462,0,0,9,6,3,556,0,0,15,12,3,1018,0,0,0,0,0,0,0,0,0,0,0,0,0,0
2723,2723,Jonas Lössl,2449,2019,Everton FC,0,0,0,0,0,0,0,0,0,0,0,0,0,0,0,0,0,0,0,0,0,0,0,0,0,0,0,0,0,0
2724,2724,Anthony Gordon,2450,2019,Everton FC,5,3,2,273,0,0,6,1,5,165,0,0,11,4,7,438,0,0,0,0,0,0,0,0,0,0,0,0,0,0
2725,2725,Tim Krul,1822,2013,Newcastle United,18,18,0,1620,0,0,18,18,0,1620,0,0,36,36,0,3240,0,0,0,0,0,0,0,0,0,0,0,0,0,0
2726,2726,Davide Santon,2451,2013,Newcastle United,14,14,0,1149,0,0,13,12,1,1074,0,0,27,26,1,2223,0,0,0,0,0,0,0,0,0,0,0,0,0,0
2727,2727,Mike Williamson,2287,2013,Newcastle United,16,16,0,1440,0,0,17,16,1,1471,0,0,33,32,1,2911,0,0,0,0,0,0,0,0,0,0,0,0,0,0
2728,2728,Mapou Yanga-Mbiwa,2452,2013,Newcastle United,9,9,0,787,0,0,14,8,6,762,0,0,23,17,6,1549,0,0,0,0,0,0,0,0,0,0,0,0,0,0
2729,2729,Mathieu Debuchy,2453,2013,Newcastle United,14,13,1,1235,0,0,15,15,0,1287,1,0,29,28,1,2522,1,0,0,0,0,0,1,1,0,0,0,0,0,0
2730,2730,Yohan Cabaye,1029,2013,Newcastle United,9,8,1,682,2,0,10,9,1,825,5,0,19,17,2,1507,7,0,0,3,3,1,3,4,0,0,0,0,0,0
2731,2731,Moussa Sissoko,1858,2013,Newcastle United,17,17,0,1472,1,0,18,18,0,1563,2,0,35,35,0,3035,3,0,3,0,3,1,1,2,0,0,0,0,0,0
2732,2732,Cheick Tioté,2289,2013,Newcastle United,15,14,1,1226,0,0,18,17,1,1538,0,0,33,31,2,2764,0,0,0,0,0,0,0,0,0,0,0,0,0,0
2733,2733,Yoan Gouffran,2454,2013,Newcastle United,18,15,3,1299,5,0,17,16,1,1324,1,0,35,31,4,2623,6,0,0,3,3,4,1,5,0,0,0,0,0,0
2734,2734,Loïc Rémy,2455,2013,Newcastle United,13,11,2,1050,8,0,13,13,0,1062,6,0,26,24,2,2112,14,0,3,3,6,5,2,7,0,0,0,0,0,0
2735,2735,Shola Ameobi,1950,2013,Newcastle United,13,9,4,746,2,0,10,5,5,477,0,0,23,14,9,1223,2,0,0,0,0,2,0,2,0,0,0,0,0,0
2736,2736,Vurnon Anita,2281,2013,Newcastle United,19,15,4,1299,0,0,15,13,2,1165,1,0,34,28,6,2464,1,0,0,0,0,0,0,0,0,0,0,0,0,0
2737,2737,Papiss Demba Cissé,2282,2013,Newcastle United,15,9,6,798,2,0,9,6,3,585,0,0,24,15,9,1383,2,0,3,0,3,1,0,1,0,0,0,0,0,0
2738,2738,Gabriel Obertan,2283,2013,Newcastle United,1,0,1,5,0,0,2,0,2,25,0,0,3,0,3,30,0,0,0,0,0,0,0,0,0,0,0,0,0,0
2739,2739,Rob Elliot,2456,2013,Newcastle United,1,1,0,90,0,0,1,1,0,90,0,0,2,2,0,180,0,0,0,0,0,0,0,0,0,0,0,0,0,0
2740,2740,Hatem Ben Arfa,2457,2013,Newcastle United,14,6,8,707,1,0,13,7,6,597,2,0,27,13,14,1304,3,0,3,0,3,1,1,2,0,1,1,0,0,0
2741,2741,James Tavernier,2458,2013,Newcastle United,0,0,0,0,0,0,0,0,0,0,0,0,0,0,0,0,0,0,0,0,0,0,0,0,0,0,0,0,0,0
2742,2742,Sammy Ameobi,2459,2013,Newcastle United,5,2,3,199,0,0,8,2,6,262,0,0,13,4,9,461,0,0,0,0,0,0,0,0,0,0,0,0,0,0
2743,2743,Ramires,2460,2013,Chelsea FC,14,13,1,1214,1,0,16,16,0,1395,0,0,30,29,1,2609,1,0,3,0,3,1,0,1,0,0,0,0,0,0
2744,2744,Samuel Eto'o,2243,2013,Chelsea FC,13,12,1,873,9,0,8,4,4,430,0,0,21,16,5,1303,9,0,3,0,3,7,0,7,0,0,0,0,0,0
2745,2745,John Mikel Obi,1769,2013,Chelsea FC,9,3,6,374,1,0,15,8,7,692,0,0,24,11,13,1066,1,0,0,0,0,0,0,0,0,0,0,0,0,0
2746,2746,Craig Short,1133,2002,Blackburn Rovers,13,13,0,1134,0,0,14,13,1,1153,1,0,27,26,1,2287,1,0,0,1,1,0,1,1,0,0,0,0,0,0
2747,2747,John Curtis,2461,2002,Blackburn Rovers,2,2,0,114,0,0,3,3,0,191,0,0,5,5,0,305,0,0,0,0,0,0,0,0,0,0,0,0,0,0
2748,2748,Damien Duff,1348,2002,Blackburn Rovers,13,13,0,1117,5,0,13,13,0,1135,4,0,26,26,0,2252,9,0,3,0,3,5,1,6,0,0,0,0,0,0
2749,2749,Sebastien Schemmel,1624,2002,West Ham United,9,8,1,747,0,0,5,5,0,431,0,0,14,13,1,1178,0,0,0,0,0,0,0,0,0,0,0,0,0,0
2750,2750,Gary Breen,2098,2002,West Ham United,5,4,1,381,0,0,9,5,4,479,0,0,14,9,5,860,0,0,0,0,0,0,0,0,0,0,0,0,0,0
2751,2751,Christian Dailly,1626,2002,West Ham United,11,10,1,904,0,0,12,10,2,913,0,0,23,20,3,1817,0,0,0,0,0,0,0,0,0,0,0,0,0,0
2752,2752,Édouard Cissé,2462,2002,West Ham United,8,5,3,457,0,0,13,9,4,736,1,0,21,14,7,1193,1,0,0,0,0,0,1,1,0,0,0,0,0,0
2753,2753,Scott Minto,2463,2002,West Ham United,4,3,1,297,0,0,7,5,2,447,0,0,11,8,3,744,0,0,0,0,0,0,0,0,0,0,0,0,0,0
2754,2754,John Moncur,2043,2002,West Ham United,2,0,2,19,0,0,5,0,5,47,0,0,7,0,7,66,0,0,0,0,0,0,0,0,0,0,0,0,0,0
2755,2755,Daniel Gabbidon,2464,2007,West Ham United,4,3,1,314,0,0,6,5,1,455,0,0,10,8,2,769,0,0,0,0,0,0,0,0,0,0,0,0,0,0
2756,2756,Matthew Upson,1279,2007,West Ham United,14,14,0,1260,1,0,14,14,0,1233,0,0,28,28,0,2493,1,0,3,0,3,1,0,1,0,0,0,0,0,0
2757,2757,Matthew Etherington,1557,2007,West Ham United,9,7,2,663,0,0,9,8,1,648,3,0,18,15,3,1311,3,0,0,0,0,0,0,0,0,0,0,0,0,0
2758,2758,Boa Morte,1085,2007,West Ham United,14,7,7,638,0,0,12,10,2,813,0,0,26,17,9,1451,0,0,0,0,0,0,0,0,0,0,0,0,0,0
2759,2759,Carlton Cole,2326,2007,West Ham United,15,10,5,863,3,0,15,11,4,994,1,0,30,21,9,1857,4,0,3,0,3,3,1,4,0,0,0,0,0,0
2760,2760,Paul Robinson,1262,2007,Tottenham Hotspur,12,12,0,1080,0,0,12,12,0,1080,0,0,24,24,0,2160,0,0,0,0,0,0,0,0,0,0,0,0,0,0
2761,2761,Pascal Chimbonda,1392,2007,Tottenham Hotspur,15,14,1,1243,2,0,16,16,0,1422,0,0,31,30,1,2665,2,0,0,0,0,1,0,1,0,0,0,0,0,0
2762,2762,Younès Kaboul,2408,2007,Tottenham Hotspur,8,8,0,604,1,0,12,10,2,913,2,0,20,18,2,1517,3,0,1,0,1,1,1,2,0,0,0,0,0,0
2763,2763,Gareth Bale,1274,2007,Tottenham Hotspur,3,3,0,234,1,0,5,5,0,379,1,0,8,8,0,613,2,0,0,0,0,1,0,1,0,0,0,0,0,0
2764,2764,Michael Dawson,1267,2007,Tottenham Hotspur,14,14,0,1188,0,0,13,12,1,1010,1,0,27,26,1,2198,1,0,0,1,1,0,1,1,0,0,0,0,0,0
2765,2765,Didier Zokora,2465,2007,Tottenham Hotspur,14,13,1,1158,0,0,14,12,2,1094,0,0,28,25,3,2252,0,0,0,0,0,0,0,0,0,0,0,0,0,0
2766,2766,Jermaine Jenas,1275,2007,Tottenham Hotspur,11,11,0,902,3,0,17,16,1,1484,1,0,28,27,1,2386,4,0,0,0,0,1,0,1,0,0,0,0,0,0
2767,2767,Steed Malbranque,1086,2007,Tottenham Hotspur,17,16,1,1279,4,0,19,18,1,1479,0,0,36,34,2,2758,4,0,1,0,1,3,0,3,0,0,0,0,0,0
2768,2768,Aaron Lennon,1052,2007,Tottenham Hotspur,15,13,2,1139,2,0,13,11,2,928,0,0,28,24,4,2067,2,0,0,0,0,1,0,1,0,0,0,0,0,0
2769,2769,Dimitar Berbatov,1397,2007,Tottenham Hotspur,17,17,0,1485,9,0,18,15,3,1416,6,0,35,32,3,2901,15,0,0,3,3,6,4,10,0,1,1,0,0,0
2770,2770,Robbie Keane,1126,2007,Tottenham Hotspur,17,16,1,1339,8,0,18,15,3,1330,7,0,35,31,4,2669,15,0,1,3,4,5,6,11,3,0,3,0,0,0
2771,2771,Jermain Defoe,1127,2007,Tottenham Hotspur,9,1,8,241,3,0,9,2,7,256,1,0,18,3,15,497,4,0,3,0,3,2,1,3,0,0,0,0,0,0
2772,2772,Darren Bent,1958,2007,Tottenham Hotspur,15,5,10,557,5,0,12,6,6,584,1,0,27,11,16,1141,6,0,0,0,0,2,1,3,0,0,0,0,0,0
2773,2773,Martin Dúbravka,2466,2019,Newcastle United,19,19,0,1710,0,0,19,19,0,1710,0,0,38,38,0,3420,0,0,0,0,0,0,0,0,0,0,0,0,0,0
2774,2774,Ciaran Clark,1437,2019,Newcastle United,7,7,0,586,1,0,7,7,0,603,1,0,14,14,0,1189,2,0,3,0,3,1,1,2,0,0,0,0,0,0
2775,2775,Paul Dummett,2467,2019,Newcastle United,7,6,1,610,0,0,9,8,1,619,0,0,16,14,2,1229,0,0,0,0,0,0,0,0,0,0,0,0,0,0
2776,2776,Jetro Willems,2468,2019,Newcastle United,11,10,1,800,1,0,8,8,0,698,1,0,19,18,1,1498,2,0,0,0,0,1,1,2,0,0,0,0,0,0
2777,2777,Federico Fernández,1697,2019,Newcastle United,16,15,1,1355,1,0,16,14,2,1263,1,0,32,29,3,2618,2,0,3,0,3,1,0,1,0,0,0,0,0,0
2778,2778,Manquillo,2469,2019,Newcastle United,12,11,1,957,0,0,9,7,2,642,0,0,21,18,3,1599,0,0,0,0,0,0,0,0,0,0,0,0,0,0
2779,2779,Jonjo Shelvey,1699,2019,Newcastle United,16,15,1,1248,3,0,10,10,0,876,3,0,26,25,1,2124,6,0,2,0,2,3,0,3,0,0,0,0,0,0
2780,2780,Isaac Hayden,2470,2019,Newcastle United,16,15,1,1260,1,0,13,11,2,1013,0,0,29,26,3,2273,1,0,3,0,3,1,0,1,0,0,0,0,0,0
2781,2781,Miguel Almirón,2471,2019,Newcastle United,19,19,0,1659,2,0,17,16,1,1375,2,0,36,35,1,3034,4,0,3,0,3,2,1,3,0,0,0,0,0,0
2782,2782,Joelinton,2472,2019,Newcastle United,19,17,2,1410,1,0,19,15,4,1288,1,0,38,32,6,2698,2,0,0,3,3,0,1,1,0,0,0,0,0,0
2783,2783,Allan Saint-Maximin,2473,2019,Newcastle United,15,12,3,1028,1,0,11,11,0,846,2,0,26,23,3,1874,3,0,0,3,3,1,2,3,0,0,0,0,0,0
2784,2784,Fabian Schär,2474,2019,Newcastle United,10,8,2,764,2,0,12,10,2,907,0,0,22,18,4,1671,2,0,1,0,1,2,0,2,0,0,0,0,0,0
2785,2785,Sean Longstaff,2475,2019,Newcastle United,11,4,7,510,0,0,12,10,2,870,1,0,23,14,9,1380,1,0,0,0,0,0,0,0,0,0,0,0,0,0
2786,2786,Andy Carroll,1779,2019,Newcastle United,10,2,8,326,0,0,9,2,7,292,0,0,19,4,15,618,0,0,0,0,0,0,0,0,0,0,0,0,0,0
2787,2787,Karl Darlow,2286,2019,Newcastle United,0,0,0,0,0,0,0,0,0,0,0,0,0,0,0,0,0,0,0,0,0,0,0,0,0,0,0,0,0,0
2788,2788,Emil Krafth,2476,2019,Newcastle United,6,4,2,375,0,0,11,7,4,644,0,0,17,11,6,1019,0,0,0,0,0,0,0,0,0,0,0,0,0,0
2789,2789,Dwight Gayle,2477,2019,Newcastle United,9,4,5,373,2,0,11,6,5,476,2,0,20,10,10,849,4,0,0,0,0,2,2,4,0,0,0,0,0,0
2790,2790,Christian Atsu,2244,2019,Newcastle United,7,2,5,207,0,0,12,4,8,534,0,0,19,6,13,741,0,0,0,0,0,0,0,0,0,0,0,0,0,0
2791,2791,Alex McCarthy,1032,2019,Southampton FC,14,14,0,1260,0,0,14,14,0,1260,0,0,28,28,0,2520,0,0,0,0,0,0,0,0,0,0,0,0,0,0
2792,2792,Cédric Soares,1910,2019,Southampton FC,9,9,0,749,0,0,7,7,0,561,0,0,16,16,0,1310,0,0,0,0,0,0,0,0,0,0,0,0,0,0
2793,2793,Jack Stephens,2329,2019,Southampton FC,14,13,1,1214,0,0,14,14,0,1243,1,0,28,27,1,2457,1,0,0,0,0,0,0,0,0,0,0,0,0,0
2794,2794,Ryan Bertrand,1148,2019,Southampton FC,16,15,1,1381,1,0,16,16,0,1440,0,0,32,31,1,2821,1,0,0,0,0,0,0,0,0,0,0,0,0,0
2795,2795,Jan Bednarek,2478,2019,Southampton FC,17,17,0,1530,1,0,17,17,0,1528,0,0,34,34,0,3058,1,0,0,0,0,1,0,1,0,0,0,0,0,0
2796,2796,James Ward-Prowse,1150,2019,Southampton FC,19,19,0,1710,2,0,19,19,0,1710,3,0,38,38,0,3420,5,0,3,0,3,1,2,3,1,0,1,0,0,0
2797,2797,Nathan Redmond,1244,2019,Southampton FC,15,15,0,1241,0,0,17,17,0,1529,4,0,32,32,0,2770,4,0,0,0,0,0,1,1,0,0,0,0,0,0
2798,2798,Pierre-Emile Højbjerg,1248,2019,Southampton FC,16,16,0,1440,0,0,17,14,3,1310,0,0,33,30,3,2750,0,0,0,0,0,0,0,0,0,0,0,0,0,0
2799,2799,Shane Long,1154,2019,Southampton FC,13,7,6,711,2,0,13,8,5,687,0,0,26,15,11,1398,2,0,0,0,0,1,0,1,0,0,0,0,0,0
2800,2800,Danny Ings,1193,2019,Southampton FC,19,17,2,1459,10,0,19,15,4,1356,12,0,38,32,6,2815,22,0,5,3,8,7,10,17,1,0,1,0,0,0
2801,2801,Moussa Djénépo,2479,2019,Southampton FC,11,7,4,690,0,0,7,3,4,298,2,0,18,10,8,988,2,0,0,3,3,0,2,2,0,0,0,0,0,0
2802,2802,Sofiane Boufal,1912,2019,Southampton FC,9,5,4,451,0,0,11,3,8,308,0,0,20,8,12,759,0,0,0,0,0,0,0,0,0,0,0,0,0,0
2803,2803,Che Adams,2480,2019,Southampton FC,15,6,9,556,3,0,15,6,9,549,1,0,30,12,18,1105,4,0,3,0,3,3,0,3,0,0,0,0,0,0
2804,2804,Angus Gunn,2159,2019,Southampton FC,5,5,0,450,0,0,5,5,0,450,0,0,10,10,0,900,0,0,0,0,0,0,0,0,0,0,0,0,0,0
2805,2805,Maya Yoshida,1145,2019,Southampton FC,5,3,2,288,0,0,3,3,0,270,0,0,8,6,2,558,0,0,0,0,0,0,0,0,0,0,0,0,0,0
2806,2806,Jannik Vestergaard,2156,2019,Southampton FC,9,8,1,677,1,0,10,9,1,821,0,0,19,17,2,1498,1,0,1,0,1,1,0,1,0,0,0,0,0,0
2807,2807,Oriol Romeu,1243,2019,Southampton FC,14,9,5,814,0,0,16,11,5,1046,0,0,30,20,10,1860,0,0,0,0,0,0,0,0,0,0,0,0,0,0
2808,2808,Michael Obafemi,2328,2019,Southampton FC,10,3,7,221,0,0,11,5,6,442,3,0,21,8,13,663,3,0,0,1,1,0,3,3,0,0,0,0,0,0
2809,2809,Sebastian Prödl,2366,2018,Watford FC,0,0,0,0,0,0,1,0,1,15,0,0,1,0,1,15,0,0,0,0,0,0,0,0,0,0,0,0,0,0
2810,2810,Mathew Ryan,2415,2018,Brighton & Hove Albion,17,17,0,1530,0,0,17,17,0,1530,0,0,34,34,0,3060,0,0,0,0,0,0,0,0,0,0,0,0,0,0
2811,2811,Bruno,2481,2018,Brighton & Hove Albion,6,6,0,534,0,0,8,8,0,602,0,0,14,14,0,1136,0,0,0,0,0,0,0,0,0,0,0,0,0,0
2812,2812,Shane Duffy,2429,2018,Brighton & Hove Albion,18,18,0,1620,2,0,17,17,0,1530,3,0,35,35,0,3150,5,0,0,0,0,0,1,1,0,0,0,0,0,0
2813,2813,Lewis Dunk,2416,2018,Brighton & Hove Albion,18,18,0,1550,0,0,18,18,0,1620,2,0,36,36,0,3170,2,0,0,0,0,0,2,2,0,0,0,0,0,0
2814,2814,Bernardo,2419,2018,Brighton & Hove Albion,11,11,0,990,0,0,11,8,3,760,0,0,22,19,3,1750,0,0,0,0,0,0,0,0,0,0,0,0,0,0
2815,2815,Dale Stephens,2421,2018,Brighton & Hove Albion,14,14,0,1191,0,0,16,15,1,1352,1,0,30,29,1,2543,1,0,0,0,0,0,1,1,0,0,0,0,0,0
2816,2816,Pascal Groß,2426,2018,Brighton & Hove Albion,13,13,0,993,2,0,12,11,1,885,1,0,25,24,1,1878,3,0,1,0,1,1,0,1,1,0,1,0,0,0
2817,2817,Solly March,2422,2018,Brighton & Hove Albion,16,13,3,1153,1,0,19,17,2,1319,0,0,35,30,5,2472,1,0,0,0,0,0,0,0,0,0,0,0,0,0
2818,2818,Davy Pröpper,2423,2018,Brighton & Hove Albion,16,16,0,1371,0,0,14,14,0,1180,1,0,30,30,0,2551,1,0,0,0,0,0,0,0,0,0,0,0,0,0
2819,2819,Anthony Knockaert,2482,2018,Brighton & Hove Albion,16,10,6,1004,1,0,14,8,6,851,1,0,30,18,12,1855,2,0,0,3,3,0,1,1,0,0,0,0,0,0
2820,2820,Glenn Murray,1010,2018,Brighton & Hove Albion,19,17,2,1384,8,0,19,13,6,1130,5,0,38,30,8,2514,13,0,7,2,9,7,4,11,2,2,4,0,0,0
2821,2821,Gaëtan Bong,2483,2018,Brighton & Hove Albion,8,8,0,720,0,0,14,11,3,1085,0,0,22,19,3,1805,0,0,0,0,0,0,0,0,0,0,0,0,0,0
2822,2822,Yves Bissouma,2484,2018,Brighton & Hove Albion,13,7,6,747,0,0,15,10,5,1022,0,0,28,17,11,1769,0,0,0,0,0,0,0,0,0,0,0,0,0,0
2823,2823,Alireza Jahanbakhsh,2431,2018,Brighton & Hove Albion,9,6,3,494,0,0,10,6,4,528,0,0,19,12,7,1022,0,0,0,0,0,0,0,0,0,0,0,0,0,0
2824,2824,David Button,2428,2018,Brighton & Hove Albion,2,2,0,180,0,0,2,2,0,180,0,0,4,4,0,360,0,0,0,0,0,0,0,0,0,0,0,0,0,0
2825,2825,Leon Balogun,2485,2018,Brighton & Hove Albion,4,2,2,309,1,0,4,3,1,282,0,0,8,5,3,591,1,0,0,0,0,0,0,0,0,0,0,0,0,0
2826,2826,Beram Kayal,2486,2018,Brighton & Hove Albion,9,5,4,495,0,0,9,4,5,441,1,0,18,9,9,936,1,0,0,3,3,0,1,1,0,0,0,0,0,0
2827,2827,Jürgen Locadia,2487,2018,Brighton & Hove Albion,14,6,8,591,2,0,12,6,6,638,0,0,26,12,14,1229,2,0,4,0,4,2,0,2,0,0,0,0,0,0
2828,2828,Ádám Bogdán,2488,2011,Bolton Wanderers,10,10,0,900,0,0,10,10,0,900,0,0,20,20,0,1800,0,0,0,0,0,0,0,0,0,0,0,0,0,0
2829,2829,Sam Ricketts,2489,2011,Bolton Wanderers,10,10,0,900,1,0,10,10,0,900,0,0,20,20,0,1800,1,0,0,0,0,1,0,1,0,0,0,0,0,0
2830,2830,Dedryck Boyata,1679,2011,Bolton Wanderers,8,8,0,683,1,0,6,5,1,440,0,0,14,13,1,1123,1,0,0,0,0,0,0,0,0,0,0,0,0,0
2831,2831,David Wheater,2218,2011,Bolton Wanderers,12,12,0,1036,2,0,12,12,0,1080,0,0,24,24,0,2116,2,0,0,0,0,1,0,1,0,0,0,0,0,0
2832,2832,Tim Ream,2490,2011,Bolton Wanderers,6,6,0,540,0,0,7,7,0,630,0,0,13,13,0,1170,0,0,0,0,0,0,0,0,0,0,0,0,0,0
2833,2833,Chris Eagles,2491,2011,Bolton Wanderers,17,12,5,1146,3,0,17,14,3,1153,1,0,34,26,8,2299,4,0,1,0,1,1,0,1,0,0,0,0,0,0
2834,2834,Martin Petrov,2492,2011,Bolton Wanderers,16,16,0,1335,2,0,15,14,1,1239,2,0,31,30,1,2574,4,0,0,0,0,1,2,3,2,2,4,0,0,0
2835,2835,Mark Davies,2493,2011,Bolton Wanderers,17,15,2,1396,2,0,18,14,4,1353,2,0,35,29,6,2749,4,0,0,0,0,2,2,4,0,0,0,0,0,0
2836,2836,Nigel Reo-Coker,2494,2011,Bolton Wanderers,18,18,0,1574,2,0,19,19,0,1691,2,0,37,37,0,3265,4,0,0,0,0,1,1,2,0,0,0,0,0,0
2837,2837,Kevin Davies,1718,2011,Bolton Wanderers,17,12,5,1007,2,0,14,9,5,861,4,0,31,21,10,1868,6,0,0,1,1,1,3,4,0,1,1,0,0,0
2838,2838,David N'Gog,1895,2011,Bolton Wanderers,16,12,4,1050,0,0,17,12,5,995,3,0,33,24,9,2045,3,0,0,3,3,0,3,3,0,0,0,0,0,0
2839,2839,Joshua Vela,2495,2011,Bolton Wanderers,2,0,2,26,0,0,1,0,1,12,0,0,3,0,3,38,0,0,0,0,0,0,0,0,0,0,0,0,0,0
2840,2840,Ivan Klasnić,2496,2011,Bolton Wanderers,16,8,8,821,5,0,13,8,5,721,3,0,29,16,13,1542,8,0,3,0,3,1,1,2,0,1,1,0,0,0
2841,2841,Ryo Miyaichi,2497,2011,Bolton Wanderers,6,4,2,342,0,0,6,4,2,340,0,0,12,8,4,682,0,0,0,0,0,0,0,0,0,0,0,0,0,0
2842,2842,Jussi Jääskeläinen,1710,2011,Bolton Wanderers,9,9,0,810,0,0,9,9,0,810,0,0,18,18,0,1620,0,0,0,0,0,0,0,0,0,0,0,0,0,0
2843,2843,Marcos Alonso,1846,2011,Bolton Wanderers,1,1,0,90,0,0,4,3,1,242,1,0,5,4,1,332,1,0,0,0,0,0,1,1,0,0,0,0,0,0
2844,2844,Zat Knight,1755,2011,Bolton Wanderers,13,10,3,989,0,0,12,11,1,991,0,0,25,21,4,1980,0,0,0,0,0,0,0,0,0,0,0,0,0,0
2845,2845,Marvin Sordell,2498,2011,Bolton Wanderers,0,0,0,0,0,0,3,0,3,40,0,0,3,0,3,40,0,0,0,0,0,0,0,0,0,0,0,0,0,0
2846,2846,Brad Friedel,1343,2011,Tottenham Hotspur,19,19,0,1710,0,0,19,19,0,1710,0,0,38,38,0,3420,0,0,0,0,0,0,0,0,0,0,0,0,0,0
2847,2847,Younès Kaboul,2408,2011,Tottenham Hotspur,16,16,0,1381,1,0,17,17,0,1530,0,0,33,33,0,2911,1,0,0,0,0,0,0,0,0,0,0,0,0,0
2848,2848,William Gallas,2040,2011,Tottenham Hotspur,7,7,0,607,0,0,8,8,0,717,0,0,15,15,0,1324,0,0,0,0,0,0,0,0,0,0,0,0,0,0
2849,2849,Danny Rose,1399,2011,Tottenham Hotspur,5,1,4,109,0,0,6,2,4,245,0,0,11,3,8,354,0,0,0,0,0,0,0,0,0,0,0,0,0,0
2850,2850,Kyle Walker,1196,2011,Tottenham Hotspur,18,18,0,1565,2,0,19,19,0,1666,0,0,37,37,0,3231,2,0,3,0,3,1,0,1,0,0,0,0,0,0
2851,2851,Gareth Bale,1274,2011,Tottenham Hotspur,17,17,0,1507,5,0,19,19,0,1710,5,0,36,36,0,3217,10,0,0,0,0,3,3,6,0,0,0,0,0,0
2852,2852,Aaron Lennon,1052,2011,Tottenham Hotspur,13,11,2,875,2,0,10,8,2,705,1,0,23,19,4,1580,3,0,0,0,0,1,0,1,0,0,0,0,0,0
2853,2853,Rafael van der Vaart,2405,2011,Tottenham Hotspur,17,14,3,1151,5,0,16,14,2,1180,6,0,33,28,5,2331,11,0,1,3,4,4,6,10,0,1,1,0,0,0
2854,2854,Luka Modrić,1272,2011,Tottenham Hotspur,19,19,0,1684,3,0,17,17,0,1530,1,0,36,36,0,3214,4,0,1,0,1,2,1,3,0,0,0,0,0,0
2855,2855,Sandro,2409,2011,Tottenham Hotspur,11,7,4,576,0,0,12,10,2,843,0,0,23,17,6,1419,0,0,0,0,0,0,0,0,0,0,0,0,0,0
2856,2856,Emmanuel Adebayor,1235,2011,Tottenham Hotspur,17,16,1,1463,9,0,16,16,0,1371,8,0,33,32,1,2834,17,0,0,1,1,4,3,7,0,3,3,0,0,0
2857,2857,Ryan Nelsen,2007,2011,Tottenham Hotspur,4,0,4,107,0,0,1,0,1,3,0,0,5,0,5,110,0,0,0,0,0,0,0,0,0,0,0,0,0,0
2858,2858,Jake Livermore,1657,2011,Tottenham Hotspur,12,4,8,514,0,0,12,3,9,342,0,0,24,7,17,856,0,0,0,0,0,0,0,0,0,0,0,0,0,0
2859,2859,Carlo Cudicini,2370,2011,Tottenham Hotspur,0,0,0,0,0,0,0,0,0,0,0,0,0,0,0,0,0,0,0,0,0,0,0,0,0,0,0,0,0,0
2860,2860,Ledley King,1119,2011,Tottenham Hotspur,11,11,0,962,0,0,10,10,0,833,0,0,21,21,0,1795,0,0,0,0,0,0,0,0,0,0,0,0,0,0
2861,2861,Giovani dos Santos,2499,2011,Tottenham Hotspur,3,0,3,30,0,0,4,0,4,21,0,0,7,0,7,51,0,0,0,0,0,0,0,0,0,0,0,0,0,0
2862,2862,Jermain Defoe,1127,2011,Tottenham Hotspur,13,5,8,625,6,0,12,6,6,660,5,0,25,11,14,1285,11,0,3,0,3,2,2,4,0,0,0,0,0,0
2863,2863,Thomas Sørensen,1090,2009,Stoke City,17,17,0,1481,0,0,16,16,0,1386,0,0,33,33,0,2867,0,0,0,0,0,0,0,0,0,0,0,0,0,0
2864,2864,Danny Higginbotham,1990,2009,Stoke City,12,12,0,1036,1,0,12,11,1,967,0,0,24,23,1,2003,1,0,0,0,0,1,0,1,0,0,0,0,0,0
2865,2865,Robert Huth,1884,2009,Stoke City,17,16,1,1441,1,0,15,14,1,1302,2,0,32,30,2,2743,3,0,1,0,1,1,2,3,0,0,0,0,0,0
2866,2866,Danny Collins,1215,2009,Stoke City,11,9,2,884,0,0,14,13,1,1194,0,0,25,22,3,2078,0,0,0,0,0,0,0,0,0,0,0,0,0,0
2867,2867,Abdoulaye Faye,1714,2009,Stoke City,15,15,0,1256,2,0,14,13,1,989,0,0,29,28,1,2245,2,0,0,0,0,1,0,1,0,0,0,0,0,0
2868,2868,Glenn Whelan,1549,2009,Stoke City,16,11,5,1046,1,0,17,14,3,1309,1,0,33,25,8,2355,2,0,0,3,3,1,1,2,0,0,0,0,0,0
2869,2869,Dean Whitehead,1218,2009,Stoke City,19,17,2,1528,0,0,17,16,1,1411,0,0,36,33,3,2939,0,0,0,0,0,0,0,0,0,0,0,0,0,0
2870,2870,Rory Delap,1993,2009,Stoke City,19,19,0,1584,0,0,17,15,2,1299,0,0,36,34,2,2883,0,0,0,0,0,0,0,0,0,0,0,0,0,0
2871,2871,Matthew Etherington,1557,2009,Stoke City,16,15,1,1339,3,0,18,18,0,1554,2,0,34,33,1,2893,5,0,0,3,3,1,2,3,1,0,1,0,0,0
2872,2872,Mamady Sidibe,1994,2009,Stoke City,12,7,5,630,2,0,12,12,0,897,0,0,24,19,5,1527,2,0,0,0,0,0,0,0,0,0,0,0,0,0
2873,2873,Tuncay Şanlı,2220,2009,Stoke City,16,6,10,586,2,0,14,7,7,700,2,0,30,13,17,1286,4,0,0,1,1,2,2,4,0,0,0,0,0,0
2874,2874,Ricardo Fuller,2500,2009,Stoke City,18,12,6,1187,2,0,17,10,7,1053,1,0,35,22,13,2240,3,0,3,3,6,2,1,3,0,0,0,0,0,0
2875,2875,Dave Kitson,1995,2009,Stoke City,9,6,3,546,2,0,9,4,5,390,1,0,18,10,8,936,3,0,3,0,3,2,1,3,0,0,0,0,0,0
2876,2876,Maik Taylor,2501,2007,Birmingham City,16,16,0,1440,0,0,18,18,0,1620,0,0,34,34,0,3060,0,0,0,0,0,0,0,0,0,0,0,0,0,0
2877,2877,David Murphy,2135,2007,Birmingham City,8,8,0,720,1,0,6,6,0,540,0,0,14,14,0,1260,1,0,0,0,0,1,0,1,0,0,0,0,0,0
2878,2878,Radhi Jaïdi,2502,2007,Birmingham City,9,9,0,810,0,0,9,9,0,810,0,0,18,18,0,1620,0,0,0,0,0,0,0,0,0,0,0,0,0,0
2879,2879,Damien Johnson,2503,2007,Birmingham City,10,10,0,839,0,0,7,7,0,630,0,0,17,17,0,1469,0,0,0,0,0,0,0,0,0,0,0,0,0,0
2880,2880,James McFadden,1413,2007,Birmingham City,7,6,1,534,3,0,5,4,1,389,1,0,12,10,2,923,4,0,1,1,2,3,1,4,1,1,2,0,0,0
2881,2881,Mauro Zárate,2504,2007,Birmingham City,8,2,6,252,3,0,6,4,2,354,1,0,14,6,8,606,4,0,1,0,1,2,1,3,0,0,0,0,0,0
2882,2882,Alan Hutton,2172,2007,Tottenham Hotspur,8,8,0,676,0,0,6,6,0,540,0,0,14,14,0,1216,0,0,0,0,0,0,0,0,0,0,0,0,0,0
2883,2883,Teemu Tainio,1395,2007,Tottenham Hotspur,8,1,7,212,0,0,7,5,2,427,0,0,15,6,9,639,0,0,0,0,0,0,0,0,0,0,0,0,0,0
2884,2884,Tom Huddlestone,1270,2007,Tottenham Hotspur,15,10,5,1106,3,0,12,7,5,739,0,0,27,17,10,1845,3,0,0,0,0,1,0,1,0,0,0,0,0,0
2885,2885,Jamie O'Hara,2505,2007,Tottenham Hotspur,7,4,3,315,1,0,10,5,5,578,0,0,17,9,8,893,1,0,0,0,0,0,0,0,0,0,0,0,0,0
2886,2886,Chris Gunter,2506,2007,Tottenham Hotspur,0,0,0,0,0,0,2,1,1,79,0,0,2,1,1,79,0,0,0,0,0,0,0,0,0,0,0,0,0,0
2887,2887,Ezequiel Schelotto,2507,2019,Brighton & Hove Albion,5,2,3,185,0,0,3,2,1,176,0,0,8,4,4,361,0,0,0,0,0,0,0,0,0,0,0,0,0,0
2888,2888,Yves Bissouma,2484,2019,Brighton & Hove Albion,11,7,4,636,0,0,11,8,3,627,1,0,22,15,7,1263,1,0,0,0,0,0,1,1,0,0,0,0,0,0
2889,2889,Alexis Mac Allister,2508,2019,Brighton & Hove Albion,4,2,2,185,0,0,5,2,3,167,0,0,9,4,5,352,0,0,0,0,0,0,0,0,0,0,0,0,0,0
2890,2890,Tariq Lamptey,2509,2019,Brighton & Hove Albion,4,3,1,253,0,0,4,4,0,338,0,0,8,7,1,591,0,0,0,0,0,0,0,0,0,0,0,0,0,0
2891,2891,Héctor Bellerín,1499,2019,Arsenal FC,7,6,1,521,0,0,8,7,1,638,1,0,15,13,2,1159,1,0,0,1,1,0,1,1,0,0,0,0,0,0
2892,2892,Rob Holding,2510,2019,Arsenal FC,3,2,1,224,0,0,5,4,1,356,0,0,8,6,2,580,0,0,0,0,0,0,0,0,0,0,0,0,0,0
2893,2893,Dani Ceballos,2511,2019,Arsenal FC,13,11,2,960,0,0,11,7,4,738,0,0,24,18,6,1698,0,0,0,0,0,0,0,0,0,0,0,0,0,0
2894,2894,Eddie Nketiah,2512,2019,Arsenal FC,7,3,4,316,1,0,6,4,2,332,1,0,13,7,6,648,2,0,0,0,0,1,1,2,0,0,0,0,0,0
2895,2895,Zech Medley,2513,2019,Arsenal FC,0,0,0,0,0,0,0,0,0,0,0,0,0,0,0,0,0,0,0,0,0,0,0,0,0,0,0,0,0,0
2896,2896,Kasper Schmeichel,2435,2014,Leicester City,13,13,0,1170,0,0,11,11,0,990,0,0,24,24,0,2160,0,0,0,0,0,0,0,0,0,0,0,0,0,0
2897,2897,Ritchie De Laet,2514,2014,Leicester City,13,9,4,961,0,0,13,11,2,922,0,0,26,20,6,1883,0,0,0,0,0,0,0,0,0,0,0,0,0,0
2898,2898,Paul Konchesky,1560,2014,Leicester City,13,13,0,1153,1,0,13,13,0,1108,0,0,26,26,0,2261,1,0,3,0,3,1,0,1,0,0,0,0,0,0
2899,2899,Wes Morgan,2446,2014,Leicester City,19,19,0,1704,1,0,18,18,0,1610,1,0,37,37,0,3314,2,0,0,0,0,0,1,1,0,0,0,0,0,0
2900,2900,Jeffrey Schlupp,2252,2014,Leicester City,16,14,2,1191,1,0,16,16,0,1347,2,0,32,30,2,2538,3,0,0,1,1,1,2,3,0,0,0,0,0,0
2901,2901,Marcin Wasilewski,2515,2014,Leicester City,13,13,0,1060,0,0,12,9,3,929,1,0,25,22,3,1989,1,0,0,0,0,0,0,0,0,0,0,0,0,0
2902,2902,Matty James,2516,2014,Leicester City,13,9,4,875,0,0,14,11,3,1015,0,0,27,20,7,1890,0,0,0,0,0,0,0,0,0,0,0,0,0,0
2903,2903,Esteban Cambiasso,2517,2014,Leicester City,13,13,0,1121,3,0,18,14,4,1300,2,0,31,27,4,2421,5,0,0,0,0,2,2,4,0,0,0,0,0,0
2904,2904,Riyad Mahrez,1842,2014,Leicester City,15,13,2,1117,3,0,15,12,3,967,1,0,30,25,5,2084,4,0,0,3,3,2,1,3,0,0,0,0,0,0
2905,2905,Jamie Vardy,2443,2014,Leicester City,18,14,4,1192,2,0,16,12,4,1055,3,0,34,26,8,2247,5,0,0,6,6,2,2,4,0,0,0,0,0,0
2906,2906,Leonardo Ulloa,2518,2014,Leicester City,19,15,4,1310,9,0,18,14,4,1097,2,0,37,29,8,2407,11,0,1,3,4,5,2,7,2,0,2,0,0,0
2907,2907,Anthony Knockaert,2482,2014,Leicester City,7,3,4,291,0,0,2,0,2,40,0,0,9,3,6,331,0,0,0,0,0,0,0,0,0,0,0,0,0,0
2908,2908,David Nugent,2519,2014,Leicester City,13,9,4,791,1,0,16,7,9,913,4,0,29,16,13,1704,5,0,0,0,0,0,2,2,1,0,1,0,0,0
2909,2909,Chris Wood,2348,2014,Leicester City,3,0,3,23,1,0,4,0,4,85,0,0,7,0,7,108,1,0,1,0,1,1,0,1,0,0,0,0,0,0
2910,2910,Ben Hamer,2520,2014,Leicester City,4,4,0,360,0,0,4,4,0,360,0,0,8,8,0,720,0,0,0,0,0,0,0,0,0,0,0,0,0,0
2911,2911,Liam Moore,2521,2014,Leicester City,4,4,0,360,0,0,7,6,1,576,0,0,11,10,1,936,0,0,0,0,0,0,0,0,0,0,0,0,0,0
2912,2912,Danny Drinkwater,2522,2014,Leicester City,12,8,4,769,0,0,11,8,3,718,0,0,23,16,7,1487,0,0,0,0,0,0,0,0,0,0,0,0,0,0
2913,2913,Andy King,2523,2014,Leicester City,12,9,3,740,2,0,12,7,5,633,0,0,24,16,8,1373,2,0,3,0,3,1,0,1,0,0,0,0,0,0
2914,2914,Costel Pantilimon,1354,2014,Sunderland AFC,14,14,0,1260,0,0,14,14,0,1260,0,0,28,28,0,2520,0,0,0,0,0,0,0,0,0,0,0,0,0,0
2915,2915,Wes Brown,1108,2014,Sunderland AFC,10,9,1,837,0,0,15,14,1,1182,0,0,25,23,2,2019,0,0,0,0,0,0,0,0,0,0,0,0,0,0
2916,2916,Anthony Réveillère,2524,2014,Sunderland AFC,9,8,1,697,0,0,7,7,0,630,0,0,16,15,1,1327,0,0,0,0,0,0,0,0,0,0,0,0,0,0
2917,2917,John O'Shea,1729,2014,Sunderland AFC,19,19,0,1651,0,0,18,18,0,1620,0,0,37,37,0,3271,0,0,0,0,0,0,0,0,0,0,0,0,0,0
2918,2918,Santiago Vergini,2262,2014,Sunderland AFC,17,16,1,1491,0,0,14,12,2,1132,0,0,31,28,3,2623,0,0,0,0,0,0,0,0,0,0,0,0,0,0
2919,2919,Lee Cattermole,1687,2014,Sunderland AFC,14,14,0,1235,0,0,14,12,2,1123,1,0,28,26,2,2358,1,0,0,0,0,0,1,1,0,0,0,0,0,0
2920,2920,Sebastian Larsson,1402,2014,Sunderland AFC,18,18,0,1568,1,0,18,18,0,1493,2,0,36,36,0,3061,3,0,0,1,1,1,2,3,0,0,0,0,0,0
2921,2921,Adam Johnson,1405,2014,Sunderland AFC,16,11,5,1005,2,0,16,12,4,1077,2,0,32,23,9,2082,4,0,0,3,3,2,2,4,0,1,1,0,0,0
2922,2922,Jordi Gómez,2059,2014,Sunderland AFC,15,10,5,883,3,0,14,12,2,1060,1,0,29,22,7,1943,4,0,3,0,3,3,1,4,3,0,3,0,0,0
2923,2923,Steven Fletcher,1408,2014,Sunderland AFC,16,10,6,872,2,0,14,10,4,910,3,0,30,20,10,1782,5,0,0,0,0,1,2,3,0,0,0,0,0,0
2924,2924,Connor Wickham,1035,2014,Sunderland AFC,18,15,3,1385,4,0,18,16,2,1387,1,0,36,31,5,2772,5,0,0,0,0,3,1,4,0,0,0,0,0,0
2925,2925,Liam Bridcutt,2264,2014,Sunderland AFC,9,6,3,565,0,0,9,4,5,382,0,0,18,10,8,947,0,0,0,0,0,0,0,0,0,0,0,0,0,0
2926,2926,Will Buckley,2525,2014,Sunderland AFC,9,5,4,479,0,0,13,4,9,390,0,0,22,9,13,869,0,0,0,0,0,0,0,0,0,0,0,0,0,0
2927,2927,Vito Mannone,2261,2014,Sunderland AFC,5,5,0,450,0,0,5,5,0,450,0,0,10,10,0,900,0,0,0,0,0,0,0,0,0,0,0,0,0,0
2928,2928,Sebastián Coates,2526,2014,Sunderland AFC,4,4,0,360,0,0,6,5,1,462,0,0,10,9,1,822,0,0,0,0,0,0,0,0,0,0,0,0,0,0
2929,2929,Tom Robson,2527,2014,Sunderland AFC,0,0,0,0,0,0,0,0,0,0,0,0,0,0,0,0,0,0,0,0,0,0,0,0,0,0,0,0,0,0
2930,2930,Jack Rodwell,1748,2014,Sunderland AFC,11,8,3,642,1,0,12,9,3,842,2,0,23,17,6,1484,3,0,1,1,2,1,1,2,0,0,0,0,0,0
2931,2931,Jozy Altidore,1615,2014,Sunderland AFC,6,1,5,182,0,0,5,1,4,122,0,0,11,2,9,304,0,0,0,0,0,0,0,0,0,0,0,0,0,0
2932,2932,Gomes,1266,2010,Tottenham Hotspur,16,16,0,1440,0,0,14,14,0,1260,0,0,30,30,0,2700,0,0,0,0,0,0,0,0,0,0,0,0,0,0
2933,2933,Benoît Assou-Ekotto,1269,2010,Tottenham Hotspur,17,17,0,1402,0,0,13,13,0,1170,0,0,30,30,0,2572,0,0,0,0,0,0,0,0,0,0,0,0,0,0
2934,2934,Wilson Palacios,1271,2010,Tottenham Hotspur,10,8,2,625,0,0,11,8,3,604,0,0,21,16,5,1229,0,0,0,0,0,0,0,0,0,0,0,0,0,0
2935,2935,Roman Pavlyuchenko,2528,2010,Tottenham Hotspur,17,10,7,891,6,0,12,8,4,710,4,0,29,18,11,1601,10,0,3,0,3,5,2,7,0,0,0,0,0,0
2936,2936,Jussi Jääskeläinen,1710,2010,Bolton Wanderers,19,19,0,1710,0,0,16,16,0,1440,0,0,35,35,0,3150,0,0,0,0,0,0,0,0,0,0,0,0,0,0
2937,2937,Paul Robinson,1262,2010,Bolton Wanderers,18,18,0,1620,0,0,17,17,0,1530,0,0,35,35,0,3150,0,0,0,0,0,0,0,0,0,0,0,0,0,0
2938,2938,Gary Cahill,1533,2010,Bolton Wanderers,18,18,0,1620,3,0,18,18,0,1620,0,0,36,36,0,3240,3,0,0,0,0,3,0,3,0,0,0,0,0,0
2939,2939,Zat Knight,1755,2010,Bolton Wanderers,18,18,0,1558,1,0,16,16,0,1440,0,0,34,34,0,2998,1,0,0,0,0,1,0,1,0,0,0,0,0,0
2940,2940,Sam Ricketts,2489,2010,Bolton Wanderers,8,7,1,656,0,0,9,7,2,733,0,0,17,14,3,1389,0,0,0,0,0,0,0,0,0,0,0,0,0,0
2941,2941,Matthew Taylor,1069,2010,Bolton Wanderers,17,12,5,1003,1,0,19,10,9,925,1,0,36,22,14,1928,2,0,0,0,0,1,1,2,0,0,0,0,0,0
2942,2942,Stuart Holden,2529,2010,Bolton Wanderers,13,13,0,1155,1,0,13,13,0,1139,1,0,26,26,0,2294,2,0,3,0,3,1,0,1,0,0,0,0,0,0
2943,2943,Mark Davies,2493,2010,Bolton Wanderers,13,5,8,560,1,0,10,4,6,417,0,0,23,9,14,977,1,0,1,0,1,1,0,1,0,0,0,0,0,0
2944,2944,Johan Elmander,1378,2010,Bolton Wanderers,19,19,0,1613,3,0,18,18,0,1496,7,0,37,37,0,3109,10,0,0,1,1,0,3,3,0,0,0,0,0,0
2945,2945,Kevin Davies,1718,2010,Bolton Wanderers,19,18,1,1638,5,0,19,19,0,1685,3,0,38,37,1,3323,8,0,0,1,1,2,3,5,4,0,4,0,0,0
2946,2946,Daniel Sturridge,1428,2010,Bolton Wanderers,7,6,1,557,5,0,5,5,0,420,3,0,12,11,1,977,8,0,3,1,4,3,3,6,0,0,0,0,0,0
2947,2947,Fabrice Muamba,1964,2010,Bolton Wanderers,18,15,3,1201,1,0,18,17,1,1397,0,0,36,32,4,2598,1,0,0,0,0,1,0,1,0,0,0,0,0,0
2948,2948,Martin Petrov,2492,2010,Bolton Wanderers,12,8,4,615,3,0,16,10,6,853,0,0,28,18,10,1468,3,0,0,0,0,1,0,1,0,0,0,0,0,0
2949,2949,Chung-yong Lee,2126,2010,Bolton Wanderers,17,15,2,1252,3,0,14,10,4,942,0,0,31,25,6,2194,3,0,0,0,0,1,0,1,0,0,0,0,0,0
2950,2950,Ádám Bogdán,2488,2010,Bolton Wanderers,1,0,1,51,0,0,3,3,0,270,0,0,4,3,1,321,0,0,0,0,0,0,0,0,0,0,0,0,0,0
2951,2951,David Wheater,2218,2010,Bolton Wanderers,2,1,1,152,0,0,5,4,1,384,0,0,7,5,2,536,0,0,0,0,0,0,0,0,0,0,0,0,0,0
2952,2952,Ivan Klasnić,2496,2010,Bolton Wanderers,11,0,11,122,3,0,11,0,11,195,1,0,22,0,22,317,4,0,6,0,6,3,1,4,0,0,0,0,0,0
2953,2953,Rodrigo,2530,2010,Bolton Wanderers,9,1,8,222,1,0,8,3,5,272,0,0,17,4,13,494,1,0,0,0,0,1,0,1,0,0,0,0,0,0
2954,2954,Ross Wallace,1221,2014,Burnley FC,5,0,5,38,0,0,10,1,9,190,1,0,15,1,14,228,1,0,0,1,1,0,1,1,0,0,0,0,0,0
2955,2955,Marvin Sordell,2498,2014,Burnley FC,6,1,5,103,0,0,8,1,7,178,0,0,14,2,12,281,0,0,0,0,0,0,0,0,0,0,0,0,0,0
2956,2956,Robert Huth,1884,2014,Leicester City,7,7,0,564,0,0,7,7,0,616,1,0,14,14,0,1180,1,0,0,0,0,0,1,1,0,0,0,0,0,0
2957,2957,Marc Albrighton,1448,2014,Leicester City,10,6,4,626,2,0,8,4,4,399,0,0,18,10,8,1025,2,0,0,0,0,1,0,1,0,0,0,0,0,0
2958,2958,Andrej Kramarić,2531,2014,Leicester City,7,2,5,234,1,0,6,4,2,340,1,0,13,6,7,574,2,0,0,0,0,0,0,0,0,0,0,0,0,0
2959,2959,Mark Schwarzer,1328,2014,Leicester City,2,2,0,180,0,0,4,4,0,360,0,0,6,6,0,540,0,0,0,0,0,0,0,0,0,0,0,0,0,0
2960,2960,Matthew Upson,1279,2014,Leicester City,1,1,0,90,0,0,4,4,0,285,0,0,5,5,0,375,0,0,0,0,0,0,0,0,0,0,0,0,0,0
2961,2961,Aleksandar Kolarov,1366,2012,Manchester City,11,8,3,647,1,0,9,3,6,422,0,0,20,11,9,1069,1,0,0,0,0,1,0,1,0,0,0,0,0,0
2962,2962,Samir Nasri,1358,2012,Manchester City,14,11,3,979,1,0,14,11,3,871,1,0,28,22,6,1850,2,0,3,0,3,1,1,2,0,0,0,0,0,0
2963,2963,Jack Rodwell,1748,2012,Manchester City,7,5,2,421,2,0,4,1,3,77,0,0,11,6,5,498,2,0,0,0,0,2,0,2,0,0,0,0,0,0
2964,2964,Gaël Clichy,1230,2012,Manchester City,13,12,1,1067,0,0,15,14,1,1267,0,0,28,26,2,2334,0,0,0,0,0,0,0,0,0,0,0,0,0,0
2965,2965,Mario Balotelli,1681,2012,Manchester City,6,2,4,185,0,0,8,5,3,403,1,0,14,7,7,588,1,0,0,0,0,0,1,1,0,0,0,0,0,0
2966,2966,Robert Green,1277,2012,Queens Park Rangers,8,8,0,720,0,0,8,6,2,600,0,0,16,14,2,1320,0,0,0,0,0,0,0,0,0,0,0,0,0,0
2967,2967,Anton Ferdinand,1686,2012,Queens Park Rangers,7,5,2,458,0,0,6,5,1,457,0,0,13,10,3,915,0,0,0,0,0,0,0,0,0,0,0,0,0,0
2968,2968,Ryan Nelsen,2007,2012,Queens Park Rangers,10,10,0,893,0,0,11,11,0,990,1,0,21,21,0,1883,1,0,0,0,0,0,1,1,0,0,0,0,0,0
2969,2969,Bosingwa,2268,2012,Queens Park Rangers,10,10,0,840,0,0,13,12,1,987,0,0,23,22,1,1827,0,0,0,0,0,0,0,0,0,0,0,0,0,0
2970,2970,Fábio,2320,2012,Queens Park Rangers,12,7,5,595,0,0,9,6,3,540,0,0,21,13,8,1135,0,0,0,0,0,0,0,0,0,0,0,0,0,0
2971,2971,Ji-Sung Park,1788,2012,Queens Park Rangers,9,7,2,629,0,0,11,8,3,713,0,0,20,15,5,1342,0,0,0,0,0,0,0,0,0,0,0,0,0,0
2972,2972,Shaun Wright-Phillips,1683,2012,Queens Park Rangers,10,8,2,652,0,0,10,6,4,596,1,0,20,14,6,1248,1,0,0,3,3,0,1,1,0,0,0,0,0,0
2973,2973,Granero,2532,2012,Queens Park Rangers,9,8,1,658,0,0,15,11,4,1005,1,0,24,19,5,1663,1,0,0,0,0,0,0,0,0,0,0,0,0,0
2974,2974,Alejandro Faurlín,2166,2012,Queens Park Rangers,6,5,1,381,0,0,5,5,0,402,0,0,11,10,1,783,0,0,0,0,0,0,0,0,0,0,0,0,0,0
2975,2975,Andy Johnson,1322,2012,Queens Park Rangers,2,1,1,45,0,0,1,1,0,90,0,0,3,2,1,135,0,0,0,0,0,0,0,0,0,0,0,0,0,0
2976,2976,Bobby Zamora,1943,2012,Queens Park Rangers,11,8,3,701,0,0,10,8,2,679,4,0,21,16,5,1380,4,0,0,1,1,0,3,3,0,0,0,0,0,0
2977,2977,Nedum Onuoha,2533,2012,Queens Park Rangers,12,8,4,851,0,0,11,7,4,757,0,0,23,15,8,1608,0,0,0,0,0,0,0,0,0,0,0,0,0,0
2978,2978,Kieron Dyer,2033,2012,Queens Park Rangers,0,0,0,0,0,0,4,1,3,196,0,0,4,1,3,196,0,0,0,0,0,0,0,0,0,0,0,0,0,0
2979,2979,Djibril Cissé,1899,2012,Queens Park Rangers,9,7,2,613,2,0,9,5,4,496,1,0,18,12,6,1109,3,0,1,0,1,1,1,2,0,0,0,0,0,0
2980,2980,Brian Murphy,2168,2012,Queens Park Rangers,0,0,0,0,0,0,0,0,0,0,0,0,0,0,0,0,0,0,0,0,0,0,0,0,0,0,0,0,0,0
2981,2981,Shaun Derry,2164,2012,Queens Park Rangers,10,4,6,566,0,0,8,6,2,513,0,0,18,10,8,1079,0,0,0,0,0,0,0,0,0,0,0,0,0,0
2982,2982,Jamie Mackie,2534,2012,Queens Park Rangers,14,9,5,965,1,0,15,8,7,737,1,0,29,17,12,1702,2,0,1,0,1,1,1,2,0,0,0,0,0,0
2983,2983,Junior Hoilett,2535,2012,Queens Park Rangers,12,8,4,738,2,0,14,7,7,710,0,0,26,15,11,1448,2,0,0,0,0,1,0,1,0,0,0,0,0,0
2984,2984,Andy Wilkinson,1553,2008,Stoke City,11,11,0,886,0,0,11,9,2,712,0,0,22,20,2,1598,0,0,0,0,0,0,0,0,0,0,0,0,0,0
2985,2985,Glenn Whelan,1549,2008,Stoke City,11,10,1,912,0,0,15,11,4,1069,1,0,26,21,5,1981,1,0,0,1,1,0,1,1,0,0,0,0,0,0
2986,2986,Liam Lawrence,2536,2008,Stoke City,11,10,1,852,2,0,9,8,1,703,1,0,20,18,2,1555,3,0,3,0,3,2,0,2,1,0,1,0,0,0
2987,2987,James Beattie,2050,2008,Stoke City,8,8,0,676,5,0,8,8,0,696,2,0,16,16,0,1372,7,0,3,0,3,4,0,4,1,0,1,0,0,0
2988,2988,Ibrahima Sonko,1609,2008,Stoke City,7,3,4,290,0,0,7,4,3,408,0,0,14,7,7,698,0,0,0,0,0,0,0,0,0,0,0,0,0,0
2989,2989,Ricardo Fuller,2500,2008,Stoke City,16,13,3,1225,6,0,18,12,6,1146,5,0,34,25,9,2371,11,0,4,0,4,5,3,8,1,1,2,0,0,0
2990,2990,Mark Davies,2493,2008,Bolton Wanderers,6,5,1,472,0,0,4,3,1,286,0,0,10,8,2,758,0,0,0,0,0,0,0,0,0,0,0,0,0,0
2991,2991,Ariza Makukula,2537,2008,Bolton Wanderers,3,2,1,126,0,0,3,2,1,167,0,0,6,4,2,293,0,0,0,0,0,0,0,0,0,0,0,0,0,0
2992,2992,Tim Howard,1743,2012,Everton FC,17,17,0,1530,0,0,19,19,0,1710,0,0,36,36,0,3240,0,0,0,0,0,0,0,0,0,0,0,0,0,0
2993,2993,Leighton Baines,1466,2012,Everton FC,19,19,0,1710,3,0,19,19,0,1710,2,0,38,38,0,3420,5,0,0,1,1,2,2,4,1,1,2,0,0,0
2994,2994,Phil Jagielka,1048,2012,Everton FC,18,18,0,1534,1,0,18,18,0,1620,1,0,36,36,0,3154,2,0,0,0,0,0,1,1,0,0,0,0,0,0
2995,2995,Sylvain Distin,1015,2012,Everton FC,18,17,1,1531,0,0,16,14,2,1305,0,0,34,31,3,2836,0,0,0,0,0,0,0,0,0,0,0,0,0,0
2996,2996,Séamus Coleman,1467,2012,Everton FC,12,11,1,999,0,0,14,13,1,1164,0,0,26,24,2,2163,0,0,0,0,0,0,0,0,0,0,0,0,0,0
2997,2997,Darron Gibson,2538,2012,Everton FC,11,10,1,863,1,0,12,12,0,946,0,0,23,22,1,1809,1,0,0,0,0,1,0,1,0,0,0,0,0,0
2998,2998,Leon Osman,1747,2012,Everton FC,19,19,0,1665,4,0,17,17,0,1517,1,0,36,36,0,3182,5,0,0,0,0,3,1,4,0,0,0,0,0,0
2999,2999,Steven Pienaar,2406,2012,Everton FC,17,17,0,1511,4,0,18,18,0,1611,2,0,35,35,0,3122,6,0,3,3,6,3,2,5,0,0,0,0,0,0
3000,3000,Marouane Fellaini,2189,2012,Everton FC,15,15,0,1350,6,0,16,16,0,1436,5,0,31,31,0,2786,11,0,5,0,5,5,3,8,0,0,0,0,0,0
3001,3001,Kevin Mirallas,2238,2012,Everton FC,13,13,0,923,4,0,14,10,4,912,2,0,27,23,4,1835,6,0,3,0,3,2,1,3,0,0,0,0,0,0
3002,3002,Victor Anichebe,1751,2012,Everton FC,13,10,3,927,3,0,13,9,4,793,3,0,26,19,7,1720,6,0,0,3,3,2,3,5,0,0,0,0,0,0
3003,3003,John Heitinga,1745,2012,Everton FC,13,8,5,804,0,0,13,9,4,800,0,0,26,17,9,1604,0,0,0,0,0,0,0,0,0,0,0,0,0,0
3004,3004,Nikica Jelavić,2228,2012,Everton FC,19,14,5,1231,5,0,18,12,6,1200,2,0,37,26,11,2431,7,0,6,0,6,3,1,4,0,0,0,0,0,0
3005,3005,Steven Naismith,2239,2012,Everton FC,13,4,9,514,2,0,18,9,9,766,2,0,31,13,18,1280,4,0,1,0,1,2,2,4,0,0,0,0,0,0
3006,3006,Ján Mucha,1752,2012,Everton FC,2,2,0,180,0,0,0,0,0,0,0,0,2,2,0,180,0,0,0,0,0,0,0,0,0,0,0,0,0,0
3007,3007,Bryan Oviedo,2240,2012,Everton FC,8,1,7,188,0,0,7,0,7,39,0,0,15,1,14,227,0,0,0,0,0,0,0,0,0,0,0,0,0,0
3008,3008,Thomas Hitzlsperger,1792,2012,Everton FC,6,3,3,269,0,0,1,1,0,82,0,0,7,4,3,351,0,0,0,0,0,0,0,0,0,0,0,0,0,0
3009,3009,Ross Barkley,1754,2012,Everton FC,3,0,3,45,0,0,4,2,2,161,0,0,7,2,5,206,0,0,0,0,0,0,0,0,0,0,0,0,0,0
3010,3010,Júlio César,2539,2012,Queens Park Rangers,11,11,0,990,0,0,13,13,0,1110,0,0,24,24,0,2100,0,0,0,0,0,0,0,0,0,0,0,0,0,0
3011,3011,Christopher Samba,2109,2012,Queens Park Rangers,5,5,0,450,0,0,5,5,0,450,0,0,10,10,0,900,0,0,0,0,0,0,0,0,0,0,0,0,0,0
3012,3012,Clint Hill,2540,2012,Queens Park Rangers,15,15,0,1324,0,0,16,16,0,1309,0,0,31,31,0,2633,0,0,0,0,0,0,0,0,0,0,0,0,0,0
3013,3013,Jermaine Jenas,1275,2012,Queens Park Rangers,6,3,3,346,1,0,6,5,1,465,1,0,12,8,4,811,2,0,0,0,0,0,1,1,0,0,0,0,0,0
3014,3014,Andros Townsend,1176,2012,Queens Park Rangers,7,7,0,569,1,0,5,5,0,450,1,0,12,12,0,1019,2,0,0,0,0,1,1,2,0,0,0,0,0,0
3015,3015,Loïc Rémy,2455,2012,Queens Park Rangers,7,6,1,557,3,0,7,7,0,630,3,0,14,13,1,1187,6,0,0,0,0,3,2,5,1,0,1,0,0,0
3016,3016,Samba Diakité,2541,2012,Queens Park Rangers,8,6,2,530,0,0,6,5,1,423,0,0,14,11,3,953,0,0,0,0,0,0,0,0,0,0,0,0,0,0
3017,3017,Adel Taarabt,2165,2012,Queens Park Rangers,17,13,4,1222,3,0,14,12,2,1025,2,0,31,25,6,2247,5,0,0,0,0,1,0,1,0,0,0,0,0,0
3018,3018,Tal Ben Haim,1715,2012,Queens Park Rangers,3,2,1,196,0,0,0,0,0,0,0,0,3,2,1,196,0,0,0,0,0,0,0,0,0,0,0,0,0,0
3019,3019,Jay Bothroyd,1960,2012,Queens Park Rangers,1,0,1,34,0,0,3,2,1,203,1,0,4,2,2,237,1,0,0,3,3,0,1,1,0,0,0,0,0,0
3020,3020,Steven Taylor,2014,2010,Newcastle United,9,7,2,585,2,0,5,5,0,423,1,0,14,12,2,1008,3,0,0,1,1,1,1,2,0,0,0,0,0,0
3021,3021,Cheick Tioté,2289,2010,Newcastle United,14,14,0,1242,1,0,12,12,0,1069,0,0,26,26,0,2311,1,0,1,0,1,1,0,1,0,0,0,0,0,0
3022,3022,Ryan Taylor,2341,2010,Newcastle United,2,2,0,180,0,0,2,1,1,117,0,0,4,3,1,297,0,0,0,0,0,0,0,0,0,0,0,0,0,0
3023,3023,James Tavernier,2458,2010,Newcastle United,0,0,0,0,0,0,0,0,0,0,0,0,0,0,0,0,0,0,0,0,0,0,0,0,0,0,0,0,0,0
3024,3024,Ryan Donaldson,2542,2010,Newcastle United,0,0,0,0,0,0,0,0,0,0,0,0,0,0,0,0,0,0,0,0,0,0,0,0,0,0,0,0,0,0
3025,3025,Shefki Kuqi,2013,2010,Newcastle United,2,0,2,6,0,0,4,0,4,17,0,0,6,0,6,23,0,0,0,0,0,0,0,0,0,0,0,0,0,0
3026,3026,Ben Foster,1653,2010,Birmingham City,19,19,0,1710,0,0,19,19,0,1660,0,0,38,38,0,3370,0,0,0,0,0,0,0,0,0,0,0,0,0,0
3027,3027,Stephen Carr,1780,2010,Birmingham City,19,19,0,1690,0,0,19,19,0,1686,0,0,38,38,0,3376,0,0,0,0,0,0,0,0,0,0,0,0,0,0
3028,3028,Roger Johnson,1781,2010,Birmingham City,19,19,0,1710,1,0,19,19,0,1666,1,0,38,38,0,3376,2,0,0,0,0,1,1,2,0,0,0,0,0,0
3029,3029,Liam Ridgewell,1772,2010,Birmingham City,18,18,0,1610,2,0,18,18,0,1620,2,0,36,36,0,3230,4,0,1,1,2,2,2,4,0,0,0,0,0,0
3030,3030,Martin Jiránek,2543,2010,Birmingham City,5,5,0,410,0,0,5,5,0,374,0,0,10,10,0,784,0,0,0,0,0,0,0,0,0,0,0,0,0,0
3031,3031,Lee Bowyer,1297,2010,Birmingham City,17,13,4,1064,2,0,12,11,1,982,2,0,29,24,5,2046,4,0,4,0,4,2,1,3,0,0,0,0,0,0
3032,3032,Sebastian Larsson,1402,2010,Birmingham City,16,15,1,1332,2,0,19,16,3,1502,2,0,35,31,4,2834,4,0,1,0,1,2,1,3,0,1,1,0,0,0
3033,3033,Barry Ferguson,1782,2010,Birmingham City,18,18,0,1620,0,0,17,17,0,1530,0,0,35,35,0,3150,0,0,0,0,0,0,0,0,0,0,0,0,0,0
3034,3034,Keith Fahey,1785,2010,Birmingham City,10,7,3,564,0,0,14,12,2,962,1,0,24,19,5,1526,1,0,0,0,0,0,0,0,0,0,0,0,0,0
3035,3035,Jean Beausejour,2544,2010,Birmingham City,9,4,5,452,1,0,8,5,3,441,1,0,17,9,8,893,2,0,0,0,0,1,1,2,0,0,0,0,0,0
3036,3036,Cameron Jerome,1783,2010,Birmingham City,16,14,2,1234,1,0,18,16,2,1421,2,0,34,30,4,2655,3,0,0,0,0,0,2,2,0,0,0,0,0,0
3037,3037,Matt Derbyshire,2247,2010,Birmingham City,6,2,4,215,0,0,7,2,5,248,0,0,13,4,9,463,0,0,0,0,0,0,0,0,0,0,0,0,0,0
3038,3038,Colin Doyle,1962,2010,Birmingham City,0,0,0,0,0,0,1,0,1,50,0,0,1,0,1,50,0,0,0,0,0,0,0,0,0,0,0,0,0,0
3039,3039,Stuart Parnaby,1881,2010,Birmingham City,3,3,0,236,0,0,2,2,0,169,0,0,5,5,0,405,0,0,0,0,0,0,0,0,0,0,0,0,0,0
3040,3040,Curtis Davies,2224,2010,Birmingham City,2,1,1,113,0,0,4,1,3,221,0,0,6,2,4,334,0,0,0,0,0,0,0,0,0,0,0,0,0,0
3041,3041,David Bentley,2011,2010,Birmingham City,7,6,1,560,0,0,6,3,3,258,0,0,13,9,4,818,0,0,0,0,0,0,0,0,0,0,0,0,0,0
3042,3042,Aliaksandr Hleb,2433,2010,Birmingham City,10,5,5,499,0,0,9,8,1,598,1,0,19,13,6,1097,1,0,0,0,0,0,1,1,0,0,0,0,0,0
3043,3043,Kevin Phillips,1100,2010,Birmingham City,10,4,6,359,1,0,4,1,3,126,0,0,14,5,9,485,1,0,0,0,0,1,0,1,0,0,0,0,0,0
3044,3044,Brian Jensen,2545,2009,Burnley FC,19,19,0,1635,0,0,19,19,0,1710,0,0,38,38,0,3345,0,0,0,0,0,0,0,0,0,0,0,0,0,0
3045,3045,Graham Alexander,2546,2009,Burnley FC,16,16,0,1377,4,0,17,17,0,1366,3,0,33,33,0,2743,7,0,1,0,1,3,2,5,3,3,6,0,0,0
3046,3046,Clarke Carlisle,2547,2009,Burnley FC,14,14,0,1260,0,0,13,13,0,1114,0,0,27,27,0,2374,0,0,0,0,0,0,0,0,0,0,0,0,0,0
3047,3047,Steven Caldwell,2375,2009,Burnley FC,7,7,0,630,1,0,6,5,1,433,0,0,13,12,1,1063,1,0,0,0,0,1,0,1,0,0,0,0,0,0
3048,3048,Tyrone Mears,1572,2009,Burnley FC,19,19,0,1710,0,0,19,19,0,1710,0,0,38,38,0,3420,0,0,0,0,0,0,0,0,0,0,0,0,0,0
3049,3049,André Bikey,2548,2009,Burnley FC,15,15,0,1246,1,0,13,11,2,941,0,0,28,26,2,2187,1,0,0,0,0,0,0,0,0,0,0,0,0,0
3050,3050,Stephen Jordan,2549,2009,Burnley FC,13,11,2,1008,0,0,12,12,0,1045,0,0,25,23,2,2053,0,0,0,0,0,0,0,0,0,0,0,0,0,0
3051,3051,Wade Elliott,2550,2009,Burnley FC,19,17,2,1565,3,0,19,17,2,1554,1,0,38,34,4,3119,4,0,4,0,4,2,0,2,0,0,0,0,0,0
3052,3052,Chris Eagles,2491,2009,Burnley FC,18,10,8,966,0,0,16,10,6,1005,2,0,34,20,14,1971,2,0,0,0,0,0,0,0,0,0,0,0,0,0
3053,3053,Steven Fletcher,1408,2009,Burnley FC,17,17,0,1417,4,0,18,18,0,1454,4,0,35,35,0,2871,8,0,0,0,0,3,1,4,0,0,0,0,0,0
3054,3054,Robbie Blake,2551,2009,Burnley FC,18,12,6,1022,1,0,13,8,5,632,1,0,31,20,11,1654,2,0,3,0,3,1,1,2,0,0,0,0,0,0
3055,3055,Kevin McDonald,2552,2009,Burnley FC,12,7,5,661,0,0,14,8,6,800,1,0,26,15,11,1461,1,0,0,1,1,0,1,1,0,0,0,0,0,0
3056,3056,Fernando Guerrero,2553,2009,Burnley FC,3,0,3,15,0,0,4,0,4,56,0,0,7,0,7,71,0,0,0,0,0,0,0,0,0,0,0,0,0,0
3057,3057,David Nugent,2519,2009,Burnley FC,15,9,6,904,5,0,15,11,4,970,1,0,30,20,10,1874,6,0,2,0,2,4,1,5,0,0,0,0,0,0
3058,3058,Mark Schwarzer,1328,2012,Fulham FC,18,18,0,1620,0,0,18,18,0,1620,0,0,36,36,0,3240,0,0,0,0,0,0,0,0,0,0,0,0,0,0
3059,3059,John Arne Riise,2362,2012,Fulham FC,16,15,1,1270,1,0,15,14,1,1261,0,0,31,29,2,2531,1,0,0,0,0,1,0,1,0,0,0,0,0,0
3060,3060,Brede Hangeland,1033,2012,Fulham FC,18,18,0,1576,0,0,17,17,0,1530,0,0,35,35,0,3106,0,0,0,0,0,0,0,0,0,0,0,0,0,0
3061,3061,Aaron Hughes,1561,2012,Fulham FC,12,11,1,1034,0,0,12,12,0,1080,0,0,24,23,1,2114,0,0,0,0,0,0,0,0,0,0,0,0,0,0
3062,3062,Sascha Riether,2554,2012,Fulham FC,18,18,0,1559,0,0,17,17,0,1486,1,0,35,35,0,3045,1,0,0,0,0,0,0,0,0,0,0,0,0,0
3063,3063,Chris Baird,1562,2012,Fulham FC,10,7,3,662,1,0,9,7,2,655,1,0,19,14,5,1317,2,0,3,0,3,1,1,2,0,0,0,0,0,0
3064,3064,Steven Sidwell,1622,2012,Fulham FC,14,12,2,1105,4,0,14,12,2,1088,0,0,28,24,4,2193,4,0,1,0,1,2,0,2,1,0,1,0,0,0
3065,3065,Damien Duff,1348,2012,Fulham FC,14,13,1,1152,0,0,17,14,3,1187,2,0,31,27,4,2339,2,0,0,0,0,0,1,1,0,0,0,0,0,0
3066,3066,Alexander Kačaniklić,2555,2012,Fulham FC,11,9,2,662,1,0,9,7,2,600,3,0,20,16,4,1262,4,0,0,3,3,0,3,3,0,0,0,0,0,0
3067,3067,Dimitar Berbatov,1397,2012,Fulham FC,16,16,0,1425,8,0,17,16,1,1422,7,0,33,32,1,2847,15,0,3,3,6,6,5,11,2,2,4,0,0,0
3068,3068,Hugo Rodallega,2061,2012,Fulham FC,14,7,7,835,2,0,15,7,8,669,1,0,29,14,15,1504,3,0,3,0,3,2,1,3,0,0,0,0,0,0
3069,3069,Alex Smith,2556,2012,Fulham FC,1,0,1,1,0,0,0,0,0,0,0,0,1,0,1,1,0,0,0,0,0,0,0,0,0,0,0,0,0,0
3070,3070,Pajtim Kasami,2557,2012,Fulham FC,2,0,2,22,0,0,0,0,0,0,0,0,2,0,2,22,0,0,0,0,0,0,0,0,0,0,0,0,0,0
3071,3071,David Stockdale,2558,2012,Fulham FC,1,1,0,90,0,0,1,1,0,90,0,0,2,2,0,180,0,0,0,0,0,0,0,0,0,0,0,0,0,0
3072,3072,Stephen Kelly,1121,2012,Fulham FC,1,0,1,61,0,0,1,0,1,44,0,0,2,0,2,105,0,0,0,0,0,0,0,0,0,0,0,0,0,0
3073,3073,Matthew Briggs,2559,2012,Fulham FC,1,1,0,90,0,0,4,2,2,205,0,0,5,3,2,295,0,0,0,0,0,0,0,0,0,0,0,0,0,0
3074,3074,Giorgios Karagounis,2560,2012,Fulham FC,13,10,3,733,1,0,12,10,2,818,0,0,25,20,5,1551,1,0,0,0,0,1,0,1,0,0,0,0,0,0
3075,3075,Marcello Trotta,2561,2012,Fulham FC,0,0,0,0,0,0,0,0,0,0,0,0,0,0,0,0,0,0,0,0,0,0,0,0,0,0,0,0,0,0
3076,3076,Billy Jones,1733,2012,West Bromwich Albion,13,12,1,1117,1,0,14,12,2,1090,0,0,27,24,3,2207,1,0,1,0,1,1,0,1,0,0,0,0,0,0
3077,3077,Markus Rosenberg,2562,2012,West Bromwich Albion,11,2,9,242,0,0,13,3,10,305,0,0,24,5,19,547,0,0,0,0,0,0,0,0,0,0,0,0,0,0
3078,3078,Graham Dorrans,1737,2012,West Bromwich Albion,15,12,3,972,0,0,11,9,2,792,1,0,26,21,5,1764,1,0,0,0,0,0,0,0,0,1,1,0,0,0
3079,3079,Eldin Jakupović,2563,2017,Leicester City,1,1,0,90,0,0,1,1,0,90,0,0,2,2,0,180,0,0,0,0,0,0,0,0,0,0,0,0,0,0
3080,3080,Danny Simpson,2395,2017,Leicester City,14,14,0,1132,0,0,14,13,1,1180,0,0,28,27,1,2312,0,0,0,0,0,0,0,0,0,0,0,0,0,0
3081,3081,Wes Morgan,2446,2017,Leicester City,16,16,0,1378,0,0,16,16,0,1440,0,0,32,32,0,2818,0,0,0,0,0,0,0,0,0,0,0,0,0,0
3082,3082,Harry Maguire,2229,2017,Leicester City,19,19,0,1710,2,0,19,19,0,1710,0,0,38,38,0,3420,2,0,1,0,1,1,0,1,0,0,0,0,0,0
3083,3083,Christian Fuchs,2564,2017,Leicester City,11,11,0,979,0,0,14,10,4,939,0,0,25,21,4,1918,0,0,0,0,0,0,0,0,0,0,0,0,0,0
3084,3084,Adrien Silva,2565,2017,Leicester City,8,6,2,492,0,0,4,3,1,270,0,0,12,9,3,762,0,0,0,0,0,0,0,0,0,0,0,0,0,0
3085,3085,Hamza Choudhury,2447,2017,Leicester City,5,2,3,207,0,0,3,2,1,170,0,0,8,4,4,377,0,0,0,0,0,0,0,0,0,0,0,0,0,0
3086,3086,Riyad Mahrez,1842,2017,Leicester City,18,18,0,1543,6,0,18,16,2,1417,6,0,36,34,2,2960,12,0,2,0,2,3,6,9,0,0,0,0,0,0
3087,3087,Jamie Vardy,2443,2017,Leicester City,18,18,0,1612,9,0,19,19,0,1646,11,0,37,37,0,3258,20,0,0,1,1,6,8,14,3,2,5,0,0,0
3088,3088,Kelechi Iheanacho,1590,2017,Leicester City,11,4,7,446,1,0,10,3,7,378,2,0,21,7,14,824,3,0,0,0,0,1,0,1,0,0,0,0,0,0
3089,3089,Fousséni Diabaté,2566,2017,Leicester City,7,4,3,353,0,0,7,1,6,229,0,0,14,5,9,582,0,0,0,0,0,0,0,0,0,0,0,0,0,0
3090,3090,Aleksandar Dragović,2567,2017,Leicester City,6,3,3,384,0,0,5,4,1,382,0,0,11,7,4,766,0,0,0,0,0,0,0,0,0,0,0,0,0,0
3091,3091,Harvey Barnes,2441,2017,Leicester City,2,0,2,3,0,0,1,0,1,5,0,0,3,0,3,8,0,0,0,0,0,0,0,0,0,0,0,0,0,0
3092,3092,Demarai Gray,2568,2017,Leicester City,17,7,10,797,2,0,18,10,8,894,1,0,35,17,18,1691,3,0,3,0,3,1,1,2,0,0,0,0,0,0
3093,3093,Ben Hamer,2520,2017,Leicester City,2,2,0,180,0,0,2,1,1,94,0,0,4,3,1,274,0,0,0,0,0,0,0,0,0,0,0,0,0,0
3094,3094,Yohan Benalouane,2569,2017,Leicester City,1,1,0,90,0,0,0,0,0,0,0,0,1,1,0,90,0,0,0,0,0,0,0,0,0,0,0,0,0,0
3095,3095,Iborra,2570,2017,Leicester City,9,9,0,675,0,0,10,8,2,741,3,0,19,17,2,1416,3,0,0,0,0,0,2,2,0,0,0,0,0,0
3096,3096,George Thomas,2571,2017,Leicester City,0,0,0,0,0,0,0,0,0,0,0,0,0,0,0,0,0,0,0,0,0,0,0,0,0,0,0,0,0,0
3097,3097,Petr Čech,1531,2017,Arsenal FC,17,17,0,1510,0,0,17,17,0,1530,0,0,34,34,0,3040,0,0,0,0,0,0,0,0,0,0,0,0,0,0
3098,3098,Rob Holding,2510,2017,Arsenal FC,6,4,2,365,0,0,6,5,1,455,0,0,12,9,3,820,0,0,0,0,0,0,0,0,0,0,0,0,0,0
3099,3099,Konstantinos Mavropanos,1484,2017,Arsenal FC,1,1,0,90,0,0,2,2,0,180,0,0,3,3,0,270,0,0,0,0,0,0,0,0,0,0,0,0,0,0
3100,3100,Sead Kolašinac,2216,2017,Arsenal FC,14,12,2,1106,2,0,13,13,0,1045,0,0,27,25,2,2151,2,0,0,0,0,1,0,1,0,0,0,0,0,0
3101,3101,Henrikh Mkhitaryan,2572,2017,Arsenal FC,5,4,1,362,1,0,6,5,1,434,1,0,11,9,2,796,2,0,0,0,0,0,1,1,0,0,0,0,0,0
3102,3102,Aaron Ramsey,1501,2017,Arsenal FC,13,11,2,976,6,0,11,10,1,872,1,0,24,21,3,1848,7,0,3,0,3,4,0,4,0,0,0,0,0,0
3103,3103,Granit Xhaka,1475,2017,Arsenal FC,19,18,1,1607,1,0,19,19,0,1659,0,0,38,37,1,3266,1,0,0,0,0,1,0,1,0,0,0,0,0,0
3104,3104,Ainsley Maitland-Niles,1473,2017,Arsenal FC,7,4,3,462,0,0,8,4,4,446,0,0,15,8,7,908,0,0,0,0,0,0,0,0,0,0,0,0,0,0
3105,3105,Pierre-Emerick Aubameyang,1476,2017,Arsenal FC,7,6,1,541,7,0,6,6,0,517,3,0,13,12,1,1058,10,0,0,3,3,3,2,5,1,0,1,0,0,0
3106,3106,Alex Iwobi,1462,2017,Arsenal FC,11,9,2,790,3,0,15,13,2,1053,0,0,26,22,4,1843,3,0,0,0,0,0,0,0,0,0,0,0,0,0
3107,3107,Danny Welbeck,1506,2017,Arsenal FC,13,6,7,598,5,0,15,6,9,587,0,0,28,12,16,1185,5,0,3,0,3,4,0,4,0,0,0,0,0,0
3108,3108,Shkodran Mustafi,1483,2017,Arsenal FC,15,14,1,1212,2,0,12,11,1,1061,1,0,27,25,2,2273,3,0,0,0,0,2,1,3,0,0,0,0,0,0
3109,3109,Eddie Nketiah,2512,2017,Arsenal FC,0,0,0,0,0,0,3,0,3,17,0,0,3,0,3,17,0,0,0,0,0,0,0,0,0,0,0,0,0,0
3110,3110,David Ospina,1495,2017,Arsenal FC,3,2,1,200,0,0,2,2,0,180,0,0,5,4,1,380,0,0,0,0,0,0,0,0,0,0,0,0,0,0
3111,3111,Per Mertesacker,1496,2017,Arsenal FC,2,1,1,103,0,0,4,3,1,262,1,0,6,4,2,365,1,0,0,0,0,0,1,1,0,0,0,0,0,0
3112,3112,Jordi Osei-Tutu,2573,2017,Arsenal FC,0,0,0,0,0,0,0,0,0,0,0,0,0,0,0,0,0,0,0,0,0,0,0,0,0,0,0,0,0,0
3113,3113,Joe Willock,1480,2017,Arsenal FC,0,0,0,0,0,0,2,1,1,82,0,0,2,1,1,82,0,0,0,0,0,0,0,0,0,0,0,0,0,0
3114,3114,Reiss Nelson,1477,2017,Arsenal FC,2,1,1,82,0,0,1,1,0,64,0,0,3,2,1,146,0,0,0,0,0,0,0,0,0,0,0,0,0,0
3115,3115,Chris Riggott,1330,2006,Middlesbrough FC,4,3,1,307,0,0,2,2,0,180,0,0,6,5,1,487,0,0,0,0,0,0,0,0,0,0,0,0,0,0
3116,3116,Andrew Davies,2295,2006,Middlesbrough FC,11,10,1,875,0,0,11,10,1,939,0,0,22,20,2,1814,0,0,0,0,0,0,0,0,0,0,0,0,0,0
3117,3117,Andrew Taylor,2574,2006,Middlesbrough FC,18,18,0,1573,0,0,16,16,0,1396,0,0,34,34,0,2969,0,0,0,0,0,0,0,0,0,0,0,0,0,0
3118,3118,Mendieta,2296,2006,Middlesbrough FC,3,3,0,187,0,0,4,1,3,104,0,0,7,4,3,291,0,0,0,0,0,0,0,0,0,0,0,0,0,0
3119,3119,Mark Viduka,1299,2006,Middlesbrough FC,15,12,3,1088,11,0,14,10,4,996,3,0,29,22,7,2084,14,0,3,4,7,5,2,7,0,0,0,0,0,0
3120,3120,Carlo Cudicini,2370,2006,Chelsea FC,4,4,0,360,0,0,4,3,1,355,0,0,8,7,1,715,0,0,0,0,0,0,0,0,0,0,0,0,0,0
3121,3121,John Terry,1534,2006,Chelsea FC,15,15,0,1350,1,0,13,12,1,1082,0,0,28,27,1,2432,1,0,0,0,0,1,0,1,0,0,0,0,0,0
3122,3122,Shaun Wright-Phillips,1683,2006,Chelsea FC,14,8,6,711,0,0,13,5,8,555,2,0,27,13,14,1266,2,0,0,0,0,0,2,2,0,0,0,0,0,0
3123,3123,Edwin van der Sar,1077,2005,Manchester United,19,19,0,1710,0,0,19,19,0,1665,0,0,38,38,0,3375,0,0,0,0,0,0,0,0,0,0,0,0,0,0
3124,3124,Gary Neville,1105,2005,Manchester United,13,13,0,1121,0,0,12,11,1,1043,0,0,25,24,1,2164,0,0,0,0,0,0,0,0,0,0,0,0,0,0
3125,3125,Rio Ferdinand,1294,2005,Manchester United,18,18,0,1595,3,0,19,19,0,1707,0,0,37,37,0,3302,3,0,3,0,3,2,0,2,0,0,0,0,0,0
3126,3126,Mikaël Silvestre,1106,2005,Manchester United,16,14,2,1250,1,0,17,16,1,1396,0,0,33,30,3,2646,1,0,0,0,0,1,0,1,0,0,0,0,0,0
3127,3127,Nemanja Vidić,1725,2005,Manchester United,5,3,2,319,0,0,6,6,0,540,0,0,11,9,2,859,0,0,0,0,0,0,0,0,0,0,0,0,0,0
3128,3128,John O'Shea,1729,2005,Manchester United,17,17,0,1309,0,0,17,17,0,1525,1,0,34,34,0,2834,1,0,0,3,3,0,1,1,0,0,0,0,0,0
3129,3129,Ryan Giggs,1110,2005,Manchester United,15,12,3,1073,2,0,12,10,2,787,0,0,27,22,5,1860,2,0,1,0,1,1,0,1,0,0,0,0,0,0
3130,3130,Ji-Sung Park,1788,2005,Manchester United,17,13,4,1096,2,0,17,10,7,927,0,0,34,23,11,2023,2,0,0,0,0,1,0,1,0,0,0,0,0,0
3131,3131,Cristiano Ronaldo,1726,2005,Manchester United,16,10,6,1034,5,0,17,14,3,1277,4,0,33,24,9,2311,9,0,0,0,0,0,1,1,0,0,0,0,0,0
3132,3132,Wayne Rooney,1058,2005,Manchester United,17,15,2,1383,7,0,19,19,0,1692,9,0,36,34,2,3075,16,0,0,0,0,2,6,8,0,0,0,0,0,0
3133,3133,Ruud van Nistelrooy,1453,2005,Manchester United,17,14,3,1250,7,0,18,14,4,1346,14,0,35,28,7,2596,21,0,6,6,12,4,8,12,1,1,2,0,0,0
3134,3134,Patrice Evra,1724,2005,Manchester United,7,5,2,423,0,0,4,2,2,149,0,0,11,7,4,572,0,0,0,0,0,0,0,0,0,0,0,0,0,0
3135,3135,Louis Saha,1727,2005,Manchester United,12,7,5,667,3,0,7,5,2,477,4,0,19,12,7,1144,7,0,0,0,0,2,3,5,0,0,0,0,0,0
3136,3136,Jens Lehmann,1522,2005,Arsenal FC,18,18,0,1620,0,0,19,19,0,1710,0,0,37,37,0,3330,0,0,0,0,0,0,0,0,0,0,0,0,0,0
3137,3137,Philippe Senderos,1228,2005,Arsenal FC,10,10,0,864,1,0,10,9,1,811,1,0,20,19,1,1675,2,0,0,0,0,0,1,1,0,0,0,0,0,0
3138,3138,Emmanuel Eboué,1231,2005,Arsenal FC,9,5,4,512,0,0,9,6,3,612,0,0,18,11,7,1124,0,0,0,0,0,0,0,0,0,0,0,0,0,0
3139,3139,Kolo Touré,1415,2005,Arsenal FC,15,15,0,1350,0,0,17,17,0,1530,0,0,32,32,0,2880,0,0,0,0,0,0,0,0,0,0,0,0,0,0
3140,3140,Robert Pirés,1603,2005,Arsenal FC,17,13,4,1205,6,0,15,9,6,871,1,0,32,22,10,2076,7,0,3,1,4,4,1,5,1,0,1,0,0,0
3141,3141,Aliaksandr Hleb,2433,2005,Arsenal FC,11,8,3,695,3,0,14,9,5,784,0,0,25,17,8,1479,3,0,0,0,0,1,0,1,0,0,0,0,0,0
3142,3142,Cesc Fàbregas,1526,2005,Arsenal FC,16,14,2,1191,1,0,18,15,3,1371,2,0,34,29,5,2562,3,0,0,0,0,1,0,1,0,0,0,0,0,0
3143,3143,Mathieu Flamini,1510,2005,Arsenal FC,15,8,7,849,0,0,15,10,5,889,0,0,30,18,12,1738,0,0,0,0,0,0,0,0,0,0,0,0,0,0
3144,3144,Gilberto Silva,1234,2005,Arsenal FC,17,17,0,1491,2,0,15,15,0,1323,0,0,32,32,0,2814,2,0,1,0,1,1,0,1,0,0,0,0,0,0
3145,3145,Robin van Persie,1528,2005,Arsenal FC,12,6,6,549,4,0,12,7,5,665,1,0,24,13,11,1214,5,0,0,0,0,1,1,2,0,0,0,0,0,0
3146,3146,Emmanuel Adebayor,1235,2005,Arsenal FC,6,5,1,433,2,0,7,7,0,572,2,0,13,12,1,1005,4,0,0,0,0,1,1,2,0,0,0,0,0,0
3147,3147,Abou Diaby,2434,2005,Arsenal FC,5,4,1,342,1,0,7,5,2,453,0,0,12,9,3,795,1,0,0,0,0,0,0,0,0,0,0,0,0,0
3148,3148,Freddie Ljungberg,1525,2005,Arsenal FC,10,7,3,611,0,0,15,14,1,1122,1,0,25,21,4,1733,1,0,0,0,0,0,1,1,0,0,0,0,0,0
3149,3149,Thierry Henry,2357,2005,Arsenal FC,16,15,1,1325,20,0,15,14,1,1257,7,0,31,29,2,2582,27,0,4,0,4,8,2,10,3,0,3,0,0,0
3150,3150,Marouane Fellaini,2189,2017,Manchester United,9,2,7,296,4,0,7,3,4,336,0,0,16,5,11,632,4,0,3,0,3,1,0,1,0,0,0,0,0,0
3151,3151,Zlatan Ibrahimović,2575,2017,Manchester United,4,1,3,101,0,0,1,0,1,2,0,0,5,1,4,103,0,0,0,0,0,0,0,0,0,0,0,0,0,0
3152,3152,Sergio Romero,2192,2017,Manchester United,1,1,0,90,0,0,0,0,0,0,0,0,1,1,0,90,0,0,0,0,0,0,0,0,0,0,0,0,0,0
3153,3153,Luke Shaw,2576,2017,Manchester United,6,5,1,473,0,0,6,4,2,405,0,0,12,9,3,878,0,0,0,0,0,0,0,0,0,0,0,0,0,0
3154,3154,Rob Elliot,2456,2017,Newcastle United,8,8,0,720,0,0,8,8,0,720,0,0,16,16,0,1440,0,0,0,0,0,0,0,0,0,0,0,0,0,0
3155,3155,Ciaran Clark,1437,2017,Newcastle United,10,9,1,845,1,0,10,10,0,900,1,0,20,19,1,1745,2,0,0,0,0,0,0,0,0,0,0,0,0,0
3156,3156,Matt Ritchie,1008,2017,Newcastle United,18,17,1,1441,3,0,17,15,2,1371,0,0,35,32,3,2812,3,0,6,0,6,2,0,2,0,0,0,0,0,0
3157,3157,Manquillo,2469,2017,Newcastle United,9,9,0,810,0,0,11,10,1,859,0,0,20,19,1,1669,0,0,0,0,0,0,0,0,0,0,0,0,0,0
3158,3158,Florian Lejeune,2577,2017,Newcastle United,12,12,0,1024,0,0,12,12,0,1080,0,0,24,24,0,2104,0,0,0,0,0,0,0,0,0,0,0,0,0,0
3159,3159,DeAndre Yedlin,1175,2017,Newcastle United,17,17,0,1530,0,0,17,14,3,1312,0,0,34,31,3,2842,0,0,0,0,0,0,0,0,0,0,0,0,0,0
3160,3160,Jonjo Shelvey,1699,2017,Newcastle United,16,14,2,1279,0,0,14,11,3,1030,1,0,30,25,5,2309,1,0,0,0,0,0,1,1,0,0,0,0,0,0
3161,3161,Isaac Hayden,2470,2017,Newcastle United,11,7,4,614,0,0,15,8,7,760,1,0,26,15,11,1374,1,0,0,0,0,0,1,1,0,0,0,0,0,0
3162,3162,Jacob Murphy,2578,2017,Newcastle United,10,4,6,406,0,0,15,9,6,739,1,0,25,13,12,1145,1,0,0,0,0,0,0,0,0,0,0,0,0,0
3163,3163,Dwight Gayle,2477,2017,Newcastle United,17,13,4,1046,2,0,18,10,8,914,4,0,35,23,12,1960,6,0,0,0,0,2,3,5,0,0,0,0,0,0
3164,3164,Joselu,2195,2017,Newcastle United,17,10,7,913,4,0,13,9,4,804,0,0,30,19,11,1717,4,0,2,0,2,4,0,4,0,0,0,0,0,0
3165,3165,Momo Diamé,2060,2017,Newcastle United,15,11,4,970,0,0,16,12,4,1073,2,0,31,23,8,2043,2,0,0,0,0,0,2,2,0,0,0,0,0,0
3166,3166,Rolando Aarons,2284,2017,Newcastle United,2,1,1,87,0,0,2,0,2,50,0,0,4,1,3,137,0,0,0,0,0,0,0,0,0,0,0,0,0,0
3167,3167,Aleksandar Mitrović,2285,2017,Newcastle United,4,0,4,53,1,0,2,0,2,36,0,0,6,0,6,89,1,0,0,0,0,0,0,0,0,0,0,0,0,0
3168,3168,Karl Darlow,2286,2017,Newcastle United,5,5,0,450,0,0,5,5,0,450,0,0,10,10,0,900,0,0,0,0,0,0,0,0,0,0,0,0,0,0
3169,3169,Chancel Mbemba,2279,2017,Newcastle United,4,3,1,313,0,0,5,4,1,359,0,0,9,7,2,672,0,0,0,0,0,0,0,0,0,0,0,0,0,0
3170,3170,Jesús Gámez,2579,2017,Newcastle United,0,0,0,0,0,0,2,1,1,97,0,0,2,1,1,97,0,0,0,0,0,0,0,0,0,0,0,0,0,0
3171,3171,Ayoze Pérez,2288,2017,Newcastle United,18,13,5,1189,4,0,18,15,3,1307,4,0,36,28,8,2496,8,0,3,3,6,2,2,4,0,0,0,0,0,0
3172,3172,Ian Bennett,2580,2006,Sheffield United,1,1,0,90,0,0,1,1,0,90,0,0,2,2,0,180,0,0,0,0,0,0,0,0,0,0,0,0,0,0
3173,3173,Leigh Bromby,2581,2006,Sheffield United,9,7,2,611,0,0,8,5,3,528,0,0,17,12,5,1139,0,0,0,0,0,0,0,0,0,0,0,0,0,0
3174,3174,David Unsworth,2582,2006,Sheffield United,3,3,0,226,0,0,2,2,0,151,0,0,5,5,0,377,0,0,0,0,0,0,0,0,0,0,0,0,0,0
3175,3175,Chris Morgan,2583,2006,Sheffield United,12,11,1,1017,1,0,12,10,2,1015,0,0,24,21,3,2032,1,0,0,0,0,1,0,1,0,0,0,0,0,0
3176,3176,Phil Jagielka,1048,2006,Sheffield United,18,18,0,1620,3,0,18,18,0,1620,1,0,36,36,0,3240,4,0,6,0,6,2,1,3,1,1,2,0,0,0
3177,3177,David Sommeil,1806,2006,Sheffield United,2,2,0,180,0,0,3,2,1,148,0,0,5,4,1,328,0,0,0,0,0,0,0,0,0,0,0,0,0,0
3178,3178,Chris Armstrong,2584,2006,Sheffield United,12,11,1,1054,0,0,13,11,2,979,0,0,25,22,3,2033,0,0,0,0,0,0,0,0,0,0,0,0,0,0
3179,3179,Mikele Leigertwood,1980,2006,Sheffield United,9,8,1,638,0,0,10,8,2,781,0,0,19,16,3,1419,0,0,0,0,0,0,0,0,0,0,0,0,0,0
3180,3180,Paul Ifill,2585,2006,Sheffield United,3,3,0,169,0,0,0,0,0,0,0,0,3,3,0,169,0,0,0,0,0,0,0,0,0,0,0,0,0,0
3181,3181,Ade Akinbiyi,1311,2006,Sheffield United,2,1,1,94,0,0,1,1,0,90,0,0,3,2,1,184,0,0,0,0,0,0,0,0,0,0,0,0,0,0
3182,3182,Rob Hulse,1327,2006,Sheffield United,14,13,1,1186,6,0,13,13,0,1087,2,0,27,26,1,2273,8,0,0,3,3,4,2,6,0,0,0,0,0,0
3183,3183,Alan Quinn,2586,2006,Sheffield United,9,5,4,495,0,0,10,6,4,473,0,0,19,11,8,968,0,0,0,0,0,0,0,0,0,0,0,0,0,0
3184,3184,Keith Gillespie,1351,2006,Sheffield United,15,13,2,1175,2,0,16,14,2,1241,0,0,31,27,4,2416,2,0,3,0,3,2,0,2,0,0,0,0,0,0
3185,3185,Christian Nadé,2587,2006,Sheffield United,15,5,10,557,2,0,10,2,8,356,1,0,25,7,18,913,3,0,3,0,3,2,0,2,0,0,0,0,0,0
3186,3186,Marcus Hahnemann,2588,2006,Reading FC,19,19,0,1710,0,0,17,17,0,1419,0,0,36,36,0,3129,0,0,0,0,0,0,0,0,0,0,0,0,0,0
3187,3187,Graeme Murty,2589,2006,Reading FC,13,13,0,1115,0,0,9,9,0,779,0,0,22,22,0,1894,0,0,0,0,0,0,0,0,0,0,0,0,0,0
3188,3188,Nicky Shorey,1731,2006,Reading FC,18,18,0,1620,1,0,17,17,0,1530,0,0,35,35,0,3150,1,0,0,0,0,1,0,1,0,0,0,0,0,0
3189,3189,Ibrahima Sonko,1609,2006,Reading FC,12,12,0,997,0,0,10,10,0,900,1,0,22,22,0,1897,1,0,0,0,0,0,1,1,0,0,0,0,0,0
3190,3190,Ívar Ingimarsson,2590,2006,Reading FC,19,19,0,1710,2,0,17,17,0,1530,0,0,36,36,0,3240,2,0,3,0,3,2,0,2,0,0,0,0,0,0
3191,3191,Steven Sidwell,1622,2006,Reading FC,17,17,0,1530,4,0,16,16,0,1383,0,0,33,33,0,2913,4,0,0,0,0,3,0,3,0,0,0,0,0,0
3192,3192,James Harper,2591,2006,Reading FC,19,18,1,1591,1,0,17,16,1,1432,2,0,36,34,2,3023,3,0,0,0,0,1,2,3,0,0,0,0,0,0
3193,3193,Bobby Convey,2592,2006,Reading FC,4,3,1,268,0,0,5,5,0,351,0,0,9,8,1,619,0,0,0,0,0,0,0,0,0,0,0,0,0,0
3194,3194,Leroy Lita,2593,2006,Reading FC,16,9,7,898,3,0,15,11,4,925,4,0,31,20,11,1823,7,0,3,0,3,1,2,3,0,0,0,0,0,0
3195,3195,Kevin Doyle,2594,2006,Reading FC,16,14,2,1263,6,0,15,13,2,1118,7,0,31,27,4,2381,13,0,3,3,6,2,6,8,1,2,3,0,0,0
3196,3196,Ki-hyeon Seol,1563,2006,Reading FC,15,13,2,1039,1,0,11,8,3,699,3,0,26,21,5,1738,4,0,0,3,3,1,2,3,0,0,0,0,0,0
3197,3197,Brynjar Gunnarsson,1988,2006,Reading FC,12,4,8,459,2,0,10,5,5,606,1,0,22,9,13,1065,3,0,0,1,1,2,1,3,0,0,0,0,0,0
3198,3198,Glen Little,2595,2006,Reading FC,11,9,2,784,0,0,12,8,4,723,0,0,23,17,6,1507,0,0,0,0,0,0,0,0,0,0,0,0,0,0
3199,3199,Stephen Hunt,2596,2006,Reading FC,18,16,2,1401,3,0,16,11,5,940,1,0,34,27,7,2341,4,0,3,0,3,1,0,1,0,0,0,0,0,0
3200,3200,Simon Mignolet,1191,2014,Liverpool FC,18,18,0,1620,0,0,18,17,1,1604,0,0,36,35,1,3224,0,0,0,0,0,0,0,0,0,0,0,0,0,0
3201,3201,Dejan Lovren,1179,2014,Liverpool FC,13,11,2,1014,0,0,13,11,2,1021,0,0,26,22,4,2035,0,0,0,0,0,0,0,0,0,0,0,0,0,0
3202,3202,Alberto Moreno,2128,2014,Liverpool FC,15,15,0,1294,1,0,13,11,2,967,1,0,28,26,2,2261,2,0,0,0,0,1,0,1,0,0,0,0,0,0
3203,3203,Martin Škrtel,1423,2014,Liverpool FC,16,16,0,1440,1,0,17,17,0,1530,0,0,33,33,0,2970,1,0,1,0,1,1,0,1,0,0,0,0,0,0
3204,3204,Steven Gerrard,1424,2014,Liverpool FC,14,11,3,1049,5,0,15,14,1,1231,4,0,29,25,4,2280,9,0,3,1,4,4,2,6,3,1,4,0,0,0
3205,3205,Coutinho,1425,2014,Liverpool FC,19,17,2,1517,3,0,16,15,1,1283,2,0,35,32,3,2800,5,0,3,0,3,3,2,5,0,0,0,0,0,0
3206,3206,Jordan Henderson,1426,2014,Liverpool FC,19,18,1,1635,3,0,18,18,0,1620,3,0,37,36,1,3255,6,0,3,3,6,3,1,4,0,1,1,0,0,0
3207,3207,Adam Lallana,1190,2014,Liverpool FC,15,14,1,1051,4,0,12,9,3,739,1,0,27,23,4,1790,5,0,0,0,0,2,1,3,0,0,0,0,0,0
3208,3208,Emre Can,1185,2014,Liverpool FC,12,12,0,1045,1,0,15,11,4,1026,0,0,27,23,4,2071,1,0,0,0,0,1,0,1,0,0,0,0,0,0
3209,3209,Raheem Sterling,1203,2014,Liverpool FC,18,17,1,1551,3,0,17,17,0,1502,4,0,35,34,1,3053,7,0,0,3,3,3,2,5,0,0,0,0,0,0
3210,3210,Jordon Ibe,1042,2014,Liverpool FC,5,3,2,245,0,0,7,4,3,373,0,0,12,7,5,618,0,0,0,0,0,0,0,0,0,0,0,0,0,0
3211,3211,Lucas Leiva,1429,2014,Liverpool FC,11,8,3,702,0,0,9,8,1,613,0,0,20,16,4,1315,0,0,0,0,0,0,0,0,0,0,0,0,0,0
3212,3212,Rickie Lambert,2597,2014,Liverpool FC,14,4,10,450,0,0,11,3,8,374,2,0,25,7,18,824,2,0,0,0,0,0,1,1,0,0,0,0,0,0
3213,3213,Jerome Sinclair,1931,2014,Liverpool FC,1,0,1,3,0,0,1,0,1,22,0,0,2,0,2,25,0,0,0,0,0,0,0,0,0,0,0,0,0,0
3214,3214,Danny Ward,2444,2014,Liverpool FC,0,0,0,0,0,0,0,0,0,0,0,0,0,0,0,0,0,0,0,0,0,0,0,0,0,0,0,0,0,0
3215,3215,Glen Johnson,1386,2014,Liverpool FC,8,6,2,567,1,0,11,9,2,763,0,0,19,15,4,1330,1,0,3,0,3,1,0,1,0,0,0,0,0,0
3216,3216,Kolo Touré,1415,2014,Liverpool FC,6,4,2,375,0,0,6,3,3,335,0,0,12,7,5,710,0,0,0,0,0,0,0,0,0,0,0,0,0,0
3217,3217,Joe Allen,1430,2014,Liverpool FC,8,6,2,557,1,0,13,10,3,913,0,0,21,16,5,1470,1,0,0,0,0,0,0,0,0,0,0,0,0,0
3218,3218,Wayne Hennessey,1018,2014,Crystal Palace,1,1,0,90,0,0,2,1,1,126,0,0,3,2,1,216,0,0,0,0,0,0,0,0,0,0,0,0,0,0
3219,3219,Joel Ward,1019,2014,Crystal Palace,18,18,0,1620,1,0,19,19,0,1710,0,0,37,37,0,3330,1,0,0,0,0,0,0,0,0,0,0,0,0,0
3220,3220,Scott Dann,1020,2014,Crystal Palace,16,16,0,1440,1,0,18,18,0,1483,1,0,34,34,0,2923,2,0,0,0,0,0,0,0,0,0,0,0,0,0
3221,3221,Martin Kelly,1034,2014,Crystal Palace,14,13,1,1141,0,0,17,14,3,1358,0,0,31,27,4,2499,0,0,0,0,0,0,0,0,0,0,0,0,0,0
3222,3222,Pape Souaré,1021,2014,Crystal Palace,6,4,2,410,0,0,3,3,0,195,0,0,9,7,2,605,0,0,0,0,0,0,0,0,0,0,0,0,0,0
3223,3223,Yannick Bolasie,1057,2014,Crystal Palace,17,14,3,1299,0,0,17,17,0,1476,4,0,34,31,3,2775,4,0,0,0,0,0,0,0,0,0,0,0,0,0
3224,3224,James McArthur,1023,2014,Crystal Palace,16,15,1,1274,2,0,16,14,2,1332,0,0,32,29,3,2606,2,0,0,0,0,1,0,1,0,0,0,0,0,0
3225,3225,Chung-yong Lee,2126,2014,Crystal Palace,2,0,2,32,0,0,1,1,0,59,0,0,3,1,2,91,0,0,0,0,0,0,0,0,0,0,0,0,0,0
3226,3226,Joe Ledley,1025,2014,Crystal Palace,14,14,0,1108,1,0,18,16,2,1467,1,0,32,30,2,2575,2,0,0,3,3,1,1,2,0,0,0,0,0,0
3227,3227,Jason Puncheon,1026,2014,Crystal Palace,18,14,4,1279,3,0,19,17,2,1546,3,0,37,31,6,2825,6,0,3,0,3,2,3,5,0,0,0,0,0,0
3228,3228,Marouane Chamakh,1031,2014,Crystal Palace,10,8,2,602,2,0,8,7,1,554,0,0,18,15,3,1156,2,0,3,0,3,1,0,1,0,0,0,0,0,0
3229,3229,Jordon Mutch,1024,2014,Crystal Palace,3,1,2,179,0,0,4,3,1,154,0,0,7,4,3,333,0,0,0,0,0,0,0,0,0,0,0,0,0,0
3230,3230,Wilfried Zaha,1028,2014,Crystal Palace,16,12,4,1057,1,0,15,11,4,924,3,0,31,23,8,1981,4,0,0,4,4,1,3,4,0,0,0,0,0,0
3231,3231,Glenn Murray,1010,2014,Crystal Palace,10,6,4,567,2,0,7,3,4,320,5,0,17,9,8,887,7,0,0,0,0,1,3,4,0,1,1,0,0,0
3232,3232,Julian Speroni,2249,2014,Crystal Palace,18,18,0,1620,0,0,18,18,0,1584,0,0,36,36,0,3204,0,0,0,0,0,0,0,0,0,0,0,0,0,0
3233,3233,Damien Delaney,1022,2014,Crystal Palace,15,15,0,1296,0,0,14,13,1,1185,0,0,29,28,1,2481,0,0,0,0,0,0,0,0,0,0,0,0,0,0
3234,3234,Mile Jedinak,1030,2014,Crystal Palace,13,13,0,1094,2,0,11,11,0,990,3,0,24,24,0,2084,5,0,0,1,1,0,2,2,0,3,3,0,0,0
3235,3235,Fraizer Campbell,1027,2014,Crystal Palace,11,7,4,609,3,0,9,6,3,566,1,0,20,13,7,1175,4,0,1,0,1,2,1,3,0,0,0,0,0,0
3236,3236,Brad Friedel,1343,2010,Aston Villa,19,19,0,1710,0,0,18,18,0,1620,0,0,37,37,0,3330,0,0,0,0,0,0,0,0,0,0,0,0,0,0
3237,3237,Luke Young,1952,2010,Aston Villa,11,11,0,990,1,0,11,11,0,990,0,0,22,22,0,1980,1,0,3,0,3,1,0,1,0,0,0,0,0,0
3238,3238,Stephen Warnock,1616,2010,Aston Villa,10,10,0,900,0,0,8,8,0,720,0,0,18,18,0,1620,0,0,0,0,0,0,0,0,0,0,0,0,0,0
3239,3239,Richard Dunne,1617,2010,Aston Villa,16,16,0,1321,0,0,15,15,0,1311,0,0,31,31,0,2632,0,0,0,0,0,0,0,0,0,0,0,0,0,0
3240,3240,Ciaran Clark,1437,2010,Aston Villa,9,8,1,797,2,0,9,7,2,681,1,0,18,15,3,1478,3,0,0,1,1,0,1,1,0,0,0,0,0,0
3241,3241,James Collins,1618,2010,Aston Villa,16,16,0,1440,2,0,16,15,1,1413,1,0,32,31,1,2853,3,0,6,1,7,2,1,3,0,0,0,0,0,0
3242,3242,Stewart Downing,1335,2010,Aston Villa,19,19,0,1687,5,0,18,18,0,1610,2,0,37,37,0,3297,7,0,3,0,3,4,2,6,0,0,0,0,0,0
3243,3243,Ashley Young,1619,2010,Aston Villa,18,18,0,1616,5,0,15,15,0,1348,2,0,33,33,0,2964,7,0,1,0,1,4,1,5,2,2,4,0,0,0
3244,3244,Marc Albrighton,1448,2010,Aston Villa,15,10,5,996,2,0,13,9,4,750,3,0,28,19,9,1746,5,0,0,0,0,0,3,3,0,0,0,0,0,0
3245,3245,Barry Bannan,1975,2010,Aston Villa,7,4,3,374,0,0,5,3,2,263,0,0,12,7,5,637,0,0,0,0,0,0,0,0,0,0,0,0,0,0
3246,3246,Nathan Delfouneso,2175,2010,Aston Villa,6,1,5,192,1,0,5,1,4,197,0,0,11,2,9,389,1,0,0,0,0,1,0,1,0,0,0,0,0,0
3247,3247,Eric Lichaj,1976,2010,Aston Villa,4,2,2,183,0,0,1,1,0,90,0,0,5,3,2,273,0,0,0,0,0,0,0,0,0,0,0,0,0,0
3248,3248,Stephen Ireland,1809,2010,Aston Villa,4,2,2,189,0,0,5,3,2,224,0,0,9,5,4,413,0,0,0,0,0,0,0,0,0,0,0,0,0,0
3249,3249,Gabriel Agbonlahor,1442,2010,Aston Villa,12,7,5,721,0,0,14,10,4,883,3,0,26,17,9,1604,3,0,0,3,3,0,3,3,0,0,0,0,0,0
3250,3250,Brad Guzan,1435,2010,Aston Villa,0,0,0,0,0,0,0,0,0,0,0,0,0,0,0,0,0,0,0,0,0,0,0,0,0,0,0,0,0,0
3251,3251,Shane Lowry,2174,2010,Aston Villa,0,0,0,0,0,0,0,0,0,0,0,0,0,0,0,0,0,0,0,0,0,0,0,0,0,0,0,0,0,0
3252,3252,Jonathan Hogg,2598,2010,Aston Villa,3,3,0,226,0,0,2,2,0,171,0,0,5,5,0,397,0,0,0,0,0,0,0,0,0,0,0,0,0,0
3253,3253,Daniel Johnson,2599,2010,Aston Villa,0,0,0,0,0,0,0,0,0,0,0,0,0,0,0,0,0,0,0,0,0,0,0,0,0,0,0,0,0,0
3254,3254,Richard Kingson,2600,2010,Blackpool FC,10,10,0,843,0,0,10,9,1,854,0,0,20,19,1,1697,0,0,0,0,0,0,0,0,0,0,0,0,0,0
3255,3255,Chris Basham,2601,2010,Blackpool FC,0,0,0,0,0,0,2,1,1,118,0,0,2,1,1,118,0,0,0,0,0,0,0,0,0,0,0,0,0,0
3256,3256,Rob Edwards,2602,2010,Blackpool FC,0,0,0,0,0,0,2,1,1,106,0,0,2,1,1,106,0,0,0,0,0,0,0,0,0,0,0,0,0,0
3257,3257,Dekel Keinan,2603,2010,Blackpool FC,1,0,1,18,0,0,5,3,2,378,0,0,6,3,3,396,0,0,0,0,0,0,0,0,0,0,0,0,0,0
3258,3258,Keith Southern,2604,2010,Blackpool FC,10,7,3,642,0,0,11,4,7,443,0,0,21,11,10,1085,0,0,0,0,0,0,0,0,0,0,0,0,0,0
3259,3259,Jason Euell,1886,2010,Blackpool FC,1,0,1,19,0,0,2,1,1,83,0,0,3,1,2,102,0,0,0,0,0,0,0,0,0,0,0,0,0,0
3260,3260,Ludovic Sylvestre,2605,2010,Blackpool FC,2,1,1,83,0,0,6,5,1,346,0,0,8,6,2,429,0,0,0,0,0,0,0,0,0,0,0,0,0,0
3261,3261,Matt Phillips,1660,2010,Blackpool FC,16,5,11,615,1,0,11,1,10,414,0,0,27,6,21,1029,1,0,0,0,0,1,0,1,0,0,0,0,0,0
3262,3262,David Carney,2606,2010,Blackpool FC,5,3,2,287,0,0,6,2,4,203,0,0,11,5,6,490,0,0,0,0,0,0,0,0,0,0,0,0,0,0
3263,3263,Marlon Harewood,1942,2010,Blackpool FC,8,3,5,311,2,0,8,4,4,350,3,0,16,7,9,661,5,0,0,0,0,1,1,2,0,0,0,0,0,0
3264,3264,Brett Ormerod,2607,2010,Blackpool FC,7,2,5,269,1,0,12,4,8,438,0,0,19,6,13,707,1,0,0,0,0,0,0,0,0,0,0,0,0,0
3265,3265,Ian Evatt,2608,2010,Blackpool FC,19,18,1,1638,0,0,19,18,1,1635,1,0,38,36,2,3273,1,0,0,0,0,0,1,1,0,0,0,0,0,0
3266,3266,Charlie Adam,1554,2010,Blackpool FC,18,18,0,1618,5,0,17,16,1,1434,7,0,35,34,1,3052,12,0,3,0,3,3,6,9,3,4,7,0,0,0
3267,3267,DJ Campbell,2167,2010,Blackpool FC,16,16,0,1440,8,0,15,14,1,1234,5,0,31,30,1,2674,13,0,4,3,7,5,3,8,0,0,0,0,0,0
3268,3268,Matt Gilks,1492,2010,Blackpool FC,9,9,0,810,0,0,9,9,0,766,0,0,18,18,0,1576,0,0,0,0,0,0,0,0,0,0,0,0,0,0
3269,3269,Neal Eardley,2609,2010,Blackpool FC,17,16,1,1413,1,0,14,14,0,1149,0,0,31,30,1,2562,1,0,0,0,0,1,0,1,0,0,0,0,0,0
3270,3270,Elliot Grandin,2610,2010,Blackpool FC,10,8,2,600,1,0,13,13,0,914,0,0,23,21,2,1514,1,0,1,0,1,1,0,1,0,0,0,0,0,0
3271,3271,Luke Varney,2611,2010,Blackpool FC,16,13,3,1041,3,0,14,11,3,1003,2,0,30,24,6,2044,5,0,0,0,0,2,0,2,0,0,0,0,0,0
3272,3272,Patrice Evra,1724,2008,Manchester United,16,16,0,1362,0,0,12,12,0,1049,0,0,28,28,0,2411,0,0,0,0,0,0,0,0,0,0,0,0,0,0
3273,3273,Rio Ferdinand,1294,2008,Manchester United,11,11,0,990,0,0,13,13,0,1150,0,0,24,24,0,2140,0,0,0,0,0,0,0,0,0,0,0,0,0,0
3274,3274,Nani,2258,2008,Manchester United,8,6,2,393,1,0,5,1,4,156,0,0,13,7,6,549,1,0,0,0,0,0,0,0,0,0,0,0,0,0
3275,3275,Bernard Mendy,2612,2008,Hull City,15,8,7,883,1,0,13,7,6,704,1,0,28,15,13,1587,2,0,0,0,0,1,0,1,0,0,0,0,0,0
3276,3276,Caleb Folan,2613,2008,Hull City,8,2,6,288,1,0,7,0,7,134,0,0,15,2,13,422,1,0,3,0,3,1,0,1,0,0,0,0,0,0
3277,3277,Danny Mills,1292,2003,Middlesbrough FC,15,15,0,1343,0,0,12,12,0,1070,0,0,27,27,0,2413,0,0,0,0,0,0,0,0,0,0,0,0,0,0
3278,3278,Colin Cooper,2138,2003,Middlesbrough FC,9,9,0,751,0,0,10,8,2,690,0,0,19,17,2,1441,0,0,0,0,0,0,0,0,0,0,0,0,0,0
3279,3279,Szilárd Németh,2139,2003,Middlesbrough FC,17,9,8,886,7,0,14,7,7,643,2,0,31,16,15,1529,9,0,3,0,3,3,0,3,0,0,0,0,0,0
3280,3280,Malcolm Christie,2137,2003,Middlesbrough FC,6,4,2,398,0,0,4,3,1,264,1,0,10,7,3,662,1,0,0,3,3,0,1,1,0,0,0,0,0,0
3281,3281,Jonathan Greening,1321,2003,Middlesbrough FC,12,9,3,806,1,0,13,8,5,800,0,0,25,17,8,1606,1,0,0,0,0,0,0,0,0,0,0,0,0,0
3282,3282,Kieron Dyer,2033,2003,Newcastle United,11,11,0,964,1,0,11,11,0,925,0,0,22,22,0,1889,1,0,0,0,0,1,0,1,0,0,0,0,0,0
3283,3283,Alan Shearer,1948,2003,Newcastle United,17,17,0,1513,15,0,16,16,0,1440,7,0,33,33,0,2953,22,0,13,5,18,7,7,14,3,4,7,0,0,0
3284,3284,Carlo Cudicini,2370,2002,Chelsea FC,18,18,0,1620,0,0,18,18,0,1620,0,0,36,36,0,3240,0,0,0,0,0,0,0,0,0,0,0,0,0,0
3285,3285,Celestine Babayaro,2015,2002,Chelsea FC,9,7,2,670,1,0,10,9,1,821,0,0,19,16,3,1491,1,0,3,0,3,1,0,1,0,0,0,0,0,0
3286,3286,Marcel Desailly,2614,2002,Chelsea FC,15,15,0,1336,2,0,16,15,1,1358,0,0,31,30,1,2694,2,0,0,0,0,1,0,1,0,0,0,0,0,0
3287,3287,William Gallas,2040,2002,Chelsea FC,19,17,2,1531,4,0,19,19,0,1710,0,0,38,36,2,3241,4,0,0,0,0,2,0,2,0,0,0,0,0,0
3288,3288,Graeme Le Saux,2615,2002,Chelsea FC,15,14,1,1080,2,0,13,13,0,1100,0,0,28,27,1,2180,2,0,0,0,0,0,0,0,0,0,0,0,0,0
3289,3289,Mario Melchiot,1512,2002,Chelsea FC,17,14,3,1344,0,0,17,17,0,1485,0,0,34,31,3,2829,0,0,0,0,0,0,0,0,0,0,0,0,0,0
3290,3290,Frank Lampard,1536,2002,Chelsea FC,19,18,1,1625,3,0,19,19,0,1682,3,0,38,37,1,3307,6,0,0,4,4,1,3,4,0,0,0,0,0,0
3291,3291,Emmanuel Petit,2616,2002,Chelsea FC,12,11,1,1003,0,0,12,12,0,1053,1,0,24,23,1,2056,1,0,0,0,0,0,0,0,0,0,0,0,0,0
3292,3292,Jody Morris,2293,2002,Chelsea FC,13,10,3,913,0,0,12,9,3,885,0,0,25,19,6,1798,0,0,0,0,0,0,0,0,0,0,0,0,0,0
3293,3293,Eiður Guðjohnsen,2373,2002,Chelsea FC,18,13,5,1204,8,0,17,7,10,819,2,0,35,20,15,2023,10,0,0,0,0,5,1,6,0,0,0,0,0,0
3294,3294,Gianfranco Zola,2617,2002,Chelsea FC,19,13,6,1201,6,0,19,17,2,1494,8,0,38,30,8,2695,14,0,1,3,4,3,5,8,0,0,0,0,0,0
3295,3295,John Terry,1534,2002,Chelsea FC,13,10,3,861,1,0,7,6,1,554,2,0,20,16,4,1415,3,0,0,1,1,0,1,1,0,0,0,0,0,0
3296,3296,Jesper Grønkjær,2618,2002,Chelsea FC,16,11,5,978,2,0,14,9,5,757,2,0,30,20,10,1735,4,0,3,0,3,1,1,2,0,0,0,0,0,0
3297,3297,Carlton Cole,2326,2002,Chelsea FC,8,1,7,206,1,0,5,1,4,182,2,0,13,2,11,388,3,0,3,3,6,1,2,3,0,0,0,0,0,0
3298,3298,Nico Vaesen,2619,2002,Birmingham City,14,14,0,1260,0,0,13,13,0,1170,0,0,27,27,0,2430,0,0,0,0,0,0,0,0,0,0,0,0,0,0
3299,3299,Jeff Kenna,2620,2002,Birmingham City,18,18,0,1469,1,0,19,18,1,1589,0,0,37,36,1,3058,1,0,1,0,1,1,0,1,0,0,0,0,0,0
3300,3300,Darren Purse,1318,2002,Birmingham City,9,9,0,799,1,0,11,10,1,901,0,0,20,19,1,1700,1,0,0,0,0,1,0,1,0,0,0,0,0,0
3301,3301,Kenny Cunningham,1511,2002,Birmingham City,16,16,0,1440,0,0,15,15,0,1323,0,0,31,31,0,2763,0,0,0,0,0,0,0,0,0,0,0,0,0,0
3302,3302,Olivier Tebily,1520,2002,Birmingham City,5,5,0,435,0,0,7,7,0,545,0,0,12,12,0,980,0,0,0,0,0,0,0,0,0,0,0,0,0,0
3303,3303,Darryl Powell,2621,2002,Birmingham City,4,1,3,122,0,0,7,2,5,233,0,0,11,3,8,355,0,0,0,0,0,0,0,0,0,0,0,0,0,0
3304,3304,Aliou Cissé,2622,2002,Birmingham City,10,10,0,900,0,0,11,11,0,981,0,0,21,21,0,1881,0,0,0,0,0,0,0,0,0,0,0,0,0,0
3305,3305,Paul Devlin,2623,2002,Birmingham City,18,10,8,952,2,0,14,10,4,942,1,0,32,20,12,1894,3,0,1,0,1,2,1,3,1,1,2,0,0,0
3306,3306,Robbie Savage,1309,2002,Birmingham City,17,17,0,1513,2,0,16,16,0,1385,2,0,33,33,0,2898,4,0,0,0,0,1,1,2,1,1,2,0,0,0
3307,3307,Stern John,1971,2002,Birmingham City,15,10,5,909,1,0,15,10,5,872,4,0,30,20,10,1781,5,0,0,4,4,1,4,5,0,1,1,0,0,0
3308,3308,Clinton Morrison,1521,2002,Birmingham City,13,10,3,885,2,0,15,14,1,1193,4,0,28,24,4,2078,6,0,0,4,4,1,3,4,0,0,0,0,0,0
3309,3309,Bryan Hughes,1957,2002,Birmingham City,12,4,8,412,2,0,10,6,4,529,0,0,22,10,12,941,2,0,0,0,0,2,0,2,0,0,0,0,0,0
3310,3310,Stan Lazaridis,2624,2002,Birmingham City,15,8,7,843,1,0,15,9,6,927,1,0,30,17,13,1770,2,0,0,0,0,0,1,1,0,0,0,0,0,0
3311,3311,Geoff Horsfield,1326,2002,Birmingham City,16,9,7,898,4,0,15,6,9,713,1,0,31,15,16,1611,5,0,3,0,3,2,0,2,0,0,0,0,0,0
3312,3312,John Ruddy,1367,2015,Norwich City,14,14,0,1260,0,0,13,13,0,1170,0,0,27,27,0,2430,0,0,0,0,0,0,0,0,0,0,0,0,0,0
3313,3313,Andre Wisdom,2625,2015,Norwich City,6,6,0,496,0,0,4,3,1,328,0,0,10,9,1,824,0,0,0,0,0,0,0,0,0,0,0,0,0,0
3314,3314,Robbie Brady,2230,2015,Norwich City,17,16,1,1387,1,0,19,18,1,1601,2,0,36,34,2,2988,3,0,0,3,3,1,2,3,0,0,0,0,0,0
3315,3315,Timm Klose,2626,2015,Norwich City,5,5,0,450,1,0,5,5,0,400,0,0,10,10,0,850,1,0,0,0,0,1,0,1,0,0,0,0,0,0
3316,3316,Martin Olsson,1372,2015,Norwich City,13,9,4,869,1,0,11,11,0,904,0,0,24,20,4,1773,1,0,3,0,3,1,0,1,0,0,0,0,0,0
3317,3317,Ryan Bennett,1382,2015,Norwich City,11,10,1,914,0,0,11,10,1,923,0,0,22,20,2,1837,0,0,0,0,0,0,0,0,0,0,0,0,0,0
3318,3318,Jonny Howson,1374,2015,Norwich City,18,17,1,1501,2,0,18,16,2,1452,1,0,36,33,3,2953,3,0,3,0,3,2,1,3,0,0,0,0,0,0
3319,3319,Matthew Jarvis,2627,2015,Norwich City,9,7,2,546,1,0,10,6,4,475,0,0,19,13,6,1021,1,0,0,0,0,0,0,0,0,0,0,0,0,0
3320,3320,Gary O'Neil,1389,2015,Norwich City,13,10,3,963,0,0,14,9,5,845,0,0,27,19,8,1808,0,0,0,0,0,0,0,0,0,0,0,0,0,0
3321,3321,Steven Naismith,2239,2015,Norwich City,6,6,0,468,1,0,7,5,2,412,0,0,13,11,2,880,1,0,0,0,0,1,0,1,0,0,0,0,0,0
3322,3322,Dieumerci Mbokani,2628,2015,Norwich City,15,8,7,851,6,0,14,7,7,736,1,0,29,15,14,1587,7,0,0,0,0,3,1,4,0,0,0,0,0,0
3323,3323,Wes Hoolahan,1383,2015,Norwich City,18,16,2,1351,4,0,12,9,3,655,0,0,30,25,5,2006,4,0,1,0,1,1,0,1,1,0,1,0,0,0
3324,3324,Nathan Redmond,1244,2015,Norwich City,17,12,5,1132,3,0,18,12,6,1204,3,0,35,24,11,2336,6,0,0,0,0,1,1,2,0,0,0,0,0,0
3325,3325,Cameron Jerome,1783,2015,Norwich City,18,8,10,795,1,0,16,11,5,980,2,0,34,19,15,1775,3,0,0,0,0,1,2,3,0,0,0,0,0,0
3326,3326,Declan Rudd,2629,2015,Norwich City,5,5,0,450,0,0,6,6,0,540,0,0,11,11,0,990,0,0,0,0,0,0,0,0,0,0,0,0,0,0
3327,3327,Sébastien Bassong,1370,2015,Norwich City,15,15,0,1350,1,0,17,15,2,1439,0,0,32,30,2,2789,1,0,0,0,0,1,0,1,0,0,0,0,0,0
3328,3328,Youssuf Mulumbu,1773,2015,Norwich City,2,1,1,91,0,0,5,4,1,280,0,0,7,5,2,371,0,0,0,0,0,0,0,0,0,0,0,0,0,0
3329,3329,Patrick Bamford,1261,2015,Norwich City,2,1,1,79,0,0,5,1,4,157,0,0,7,2,5,236,0,0,0,0,0,0,0,0,0,0,0,0,0,0
3330,3330,Andros Townsend,1176,2015,Newcastle United,6,6,0,515,2,0,7,6,1,574,2,0,13,12,1,1089,4,0,3,0,3,1,0,1,0,0,0,0,0,0
3331,3331,Freddie Woodman,2630,2015,Newcastle United,0,0,0,0,0,0,0,0,0,0,0,0,0,0,0,0,0,0,0,0,0,0,0,0,0,0,0,0,0,0
3332,3332,Jamaal Lascelles,2631,2015,Newcastle United,7,5,2,458,1,0,11,5,6,688,1,0,18,10,8,1146,2,0,0,0,0,1,0,1,0,0,0,0,0,0
3333,3333,Jamie Sterry,2632,2015,Newcastle United,1,0,1,6,0,0,0,0,0,0,0,0,1,0,1,6,0,0,0,0,0,0,0,0,0,0,0,0,0,0
3334,3334,Siem de Jong,2633,2015,Newcastle United,10,2,8,241,0,0,8,1,7,204,0,0,18,3,15,445,0,0,0,0,0,0,0,0,0,0,0,0,0,0
3335,3335,Emmanuel Rivière,2634,2015,Newcastle United,1,1,0,46,0,0,2,0,2,18,0,0,3,1,2,64,0,0,0,0,0,0,0,0,0,0,0,0,0,0
3336,3336,Mark Schwarzer,1328,2007,Middlesbrough FC,17,17,0,1530,0,0,17,17,0,1530,0,0,34,34,0,3060,0,0,0,0,0,0,0,0,0,0,0,0,0,0
3337,3337,Luke Young,1952,2007,Middlesbrough FC,18,18,0,1580,1,0,17,17,0,1530,0,0,35,35,0,3110,1,0,1,0,1,1,0,1,0,0,0,0,0,0
3338,3338,Emanuel Pogatetz,1883,2007,Middlesbrough FC,11,11,0,990,0,0,13,12,1,1141,0,0,24,23,1,2131,0,0,0,0,0,0,0,0,0,0,0,0,0,0
3339,3339,Robert Huth,1884,2007,Middlesbrough FC,6,4,2,404,0,0,7,5,2,515,1,0,13,9,4,919,1,0,0,1,1,0,1,1,0,0,0,0,0,0
3340,3340,David Wheater,2218,2007,Middlesbrough FC,17,17,0,1530,2,0,17,17,0,1486,1,0,34,34,0,3016,3,0,0,0,0,2,1,3,0,0,0,0,0,0
3341,3341,Gary O'Neil,1389,2007,Middlesbrough FC,12,12,0,1062,0,0,14,13,1,1130,0,0,26,25,1,2192,0,0,0,0,0,0,0,0,0,0,0,0,0,0
3342,3342,George Boateng,1333,2007,Middlesbrough FC,17,14,3,1302,1,0,16,15,1,1307,0,0,33,29,4,2609,1,0,0,0,0,1,0,1,0,0,0,0,0,0
3343,3343,Mohamed Shawky,2635,2007,Middlesbrough FC,1,0,1,25,0,0,4,3,1,227,0,0,5,3,2,252,0,0,0,0,0,0,0,0,0,0,0,0,0,0
3344,3344,Stewart Downing,1335,2007,Middlesbrough FC,19,19,0,1708,6,0,19,19,0,1709,3,0,38,38,0,3417,9,0,0,1,1,4,2,6,2,0,2,0,0,0
3345,3345,Tuncay Şanlı,2220,2007,Middlesbrough FC,17,14,3,1070,3,0,17,13,4,1147,5,0,34,27,7,2217,8,0,3,7,10,1,5,6,0,0,0,0,0,0
3346,3346,Jérémie Aliadiére,1530,2007,Middlesbrough FC,15,13,2,1108,3,0,14,13,1,1061,2,0,29,26,3,2169,5,0,6,0,6,2,2,4,0,0,0,0,0,0
3347,3347,Andrew Taylor,2574,2007,Middlesbrough FC,9,9,0,794,0,0,10,9,1,764,0,0,19,18,1,1558,0,0,0,0,0,0,0,0,0,0,0,0,0,0
3348,3348,Lee Cattermole,1687,2007,Middlesbrough FC,13,3,10,362,0,0,11,7,4,632,1,0,24,10,14,994,1,0,0,3,3,0,1,1,0,0,0,0,0,0
3349,3349,Mido,2636,2007,Middlesbrough FC,6,4,2,403,1,0,6,4,2,345,1,0,12,8,4,748,2,0,0,0,0,1,1,2,0,0,0,0,0,0
3350,3350,Darren Randolph,2637,2016,West Ham United,10,10,0,900,0,0,12,12,0,1080,0,0,22,22,0,1980,0,0,0,0,0,0,0,0,0,0,0,0,0,0
3351,3351,Winston Reid,2638,2016,West Ham United,17,17,0,1432,1,0,13,13,0,1158,1,0,30,30,0,2590,2,0,3,0,3,1,0,1,0,0,0,0,0,0
3352,3352,Aaron Cresswell,2199,2016,West Ham United,12,11,1,940,0,0,14,13,1,1192,0,0,26,24,2,2132,0,0,0,0,0,0,0,0,0,0,0,0,0,0
3353,3353,Angelo Ogbonna,2201,2016,West Ham United,9,9,0,766,0,0,11,11,0,990,0,0,20,20,0,1756,0,0,0,0,0,0,0,0,0,0,0,0,0,0
3354,3354,Cheikhou Kouyaté,2311,2016,West Ham United,15,15,0,1331,1,0,16,16,0,1397,0,0,31,31,0,2728,1,0,3,0,3,1,0,1,0,0,0,0,0,0
3355,3355,Manuel Lanzini,2351,2016,West Ham United,18,17,1,1400,5,0,17,14,3,1315,3,0,35,31,4,2715,8,0,3,3,6,2,2,4,0,2,2,0,0,0
3356,3356,Pedro Obiang,2639,2016,West Ham United,13,12,1,987,0,0,9,9,0,780,1,0,22,21,1,1767,1,0,0,0,0,0,1,1,0,0,0,0,0,0
3357,3357,Mark Noble,2204,2016,West Ham United,15,15,0,1273,2,0,15,14,1,1126,1,0,30,29,1,2399,3,0,6,0,6,2,0,2,1,0,1,0,0,0
3358,3358,Dimitri Payet,2640,2016,West Ham United,9,9,0,789,1,0,9,8,1,726,1,0,18,17,1,1515,2,0,1,0,1,1,1,2,0,0,0,0,0,0
3359,3359,Andy Carroll,1779,2016,West Ham United,8,6,2,560,2,0,10,9,1,754,5,0,18,15,3,1314,7,0,0,0,0,0,4,4,0,0,0,0,0,0
3360,3360,Michail Antonio,2208,2016,West Ham United,14,14,0,1182,3,0,15,15,0,1262,6,0,29,29,0,2444,9,0,3,0,3,2,3,5,0,0,0,0,0,0
3361,3361,Håvard Nordtveit,2641,2016,West Ham United,7,5,2,423,0,0,9,6,3,533,0,0,16,11,5,956,0,0,0,0,0,0,0,0,0,0,0,0,0,0
3362,3362,André Ayew,2274,2016,West Ham United,11,6,5,609,1,0,14,10,4,831,5,0,25,16,9,1440,6,0,0,4,4,0,5,5,0,0,0,0,0,0
3363,3363,Ashley Fletcher,2642,2016,West Ham United,11,1,10,220,0,0,5,1,4,134,0,0,16,2,14,354,0,0,0,0,0,0,0,0,0,0,0,0,0,0
3364,3364,Adrián,2309,2016,West Ham United,9,9,0,810,0,0,7,7,0,630,0,0,16,16,0,1440,0,0,0,0,0,0,0,0,0,0,0,0,0,0
3365,3365,Edimilson Fernandes,2643,2016,West Ham United,15,4,11,494,0,0,13,4,9,492,0,0,28,8,20,986,0,0,0,0,0,0,0,0,0,0,0,0,0,0
3366,3366,Domingos Quina,2094,2016,West Ham United,0,0,0,0,0,0,0,0,0,0,0,0,0,0,0,0,0,0,0,0,0,0,0,0,0,0,0,0,0,0
3367,3367,Marcus Browne,2644,2016,West Ham United,0,0,0,0,0,0,0,0,0,0,0,0,0,0,0,0,0,0,0,0,0,0,0,0,0,0,0,0,0,0
3368,3368,Andre Gray,1925,2016,Burnley FC,14,12,2,1035,5,0,18,14,4,1232,4,0,32,26,6,2267,9,0,3,0,3,2,3,5,0,2,2,0,0,0
3369,3369,Ashley Barnes,1491,2016,Burnley FC,13,8,5,727,2,0,15,12,3,1050,4,0,28,20,8,1777,6,0,3,0,3,1,3,4,1,1,2,0,0,0
3370,3370,Glen Johnson,1386,2009,Liverpool FC,12,12,0,1026,2,0,13,12,1,1115,1,0,25,24,1,2141,3,0,0,0,0,0,1,1,0,0,0,0,0,0
3371,3371,Albert Riera,1890,2009,Liverpool FC,6,5,1,388,0,0,6,4,2,262,0,0,12,9,3,650,0,0,0,0,0,0,0,0,0,0,0,0,0,0
3372,3372,Ryan Babel,1897,2009,Liverpool FC,12,4,8,419,3,0,13,5,8,537,1,0,25,9,16,956,4,0,0,0,0,0,0,0,0,0,0,0,0,0
3373,3373,Teemu Tainio,1395,2009,Birmingham City,2,2,0,151,0,0,4,3,1,210,0,0,6,5,1,361,0,0,0,0,0,0,0,0,0,0,0,0,0,0
3374,3374,Grégory Vignal,2645,2009,Birmingham City,3,3,0,215,0,0,5,3,2,287,0,0,8,6,2,502,0,0,0,0,0,0,0,0,0,0,0,0,0,0
3375,3375,Lee Carsley,1803,2009,Birmingham City,3,0,3,52,0,0,4,3,1,301,0,0,7,3,4,353,0,0,0,0,0,0,0,0,0,0,0,0,0,0
3376,3376,Gary McSheffrey,1966,2009,Birmingham City,1,0,1,14,0,0,4,1,3,87,0,0,5,1,4,101,0,0,0,0,0,0,0,0,0,0,0,0,0,0
3377,3377,Jonathan Woodgate,1882,2003,Newcastle United,11,11,0,933,0,0,7,7,0,630,0,0,18,18,0,1563,0,0,0,0,0,0,0,0,0,0,0,0,0,0
3378,3378,Darren Ambrose,1956,2003,Newcastle United,13,6,7,568,0,0,10,3,7,314,2,0,23,9,14,882,2,0,0,2,2,0,2,2,0,0,0,0,0,0
3379,3379,Craig Bellamy,2012,2003,Newcastle United,5,4,1,371,2,0,8,7,1,607,2,0,13,11,2,978,4,0,0,0,0,2,2,4,0,0,0,0,0,0
3380,3380,Ian Walker,2646,2003,Leicester City,19,19,0,1684,0,0,18,18,0,1608,0,0,37,37,0,3292,0,0,0,0,0,0,0,0,0,0,0,0,0,0
3381,3381,Andy Impey,1304,2003,Leicester City,6,5,1,453,0,0,7,6,1,559,0,0,13,11,2,1012,0,0,0,0,0,0,0,0,0,0,0,0,0,0
3382,3382,Gerry Taggart,2647,2003,Leicester City,4,4,0,327,0,0,5,5,0,409,0,0,9,9,0,736,0,0,0,0,0,0,0,0,0,0,0,0,0,0
3383,3383,Callum Davidson,1306,2003,Leicester City,6,4,2,393,0,0,7,4,3,424,0,0,13,8,5,817,0,0,0,0,0,0,0,0,0,0,0,0,0,0
3384,3384,Riccardo Scimeca,1316,2003,Leicester City,14,14,0,1260,0,0,15,14,1,1275,1,0,29,28,1,2535,1,0,0,0,0,0,0,0,0,0,0,0,0,0
3385,3385,Ben Thatcher,1807,2003,Leicester City,15,14,1,1221,0,0,14,14,0,1260,1,0,29,28,1,2481,1,0,0,0,0,0,1,1,0,0,0,0,0,0
3386,3386,Steffen Freund,2079,2003,Leicester City,6,6,0,499,0,0,8,7,1,591,0,0,14,13,1,1090,0,0,0,0,0,0,0,0,0,0,0,0,0,0
3387,3387,Steve Guppy,2648,2003,Leicester City,8,5,3,543,0,0,7,4,3,342,0,0,15,9,6,885,0,0,0,0,0,0,0,0,0,0,0,0,0,0
3388,3388,James Scowcroft,2649,2003,Leicester City,17,16,1,1472,3,0,18,17,1,1528,2,0,35,33,2,3000,5,0,1,0,1,1,2,3,0,0,0,0,0,0
3389,3389,Paul Dickov,1878,2003,Leicester City,18,15,3,1358,6,0,17,13,4,1162,5,0,35,28,7,2520,11,0,0,0,0,3,3,6,1,1,2,0,0,0
3390,3390,Marcus Bent,1349,2003,Leicester City,16,13,3,1144,2,0,17,15,2,1350,7,0,33,28,5,2494,9,0,1,0,1,2,3,5,0,0,0,0,0,0
3391,3391,Frank Sinclair,1305,2003,Leicester City,7,6,1,508,1,0,7,5,2,482,0,0,14,11,3,990,1,0,0,0,0,0,0,0,0,0,0,0,0,0
3392,3392,Jordan Stewart,2113,2003,Leicester City,13,8,5,776,0,0,12,8,4,800,1,0,25,16,9,1576,1,0,0,0,0,0,1,1,0,0,0,0,0,0
3393,3393,Les Ferdinand,2083,2003,Leicester City,14,11,3,795,3,0,15,9,6,807,9,0,29,20,9,1602,12,0,0,5,5,2,6,8,0,0,0,0,0,0
3394,3394,Tomasz Kuszczak,1786,2010,Manchester United,2,2,0,180,0,0,3,3,0,270,0,0,5,5,0,450,0,0,0,0,0,0,0,0,0,0,0,0,0,0
3395,3395,Patrice Evra,1724,2010,Manchester United,18,17,1,1514,1,0,17,17,0,1447,0,0,35,34,1,2961,1,0,0,0,0,1,0,1,0,0,0,0,0,0
3396,3396,Chris Smalling,1640,2010,Manchester United,8,5,3,512,0,0,8,6,2,569,0,0,16,11,5,1081,0,0,0,0,0,0,0,0,0,0,0,0,0,0
3397,3397,Nemanja Vidić,1725,2010,Manchester United,17,17,0,1498,3,0,18,18,0,1620,2,0,35,35,0,3118,5,0,0,1,1,1,2,3,0,0,0,0,0,0
3398,3398,John O'Shea,1729,2010,Manchester United,10,10,0,807,0,0,10,8,2,735,0,0,20,18,2,1542,0,0,0,0,0,0,0,0,0,0,0,0,0,0
3399,3399,Anderson,2018,2010,Manchester United,11,9,2,782,1,0,7,5,2,406,0,0,18,14,4,1188,1,0,0,0,0,1,0,1,0,0,0,0,0,0
3400,3400,Paul Scholes,1112,2010,Manchester United,10,6,4,609,0,0,12,10,2,930,1,0,22,16,6,1539,1,0,0,0,0,0,1,1,0,0,0,0,0,0
3401,3401,Antonio Valencia,1641,2010,Manchester United,5,5,0,433,1,0,5,3,2,309,0,0,10,8,2,742,1,0,0,0,0,0,0,0,0,0,0,0,0,0
3402,3402,Darron Gibson,2538,2010,Manchester United,7,3,4,383,0,0,5,3,2,268,0,0,12,6,6,651,0,0,0,0,0,0,0,0,0,0,0,0,0,0
3403,3403,Dimitar Berbatov,1397,2010,Manchester United,14,12,2,1096,17,0,18,12,6,1115,4,0,32,24,8,2211,21,0,6,3,9,8,2,10,0,0,0,0,0,0
3404,3404,Nani,2258,2010,Manchester United,16,16,0,1389,7,0,17,15,2,1278,2,0,33,31,2,2667,9,0,3,0,3,2,2,4,0,0,0,0,0,0
3405,3405,Fábio,2320,2010,Manchester United,5,2,3,279,0,0,6,3,3,275,1,0,11,5,6,554,1,0,0,0,0,0,0,0,0,0,0,0,0,0
3406,3406,Michael Carrick,1627,2010,Manchester United,14,10,4,832,0,0,14,13,1,1141,0,0,28,23,5,1973,0,0,0,0,0,0,0,0,0,0,0,0,0,0
3407,3407,Michael Owen,1949,2010,Manchester United,6,0,6,134,1,0,5,1,4,96,1,0,11,1,10,230,2,0,0,1,1,0,1,1,0,0,0,0,0,0
3408,3408,Edwin van der Sar,1077,2010,Manchester United,17,17,0,1530,0,0,16,16,0,1440,0,0,33,33,0,2970,0,0,0,0,0,0,0,0,0,0,0,0,0,0
3409,3409,Wes Brown,1108,2010,Manchester United,3,2,1,162,0,0,4,2,2,265,0,0,7,4,3,427,0,0,0,0,0,0,0,0,0,0,0,0,0,0
3410,3410,Ji-Sung Park,1788,2010,Manchester United,8,8,0,641,5,0,7,5,2,443,0,0,15,13,2,1084,5,0,6,0,6,4,0,4,0,0,0,0,0,0
3411,3411,Javier Hernández,2257,2010,Manchester United,10,7,3,631,5,0,17,8,9,854,8,0,27,15,12,1485,13,0,3,6,9,4,5,9,0,0,0,0,0,0
3412,3412,Mark Schwarzer,1328,2010,Fulham FC,16,16,0,1440,0,0,15,15,0,1350,0,0,31,31,0,2790,0,0,0,0,0,0,0,0,0,0,0,0,0,0
3413,3413,Carlos Salcido,2650,2010,Fulham FC,13,13,0,1065,0,0,10,9,1,838,0,0,23,22,1,1903,0,0,0,0,0,0,0,0,0,0,0,0,0,0
3414,3414,Brede Hangeland,1033,2010,Fulham FC,19,19,0,1710,4,0,18,18,0,1620,2,0,37,37,0,3330,6,0,2,0,2,2,1,3,0,0,0,0,0,0
3415,3415,Aaron Hughes,1561,2010,Fulham FC,19,19,0,1695,1,0,19,19,0,1710,0,0,38,38,0,3405,1,0,0,0,0,1,0,1,0,0,0,0,0,0
3416,3416,Chris Baird,1562,2010,Fulham FC,16,13,3,1261,0,0,13,12,1,1124,2,0,29,25,4,2385,2,0,0,0,0,0,1,1,0,0,0,0,0,0
3417,3417,Danny Murphy,1398,2010,Fulham FC,19,19,0,1579,0,0,18,18,0,1550,0,0,37,37,0,3129,0,0,0,0,0,0,0,0,0,0,0,0,0,0
3418,3418,Dickson Etuhu,1969,2010,Fulham FC,13,11,2,918,1,0,15,12,3,1049,1,0,28,23,5,1967,2,0,0,1,1,0,1,1,0,0,0,0,0,0
3419,3419,Mousa Dembélé,1172,2010,Fulham FC,12,11,1,934,3,0,12,11,1,987,0,0,24,22,2,1921,3,0,3,0,3,2,0,2,0,0,0,0,0,0
3420,3420,Clint Dempsey,1565,2010,Fulham FC,19,19,0,1634,8,0,18,16,2,1462,4,0,37,35,2,3096,12,0,1,2,3,4,3,7,1,0,1,0,0,0
3421,3421,Gaël Kakuta,2651,2010,Fulham FC,3,0,3,45,0,0,4,2,2,187,1,0,7,2,5,232,1,0,0,0,0,0,1,1,0,0,0,0,0,0
3422,3422,Bobby Zamora,1943,2010,Fulham FC,7,4,3,339,4,0,7,5,2,419,1,0,14,9,5,758,5,0,3,0,3,3,1,4,1,0,1,0,0,0
3423,3423,Zoltán Gera,1323,2010,Fulham FC,15,6,9,697,1,0,12,4,8,426,0,0,27,10,17,1123,1,0,0,0,0,0,0,0,0,0,0,0,0,0
3424,3424,Jonathan Greening,1321,2010,Fulham FC,5,4,1,306,0,0,5,2,3,221,0,0,10,6,4,527,0,0,0,0,0,0,0,0,0,0,0,0,0,0
3425,3425,Eiður Guðjohnsen,2373,2010,Fulham FC,3,2,1,158,0,0,7,2,5,251,0,0,10,4,6,409,0,0,0,0,0,0,0,0,0,0,0,0,0,0
3426,3426,David Stockdale,2558,2010,Fulham FC,3,3,0,270,0,0,4,4,0,360,0,0,7,7,0,630,0,0,0,0,0,0,0,0,0,0,0,0,0,0
3427,3427,Stephen Kelly,1121,2010,Fulham FC,4,2,2,189,0,0,6,6,0,540,0,0,10,8,2,729,0,0,0,0,0,0,0,0,0,0,0,0,0,0
3428,3428,Rafik Halliche,2652,2010,Fulham FC,1,0,1,15,0,0,0,0,0,0,0,0,1,0,1,15,0,0,0,0,0,0,0,0,0,0,0,0,0,0
3429,3429,Steven Sidwell,1622,2010,Fulham FC,7,5,2,491,2,0,5,5,0,450,0,0,12,10,2,941,2,0,0,0,0,1,0,1,0,0,0,0,0,0
3430,3430,Brad Friedel,1343,2004,Blackburn Rovers,19,19,0,1710,0,0,18,18,0,1620,0,0,37,37,0,3330,0,0,0,0,0,0,0,0,0,0,0,0,0,0
3431,3431,Lucas Neill,1132,2004,Blackburn Rovers,18,17,1,1574,1,0,17,17,0,1530,0,0,35,34,1,3104,1,0,0,0,0,1,0,1,0,0,0,0,0,0
3432,3432,Nils-Eric Johansson,1134,2004,Blackburn Rovers,10,7,3,766,0,0,11,10,1,855,0,0,21,17,4,1621,0,0,0,0,0,0,0,0,0,0,0,0,0,0
3433,3433,Steven Reid,1140,2004,Blackburn Rovers,14,11,3,902,2,0,14,12,2,1057,0,0,28,23,5,1959,2,0,0,0,0,0,0,0,0,0,0,0,0,0
3434,3434,Andy Todd,1672,2004,Blackburn Rovers,12,12,0,1035,1,0,14,14,0,1260,0,0,26,26,0,2295,1,0,1,0,1,1,0,1,0,0,0,0,0,0
3435,3435,Jay McEveley,1569,2004,Blackburn Rovers,2,2,0,180,0,0,3,3,0,270,0,0,5,5,0,450,0,0,0,0,0,0,0,0,0,0,0,0,0,0
3436,3436,Brett Emerton,1141,2004,Blackburn Rovers,19,16,3,1562,3,0,17,16,1,1436,1,0,36,32,4,2998,4,0,3,1,4,3,1,4,0,0,0,0,0,0
3437,3437,Tugay Kerimoğlu,1136,2004,Blackburn Rovers,12,7,5,768,0,0,8,5,3,464,0,0,20,12,8,1232,0,0,0,0,0,0,0,0,0,0,0,0,0,0
3438,3438,Barry Ferguson,1782,2004,Blackburn Rovers,11,11,0,990,1,0,9,9,0,810,1,0,20,20,0,1800,2,0,0,0,0,1,1,2,0,0,0,0,0,0
3439,3439,Paul Dickov,1878,2004,Blackburn Rovers,15,14,1,1255,4,0,13,13,0,1057,5,0,28,27,1,2312,9,0,0,5,5,2,4,6,0,1,1,0,0,0
3440,3440,Matt Jansen,1350,2004,Blackburn Rovers,4,2,2,148,2,0,3,1,2,150,0,0,7,3,4,298,2,0,3,0,3,2,0,2,0,0,0,0,0,0
3441,3441,David Thompson,2102,2004,Blackburn Rovers,13,6,7,623,0,0,11,5,6,551,0,0,24,11,13,1174,0,0,0,0,0,0,0,0,0,0,0,0,0,0
3442,3442,Paul Gallagher,1142,2004,Blackburn Rovers,9,3,6,291,1,0,7,2,5,232,1,0,16,5,11,523,2,0,1,0,1,1,1,2,0,0,0,0,0,0
3443,3443,Maik Taylor,2501,2004,Birmingham City,16,16,0,1440,0,0,18,18,0,1620,0,0,34,34,0,3060,0,0,0,0,0,0,0,0,0,0,0,0,0,0
3444,3444,Jesper Grønkjær,2618,2004,Birmingham City,8,7,1,608,0,0,8,6,2,536,0,0,16,13,3,1144,0,0,0,0,0,0,0,0,0,0,0,0,0,0
3445,3445,Robbie Savage,1309,2004,Birmingham City,9,9,0,807,1,0,8,8,0,716,3,0,17,17,0,1523,4,0,0,0,0,1,2,3,1,0,1,0,0,0
3446,3446,David Dunn,1456,2004,Birmingham City,6,5,1,422,0,0,4,3,1,241,2,0,10,8,2,663,2,0,0,0,0,0,0,0,0,0,0,0,0,0
3447,3447,Julian Gray,2653,2004,Birmingham City,16,9,7,965,2,0,15,9,6,923,0,0,31,18,13,1888,2,0,0,0,0,0,0,0,0,0,0,0,0,0
3448,3448,Damien Johnson,2503,2004,Birmingham City,18,18,0,1596,0,0,17,17,0,1515,0,0,35,35,0,3111,0,0,0,0,0,0,0,0,0,0,0,0,0,0
3449,3449,Darren Anderton,2082,2004,Birmingham City,8,3,5,304,1,0,11,6,5,555,2,0,19,9,10,859,3,0,0,3,3,0,2,2,0,0,0,0,0,0
3450,3450,Dwight Yorke,1223,2004,Birmingham City,8,2,6,335,2,0,5,2,3,184,0,0,13,4,9,519,2,0,1,0,1,2,0,2,0,0,0,0,0,0
3451,3451,Paul Robinson,1262,2009,Wigan Athletic,1,1,0,90,0,0,0,0,0,0,0,0,1,1,0,90,0,0,0,0,0,0,0,0,0,0,0,0,0,0
3452,3452,Christopher Samba,2109,2009,Wigan Athletic,1,1,0,90,0,0,0,0,0,0,0,0,1,1,0,90,0,0,0,0,0,0,0,0,0,0,0,0,0,0
3453,3453,Gaël Givet,2654,2009,Wigan Athletic,1,1,0,90,0,0,0,0,0,0,0,0,1,1,0,90,0,0,0,0,0,0,0,0,0,0,0,0,0,0
3454,3454,Ryan Nelsen,2007,2009,Wigan Athletic,1,1,0,90,0,0,0,0,0,0,0,0,1,1,0,90,0,0,0,0,0,0,0,0,0,0,0,0,0,0
3455,3455,Míchel Salgado,2655,2009,Wigan Athletic,1,1,0,76,0,0,0,0,0,0,0,0,1,1,0,76,0,0,0,0,0,0,0,0,0,0,0,0,0,0
3456,3456,Pascal Chimbonda,1392,2009,Wigan Athletic,1,1,0,67,0,0,0,0,0,0,0,0,1,1,0,67,0,0,0,0,0,0,0,0,0,0,0,0,0,0
3457,3457,Steven N'Zonzi,1550,2009,Wigan Athletic,1,1,0,90,0,0,0,0,0,0,0,0,1,1,0,90,0,0,0,0,0,0,0,0,0,0,0,0,0,0
3458,3458,Keith Andrews,2656,2009,Wigan Athletic,1,1,0,90,0,0,0,0,0,0,0,0,1,1,0,90,0,0,0,0,0,0,0,0,0,0,0,0,0,0
3459,3459,Junior Hoilett,2535,2009,Wigan Athletic,1,1,0,90,0,0,0,0,0,0,0,0,1,1,0,90,0,0,0,0,0,0,0,0,0,0,0,0,0,0
3460,3460,Benny McCarthy,2112,2009,Wigan Athletic,1,1,0,90,0,0,0,0,0,0,0,0,1,1,0,90,0,0,0,0,0,0,0,0,0,0,0,0,0,0
3461,3461,Franco Di Santo,2272,2009,Wigan Athletic,1,1,0,72,0,0,0,0,0,0,0,0,1,1,0,72,0,0,0,0,0,0,0,0,0,0,0,0,0,0
3462,3462,Lars Jacobsen,2657,2009,Wigan Athletic,1,0,1,23,0,0,0,0,0,0,0,0,1,0,1,23,0,0,0,0,0,0,0,0,0,0,0,0,0,0
3463,3463,Morten Gamst Pedersen,2009,2009,Wigan Athletic,1,0,1,14,0,0,0,0,0,0,0,0,1,0,1,14,0,0,0,0,0,0,0,0,0,0,0,0,0,0
3464,3464,Jason Roberts,1820,2009,Wigan Athletic,1,0,1,18,0,0,0,0,0,0,0,0,1,0,1,18,0,0,0,0,0,0,0,0,0,0,0,0,0,0
3465,3465,Mathew Ryan,2415,2017,Brighton & Hove Albion,19,19,0,1710,0,0,19,19,0,1710,0,0,38,38,0,3420,0,0,0,0,0,0,0,0,0,0,0,0,0,0
3466,3466,Bruno,2481,2017,Brighton & Hove Albion,14,12,2,1073,0,0,11,11,0,945,0,0,25,23,2,2018,0,0,0,0,0,0,0,0,0,0,0,0,0,0
3467,3467,Gaëtan Bong,2483,2017,Brighton & Hove Albion,11,11,0,990,0,0,14,14,0,1248,0,0,25,25,0,2238,0,0,0,0,0,0,0,0,0,0,0,0,0,0
3468,3468,Lewis Dunk,2416,2017,Brighton & Hove Albion,19,19,0,1710,1,0,19,19,0,1710,0,0,38,38,0,3420,1,0,0,0,0,1,0,1,0,0,0,0,0,0
3469,3469,Shane Duffy,2429,2017,Brighton & Hove Albion,18,18,0,1603,0,0,19,19,0,1691,0,0,37,37,0,3294,0,0,0,0,0,0,0,0,0,0,0,0,0,0
3470,3470,Dale Stephens,2421,2017,Brighton & Hove Albion,18,18,0,1620,0,0,18,18,0,1620,0,0,36,36,0,3240,0,0,0,0,0,0,0,0,0,0,0,0,0,0
3471,3471,Pascal Groß,2426,2017,Brighton & Hove Albion,19,19,0,1614,7,0,19,16,3,1335,0,0,38,35,3,2949,7,0,7,0,7,5,0,5,1,0,1,0,0,0
3472,3472,Davy Pröpper,2423,2017,Brighton & Hove Albion,18,18,0,1620,0,0,17,17,0,1516,0,0,35,35,0,3136,0,0,0,0,0,0,0,0,0,0,0,0,0,0
3473,3473,Anthony Knockaert,2482,2017,Brighton & Hove Albion,16,15,1,1284,3,0,17,12,5,1150,0,0,33,27,6,2434,3,0,0,0,0,2,0,2,0,0,0,0,0,0
3474,3474,Glenn Murray,1010,2017,Brighton & Hove Albion,18,14,4,1220,7,0,17,11,6,977,5,0,35,25,10,2197,12,0,1,3,4,4,3,7,2,2,4,0,0,0
3475,3475,José Izquierdo,2658,2017,Brighton & Hove Albion,16,11,5,989,2,0,16,12,4,998,3,0,32,23,9,1987,5,0,1,0,1,2,1,3,0,0,0,0,0,0
3476,3476,Solly March,2422,2017,Brighton & Hove Albion,18,8,10,808,0,0,18,10,8,1035,1,0,36,18,18,1843,1,0,0,0,0,0,1,1,0,0,0,0,0,0
3477,3477,Izzy Brown,2659,2017,Brighton & Hove Albion,8,2,6,136,0,0,5,2,3,170,0,0,13,4,9,306,0,0,0,0,0,0,0,0,0,0,0,0,0,0
3478,3478,Tim Krul,1822,2017,Brighton & Hove Albion,0,0,0,0,0,0,0,0,0,0,0,0,0,0,0,0,0,0,0,0,0,0,0,0,0,0,0,0,0,0
3479,3479,Connor Goldson,2660,2017,Brighton & Hove Albion,2,2,0,180,0,0,1,0,1,19,0,0,3,2,1,199,0,0,0,0,0,0,0,0,0,0,0,0,0,0
3480,3480,Ezequiel Schelotto,2507,2017,Brighton & Hove Albion,9,7,2,615,0,0,11,8,3,701,0,0,20,15,5,1316,0,0,0,0,0,0,0,0,0,0,0,0,0,0
3481,3481,Markus Suttner,2661,2017,Brighton & Hove Albion,8,8,0,720,0,0,6,5,1,458,0,0,14,13,1,1178,0,0,0,0,0,0,0,0,0,0,0,0,0,0
3482,3482,Tomer Hemed,2662,2017,Brighton & Hove Albion,7,5,2,420,2,0,9,4,5,428,0,0,16,9,7,848,2,0,3,0,3,1,0,1,0,0,0,0,0,0
3483,3483,Jack Stephens,2329,2017,Southampton FC,11,11,0,990,1,0,11,11,0,990,1,0,22,22,0,1980,2,0,1,0,1,1,1,2,0,0,0,0,0,0
3484,3484,Sam McQueen,1246,2017,Southampton FC,2,0,2,13,0,0,5,1,4,129,0,0,7,1,6,142,0,0,0,0,0,0,0,0,0,0,0,0,0,0
3485,3485,Victor Wanyama,1864,2014,Southampton FC,16,12,4,1156,1,0,16,14,2,1204,2,0,32,26,6,2360,3,0,0,6,6,0,2,2,0,0,0,0,0,0
3486,3486,Filip Đuričić,2663,2014,Southampton FC,4,2,2,173,0,0,5,1,4,154,0,0,9,3,6,327,0,0,0,0,0,0,0,0,0,0,0,0,0,0
3487,3487,Shay Given,1581,2014,Aston Villa,2,2,0,180,0,0,1,1,0,90,0,0,3,3,0,270,0,0,0,0,0,0,0,0,0,0,0,0,0,0
3488,3488,Ron Vlaar,1436,2014,Aston Villa,11,11,0,915,0,0,9,8,1,732,0,0,20,19,1,1647,0,0,0,0,0,0,0,0,0,0,0,0,0,0
3489,3489,Jores Okore,2664,2014,Aston Villa,11,10,1,929,1,0,12,12,0,1080,0,0,23,22,1,2009,1,0,0,0,0,1,0,1,0,0,0,0,0,0
3490,3490,Leandro Bacuna,1438,2014,Aston Villa,12,6,6,586,0,0,7,4,3,394,0,0,19,10,9,980,0,0,0,0,0,0,0,0,0,0,0,0,0,0
3491,3491,Alan Hutton,2172,2014,Aston Villa,16,13,3,1202,1,0,14,14,0,1216,0,0,30,27,3,2418,1,0,3,0,3,1,0,1,0,0,0,0,0,0
3492,3492,Tom Cleverley,2091,2014,Aston Villa,15,15,0,1122,2,0,16,16,0,1398,1,0,31,31,0,2520,3,0,3,0,3,1,0,1,0,0,0,0,0,0
3493,3493,Ashley Westwood,1440,2014,Aston Villa,13,12,1,1010,0,0,14,13,1,1142,0,0,27,25,2,2152,0,0,0,0,0,0,0,0,0,0,0,0,0,0
3494,3494,Fabian Delph,1198,2014,Aston Villa,15,15,0,1350,0,0,13,12,1,1124,0,0,28,27,1,2474,0,0,0,0,0,0,0,0,0,0,0,0,0,0
3495,3495,Charles N'Zogbia,2016,2014,Aston Villa,15,12,3,880,0,0,12,7,5,553,0,0,27,19,8,1433,0,0,0,0,0,0,0,0,0,0,0,0,0,0
3496,3496,Jack Grealish,1870,2014,Aston Villa,11,4,7,525,0,0,6,3,3,290,0,0,17,7,10,815,0,0,0,0,0,0,0,0,0,0,0,0,0,0
3497,3497,Christian Benteke,1443,2014,Aston Villa,15,13,2,1206,7,0,14,13,1,1198,6,0,29,26,3,2404,13,0,4,6,10,6,3,9,1,0,1,0,0,0
3498,3498,Matthew Lowton,1250,2014,Aston Villa,4,3,1,285,0,0,8,5,3,469,0,0,12,8,4,754,0,0,0,0,0,0,0,0,0,0,0,0,0,0
3499,3499,Scott Sinclair,1420,2014,Aston Villa,4,2,2,214,1,0,5,3,2,247,0,0,9,5,4,461,1,0,0,0,0,1,0,1,0,0,0,0,0,0
3500,3500,Gabriel Agbonlahor,1442,2014,Aston Villa,16,14,2,1258,3,0,18,16,2,1460,3,0,34,30,4,2718,6,0,0,3,3,3,1,4,0,0,0,0,0,0
3501,3501,Brad Guzan,1435,2014,Aston Villa,16,16,0,1440,0,0,18,18,0,1620,0,0,34,34,0,3060,0,0,0,0,0,0,0,0,0,0,0,0,0,0
3502,3502,Philippe Senderos,1228,2014,Aston Villa,4,4,0,360,0,0,4,3,1,272,0,0,8,7,1,632,0,0,0,0,0,0,0,0,0,0,0,0,0,0
3503,3503,Carlos Sánchez,1867,2014,Aston Villa,15,10,5,1015,0,0,13,10,3,971,1,0,28,20,8,1986,1,0,0,0,0,0,1,1,0,0,0,0,0,0
3504,3504,Andreas Weimann,1441,2014,Aston Villa,14,10,4,882,2,0,17,10,7,896,1,0,31,20,11,1778,3,0,0,3,3,1,1,2,0,0,0,0,0,0
3505,3505,Dean Kiely,2334,2003,Charlton Athletic,18,18,0,1620,0,0,18,18,0,1620,0,0,36,36,0,3240,0,0,0,0,0,0,0,0,0,0,0,0,0,0
3506,3506,Radostin Kishishev,1668,2003,Charlton Athletic,17,16,1,1293,0,0,15,13,2,1202,0,0,32,29,3,2495,0,0,0,0,0,0,0,0,0,0,0,0,0,0
3507,3507,Hermann Hreiðarsson,1953,2003,Charlton Athletic,16,16,0,1440,1,0,16,16,0,1439,1,0,32,32,0,2879,2,0,0,3,3,1,1,2,0,0,0,0,0,0
3508,3508,Jonathan Fortune,2665,2003,Charlton Athletic,12,9,3,903,1,0,15,11,4,1032,1,0,27,20,7,1935,2,0,0,0,0,1,1,2,0,0,0,0,0,0
3509,3509,Chris Perry,1954,2003,Charlton Athletic,15,14,1,1263,1,0,13,10,3,955,0,0,28,24,4,2218,1,0,0,0,0,0,0,0,0,0,0,0,0,0
3510,3510,Graham Stuart,1673,2003,Charlton Athletic,13,11,2,1020,2,0,14,11,3,914,1,0,27,22,5,1934,3,0,0,3,3,1,1,2,0,0,0,0,0,0
3511,3511,Scott Parker,1282,2003,Charlton Athletic,10,10,0,886,0,0,9,9,0,810,2,0,19,19,0,1696,2,0,0,0,0,0,1,1,0,0,0,0,0,0
3512,3512,Matt Holland,1955,2003,Charlton Athletic,19,19,0,1697,3,0,18,18,0,1620,3,0,37,37,0,3317,6,0,4,0,4,3,2,5,0,0,0,0,0,0
3513,3513,Jason Euell,1886,2003,Charlton Athletic,17,13,4,1233,7,0,13,10,3,921,3,0,30,23,7,2154,10,0,0,1,1,4,2,6,2,1,3,0,0,0
3514,3514,Paolo Di Canio,2042,2003,Charlton Athletic,15,11,4,924,2,0,15,11,4,1003,2,0,30,22,8,1927,4,0,0,2,2,2,2,4,2,1,3,0,0,0
3515,3515,Jonatan Johansson,1676,2003,Charlton Athletic,13,8,5,738,4,0,13,8,5,681,0,0,26,16,10,1419,4,0,0,0,0,1,0,1,0,0,0,0,0,0
3516,3516,Chris Powell,1669,2003,Charlton Athletic,8,5,3,475,0,0,8,6,2,489,0,0,16,11,5,964,0,0,0,0,0,0,0,0,0,0,0,0,0,0
3517,3517,Paul Konchesky,1560,2003,Charlton Athletic,12,8,4,715,0,0,9,9,0,766,0,0,21,17,4,1481,0,0,0,0,0,0,0,0,0,0,0,0,0,0
3518,3518,Marcel Desailly,2614,2003,Chelsea FC,9,9,0,810,0,0,6,6,0,521,0,0,15,15,0,1331,0,0,0,0,0,0,0,0,0,0,0,0,0,0
3519,3519,Jesper Grønkjær,2618,2003,Chelsea FC,15,9,6,746,1,0,15,9,6,811,1,0,30,18,12,1557,2,0,3,0,3,1,1,2,0,0,0,0,0,0
3520,3520,Jimmy Floyd Hasselbaink,1337,2003,Chelsea FC,14,10,4,952,8,0,16,12,4,1025,5,0,30,22,8,1977,13,0,10,6,16,5,3,8,2,0,2,0,0,0
3521,3521,Geremi,1764,2003,Chelsea FC,12,9,3,843,1,0,12,9,3,836,0,0,24,18,6,1679,1,0,0,0,0,0,0,0,0,0,0,0,0,0
3522,3522,Coutinho,1425,2017,Liverpool FC,8,7,1,596,2,0,6,6,0,520,5,0,14,13,1,1116,7,0,0,0,0,1,3,4,0,0,0,0,0,0
3523,3523,Kasper Schmeichel,2435,2017,Leicester City,16,16,0,1440,0,0,17,17,0,1526,0,0,33,33,0,2966,0,0,0,0,0,0,0,0,0,0,0,0,0,0
3524,3524,Marc Albrighton,1448,2017,Leicester City,17,16,1,1357,1,0,17,14,3,1221,1,0,34,30,4,2578,2,0,0,0,0,0,1,1,0,0,0,0,0,0
3525,3525,Daniel Amartey,2666,2017,Leicester City,4,3,1,233,0,0,4,3,1,272,0,0,8,6,2,505,0,0,0,0,0,0,0,0,0,0,0,0,0,0
3526,3526,Wilfred Ndidi,2442,2017,Leicester City,16,16,0,1440,0,0,17,17,0,1491,0,0,33,33,0,2931,0,0,0,0,0,0,0,0,0,0,0,0,0,0
3527,3527,Matty James,2516,2017,Leicester City,7,6,1,546,0,0,6,5,1,449,0,0,13,11,2,995,0,0,0,0,0,0,0,0,0,0,0,0,0,0
3528,3528,Islam Slimani,2667,2017,Leicester City,7,2,5,185,1,0,5,0,5,56,0,0,12,2,10,241,1,0,0,0,0,0,0,0,0,0,0,0,0,0
3529,3529,Shinji Okazaki,2668,2017,Leicester City,12,5,7,491,2,0,15,12,3,838,4,0,27,17,10,1329,6,0,0,0,0,1,1,2,0,0,0,0,0,0
3530,3530,Ahmed Musa,2669,2017,Leicester City,0,0,0,0,0,0,0,0,0,0,0,0,0,0,0,0,0,0,0,0,0,0,0,0,0,0,0,0,0,0
3531,3531,De Gea,1638,2011,Manchester United,13,13,0,1170,0,0,15,15,0,1350,0,0,28,28,0,2520,0,0,0,0,0,0,0,0,0,0,0,0,0,0
3532,3532,Patrice Evra,1724,2011,Manchester United,18,18,0,1595,0,0,18,18,0,1554,0,0,36,36,0,3149,0,0,0,0,0,0,0,0,0,0,0,0,0,0
3533,3533,Rio Ferdinand,1294,2011,Manchester United,14,13,1,1166,0,0,16,16,0,1399,0,0,30,29,1,2565,0,0,0,0,0,0,0,0,0,0,0,0,0,0
3534,3534,Jonny Evans,1216,2011,Manchester United,14,14,0,1216,0,0,14,13,1,1163,1,0,28,27,1,2379,1,0,0,0,0,0,1,1,0,0,0,0,0,0
3535,3535,Rafael,1787,2011,Manchester United,8,7,1,610,0,0,4,3,1,316,0,0,12,10,2,926,0,0,0,0,0,0,0,0,0,0,0,0,0,0
3536,3536,Michael Carrick,1627,2011,Manchester United,15,13,2,1205,1,0,15,14,1,1311,1,0,30,27,3,2516,2,0,0,0,0,0,0,0,0,0,0,0,0,0
3537,3537,Ashley Young,1619,2011,Manchester United,10,9,1,755,3,0,14,9,5,756,3,0,24,18,6,1511,6,0,0,0,0,0,0,0,0,0,0,0,0,0
3538,3538,Paul Scholes,1112,2011,Manchester United,9,8,1,638,3,0,8,6,2,530,1,0,17,14,3,1168,4,0,0,0,0,2,1,3,0,0,0,0,0,0
3539,3539,Antonio Valencia,1641,2011,Manchester United,13,12,1,1106,1,0,14,10,4,1013,3,0,27,22,5,2119,4,0,0,0,0,0,2,2,0,0,0,0,0,0
3540,3540,Wayne Rooney,1058,2011,Manchester United,16,15,1,1338,17,0,17,16,1,1409,10,0,33,31,2,2747,27,0,3,3,6,6,4,10,4,2,6,0,0,0
3541,3541,Danny Welbeck,1506,2011,Manchester United,13,12,1,1011,6,0,16,10,6,970,3,0,29,22,7,1981,9,0,0,3,3,3,2,5,0,0,0,0,0,0
3542,3542,Tom Cleverley,2091,2011,Manchester United,5,1,4,144,0,0,4,3,1,198,0,0,9,4,5,342,0,0,0,0,0,0,0,0,0,0,0,0,0,0
3543,3543,Dimitar Berbatov,1397,2011,Manchester United,7,3,4,326,6,0,5,2,3,189,1,0,12,5,7,515,7,0,0,0,0,1,0,1,2,0,2,0,0,0
3544,3544,Nani,2258,2011,Manchester United,12,11,1,907,6,0,16,12,4,1133,2,0,28,23,5,2040,8,0,0,0,0,1,1,2,0,0,0,0,0,0
3545,3545,Ben Amos,2260,2011,Manchester United,1,1,0,90,0,0,0,0,0,0,0,0,1,1,0,90,0,0,0,0,0,0,0,0,0,0,0,0,0,0
3546,3546,Phil Jones,1650,2011,Manchester United,11,8,3,766,0,0,17,16,1,1271,1,0,28,24,4,2037,1,0,0,3,3,0,1,1,0,0,0,0,0,0
3547,3547,Ryan Giggs,1110,2011,Manchester United,8,4,4,419,0,0,16,10,6,1029,2,0,24,14,10,1448,2,0,0,3,3,0,1,1,0,0,0,0,0,0
3548,3548,Javier Hernández,2257,2011,Manchester United,14,9,5,788,2,0,13,9,4,638,8,0,27,18,9,1426,10,0,0,8,8,2,5,7,1,0,1,0,0,0
3549,3549,Ciaran Clark,1437,2011,Aston Villa,6,5,1,459,1,0,9,8,1,689,0,0,15,13,2,1148,1,0,0,0,0,1,0,1,0,0,0,0,0,0
3550,3550,Eric Lichaj,1976,2011,Aston Villa,5,5,0,450,1,0,5,4,1,372,0,0,10,9,1,822,1,0,0,0,0,1,0,1,0,0,0,0,0,0
3551,3551,Nathan Baker,1973,2011,Aston Villa,5,4,1,361,0,0,3,2,1,189,0,0,8,6,2,550,0,0,0,0,0,0,0,0,0,0,0,0,0,0
3552,3552,Samir Carruthers,2670,2011,Aston Villa,0,0,0,0,0,0,3,0,3,20,0,0,3,0,3,20,0,0,0,0,0,0,0,0,0,0,0,0,0,0
3553,3553,Emile Heskey,1519,2011,Aston Villa,13,7,6,615,1,0,15,11,4,847,0,0,28,18,10,1462,1,0,0,0,0,0,0,0,0,0,0,0,0,0
3554,3554,Carlos Cuéllar,1401,2011,Aston Villa,9,8,1,734,0,0,9,9,0,760,0,0,18,17,1,1494,0,0,0,0,0,0,0,0,0,0,0,0,0,0
3555,3555,Daniel Johnson,2599,2011,Aston Villa,0,0,0,0,0,0,0,0,0,0,0,0,0,0,0,0,0,0,0,0,0,0,0,0,0,0,0,0,0,0
3556,3556,Jussi Jääskeläinen,1710,2009,Bolton Wanderers,19,19,0,1710,0,0,19,19,0,1710,0,0,38,38,0,3420,0,0,0,0,0,0,0,0,0,0,0,0,0,0
3557,3557,Zat Knight,1755,2009,Bolton Wanderers,18,18,0,1620,1,0,17,17,0,1530,0,0,35,35,0,3150,1,0,3,0,3,1,0,1,0,0,0,0,0,0
3558,3558,Grétar Steinsson,2410,2009,Bolton Wanderers,11,10,1,867,0,0,16,15,1,1371,0,0,27,25,2,2238,0,0,0,0,0,0,0,0,0,0,0,0,0,0
3559,3559,Andy O'Brien,2160,2009,Bolton Wanderers,3,3,0,243,0,0,3,3,0,270,0,0,6,6,0,513,0,0,0,0,0,0,0,0,0,0,0,0,0,0
3560,3560,Fabrice Muamba,1964,2009,Bolton Wanderers,19,19,0,1588,1,0,17,16,1,1361,0,0,36,35,1,2949,1,0,0,0,0,0,0,0,0,0,0,0,0,0
3561,3561,Tamir Cohen,2671,2009,Bolton Wanderers,14,14,0,1198,1,0,13,12,1,922,2,0,27,26,1,2120,3,0,0,0,0,1,2,3,0,0,0,0,0,0
3562,3562,Chung-yong Lee,2126,2009,Bolton Wanderers,17,13,4,1179,3,0,17,14,3,1232,1,0,34,27,7,2411,4,0,3,3,6,3,1,4,0,0,0,0,0,0
3563,3563,Jack Wilshere,1694,2009,Bolton Wanderers,6,6,0,499,0,0,8,7,1,592,1,0,14,13,1,1091,1,0,0,0,0,0,0,0,0,0,0,0,0,0
3564,3564,Johan Elmander,1378,2009,Bolton Wanderers,13,8,5,698,1,0,12,7,5,662,2,0,25,15,10,1360,3,0,0,0,0,1,0,1,0,0,0,0,0,0
3565,3565,Kevin Davies,1718,2009,Bolton Wanderers,19,19,0,1696,5,0,18,18,0,1620,1,0,37,37,0,3316,6,0,0,0,0,2,1,3,1,0,1,0,0,0
3566,3566,Matthew Taylor,1069,2009,Bolton Wanderers,18,14,4,1239,2,0,19,15,4,1342,6,0,37,29,8,2581,8,0,1,3,4,1,4,5,1,2,3,0,0,0
3567,3567,Vladimír Weiss,2672,2009,Bolton Wanderers,7,2,5,198,0,0,6,1,5,188,0,0,13,3,10,386,0,0,0,0,0,0,0,0,0,0,0,0,0,0
3568,3568,Ivan Klasnić,2496,2009,Bolton Wanderers,15,7,8,711,7,0,12,5,7,495,1,0,27,12,15,1206,8,0,3,0,3,7,1,8,1,0,1,0,0,0
3569,3569,Gary Caldwell,2673,2009,Wigan Athletic,8,8,0,720,1,0,8,8,0,720,1,0,16,16,0,1440,2,0,0,0,0,1,1,2,0,0,0,0,0,0
3570,3570,James McCarthy,1053,2009,Wigan Athletic,11,10,1,836,0,0,9,9,0,801,1,0,20,19,1,1637,1,0,0,0,0,0,1,1,0,0,0,0,0,0
3571,3571,Victor Moses,1434,2009,Wigan Athletic,8,1,7,237,1,0,6,1,5,193,0,0,14,2,12,430,1,0,0,0,0,1,0,1,0,0,0,0,0,0
3572,3572,Leroy Sané,1205,2019,Manchester City,1,0,1,11,0,0,0,0,0,0,0,0,1,0,1,11,0,0,0,0,0,0,0,0,0,0,0,0,0,0
3573,3573,Scott Carson,1999,2019,Manchester City,0,0,0,0,0,0,0,0,0,0,0,0,0,0,0,0,0,0,0,0,0,0,0,0,0,0,0,0,0,0
3574,3574,Benjamin Mendy,2674,2019,Manchester City,10,10,0,826,0,0,9,8,1,671,0,0,19,18,1,1497,0,0,0,0,0,0,0,0,0,0,0,0,0,0
3575,3575,Josh Brownhill,2675,2019,Burnley FC,5,4,1,356,0,0,5,5,0,450,0,0,10,9,1,806,0,0,0,0,0,0,0,0,0,0,0,0,0,0
3576,3576,Matěj Vydra,2302,2019,Burnley FC,7,3,4,341,1,0,12,4,8,471,1,0,19,7,12,812,2,0,0,3,3,1,1,2,0,0,0,0,0,0
3577,3577,Max Thompson,2676,2019,Burnley FC,0,0,0,0,0,0,1,0,1,2,0,0,1,0,1,2,0,0,0,0,0,0,0,0,0,0,0,0,0,0
3578,3578,Bailey Peacock-Farrell,2677,2019,Burnley FC,0,0,0,0,0,0,0,0,0,0,0,0,0,0,0,0,0,0,0,0,0,0,0,0,0,0,0,0,0,0
3579,3579,Lukas Jensen,2678,2019,Burnley FC,0,0,0,0,0,0,0,0,0,0,0,0,0,0,0,0,0,0,0,0,0,0,0,0,0,0,0,0,0,0
3580,3580,Jimmy Dunne,2679,2019,Burnley FC,0,0,0,0,0,0,0,0,0,0,0,0,0,0,0,0,0,0,0,0,0,0,0,0,0,0,0,0,0,0
3581,3581,Bobby Thomas,2680,2019,Burnley FC,0,0,0,0,0,0,0,0,0,0,0,0,0,0,0,0,0,0,0,0,0,0,0,0,0,0,0,0,0,0
3582,3582,Ian Walker,2646,2001,Leicester City,17,17,0,1464,0,0,17,17,0,1530,0,0,34,34,0,2994,0,0,0,0,0,0,0,0,0,0,0,0,0,0
3583,3583,Jacob Laursen,2681,2001,Leicester City,6,6,0,540,0,0,3,3,0,270,0,0,9,9,0,810,0,0,0,0,0,0,0,0,0,0,0,0,0,0
3584,3584,Damien Delaney,1022,2001,Leicester City,1,1,0,90,0,0,2,1,1,150,0,0,3,2,1,240,0,0,0,0,0,0,0,0,0,0,0,0,0,0
3585,3585,Frank Sinclair,1305,2001,Leicester City,19,18,1,1555,0,0,15,14,1,1249,0,0,34,32,2,2804,0,0,0,0,0,0,0,0,0,0,0,0,0,0
3586,3586,Lee Marshall,1308,2001,Leicester City,17,14,3,1236,0,0,18,15,3,1423,0,0,35,29,6,2659,0,0,0,0,0,0,0,0,0,0,0,0,0,0
3587,3587,Muzzy Izzet,2682,2001,Leicester City,16,15,1,1382,3,0,15,14,1,1205,1,0,31,29,2,2587,4,0,0,3,3,2,1,3,1,1,2,0,0,0
3588,3588,Robbie Savage,1309,2001,Leicester City,18,18,0,1620,0,0,16,16,0,1374,0,0,34,34,0,2994,0,0,0,0,0,0,0,0,0,0,0,0,0,0
3589,3589,Matthew Piper,2683,2001,Leicester City,9,8,1,705,1,0,6,5,1,461,0,0,15,13,2,1166,1,0,3,0,3,1,0,1,0,0,0,0,0,0
3590,3590,James Scowcroft,2649,2001,Leicester City,11,10,1,833,3,0,12,10,2,852,2,0,23,20,3,1685,5,0,0,1,1,3,1,4,0,0,0,0,0,0
3591,3591,Paul Dickov,1878,2001,Leicester City,7,6,1,548,3,0,5,5,0,415,1,0,12,11,1,963,4,0,3,0,3,3,1,4,0,0,0,0,0,0
3592,3592,Brian Deane,2072,2001,Leicester City,7,5,2,499,0,0,8,8,0,684,6,0,15,13,2,1183,6,0,0,0,0,0,2,2,0,0,0,0,0,0
3593,3593,Stefan Oakes,1313,2001,Leicester City,12,9,3,764,0,0,8,6,2,581,1,0,20,15,5,1345,1,0,0,0,0,0,0,0,0,0,0,0,0,0
3594,3594,Dean Kiely,2334,2001,Charlton Athletic,18,18,0,1620,0,0,16,16,0,1440,0,0,34,34,0,3060,0,0,0,0,0,0,0,0,0,0,0,0,0,0
3595,3595,Jorge Costa,2684,2001,Charlton Athletic,10,10,0,900,0,0,11,9,2,864,0,0,21,19,2,1764,0,0,0,0,0,0,0,0,0,0,0,0,0,0
3596,3596,Chris Powell,1669,2001,Charlton Athletic,18,17,1,1521,0,0,15,15,0,1343,1,0,33,32,1,2864,1,0,0,3,3,0,1,1,0,0,0,0,0,0
3597,3597,Paul Konchesky,1560,2001,Charlton Athletic,15,9,6,840,0,0,16,10,6,997,1,0,31,19,12,1837,1,0,0,0,0,0,0,0,0,0,0,0,0,0
3598,3598,Luke Young,1952,2001,Charlton Athletic,16,16,0,1318,0,0,15,15,0,1319,0,0,31,31,0,2637,0,0,0,0,0,0,0,0,0,0,0,0,0,0
3599,3599,Jonathan Fortune,2665,2001,Charlton Athletic,8,4,4,448,0,0,8,7,1,631,0,0,16,11,5,1079,0,0,0,0,0,0,0,0,0,0,0,0,0,0
3600,3600,Graham Stuart,1673,2001,Charlton Athletic,14,14,0,1224,2,0,13,13,0,1134,1,0,27,27,0,2358,3,0,0,0,0,1,1,2,0,0,0,0,0,0
3601,3601,Scott Parker,1282,2001,Charlton Athletic,18,17,1,1413,1,0,16,15,1,1246,0,0,34,32,2,2659,1,0,0,0,0,1,0,1,0,0,0,0,0,0
3602,3602,Chris Bart-Williams,2685,2001,Charlton Athletic,6,3,3,250,1,0,8,6,2,555,0,0,14,9,5,805,1,0,3,0,3,1,0,1,0,0,0,0,0,0
3603,3603,Jason Euell,1886,2001,Charlton Athletic,17,15,2,1340,6,0,15,13,2,1226,5,0,32,28,4,2566,11,0,6,2,8,6,2,8,0,0,0,0,0,0
3604,3604,Mathias Svensson,2335,2001,Charlton Athletic,4,1,3,135,0,0,6,4,2,349,0,0,10,5,5,484,0,0,0,0,0,0,0,0,0,0,0,0,0,0
3605,3605,Steve Brown,2686,2001,Charlton Athletic,7,7,0,566,0,0,5,3,2,335,2,0,12,10,2,901,2,0,0,0,0,0,1,1,0,0,0,0,0,0
3606,3606,Jordan Henderson,1426,2017,Liverpool FC,13,13,0,1145,0,0,14,12,2,1028,1,0,27,25,2,2173,1,0,0,0,0,0,0,0,0,0,0,0,0,0
3607,3607,Alberto Moreno,2128,2017,Liverpool FC,7,6,1,543,0,0,9,8,1,721,0,0,16,14,2,1264,0,0,0,0,0,0,0,0,0,0,0,0,0,0
3608,3608,Sander Westerveld,2687,2000,Liverpool FC,19,19,0,1710,0,0,17,17,0,1530,0,0,36,36,0,3240,0,0,0,0,0,0,0,0,0,0,0,0,0,0
3609,3609,Stéphane Henchoz,2360,2000,Liverpool FC,17,17,0,1530,0,0,13,13,0,1141,0,0,30,30,0,2671,0,0,0,0,0,0,0,0,0,0,0,0,0,0
3610,3610,Markus Babbel,2688,2000,Liverpool FC,19,19,0,1653,2,0,17,17,0,1521,1,0,36,36,0,3174,3,0,3,0,3,1,1,2,0,0,0,0,0,0
3611,3611,Sami Hyypiä,2361,2000,Liverpool FC,17,17,0,1530,0,0,17,17,0,1530,3,0,34,34,0,3060,3,0,0,0,0,0,2,2,0,0,0,0,0,0
3612,3612,Jamie Carragher,1778,2000,Liverpool FC,17,14,3,1263,0,0,15,14,1,1248,0,0,32,28,4,2511,0,0,0,0,0,0,0,0,0,0,0,0,0,0
3613,3613,Danny Murphy,1398,2000,Liverpool FC,12,4,8,518,0,0,12,7,5,716,4,0,24,11,13,1234,4,0,0,3,3,0,2,2,0,0,0,0,0,0
3614,3614,Patrik Berger,2689,2000,Liverpool FC,8,6,2,473,1,0,5,5,0,417,1,0,13,11,2,890,2,0,0,0,0,0,0,0,1,0,1,0,0,0
3615,3615,Dietmar Hamann,2690,2000,Liverpool FC,15,13,2,1144,2,0,13,11,2,1022,0,0,28,24,4,2166,2,0,3,0,3,1,0,1,0,0,0,0,0,0
3616,3616,Steven Gerrard,1424,2000,Liverpool FC,18,16,2,1403,5,0,13,11,2,985,2,0,31,27,4,2388,7,0,0,0,0,3,1,4,0,0,0,0,0,0
3617,3617,Robbie Fowler,2691,2000,Liverpool FC,15,8,7,786,5,0,12,7,5,775,3,0,27,15,12,1561,8,0,0,0,0,0,2,2,0,0,0,0,0,0
3618,3618,Michael Owen,1949,2000,Liverpool FC,15,12,3,1068,12,0,12,7,5,631,4,0,27,19,8,1699,16,0,2,0,2,7,2,9,0,0,0,0,0,0
3619,3619,Vladimír Šmicer,2692,2000,Liverpool FC,15,8,7,785,1,0,11,8,3,712,1,0,26,16,10,1497,2,0,0,0,0,1,1,2,0,0,0,0,0,0
3620,3620,Gary McAllister,2693,2000,Liverpool FC,14,10,4,982,2,0,15,10,5,914,3,0,29,20,9,1896,5,0,0,3,3,2,1,3,1,0,1,0,0,0
3621,3621,Emile Heskey,1519,2000,Liverpool FC,19,17,2,1339,7,0,15,14,1,1175,7,0,34,31,3,2514,14,0,6,0,6,4,4,8,0,0,0,0,0,0
3622,3622,David Batty,2694,2000,Leeds United,6,5,1,461,0,0,8,7,1,644,0,0,14,12,2,1105,0,0,0,0,0,0,0,0,0,0,0,0,0,0
3623,3623,Robbie Keane,1126,2000,Leeds United,7,5,2,423,5,0,9,6,3,489,4,0,16,11,5,912,9,0,4,0,4,4,1,5,1,0,1,0,0,0
3624,3624,Paul Jones,2044,2002,Southampton FC,7,6,1,544,0,0,5,5,0,450,0,0,12,11,1,994,0,0,0,0,0,0,0,0,0,0,0,0,0,0
3625,3625,Jason Dodd,2046,2002,Southampton FC,7,7,0,605,0,0,8,6,2,531,0,0,15,13,2,1136,0,0,0,0,0,0,0,0,0,0,0,0,0,0
3626,3626,Paul Williams,2097,2002,Southampton FC,5,5,0,436,0,0,6,4,2,378,0,0,11,9,2,814,0,0,0,0,0,0,0,0,0,0,0,0,0,0
3627,3627,Claus Lundekvam,2047,2002,Southampton FC,17,17,0,1530,0,0,15,15,0,1287,0,0,32,32,0,2817,0,0,0,0,0,0,0,0,0,0,0,0,0,0
3628,3628,Wayne Bridge,1768,2002,Southampton FC,18,18,0,1610,0,0,14,14,0,1260,1,0,32,32,0,2870,1,0,0,0,0,0,1,1,0,0,0,0,0,0
3629,3629,Chris Marsden,2048,2002,Southampton FC,16,16,0,1388,1,0,12,12,0,1069,0,0,28,28,0,2457,1,0,1,0,1,1,0,1,0,0,0,0,0,0
3630,3630,Anders Svensson,2053,2002,Southampton FC,16,13,3,1094,1,0,14,11,3,976,1,0,30,24,6,2070,2,0,0,0,0,0,1,1,0,0,0,0,0,0
3631,3631,Rory Delap,1993,2002,Southampton FC,12,11,1,992,0,0,11,10,1,817,0,0,23,21,2,1809,0,0,0,0,0,0,0,0,0,0,0,0,0,0
3632,3632,Fabrice Fernandes,2695,2002,Southampton FC,19,19,0,1667,1,0,16,15,1,1179,2,0,35,34,1,2846,3,0,0,1,1,1,2,3,0,0,0,0,0,0
3633,3633,James Beattie,2050,2002,Southampton FC,19,18,1,1632,14,0,17,15,2,1387,9,0,36,33,3,3019,23,0,6,9,15,10,6,16,4,1,5,0,0,0
3634,3634,Marians Pahars,2051,2002,Southampton FC,6,3,3,308,1,0,3,2,1,155,0,0,9,5,4,463,1,0,3,0,3,1,0,1,1,0,1,0,0,0
3635,3635,Paul Telfer,2105,2002,Southampton FC,16,12,4,1111,0,0,15,13,2,1187,0,0,31,25,6,2298,0,0,0,0,0,0,0,0,0,0,0,0,0,0
3636,3636,Jo Tessem,2696,2002,Southampton FC,13,4,9,449,1,0,13,5,8,639,1,0,26,9,17,1088,2,0,3,0,3,1,0,1,0,0,0,0,0,0
3637,3637,Robbie Stockdale,2697,2002,Middlesbrough FC,7,6,1,532,0,0,6,6,0,518,0,0,13,12,1,1050,0,0,0,0,0,0,0,0,0,0,0,0,0,0
3638,3638,Carlos Marinelli,2698,2002,Middlesbrough FC,2,2,0,129,0,0,5,1,4,159,0,0,7,3,4,288,0,0,0,0,0,0,0,0,0,0,0,0,0,0
3639,3639,Noel Whelan,2075,2002,Middlesbrough FC,7,0,7,108,1,0,8,2,6,233,0,0,15,2,13,341,1,0,0,0,0,0,0,0,0,0,0,0,0,0
3640,3640,Alen Bokšić,2699,2002,Middlesbrough FC,11,9,2,745,2,0,6,3,3,299,0,0,17,12,5,1044,2,0,0,0,0,1,0,1,0,0,0,0,0,0
3641,3641,Ederson,1195,2018,Manchester City,19,19,0,1710,0,0,19,19,0,1710,0,0,38,38,0,3420,0,0,0,0,0,0,0,0,0,0,0,0,0,0
3642,3642,Kyle Walker,1196,2018,Manchester City,15,13,2,1245,1,0,18,17,1,1532,0,0,33,30,3,2777,1,0,3,0,3,1,0,1,0,0,0,0,0,0
3643,3643,John Stones,1197,2018,Manchester City,12,11,1,969,0,0,12,9,3,794,0,0,24,20,4,1763,0,0,0,0,0,0,0,0,0,0,0,0,0,0
3644,3644,Aymeric Laporte,2413,2018,Manchester City,17,17,0,1526,0,0,18,17,1,1531,3,0,35,34,1,3057,3,0,0,1,1,0,3,3,0,0,0,0,0,0
3645,3645,Fabian Delph,1198,2018,Manchester City,5,3,2,266,0,0,6,5,1,460,0,0,11,8,3,726,0,0,0,0,0,0,0,0,0,0,0,0,0,0
3646,3646,Nicolás Otamendi,1199,2018,Manchester City,9,8,1,682,0,0,9,6,3,552,0,0,18,14,4,1234,0,0,0,0,0,0,0,0,0,0,0,0,0,0
3647,3647,İlkay Gündoğan,1200,2018,Manchester City,15,10,5,985,4,0,16,13,3,1150,2,0,31,23,8,2135,6,0,0,0,0,1,0,1,0,0,0,0,0,0
3648,3648,Raheem Sterling,1203,2018,Manchester City,16,14,2,1256,12,0,18,17,1,1521,5,0,34,31,3,2777,17,0,0,0,0,5,2,7,0,0,0,0,0,0
3649,3649,Leroy Sané,1205,2018,Manchester City,16,11,5,1024,5,0,15,10,5,843,5,0,31,21,10,1867,10,0,3,0,3,2,1,3,0,0,0,0,0,0
3650,3650,Bernardo Silva,1207,2018,Manchester City,18,16,2,1470,2,0,18,15,3,1383,5,0,36,31,5,2853,7,0,0,0,0,1,3,4,0,0,0,0,0,0
3651,3651,Gabriel Jesus,1841,2018,Manchester City,14,7,7,702,5,0,15,1,14,319,2,0,29,8,21,1021,7,0,0,0,0,2,0,2,1,0,1,0,0,0
3652,3652,Kevin De Bruyne,1201,2018,Manchester City,9,5,4,477,2,0,10,6,4,497,0,0,19,11,8,974,2,0,0,0,0,1,0,1,0,0,0,0,0,0
3653,3653,Kun Agüero,1204,2018,Manchester City,16,14,2,1125,15,0,17,17,0,1355,6,0,33,31,2,2480,21,0,3,3,6,6,4,10,2,0,2,0,0,0
3654,3654,Riyad Mahrez,1842,2018,Manchester City,14,7,7,647,1,0,13,7,6,692,6,0,27,14,13,1339,7,0,0,6,6,0,2,2,0,0,0,0,0,0
3655,3655,Aro Murić,2700,2018,Manchester City,0,0,0,0,0,0,0,0,0,0,0,0,0,0,0,0,0,0,0,0,0,0,0,0,0,0,0,0,0,0
3656,3656,Danilo,1206,2018,Manchester City,5,5,0,450,0,0,6,4,2,356,1,0,11,9,2,806,1,0,0,0,0,0,1,1,0,0,0,0,0,0
3657,3657,Oleksandr Zinchenko,1210,2018,Manchester City,8,8,0,613,0,0,6,6,0,540,0,0,14,14,0,1153,0,0,0,0,0,0,0,0,0,0,0,0,0,0
3658,3658,Phil Foden,1844,2018,Manchester City,10,3,7,281,1,0,3,0,3,48,0,0,13,3,10,329,1,0,3,0,3,1,0,1,0,0,0,0,0,0
3659,3659,Guaita,2701,2018,Crystal Palace,12,12,0,1035,0,0,8,8,0,720,0,0,20,20,0,1755,0,0,0,0,0,0,0,0,0,0,0,0,0,0
3660,3660,Patrick van Aanholt,2254,2018,Crystal Palace,19,19,0,1703,2,0,17,17,0,1495,1,0,36,36,0,3198,3,0,0,0,0,0,1,1,0,0,0,0,0,0
3661,3661,James Tomkins,1281,2018,Crystal Palace,13,13,0,1140,0,0,16,16,0,1423,1,0,29,29,0,2563,1,0,0,0,0,0,1,1,0,0,0,0,0,0
3662,3662,Mamadou Sakho,2250,2018,Crystal Palace,13,13,0,1170,0,0,14,14,0,1247,0,0,27,27,0,2417,0,0,0,0,0,0,0,0,0,0,0,0,0,0
3663,3663,Aaron Wan-Bissaka,2702,2018,Crystal Palace,18,18,0,1620,0,0,17,17,0,1530,0,0,35,35,0,3150,0,0,0,0,0,0,0,0,0,0,0,0,0,0
3664,3664,Luka Milivojević,2251,2018,Crystal Palace,19,19,0,1710,7,0,19,19,0,1710,5,0,38,38,0,3420,12,0,4,3,7,6,1,7,5,5,10,0,0,0
3665,3665,Max Meyer,2312,2018,Crystal Palace,18,7,11,718,0,0,11,8,3,696,1,0,29,15,14,1414,1,0,0,0,0,0,0,0,0,0,0,0,0,0
3666,3666,Jeffrey Schlupp,2252,2018,Crystal Palace,14,10,4,849,1,0,16,8,8,817,3,0,30,18,12,1666,4,0,0,0,0,0,2,2,0,0,0,0,0,0
3667,3667,James McArthur,1023,2018,Crystal Palace,19,18,1,1506,1,0,19,18,1,1565,2,0,38,36,2,3071,3,0,0,0,0,1,1,2,0,0,0,0,0,0
3668,3668,Andros Townsend,1176,2018,Crystal Palace,19,18,1,1571,2,0,19,16,3,1447,4,0,38,34,4,3018,6,0,0,0,0,0,3,3,0,0,0,0,0,0
3669,3669,Wilfried Zaha,1028,2018,Crystal Palace,15,15,0,1347,1,0,19,19,0,1697,9,0,34,34,0,3044,10,0,1,3,4,1,5,6,0,0,0,0,0,0
3670,3670,Jason Puncheon,1026,2018,Crystal Palace,3,0,3,4,0,0,2,0,2,7,0,0,5,0,5,11,0,0,0,0,0,0,0,0,0,0,0,0,0,0
3671,3671,Jordan Ayew,1869,2018,Crystal Palace,8,8,0,616,0,0,12,6,6,571,1,0,20,14,6,1187,1,0,0,0,0,0,1,1,0,0,0,0,0,0
3672,3672,Julian Speroni,2249,2018,Crystal Palace,0,0,0,0,0,0,1,1,0,90,0,0,1,1,0,90,0,0,0,0,0,0,0,0,0,0,0,0,0,0
3673,3673,Joel Ward,1019,2018,Crystal Palace,3,2,1,191,1,0,4,4,0,360,0,0,7,6,1,551,1,0,0,0,0,0,0,0,0,0,0,0,0,0
3674,3674,Scott Dann,1020,2018,Crystal Palace,4,4,0,360,0,0,6,3,3,301,0,0,10,7,3,661,0,0,0,0,0,0,0,0,0,0,0,0,0,0
3675,3675,Jaïro Riedewald,2256,2018,Crystal Palace,0,0,0,0,0,0,0,0,0,0,0,0,0,0,0,0,0,0,0,0,0,0,0,0,0,0,0,0,0,0
3676,3676,Alexander Sørloth,2703,2018,Crystal Palace,8,0,8,121,0,0,4,0,4,52,0,0,12,0,12,173,0,0,0,0,0,0,0,0,0,0,0,0,0,0
3677,3677,Boa Morte,1085,2006,Fulham FC,7,5,2,489,0,0,8,7,1,613,0,0,15,12,3,1102,0,0,0,0,0,0,0,0,0,0,0,0,0,0
3678,3678,Claus Jensen,1674,2006,Fulham FC,5,4,1,392,2,0,7,6,1,521,0,0,12,10,2,913,2,0,3,0,3,1,0,1,0,0,0,0,0,0
3679,3679,Tomasz Radzinski,1935,2006,Fulham FC,16,13,3,1065,1,0,17,10,7,1008,1,0,33,23,10,2073,2,0,0,0,0,0,1,1,0,0,0,0,0,0
3680,3680,John Oster,2704,2006,Reading FC,13,3,10,398,0,0,12,3,9,438,1,0,25,6,19,836,1,0,0,0,0,0,0,0,0,0,0,0,0,0
3681,3681,Morgan Gibbs-White,2705,2018,Wolverhampton Wanderers,13,4,9,427,0,0,13,1,12,222,0,0,26,5,21,649,0,0,0,0,0,0,0,0,0,0,0,0,0,0
3682,3682,Leander Dendoncker,2181,2018,Wolverhampton Wanderers,9,7,2,635,1,0,10,10,0,834,1,0,19,17,2,1469,2,0,3,0,3,1,0,1,0,0,0,0,0,0
3683,3683,José Izquierdo,2658,2018,Brighton & Hove Albion,8,4,4,365,0,0,7,5,2,429,0,0,15,9,6,794,0,0,0,0,0,0,0,0,0,0,0,0,0,0
3684,3684,Dan Burn,2420,2018,Brighton & Hove Albion,0,0,0,0,0,0,0,0,0,0,0,0,0,0,0,0,0,0,0,0,0,0,0,0,0,0,0,0,0,0
3685,3685,Florin Andone,2706,2018,Brighton & Hove Albion,12,3,9,415,2,0,11,5,6,459,1,0,23,8,15,874,3,0,3,3,6,1,1,2,0,0,0,0,0,0
3686,3686,Gábor Király,2020,2006,Aston Villa,3,3,0,270,0,0,2,2,0,180,0,0,5,5,0,450,0,0,0,0,0,0,0,0,0,0,0,0,0,0
3687,3687,Wilfred Bouma,2707,2006,Aston Villa,12,12,0,1001,0,0,13,11,2,977,0,0,25,23,2,1978,0,0,0,0,0,0,0,0,0,0,0,0,0,0
3688,3688,Gary Cahill,1533,2006,Aston Villa,10,10,0,900,0,0,10,9,1,844,0,0,20,19,1,1744,0,0,0,0,0,0,0,0,0,0,0,0,0,0
3689,3689,Isaiah Osbourne,2708,2006,Aston Villa,3,1,2,131,0,0,8,5,3,513,0,0,11,6,5,644,0,0,0,0,0,0,0,0,0,0,0,0,0,0
3690,3690,Hilário,2709,2006,Chelsea FC,6,6,0,540,0,0,5,5,0,450,0,0,11,11,0,990,0,0,0,0,0,0,0,0,0,0,0,0,0,0
3691,3691,Khalid Boulahrouz,2710,2006,Chelsea FC,6,4,2,386,0,0,7,6,1,499,0,0,13,10,3,885,0,0,0,0,0,0,0,0,0,0,0,0,0,0
3692,3692,Tim Krul,1822,2011,Newcastle United,19,19,0,1710,0,0,19,19,0,1710,0,0,38,38,0,3420,0,0,0,0,0,0,0,0,0,0,0,0,0,0
3693,3693,Fabricio Coloccini,2278,2011,Newcastle United,18,18,0,1557,0,0,17,17,0,1486,0,0,35,35,0,3043,0,0,0,0,0,0,0,0,0,0,0,0,0,0
3694,3694,Davide Santon,2451,2011,Newcastle United,13,10,3,853,0,0,11,9,2,810,0,0,24,19,5,1663,0,0,0,0,0,0,0,0,0,0,0,0,0,0
3695,3695,Mike Williamson,2287,2011,Newcastle United,10,10,0,900,0,0,12,11,1,995,0,0,22,21,1,1895,0,0,0,0,0,0,0,0,0,0,0,0,0,0
3696,3696,James Perch,2400,2011,Newcastle United,11,7,4,687,0,0,14,6,8,642,0,0,25,13,12,1329,0,0,0,0,0,0,0,0,0,0,0,0,0,0
3697,3697,Yohan Cabaye,1029,2011,Newcastle United,17,17,0,1362,4,0,17,17,0,1476,0,0,34,34,0,2838,4,0,3,0,3,2,0,2,0,0,0,0,0,0
3698,3698,Hatem Ben Arfa,2457,2011,Newcastle United,14,6,8,708,1,0,12,10,2,853,4,0,26,16,10,1561,5,0,0,0,0,1,2,3,0,0,0,0,0,0
3699,3699,Jonás Gutiérrez,2398,2011,Newcastle United,18,18,0,1614,1,0,19,19,0,1705,1,0,37,37,0,3319,2,0,0,0,0,0,0,0,0,0,0,0,0,0
3700,3700,Cheick Tioté,2289,2011,Newcastle United,13,13,0,1144,0,0,11,11,0,907,0,0,24,24,0,2051,0,0,0,0,0,0,0,0,0,0,0,0,0,0
3701,3701,Papiss Demba Cissé,2282,2011,Newcastle United,8,7,1,605,7,0,6,6,0,507,6,0,14,13,1,1112,13,0,6,0,6,4,3,7,0,0,0,0,0,0
3702,3702,Demba Ba,1544,2011,Newcastle United,18,17,1,1430,8,0,16,15,1,1300,8,0,34,32,2,2730,16,0,0,1,1,6,4,10,0,2,2,0,0,0
3703,3703,Ryan Taylor,2341,2011,Newcastle United,15,12,3,1047,1,0,16,11,5,1077,1,0,31,23,8,2124,2,0,0,3,3,0,1,1,0,0,0,0,0,0
3704,3704,Shane Ferguson,2403,2011,Newcastle United,2,0,2,60,0,0,5,0,5,93,0,0,7,0,7,153,0,0,0,0,0,0,0,0,0,0,0,0,0,0
3705,3705,Shola Ameobi,1950,2011,Newcastle United,15,3,12,469,2,0,10,5,5,511,0,0,25,8,17,980,2,0,2,0,2,2,0,2,0,0,0,0,0,0
3706,3706,Rob Elliot,2456,2011,Newcastle United,0,0,0,0,0,0,0,0,0,0,0,0,0,0,0,0,0,0,0,0,0,0,0,0,0,0,0,0,0,0
3707,3707,Dan Gosling,1005,2011,Newcastle United,5,0,5,109,0,0,7,1,6,152,1,0,12,1,11,261,1,0,0,0,0,0,0,0,0,0,0,0,0,0
3708,3708,Sylvain Marveaux,2711,2011,Newcastle United,3,1,2,72,0,0,4,0,4,63,0,0,7,1,6,135,0,0,0,0,0,0,0,0,0,0,0,0,0,0
3709,3709,Gabriel Obertan,2283,2011,Newcastle United,10,7,3,692,0,0,13,11,2,869,1,0,23,18,5,1561,1,0,0,0,0,0,0,0,0,0,0,0,0,0
3710,3710,Joe Hart,1363,2011,Manchester City,19,19,0,1710,0,0,19,19,0,1710,0,0,38,38,0,3420,0,0,0,0,0,0,0,0,0,0,0,0,0,0
3711,3711,Vincent Kompany,1414,2011,Manchester City,16,16,0,1440,2,0,15,15,0,1350,1,0,31,31,0,2790,3,0,3,0,3,1,1,2,0,0,0,0,0,0
3712,3712,Pablo Zabaleta,1355,2011,Manchester City,7,6,1,478,1,0,14,12,2,1069,0,0,21,18,3,1547,1,0,0,0,0,1,0,1,0,0,0,0,0,0
3713,3713,Joleon Lescott,1365,2011,Manchester City,15,14,1,1274,1,0,16,16,0,1412,1,0,31,30,1,2686,2,0,0,3,3,0,1,1,0,0,0,0,0,0
3714,3714,Gaël Clichy,1230,2011,Manchester City,14,14,0,1260,0,0,14,14,0,1260,0,0,28,28,0,2520,0,0,0,0,0,0,0,0,0,0,0,0,0,0
3715,3715,Gareth Barry,1418,2011,Manchester City,16,14,2,1279,0,0,18,17,1,1473,1,0,34,31,3,2752,1,0,0,0,0,0,0,0,0,0,0,0,0,0
3716,3716,Samir Nasri,1358,2011,Manchester City,14,13,1,1106,3,0,16,13,3,1067,2,0,30,26,4,2173,5,0,3,0,3,2,0,2,0,0,0,0,0,0
3717,3717,David Silva,1211,2011,Manchester City,18,16,2,1379,3,0,18,17,1,1440,3,0,36,33,3,2819,6,0,3,0,3,1,2,3,0,0,0,0,0,0
3718,3718,Yaya Touré,1359,2011,Manchester City,16,16,0,1345,2,0,16,15,1,1304,4,0,32,31,1,2649,6,0,0,4,4,0,3,3,0,0,0,0,0,0
3719,3719,Kun Agüero,1204,2011,Manchester City,16,15,1,1258,16,0,18,16,2,1337,7,0,34,31,3,2595,23,0,3,0,3,8,2,10,3,0,3,0,0,0
3720,3720,Carlos Tévez,1417,2011,Manchester City,6,4,2,323,1,0,7,3,4,278,3,0,13,7,6,601,4,0,0,0,0,0,1,1,0,0,0,0,0,0
3721,3721,Micah Richards,1364,2011,Manchester City,16,15,1,1259,1,0,13,8,5,783,0,0,29,23,6,2042,1,0,0,0,0,0,0,0,0,0,0,0,0,0
3722,3722,Nigel de Jong,1680,2011,Manchester City,12,7,5,667,0,0,9,4,5,403,0,0,21,11,10,1070,0,0,0,0,0,0,0,0,0,0,0,0,0,0
3723,3723,Edin Džeko,1362,2011,Manchester City,14,8,6,726,5,0,16,8,8,774,9,0,30,16,14,1500,14,0,0,3,3,3,3,6,0,0,0,0,0,0
3724,3724,Costel Pantilimon,1354,2011,Manchester City,0,0,0,0,0,0,0,0,0,0,0,0,0,0,0,0,0,0,0,0,0,0,0,0,0,0,0,0,0,0
3725,3725,Aleksandar Kolarov,1366,2011,Manchester City,4,4,0,360,2,0,8,5,3,462,0,0,12,9,3,822,2,0,1,0,1,1,0,1,0,0,0,0,0,0
3726,3726,James Milner,1189,2011,Manchester City,14,6,8,623,3,0,12,11,1,960,0,0,26,17,9,1583,3,0,0,0,0,0,0,0,1,0,1,0,0,0
3727,3727,Adam Johnson,1405,2011,Manchester City,13,7,6,735,4,0,13,3,10,401,2,0,26,10,16,1136,6,0,0,0,0,0,1,1,0,0,0,0,0,0
3728,3728,Emre Belözoğlu,2712,2005,Newcastle United,10,10,0,762,2,0,10,9,1,837,0,0,20,19,1,1599,2,0,6,0,6,2,0,2,0,0,0,0,0,0
3729,3729,Kieron Dyer,2033,2005,Newcastle United,4,2,2,157,0,0,7,2,5,292,0,0,11,4,7,449,0,0,0,0,0,0,0,0,0,0,0,0,0,0
3730,3730,Luque,2713,2005,Newcastle United,7,4,3,328,0,0,7,2,5,322,1,0,14,6,8,650,1,0,0,0,0,0,0,0,0,0,0,0,0,0
3731,3731,Jermaine Jenas,1275,2005,Newcastle United,2,1,1,157,0,0,2,2,0,180,0,0,4,3,1,337,0,0,0,0,0,0,0,0,0,0,0,0,0,0
3732,3732,Gabriel Heinze,1728,2005,Manchester United,2,1,1,122,0,0,2,1,1,108,0,0,4,2,2,230,0,0,0,0,0,0,0,0,0,0,0,0,0,0
3733,3733,Roy Keane,1111,2005,Manchester United,2,1,1,102,0,0,3,3,0,268,0,0,5,4,1,370,0,0,0,0,0,0,0,0,0,0,0,0,0,0
3734,3734,Paul Scholes,1112,2005,Manchester United,10,9,1,809,2,0,10,9,1,807,0,0,20,18,2,1616,2,0,0,0,0,2,0,2,0,0,0,0,0,0
3735,3735,Darren Fletcher,1730,2005,Manchester United,12,10,2,842,1,0,15,13,2,1066,0,0,27,23,4,1908,1,0,3,0,3,1,0,1,0,0,0,0,0,0
3736,3736,Alan Smith,1300,2005,Manchester United,10,8,2,742,0,0,11,7,4,726,1,0,21,15,6,1468,1,0,0,0,0,0,1,1,0,0,0,0,0,0
3737,3737,Kasper Schmeichel,2435,2015,Leicester City,19,19,0,1710,0,0,19,19,0,1710,0,0,38,38,0,3420,0,0,0,0,0,0,0,0,0,0,0,0,0,0
3738,3738,Wes Morgan,2446,2015,Leicester City,19,19,0,1710,1,0,19,19,0,1710,1,0,38,38,0,3420,2,0,3,1,4,1,1,2,0,0,0,0,0,0
3739,3739,Robert Huth,1884,2015,Leicester City,18,18,0,1620,0,0,17,17,0,1530,3,0,35,35,0,3150,3,0,0,3,3,0,2,2,0,0,0,0,0,0
3740,3740,Danny Simpson,2395,2015,Leicester City,14,14,0,1234,0,0,16,16,0,1415,0,0,30,30,0,2649,0,0,0,0,0,0,0,0,0,0,0,0,0,0
3741,3741,Christian Fuchs,2564,2015,Leicester City,16,15,1,1352,0,0,16,15,1,1358,0,0,32,30,2,2710,0,0,0,0,0,0,0,0,0,0,0,0,0,0
3742,3742,Danny Drinkwater,2522,2015,Leicester City,18,18,0,1515,2,0,17,17,0,1528,1,0,35,35,0,3043,3,0,0,1,1,2,1,3,0,0,0,0,0,0
3743,3743,Marc Albrighton,1448,2015,Leicester City,19,18,1,1379,2,0,19,16,3,1389,0,0,38,34,4,2768,2,0,0,0,0,0,0,0,0,0,0,0,0,0
3744,3744,N'Golo Kanté,1848,2015,Leicester City,18,15,3,1376,1,0,19,18,1,1644,0,0,37,33,4,3020,1,0,0,0,0,1,0,1,0,0,0,0,0,0
3745,3745,Riyad Mahrez,1842,2015,Leicester City,19,19,0,1649,5,0,18,17,1,1408,12,0,37,36,1,3057,17,0,1,6,7,2,7,9,1,3,4,0,0,0
3746,3746,Jamie Vardy,2443,2015,Leicester City,18,18,0,1610,14,0,18,18,0,1564,10,0,36,36,0,3174,24,0,3,3,6,9,7,16,2,3,5,0,0,0
3747,3747,Shinji Okazaki,2668,2015,Leicester City,18,14,4,1034,1,0,18,14,4,1037,4,0,36,28,8,2071,5,0,3,0,3,1,2,3,0,0,0,0,0,0
3748,3748,Daniel Amartey,2666,2015,Leicester City,2,1,1,90,0,0,3,0,3,12,0,0,5,1,4,102,0,0,0,0,0,0,0,0,0,0,0,0,0,0
3749,3749,Jeffrey Schlupp,2252,2015,Leicester City,13,7,6,730,0,0,11,7,4,653,1,0,24,14,10,1383,1,0,0,0,0,0,0,0,0,0,0,0,0,0
3750,3750,Leonardo Ulloa,2518,2015,Leicester City,16,3,13,488,5,0,13,4,9,480,1,0,29,7,22,968,6,0,4,0,4,2,0,2,1,0,1,0,0,0
3751,3751,Mark Schwarzer,1328,2015,Leicester City,0,0,0,0,0,0,0,0,0,0,0,0,0,0,0,0,0,0,0,0,0,0,0,0,0,0,0,0,0,0
3752,3752,Marcin Wasilewski,2515,2015,Leicester City,1,1,0,90,0,0,3,2,1,212,0,0,4,3,1,302,0,0,0,0,0,0,0,0,0,0,0,0,0,0
3753,3753,Andy King,2523,2015,Leicester City,11,4,7,522,2,0,14,5,9,526,0,0,25,9,16,1048,2,0,0,0,0,1,0,1,0,0,0,0,0,0
3754,3754,Demarai Gray,2568,2015,Leicester City,6,0,6,53,0,0,6,1,5,125,0,0,12,1,11,178,0,0,0,0,0,0,0,0,0,0,0,0,0,0
3755,3755,Adrián,2309,2015,West Ham United,15,15,0,1350,0,0,17,17,0,1530,0,0,32,32,0,2880,0,0,0,0,0,0,0,0,0,0,0,0,0,0
3756,3756,Winston Reid,2638,2015,West Ham United,13,13,0,1170,1,0,11,11,0,966,0,0,24,24,0,2136,1,0,3,0,3,1,0,1,0,0,0,0,0,0
3757,3757,Aaron Cresswell,2199,2015,West Ham United,18,18,0,1620,0,0,19,19,0,1695,2,0,37,37,0,3315,2,0,0,0,0,0,2,2,0,0,0,0,0,0
3758,3758,Angelo Ogbonna,2201,2015,West Ham United,15,14,1,1158,0,0,13,13,0,1170,0,0,28,27,1,2328,0,0,0,0,0,0,0,0,0,0,0,0,0,0
3759,3759,Cheikhou Kouyaté,2311,2015,West Ham United,19,19,0,1683,3,0,15,15,0,1350,2,0,34,34,0,3033,5,0,1,0,1,2,2,4,0,0,0,0,0,0
3760,3760,Pedro Obiang,2639,2015,West Ham United,13,3,10,440,0,0,11,8,3,640,0,0,24,11,13,1080,0,0,0,0,0,0,0,0,0,0,0,0,0,0
3761,3761,Mark Noble,2204,2015,West Ham United,18,18,0,1597,3,0,19,19,0,1620,4,0,37,37,0,3217,7,0,0,1,1,0,1,1,3,0,3,0,0,0
3762,3762,Dimitri Payet,2640,2015,West Ham United,16,15,1,1336,4,0,14,14,0,1237,5,0,30,29,1,2573,9,0,0,4,4,2,3,5,0,0,0,0,0,0
3763,3763,Michail Antonio,2208,2015,West Ham United,13,12,1,1051,6,0,13,11,2,1011,2,0,26,23,3,2062,8,0,6,0,6,6,1,7,0,0,0,0,0,0
3764,3764,Victor Moses,1434,2015,West Ham United,9,5,4,450,0,0,12,8,4,532,1,0,21,13,8,982,1,0,0,0,0,0,1,1,0,0,0,0,0,0
3765,3765,Emmanuel Emenike,2714,2015,West Ham United,6,3,3,252,0,0,7,2,5,256,0,0,13,5,8,508,0,0,0,0,0,0,0,0,0,0,0,0,0,0
3766,3766,Manuel Lanzini,2351,2015,West Ham United,15,13,2,1077,2,0,11,10,1,843,4,0,26,23,3,1920,6,0,0,0,0,2,3,5,0,0,0,0,0,0
3767,3767,Andy Carroll,1779,2015,West Ham United,15,7,8,813,7,0,12,6,6,618,2,0,27,13,14,1431,9,0,6,0,6,5,2,7,0,1,1,0,0,0
3768,3768,Enner Valencia,2715,2015,West Ham United,9,4,5,417,2,0,10,6,4,612,2,0,19,10,9,1029,4,0,0,0,0,2,1,3,0,0,0,0,0,0
3769,3769,Darren Randolph,2637,2015,West Ham United,4,4,0,360,0,0,2,2,0,180,0,0,6,6,0,540,0,0,0,0,0,0,0,0,0,0,0,0,0,0
3770,3770,James Tomkins,1281,2015,West Ham United,11,9,2,826,0,0,14,14,0,1139,0,0,25,23,2,1965,0,0,0,0,0,0,0,0,0,0,0,0,0,0
3771,3771,James Collins,1618,2015,West Ham United,9,8,1,697,0,0,10,8,2,749,0,0,19,16,3,1446,0,0,0,0,0,0,0,0,0,0,0,0,0,0
3772,3772,Sam Byram,1823,2015,West Ham United,2,1,1,167,0,0,2,1,1,119,0,0,4,2,2,286,0,0,0,0,0,0,0,0,0,0,0,0,0,0
3773,3773,Andy Impey,1304,2001,Leicester City,14,11,3,959,0,0,12,8,4,788,0,0,26,19,7,1747,0,0,0,0,0,0,0,0,0,0,0,0,0,0
3774,3774,Callum Davidson,1306,2001,Leicester City,15,15,0,1254,0,0,14,13,1,1079,0,0,29,28,1,2333,0,0,0,0,0,0,0,0,0,0,0,0,0,0
3775,3775,Matt Elliott,2716,2001,Leicester City,16,16,0,1440,0,0,14,14,0,1260,0,0,30,30,0,2700,0,0,0,0,0,0,0,0,0,0,0,0,0,0
3776,3776,Junior Lewis,1307,2001,Leicester City,2,1,1,133,0,0,4,3,1,300,0,0,6,4,2,433,0,0,0,0,0,0,0,0,0,0,0,0,0,0
3777,3777,Ade Akinbiyi,1311,2001,Leicester City,10,8,2,664,1,0,11,8,3,791,1,0,21,16,5,1455,2,0,3,0,3,1,1,2,0,0,0,0,0,0
3778,3778,Jordan Stewart,2113,2001,Leicester City,5,3,2,307,0,0,6,5,1,366,0,0,11,8,3,673,0,0,0,0,0,0,0,0,0,0,0,0,0,0
3779,3779,Dean Sturridge,1312,2001,Leicester City,5,4,1,289,1,0,4,4,0,281,2,0,9,8,1,570,3,0,1,0,1,1,2,3,0,0,0,0,0,0
3780,3780,Matteo Sereni,2717,2001,Ipswich Town,12,12,0,1080,0,0,13,13,0,1170,0,0,25,25,0,2250,0,0,0,0,0,0,0,0,0,0,0,0,0,0
3781,3781,Hermann Hreiðarsson,1953,2001,Ipswich Town,19,19,0,1710,1,0,19,19,0,1710,0,0,38,38,0,3420,1,0,0,0,0,1,0,1,0,0,0,0,0,0
3782,3782,Titus Bramble,1411,2001,Ipswich Town,9,9,0,810,0,0,9,7,2,682,0,0,18,16,2,1492,0,0,0,0,0,0,0,0,0,0,0,0,0,0
3783,3783,Chris Makin,1101,2001,Ipswich Town,16,16,0,1241,0,0,14,14,0,1183,0,0,30,30,0,2424,0,0,0,0,0,0,0,0,0,0,0,0,0,0
3784,3784,John McGreal,2718,2001,Ipswich Town,11,11,0,990,1,0,16,16,0,1364,0,0,27,27,0,2354,1,0,3,0,3,1,0,1,0,0,0,0,0,0
3785,3785,Jim Magilton,2719,2001,Ipswich Town,12,7,5,692,0,0,12,9,3,769,0,0,24,16,8,1461,0,0,0,0,0,0,0,0,0,0,0,0,0,0
3786,3786,Matt Holland,1955,2001,Ipswich Town,19,19,0,1710,2,0,19,19,0,1710,1,0,38,38,0,3420,3,0,0,3,3,1,1,2,0,0,0,0,0,0
3787,3787,Jermaine Wright,2720,2001,Ipswich Town,15,11,4,1023,0,0,14,13,1,1096,1,0,29,24,5,2119,1,0,0,1,1,0,1,1,0,0,0,0,0,0
3788,3788,Martijn Reuser,2721,2001,Ipswich Town,14,12,2,977,0,0,10,6,4,646,1,0,24,18,6,1623,1,0,0,0,0,0,0,0,0,0,0,0,0,0
3789,3789,Marcus Stewart,2722,2001,Ipswich Town,13,9,4,832,1,0,15,11,4,1149,5,0,28,20,8,1981,6,0,0,1,1,1,3,4,0,1,1,0,0,0
3790,3790,Finidi George,2723,2001,Ipswich Town,13,11,2,900,4,0,12,10,2,694,2,0,25,21,4,1594,6,0,0,0,0,1,2,3,0,0,0,0,0,0
3791,3791,Keith Branagan,2724,2001,Ipswich Town,0,0,0,0,0,0,1,0,1,29,0,0,1,0,1,29,0,0,0,0,0,0,0,0,0,0,0,0,0,0
3792,3792,Alun Armstrong,2725,2001,Ipswich Town,16,11,5,839,3,0,15,10,5,774,1,0,31,21,10,1613,4,0,0,3,3,2,1,3,0,0,0,0,0,0
3793,3793,John Paintsil,2036,2010,Fulham FC,8,7,1,652,0,0,8,8,0,692,0,0,16,15,1,1344,0,0,0,0,0,0,0,0,0,0,0,0,0,0
3794,3794,Damien Duff,1348,2010,Fulham FC,11,9,2,813,3,0,13,13,0,1071,1,0,24,22,2,1884,4,0,3,1,4,3,1,4,0,0,0,0,0,0
3795,3795,Andy Johnson,1322,2010,Fulham FC,13,7,6,736,0,0,14,8,6,815,3,0,27,15,12,1551,3,0,0,2,2,0,3,3,0,0,0,0,0,0
3796,3796,Simon Davies,1125,2010,Fulham FC,17,13,4,1125,2,0,13,12,1,1089,2,0,30,25,5,2214,4,0,0,0,0,2,0,2,0,0,0,0,0,0
3797,3797,Diomansy Kamara,1564,2010,Fulham FC,6,4,2,334,1,0,4,3,1,204,1,0,10,7,3,538,2,0,0,0,0,1,1,2,0,0,0,0,0,0
3798,3798,Michael Richardson,2726,2010,Newcastle United,0,0,0,0,0,0,0,0,0,0,0,0,0,0,0,0,0,0,0,0,0,0,0,0,0,0,0,0,0,0
3799,3799,Sami Hyypiä,2361,2008,Liverpool FC,8,5,3,460,0,0,8,7,1,631,1,0,16,12,4,1091,1,0,0,0,0,0,0,0,0,0,0,0,0,0
3800,3800,Daniel Agger,1776,2008,Liverpool FC,9,8,1,733,1,0,9,7,2,634,0,0,18,15,3,1367,1,0,0,0,0,0,0,0,0,0,0,0,0,0
3801,3801,Robbie Keane,1126,2008,Liverpool FC,10,9,1,728,4,0,9,7,2,534,1,0,19,16,3,1262,5,0,0,1,1,1,1,2,0,0,0,0,0,0
3802,3802,Riga Mustapha,2727,2008,Bolton Wanderers,8,1,7,229,0,0,8,0,8,149,0,0,16,1,15,378,0,0,0,0,0,0,0,0,0,0,0,0,0,0
3803,3803,Ebi Smolarek,2728,2008,Bolton Wanderers,5,1,4,113,0,0,7,0,7,106,0,0,12,1,11,219,0,0,0,0,0,0,0,0,0,0,0,0,0,0
3804,3804,Gabriel Tamaş,2729,2012,West Bromwich Albion,5,4,1,322,0,0,6,3,3,311,0,0,11,7,4,633,0,0,0,0,0,0,0,0,0,0,0,0,0,0
3805,3805,Luke Daniels,2303,2012,West Bromwich Albion,0,0,0,0,0,0,0,0,0,0,0,0,0,0,0,0,0,0,0,0,0,0,0,0,0,0,0,0,0,0
3806,3806,Goran Popov,2304,2012,West Bromwich Albion,6,6,0,540,0,0,6,4,2,391,0,0,12,10,2,931,0,0,0,0,0,0,0,0,0,0,0,0,0,0
3807,3807,Micah Richards,1364,2012,Manchester City,5,5,0,434,0,0,2,2,0,180,0,0,7,7,0,614,0,0,0,0,0,0,0,0,0,0,0,0,0,0
3808,3808,Thibaut Courtois,2730,2016,Chelsea FC,18,18,0,1620,0,0,18,18,0,1620,0,0,36,36,0,3240,0,0,0,0,0,0,0,0,0,0,0,0,0,0
3809,3809,Marcos Alonso,1846,2016,Chelsea FC,15,15,0,1334,3,0,16,15,1,1360,3,0,31,30,1,2694,6,0,0,0,0,1,1,2,0,0,0,0,0,0
3810,3810,Gary Cahill,1533,2016,Chelsea FC,18,17,1,1586,4,0,19,19,0,1710,2,0,37,36,1,3296,6,0,0,3,3,2,1,3,0,0,0,0,0,0
3811,3811,Azpilicueta,1535,2016,Chelsea FC,19,19,0,1710,1,0,19,19,0,1710,0,0,38,38,0,3420,1,0,0,0,0,1,0,1,0,0,0,0,0,0
3812,3812,David Luiz,1471,2016,Chelsea FC,16,16,0,1434,0,0,17,17,0,1522,1,0,33,33,0,2956,1,0,0,0,0,0,1,1,0,0,0,0,0,0
3813,3813,N'Golo Kanté,1848,2016,Chelsea FC,17,17,0,1530,1,0,18,18,0,1609,0,0,35,35,0,3139,1,0,0,0,0,0,0,0,0,0,0,0,0,0
3814,3814,Victor Moses,1434,2016,Chelsea FC,16,13,3,1142,3,0,18,16,2,1356,0,0,34,29,5,2498,3,0,3,0,3,1,0,1,0,0,0,0,0,0
3815,3815,Nemanja Matić,1537,2016,Chelsea FC,17,14,3,1298,1,0,18,16,2,1398,0,0,35,30,5,2696,1,0,0,0,0,0,0,0,0,0,0,0,0,0
3816,3816,Eden Hazard,1541,2016,Chelsea FC,19,19,0,1575,12,0,17,17,0,1432,4,0,36,36,0,3007,16,0,3,0,3,7,2,9,2,0,2,0,0,0
3817,3817,Pedro,1851,2016,Chelsea FC,18,12,6,1001,7,0,17,14,3,1150,3,0,35,26,9,2151,10,0,0,0,0,4,2,6,0,0,0,0,0,0
3818,3818,Diego Costa,2731,2016,Chelsea FC,17,17,0,1477,11,0,18,18,0,1613,9,0,35,35,0,3090,20,0,6,10,16,5,6,11,0,0,0,0,0,0
3819,3819,Cesc Fàbregas,1526,2016,Chelsea FC,13,8,5,739,4,0,16,5,11,589,1,0,29,13,16,1328,5,0,3,3,6,3,1,4,0,0,0,0,0,0
3820,3820,Willian,1538,2016,Chelsea FC,17,7,10,729,4,0,17,8,9,800,4,0,34,15,19,1529,8,0,0,0,0,3,3,6,0,0,0,0,0,0
3821,3821,Michy Batshuayi,2732,2016,Chelsea FC,9,1,8,169,3,0,11,0,11,70,2,0,20,1,19,239,5,0,0,3,3,0,2,2,0,0,0,0,0,0
3822,3822,Asmir Begović,1036,2016,Chelsea FC,1,1,0,90,0,0,1,1,0,90,0,0,2,2,0,180,0,0,0,0,0,0,0,0,0,0,0,0,0,0
3823,3823,Kurt Zouma,1903,2016,Chelsea FC,4,2,2,143,0,0,5,1,4,104,0,0,9,3,6,247,0,0,0,0,0,0,0,0,0,0,0,0,0,0
3824,3824,Nathan Aké,1037,2016,Chelsea FC,1,1,0,90,0,0,1,0,1,8,0,0,2,1,1,98,0,0,0,0,0,0,0,0,0,0,0,0,0,0
3825,3825,Nathaniel Chalobah,2330,2016,Chelsea FC,6,1,5,142,0,0,4,0,4,17,0,0,10,1,9,159,0,0,0,0,0,0,0,0,0,0,0,0,0,0
3826,3826,Eldin Jakupović,2563,2016,Hull City,11,11,0,990,0,0,11,11,0,990,0,0,22,22,0,1980,0,0,0,0,0,0,0,0,0,0,0,0,0,0
3827,3827,Andrew Robertson,1181,2016,Hull City,17,15,2,1368,1,0,16,16,0,1369,0,0,33,31,2,2737,1,0,0,0,0,1,0,1,0,0,0,0,0,0
3828,3828,Harry Maguire,2229,2016,Hull City,15,12,3,1132,1,0,14,13,1,1174,1,0,29,25,4,2306,2,0,0,0,0,0,1,1,0,0,0,0,0,0
3829,3829,Curtis Davies,2224,2016,Hull City,13,13,0,1082,0,0,13,12,1,1057,0,0,26,25,1,2139,0,0,0,0,0,0,0,0,0,0,0,0,0,0
3830,3830,Omar Elabdellaoui,2733,2016,Hull City,4,4,0,352,0,0,4,3,1,264,0,0,8,7,1,616,0,0,0,0,0,0,0,0,0,0,0,0,0,0
3831,3831,Michael Dawson,1267,2016,Hull City,10,8,2,730,3,0,12,11,1,991,0,0,22,19,3,1721,3,0,4,0,4,3,0,3,0,0,0,0,0,0
3832,3832,Tom Huddlestone,1270,2016,Hull City,16,11,5,972,1,0,15,12,3,1070,0,0,31,23,8,2042,1,0,0,0,0,1,0,1,1,0,1,0,0,0
3833,3833,Sam Clucas,2734,2016,Hull City,18,17,1,1543,2,0,19,19,0,1647,1,0,37,36,1,3190,3,0,0,0,0,0,1,1,0,0,0,0,0,0
3834,3834,Ryan Mason,1166,2016,Hull City,7,5,2,461,0,0,9,6,3,468,1,0,16,11,5,929,1,0,0,0,0,0,1,1,0,0,0,0,0,0
3835,3835,Evandro,2735,2016,Hull City,5,2,3,165,0,0,6,5,1,412,0,0,11,7,4,577,0,0,0,0,0,0,0,0,0,0,0,0,0,0
3836,3836,Abel Hernández,2227,2016,Hull City,14,10,4,815,3,0,10,6,4,612,1,0,24,16,8,1427,4,0,0,0,0,2,0,2,0,0,0,0,0,0
3837,3837,David Meyler,2225,2016,Hull City,10,6,4,514,0,0,10,3,7,440,1,0,20,9,11,954,1,0,0,0,0,0,0,0,0,0,0,0,0,0
3838,3838,Adama Diomandé,2736,2016,Hull City,10,7,3,628,2,0,12,6,6,540,0,0,22,13,9,1168,2,0,0,0,0,2,0,2,0,0,0,0,0,0
3839,3839,Oumar Niasse,1059,2016,Hull City,9,5,4,532,4,0,8,7,1,628,0,0,17,12,5,1160,4,0,0,0,0,2,0,2,0,0,0,0,0,0
3840,3840,David Marshall,2737,2016,Hull City,8,8,0,720,0,0,8,8,0,720,0,0,16,16,0,1440,0,0,0,0,0,0,0,0,0,0,0,0,0,0
3841,3841,Josh Tymon,1909,2016,Hull City,3,2,1,191,0,0,2,2,0,134,0,0,5,4,1,325,0,0,0,0,0,0,0,0,0,0,0,0,0,0
3842,3842,Shaun Maloney,2738,2016,Hull City,4,1,3,147,0,0,5,1,4,131,1,0,9,2,7,278,1,0,0,0,0,0,1,1,0,0,0,0,0,0
3843,3843,Jarrod Bowen,2739,2016,Hull City,1,1,0,72,0,0,6,0,6,105,0,0,7,1,6,177,0,0,0,0,0,0,0,0,0,0,0,0,0,0
3844,3844,Asmir Begović,1036,2018,AFC Bournemouth,12,12,0,1080,0,0,12,12,0,1080,0,0,24,24,0,2160,0,0,0,0,0,0,0,0,0,0,0,0,0,0
3845,3845,Steve Cook,1002,2018,AFC Bournemouth,15,15,0,1350,0,0,16,16,0,1437,1,0,31,31,0,2787,1,0,0,3,3,0,1,1,0,0,0,0,0,0
3846,3846,Nathan Aké,1037,2018,AFC Bournemouth,19,19,0,1710,3,0,19,19,0,1702,1,0,38,38,0,3412,4,0,4,0,4,2,0,2,0,0,0,0,0,0
3847,3847,Charlie Daniels,1003,2018,AFC Bournemouth,11,9,2,805,1,0,10,8,2,780,0,0,21,17,4,1585,1,0,0,0,0,0,0,0,0,0,0,0,0,0
3848,3848,Adam Smith,1004,2018,AFC Bournemouth,12,12,0,1080,1,0,13,13,0,1022,0,0,25,25,0,2102,1,0,0,0,0,0,0,0,0,0,0,0,0,0
3849,3849,Dan Gosling,1005,2018,AFC Bournemouth,13,10,3,911,0,0,12,9,3,826,2,0,25,19,6,1737,2,0,0,0,0,0,2,2,0,0,0,0,0,0
3850,3850,Andrew Surman,1006,2018,AFC Bournemouth,7,6,1,527,0,0,11,10,1,912,0,0,18,16,2,1439,0,0,0,0,0,0,0,0,0,0,0,0,0,0
3851,3851,David Brooks,2740,2018,AFC Bournemouth,17,17,0,1289,4,0,13,12,1,990,3,0,30,29,1,2279,7,0,0,0,0,2,1,3,0,0,0,0,0,0
3852,3852,Callum Wilson,1039,2018,AFC Bournemouth,15,15,0,1324,5,0,15,14,1,1211,9,0,30,29,1,2535,14,0,0,1,1,4,6,10,0,1,1,0,0,0
3853,3853,Joshua King,1040,2018,AFC Bournemouth,18,18,0,1563,9,0,17,16,1,1411,3,0,35,34,1,2974,12,0,0,0,0,5,0,5,4,1,5,0,0,0
3854,3854,Ryan Fraser,1041,2018,AFC Bournemouth,19,18,1,1605,5,0,19,17,2,1568,2,0,38,35,3,3173,7,0,1,0,1,3,0,3,0,0,0,0,0,0
3855,3855,Lewis Cook,1038,2018,AFC Bournemouth,7,4,3,381,0,0,6,4,2,341,0,0,13,8,5,722,0,0,0,0,0,0,0,0,0,0,0,0,0,0
3856,3856,Lys Mousset,1044,2018,AFC Bournemouth,13,0,13,100,0,0,11,1,10,250,1,0,24,1,23,350,1,0,0,0,0,0,0,0,0,0,0,0,0,0
3857,3857,Jordon Ibe,1042,2018,AFC Bournemouth,10,3,7,335,0,0,9,6,3,460,1,0,19,9,10,795,1,0,0,0,0,0,0,0,0,0,0,0,0,0
3858,3858,Artur Boruc,1000,2018,AFC Bournemouth,6,6,0,540,0,0,6,6,0,540,0,0,12,12,0,1080,0,0,0,0,0,0,0,0,0,0,0,0,0,0
3859,3859,Simon Francis,1001,2018,AFC Bournemouth,9,7,2,675,0,0,8,6,2,551,0,0,17,13,4,1226,0,0,0,0,0,0,0,0,0,0,0,0,0,0
3860,3860,Jefferson Lerma,2741,2018,AFC Bournemouth,15,15,0,1319,0,0,15,14,1,1192,2,0,30,29,1,2511,2,0,0,0,0,0,0,0,0,0,0,0,0,0
3861,3861,Jermain Defoe,1127,2018,AFC Bournemouth,1,0,1,1,0,0,3,0,3,21,0,0,4,0,4,22,0,0,0,0,0,0,0,0,0,0,0,0,0,0
3862,3862,Jordan Pickford,1046,2018,Everton FC,19,19,0,1710,0,0,19,19,0,1710,0,0,38,38,0,3420,0,0,0,0,0,0,0,0,0,0,0,0,0,0
3863,3863,Mason Holgate,1062,2018,Everton FC,3,3,0,270,0,0,2,1,1,137,0,0,5,4,1,407,0,0,0,0,0,0,0,0,0,0,0,0,0,0
3864,3864,Leighton Baines,1466,2018,Everton FC,3,2,1,141,0,0,3,3,0,235,0,0,6,5,1,376,0,0,0,0,0,0,0,0,0,0,0,0,0,0
3865,3865,Michael Keane,1047,2018,Everton FC,15,15,0,1350,0,0,18,18,0,1620,1,0,33,33,0,2970,1,0,0,0,0,0,0,0,0,0,0,0,0,0
3866,3866,Séamus Coleman,1467,2018,Everton FC,15,15,0,1333,2,0,14,14,0,1227,0,0,29,29,0,2560,2,0,0,0,0,1,0,1,0,0,0,0,0,0
3867,3867,Gylfi Sigurðsson,1055,2018,Everton FC,19,18,1,1602,7,0,19,18,1,1532,6,0,38,36,2,3134,13,0,3,3,6,2,2,4,0,2,2,0,0,0
3868,3868,Idrissa Gueye,1054,2018,Everton FC,16,16,0,1407,0,0,17,16,1,1418,0,0,33,32,1,2825,0,0,0,0,0,0,0,0,0,0,0,0,0,0
3869,3869,Tom Davies,1063,2018,Everton FC,8,5,3,521,0,0,8,5,3,455,0,0,16,10,6,976,0,0,0,0,0,0,0,0,0,0,0,0,0,0
3870,3870,Theo Walcott,1237,2018,Everton FC,19,13,6,1114,3,0,18,11,7,1009,2,0,37,24,13,2123,5,0,0,0,0,2,2,4,0,0,0,0,0,0
3871,3871,Cenk Tosun,1463,2018,Everton FC,13,5,8,536,2,0,12,5,7,514,1,0,25,10,15,1050,3,0,0,0,0,0,1,1,0,0,0,0,0,0
3872,3872,Richarlison,1461,2018,Everton FC,17,15,2,1283,7,0,18,17,1,1445,6,0,35,32,3,2728,13,0,1,3,4,5,4,9,0,0,0,0,0,0
3873,3873,Kurt Zouma,1903,2018,Everton FC,16,15,1,1351,1,0,16,14,2,1262,1,0,32,29,3,2613,2,0,0,0,0,1,1,2,0,0,0,0,0,0
3874,3874,Bernard,1468,2018,Everton FC,16,11,5,960,0,0,18,14,4,1168,1,0,34,25,9,2128,1,0,0,0,0,0,0,0,0,0,0,0,0,0
3875,3875,Dominic Calvert-Lewin,1056,2018,Everton FC,18,11,7,1023,3,0,17,8,9,752,3,0,35,19,16,1775,6,0,1,0,1,2,1,3,0,0,0,0,0,0
3876,3876,Maarten Stekelenburg,1465,2018,Everton FC,0,0,0,0,0,0,0,0,0,0,0,0,0,0,0,0,0,0,0,0,0,0,0,0,0,0,0,0,0,0
3877,3877,Lucas Digne,1458,2018,Everton FC,17,17,0,1511,2,0,18,16,2,1479,2,0,35,33,2,2990,4,0,1,0,1,1,0,1,0,0,0,0,0,0
3878,3878,Kieran Dowell,2742,2018,Everton FC,0,0,0,0,0,0,0,0,0,0,0,0,0,0,0,0,0,0,0,0,0,0,0,0,0,0,0,0,0,0
3879,3879,Oumar Niasse,1059,2018,Everton FC,3,0,3,39,0,0,2,0,2,19,0,0,5,0,5,58,0,0,0,0,0,0,0,0,0,0,0,0,0,0
3880,3880,Mario Melchiot,1512,2007,Wigan Athletic,16,16,0,1376,0,0,15,15,0,1264,0,0,31,31,0,2640,0,0,0,0,0,0,0,0,0,0,0,0,0,0
3881,3881,Jason Koumas,2062,2007,Wigan Athletic,15,11,4,1044,1,0,15,10,5,1021,0,0,30,21,9,2065,1,0,1,0,1,1,0,1,1,0,1,0,0,0
3882,3882,Josip Skoko,2743,2007,Wigan Athletic,4,2,2,215,0,0,8,5,3,453,0,0,12,7,5,668,0,0,0,0,0,0,0,0,0,0,0,0,0,0
3883,3883,Pepe Reina,1775,2007,Liverpool FC,19,19,0,1710,0,0,19,19,0,1710,0,0,38,38,0,3420,0,0,0,0,0,0,0,0,0,0,0,0,0,0
3884,3884,Sami Hyypiä,2361,2007,Liverpool FC,15,13,2,1182,1,0,12,11,1,844,0,0,27,24,3,2026,1,0,0,0,0,1,0,1,0,0,0,0,0,0
3885,3885,John Arne Riise,2362,2007,Liverpool FC,14,11,3,972,0,0,15,11,4,1014,0,0,29,22,7,1986,0,0,0,0,0,0,0,0,0,0,0,0,0,0
3886,3886,Fábio Aurélio,2054,2007,Liverpool FC,9,7,2,610,0,0,7,6,1,514,1,0,16,13,3,1124,1,0,0,0,0,0,0,0,0,0,0,0,0,0
3887,3887,Arbeloa,2744,2007,Liverpool FC,16,15,1,1323,0,0,12,11,1,950,0,0,28,26,2,2273,0,0,0,0,0,0,0,0,0,0,0,0,0,0
3888,3888,Jamie Carragher,1778,2007,Liverpool FC,17,17,0,1491,0,0,18,17,1,1551,0,0,35,34,1,3042,0,0,0,0,0,0,0,0,0,0,0,0,0,0
3889,3889,Steven Gerrard,1424,2007,Liverpool FC,18,18,0,1585,7,0,16,14,2,1260,4,0,34,32,2,2845,11,0,0,6,6,2,4,6,3,0,3,0,0,0
3890,3890,Jermaine Pennant,1514,2007,Liverpool FC,9,7,2,555,1,0,9,7,2,580,1,0,18,14,4,1135,2,0,0,0,0,1,1,2,0,0,0,0,0,0
3891,3891,Javier Mascherano,1893,2007,Liverpool FC,14,14,0,1232,1,0,11,11,0,972,0,0,25,25,0,2204,1,0,0,0,0,1,0,1,0,0,0,0,0,0
3892,3892,Fernando Torres,1539,2007,Liverpool FC,19,17,2,1488,21,0,14,12,2,1056,3,0,33,29,4,2544,24,0,10,1,11,10,2,12,0,0,0,0,0,0
3893,3893,Dirk Kuyt,1894,2007,Liverpool FC,18,13,5,1168,0,0,14,11,3,998,3,0,32,24,8,2166,3,0,0,3,3,0,2,2,0,2,2,0,0,0
3894,3894,Yossi Benayoun,1892,2007,Liverpool FC,17,6,11,743,2,0,13,9,4,833,2,0,30,15,15,1576,4,0,0,4,4,2,2,4,0,0,0,0,0,0
3895,3895,Mohamed Sissoko,2745,2007,Liverpool FC,1,0,1,13,0,0,8,6,2,540,1,0,9,6,3,553,1,0,0,0,0,0,1,1,0,0,0,0,0,0
3896,3896,Andriy Voronin,2746,2007,Liverpool FC,7,4,3,319,3,0,12,9,3,801,2,0,19,13,6,1120,5,0,0,0,0,1,1,2,0,0,0,0,0,0
3897,3897,Dean Kiely,2334,2004,Charlton Athletic,18,18,0,1620,0,0,17,17,0,1530,0,0,35,35,0,3150,0,0,0,0,0,0,0,0,0,0,0,0,0,0
3898,3898,Luke Young,1952,2004,Charlton Athletic,18,18,0,1620,1,0,16,16,0,1440,1,0,34,34,0,3060,2,0,0,0,0,0,1,1,0,0,0,0,0,0
3899,3899,Chris Perry,1954,2004,Charlton Athletic,9,8,1,742,1,0,10,9,1,767,0,0,19,17,2,1509,1,0,1,0,1,1,0,1,0,0,0,0,0,0
3900,3900,Hermann Hreiðarsson,1953,2004,Charlton Athletic,17,16,1,1453,1,0,16,16,0,1418,0,0,33,32,1,2871,1,0,0,0,0,0,0,0,0,0,0,0,0,0
3901,3901,Jonathan Fortune,2665,2004,Charlton Athletic,15,14,1,1305,1,0,14,12,2,1101,1,0,29,26,3,2406,2,0,1,0,1,1,0,1,0,0,0,0,0,0
3902,3902,Graham Stuart,1673,2004,Charlton Athletic,2,2,0,180,0,0,2,2,0,164,0,0,4,4,0,344,0,0,0,0,0,0,0,0,0,0,0,0,0,0
3903,3903,Matt Holland,1955,2004,Charlton Athletic,15,15,0,1314,0,0,15,14,1,1198,3,0,30,29,1,2512,3,0,0,6,6,0,3,3,0,0,0,0,0,0
3904,3904,Danny Murphy,1398,2004,Charlton Athletic,19,18,1,1572,2,0,17,17,0,1496,1,0,36,35,1,3068,3,0,0,0,0,0,1,1,0,0,0,0,0,0
3905,3905,Kevin Lisbie,2337,2004,Charlton Athletic,9,6,3,585,0,0,7,5,2,458,1,0,16,11,5,1043,1,0,0,0,0,0,0,0,0,0,0,0,0,0
3906,3906,Shaun Bartlett,1675,2004,Charlton Athletic,13,13,0,1069,3,0,11,11,0,913,3,0,24,24,0,1982,6,0,0,0,0,3,2,5,0,0,0,0,0,0
3907,3907,Dennis Rommedahl,2747,2004,Charlton Athletic,14,11,3,911,0,0,11,7,4,662,2,0,25,18,7,1573,2,0,0,4,4,0,2,2,0,0,0,0,0,0
3908,3908,Francis Jeffers,2359,2004,Charlton Athletic,12,5,7,426,3,0,8,4,4,436,0,0,20,9,11,862,3,0,0,0,0,2,0,2,0,0,0,0,0,0
3909,3909,Stephen Carr,1780,2004,Newcastle United,13,13,0,1023,0,0,12,12,0,1022,1,0,25,25,0,2045,1,0,0,3,3,0,1,1,0,0,0,0,0,0
3910,3910,Andy O'Brien,2160,2004,Newcastle United,9,8,1,754,1,0,13,12,1,1102,1,0,22,20,2,1856,2,0,0,0,0,0,1,1,0,0,0,0,0,0
3911,3911,Nicky Butt,1115,2004,Newcastle United,8,7,1,632,0,0,10,9,1,792,1,0,18,16,2,1424,1,0,0,1,1,0,1,1,0,0,0,0,0,0
3912,3912,Darren Ambrose,1956,2004,Newcastle United,4,3,1,268,0,0,7,4,3,383,3,0,11,7,4,651,3,0,0,0,0,0,3,3,0,0,0,0,0,0
3913,3913,Alan Shearer,1948,2004,Newcastle United,15,15,0,1322,5,0,13,11,2,940,2,0,28,26,2,2262,7,0,0,0,0,2,2,4,2,1,3,0,0,0
3914,3914,Shola Ameobi,1950,2004,Newcastle United,16,8,8,810,1,0,14,8,6,807,1,0,30,16,14,1617,2,0,0,0,0,1,0,1,0,0,0,0,0,0
3915,3915,Petr Čech,1531,2012,Chelsea FC,17,17,0,1530,0,0,18,18,0,1576,0,0,35,35,0,3106,0,0,0,0,0,0,0,0,0,0,0,0,0,0
3916,3916,Branislav Ivanović,1532,2012,Chelsea FC,15,15,0,1338,4,0,18,17,1,1545,1,0,33,32,1,2883,5,0,3,0,3,1,1,2,0,0,0,0,0,0
3917,3917,Ashley Cole,1523,2012,Chelsea FC,15,15,0,1350,1,0,15,15,0,1350,0,0,30,30,0,2700,1,0,3,0,3,1,0,1,0,0,0,0,0,0
3918,3918,Gary Cahill,1533,2012,Chelsea FC,13,12,1,1129,1,0,12,11,1,1000,1,0,25,23,2,2129,2,0,0,0,0,1,1,2,0,0,0,0,0,0
3919,3919,Azpilicueta,1535,2012,Chelsea FC,15,12,3,1123,0,0,11,11,0,983,0,0,26,23,3,2106,0,0,0,0,0,0,0,0,0,0,0,0,0,0
3920,3920,Ramires,2460,2012,Chelsea FC,17,14,3,1218,5,0,17,14,3,1317,0,0,34,28,6,2535,5,0,0,0,0,3,0,3,0,0,0,0,0,0
3921,3921,Frank Lampard,1536,2012,Chelsea FC,13,9,4,843,7,0,15,11,4,998,8,0,28,20,8,1841,15,0,0,6,6,3,5,8,3,2,5,0,0,0
3922,3922,Mata,1643,2012,Chelsea FC,18,15,3,1345,3,0,16,15,1,1327,8,0,34,30,4,2672,11,0,0,6,6,2,7,9,0,0,0,0,0,0
3923,3923,Oscar,1543,2012,Chelsea FC,17,15,2,1328,3,0,16,9,7,942,1,0,33,24,9,2270,4,0,0,0,0,2,1,3,1,0,1,0,0,0
3924,3924,Fernando Torres,1539,2012,Chelsea FC,16,13,3,1211,5,0,19,14,5,1316,3,0,35,27,8,2527,8,0,3,0,3,4,2,6,0,1,1,0,0,0
3925,3925,Eden Hazard,1541,2012,Chelsea FC,17,16,1,1372,6,0,16,14,2,1177,3,0,33,30,3,2549,9,0,0,0,0,1,2,3,1,1,2,0,0,0
3926,3926,Ryan Bertrand,1148,2012,Chelsea FC,7,5,2,459,0,0,12,9,3,825,0,0,19,14,5,1284,0,0,0,0,0,0,0,0,0,0,0,0,0,0
3927,3927,Marko Marin,2748,2012,Chelsea FC,4,1,3,71,1,0,2,1,1,72,0,0,6,2,4,143,1,0,0,0,0,0,0,0,0,0,0,0,0,0
3928,3928,Demba Ba,1544,2012,Chelsea FC,7,6,1,478,2,0,7,5,2,391,0,0,14,11,3,869,2,0,3,0,3,2,0,2,0,0,0,0,0,0
3929,3929,Ross Turnbull,2217,2012,Chelsea FC,1,1,0,90,0,0,2,1,1,134,0,0,3,2,1,224,0,0,0,0,0,0,0,0,0,0,0,0,0,0
3930,3930,Paulo Ferreira,1761,2012,Chelsea FC,1,0,1,1,0,0,1,0,1,7,0,0,2,0,2,8,0,0,0,0,0,0,0,0,0,0,0,0,0,0
3931,3931,John Terry,1534,2012,Chelsea FC,6,4,2,322,1,0,8,7,1,625,3,0,14,11,3,947,4,0,0,0,0,1,1,2,0,0,0,0,0,0
3932,3932,Nathan Aké,1037,2012,Chelsea FC,1,1,0,90,0,0,2,0,2,2,0,0,3,1,2,92,0,0,0,0,0,0,0,0,0,0,0,0,0,0
3933,3933,Wojciech Szczęsny,1507,2012,Arsenal FC,14,14,0,1260,0,0,11,11,0,990,0,0,25,25,0,2250,0,0,0,0,0,0,0,0,0,0,0,0,0,0
3934,3934,Bacary Sagna,1596,2012,Arsenal FC,14,14,0,1250,0,0,11,11,0,990,0,0,25,25,0,2240,0,0,0,0,0,0,0,0,0,0,0,0,0,0
3935,3935,Per Mertesacker,1496,2012,Arsenal FC,16,15,1,1428,1,0,18,18,0,1620,2,0,34,33,1,3048,3,0,0,3,3,1,1,2,0,0,0,0,0,0
3936,3936,Thomas Vermaelen,2749,2012,Arsenal FC,15,14,1,1228,0,0,14,11,3,1009,0,0,29,25,4,2237,0,0,0,0,0,0,0,0,0,0,0,0,0,0
3937,3937,Kieran Gibbs,1508,2012,Arsenal FC,14,13,1,1136,0,0,13,10,3,965,0,0,27,23,4,2101,0,0,0,0,0,0,0,0,0,0,0,0,0,0
3938,3938,Abou Diaby,2434,2012,Arsenal FC,5,5,0,276,0,0,6,5,1,437,0,0,11,10,1,713,0,0,0,0,0,0,0,0,0,0,0,0,0,0
3939,3939,Jack Wilshere,1694,2012,Arsenal FC,14,12,2,1015,0,0,11,8,3,701,0,0,25,20,5,1716,0,0,0,0,0,0,0,0,0,0,0,0,0,0
3940,3940,Santi Cazorla,1502,2012,Arsenal FC,19,18,1,1635,5,0,19,19,0,1674,7,0,38,37,1,3309,12,0,3,3,6,2,1,3,0,0,0,0,0,0
3941,3941,Francis Coquelin,1503,2012,Arsenal FC,4,2,2,139,0,0,7,1,6,85,0,0,11,3,8,224,0,0,0,0,0,0,0,0,0,0,0,0,0,0
3942,3942,Olivier Giroud,1504,2012,Arsenal FC,17,11,6,1091,10,0,17,13,4,1234,1,0,34,24,10,2325,11,0,1,0,1,4,1,5,0,0,0,0,0,0
3943,3943,Theo Walcott,1237,2012,Arsenal FC,17,13,4,1224,9,0,15,11,4,1062,5,0,32,24,8,2286,14,0,1,3,4,5,3,8,0,0,0,0,0,0
3944,3944,Aaron Ramsey,1501,2012,Arsenal FC,17,9,8,939,1,0,19,12,7,1148,0,0,36,21,15,2087,1,0,0,0,0,0,0,0,0,0,0,0,0,0
3945,3945,Andrey Arshavin,2750,2012,Arsenal FC,3,0,3,28,0,0,4,0,4,53,0,0,7,0,7,81,0,0,0,0,0,0,0,0,0,0,0,0,0,0
3946,3946,Vito Mannone,2261,2012,Arsenal FC,3,3,0,270,0,0,6,6,0,540,0,0,9,9,0,810,0,0,0,0,0,0,0,0,0,0,0,0,0,0
3947,3947,Laurent Koscielny,1497,2012,Arsenal FC,13,11,2,1024,0,0,12,9,3,731,2,0,25,20,5,1755,2,0,0,4,4,0,2,2,0,0,0,0,0,0
3948,3948,André Santos,2751,2012,Arsenal FC,4,1,3,173,0,0,4,2,2,222,0,0,8,3,5,395,0,0,0,0,0,0,0,0,0,0,0,0,0,0
3949,3949,Carl Jenkinson,2752,2012,Arsenal FC,5,5,0,436,0,0,9,9,0,780,0,0,14,14,0,1216,0,0,0,0,0,0,0,0,0,0,0,0,0,0
3950,3950,Emmanuel Frimpong,2753,2012,Arsenal FC,0,0,0,0,0,0,0,0,0,0,0,0,0,0,0,0,0,0,0,0,0,0,0,0,0,0,0,0,0,0
3951,3951,James Milner,1189,2016,Liverpool FC,19,19,0,1694,3,0,17,17,0,1466,4,0,36,36,0,3160,7,0,0,3,3,0,4,4,3,4,7,0,0,0
3952,3952,Marko Grujić,2754,2016,Liverpool FC,3,0,3,25,0,0,2,0,2,13,0,0,5,0,5,38,0,0,0,0,0,0,0,0,0,0,0,0,0,0
3953,3953,De Gea,1638,2016,Manchester United,18,18,0,1620,0,0,17,17,0,1530,0,0,35,35,0,3150,0,0,0,0,0,0,0,0,0,0,0,0,0,0
3954,3954,Eric Bailly,2755,2016,Manchester United,12,11,1,966,0,0,13,13,0,1094,0,0,25,24,1,2060,0,0,0,0,0,0,0,0,0,0,0,0,0,0
3955,3955,Chris Smalling,1640,2016,Manchester United,6,4,2,378,1,0,12,9,3,837,0,0,18,13,5,1215,1,0,0,0,0,1,0,1,0,0,0,0,0,0
3956,3956,Daley Blind,2186,2016,Manchester United,12,11,1,946,1,0,11,9,2,883,0,0,23,20,3,1829,1,0,0,0,0,1,0,1,0,0,0,0,0,0
3957,3957,Antonio Valencia,1641,2016,Manchester United,16,15,1,1431,0,0,12,12,0,1052,1,0,28,27,1,2483,1,0,0,0,0,0,0,0,0,0,0,0,0,0
3958,3958,Paul Pogba,1642,2016,Manchester United,17,16,1,1439,3,0,13,13,0,1170,2,0,30,29,1,2609,5,0,3,0,3,1,2,3,0,0,0,0,0,0
3959,3959,Ashley Young,1619,2016,Manchester United,5,4,1,338,0,0,7,4,3,420,0,0,12,8,4,758,0,0,0,0,0,0,0,0,0,0,0,0,0,0
3960,3960,Ander Herrera,1644,2016,Manchester United,16,14,2,1300,1,0,15,13,2,1187,0,0,31,27,4,2487,1,0,0,0,0,0,0,0,0,0,0,0,0,0
3961,3961,Marouane Fellaini,2189,2016,Manchester United,13,6,7,595,0,0,15,12,3,1011,1,0,28,18,10,1606,1,0,0,0,0,0,1,1,0,0,0,0,0,0
3962,3962,Zlatan Ibrahimović,2575,2016,Manchester United,15,14,1,1267,7,0,13,13,0,1170,10,0,28,27,1,2437,17,0,3,3,6,4,4,8,2,0,2,0,0,0
3963,3963,Marcus Rashford,1648,2016,Manchester United,15,10,5,962,2,0,17,6,11,740,3,0,32,16,16,1702,5,0,0,3,3,1,2,3,0,0,0,0,0,0
3964,3964,Luke Shaw,2576,2016,Manchester United,6,5,1,365,0,0,5,4,1,327,0,0,11,9,2,692,0,0,0,0,0,0,0,0,0,0,0,0,0,0
3965,3965,Wayne Rooney,1058,2016,Manchester United,13,5,8,620,1,0,12,10,2,918,4,0,25,15,10,1538,5,0,0,1,1,1,1,2,1,0,1,0,0,0
3966,3966,Sergio Romero,2192,2016,Manchester United,0,0,0,0,0,0,2,2,0,180,0,0,2,2,0,180,0,0,0,0,0,0,0,0,0,0,0,0,0,0
3967,3967,Marcos Rojo,1651,2016,Manchester United,12,11,1,1016,1,0,9,7,2,645,0,0,21,18,3,1661,1,0,0,0,0,1,0,1,0,0,0,0,0,0
3968,3968,Mata,1643,2016,Manchester United,12,9,3,768,3,0,13,10,3,858,3,0,25,19,6,1626,6,0,0,0,0,2,2,4,0,0,0,0,0,0
3969,3969,Jesse Lingard,1646,2016,Manchester United,13,11,2,807,0,0,12,7,5,560,1,0,25,18,7,1367,1,0,0,0,0,0,0,0,0,0,0,0,0,0
3970,3970,Michael Carrick,1627,2016,Manchester United,12,9,3,764,0,0,11,9,2,837,0,0,23,18,5,1601,0,0,0,0,0,0,0,0,0,0,0,0,0,0
3971,3971,Thomas Sørensen,1090,2010,Stoke City,5,5,0,450,0,0,5,5,0,450,0,0,10,10,0,900,0,0,0,0,0,0,0,0,0,0,0,0,0,0
3972,3972,Robert Huth,1884,2010,Stoke City,17,17,0,1490,4,0,18,18,0,1620,2,0,35,35,0,3110,6,0,6,0,6,4,2,6,0,0,0,0,0,0
3973,3973,Danny Collins,1215,2010,Stoke City,13,12,1,1048,0,0,12,11,1,983,0,0,25,23,2,2031,0,0,0,0,0,0,0,0,0,0,0,0,0,0
3974,3974,Marc Wilson,1546,2010,Stoke City,14,9,5,807,0,0,14,12,2,1049,1,0,28,21,7,1856,1,0,0,0,0,0,0,0,0,0,0,0,0,0
3975,3975,Ryan Shawcross,1547,2010,Stoke City,18,18,0,1620,1,0,18,18,0,1620,0,0,36,36,0,3240,1,0,0,0,0,0,0,0,0,0,0,0,0,0
3976,3976,Abdoulaye Faye,1714,2010,Stoke City,7,6,1,580,0,0,7,6,1,547,1,0,14,12,2,1127,1,0,0,0,0,0,0,0,0,0,0,0,0,0
3977,3977,Jermaine Pennant,1514,2010,Stoke City,17,16,1,1265,3,0,12,10,2,766,0,0,29,26,3,2031,3,0,0,0,0,0,0,0,0,0,0,0,0,0
3978,3978,Rory Delap,1993,2010,Stoke City,19,19,0,1692,1,0,18,14,4,1269,1,0,37,33,4,2961,2,0,0,0,0,1,1,2,0,0,0,0,0,0
3979,3979,Matthew Etherington,1557,2010,Stoke City,18,17,1,1414,2,0,14,13,1,1120,3,0,32,30,2,2534,5,0,1,0,1,1,2,3,1,1,2,0,0,0
3980,3980,Kenwyne Jones,1222,2010,Stoke City,18,18,0,1548,6,0,16,15,1,1247,3,0,34,33,1,2795,9,0,1,0,1,5,2,7,0,0,0,0,0,0
3981,3981,Jon Walters,1555,2010,Stoke City,19,12,7,1046,4,0,17,15,2,1293,2,0,36,27,9,2339,6,0,3,0,3,3,0,3,0,1,1,0,0,0
3982,3982,Danny Higginbotham,1990,2010,Stoke City,7,6,1,573,2,0,3,3,0,270,0,0,10,9,1,843,2,0,0,0,0,1,0,1,0,0,0,0,0,0
3983,3983,Tuncay Şanlı,2220,2010,Stoke City,7,1,6,257,1,0,7,4,3,452,0,0,14,5,9,709,1,0,0,0,0,1,0,1,0,0,0,0,0,0
3984,3984,Asmir Begović,1036,2010,Stoke City,14,14,0,1260,0,0,14,14,0,1260,0,0,28,28,0,2520,0,0,0,0,0,0,0,0,0,0,0,0,0,0
3985,3985,Andy Wilkinson,1553,2010,Stoke City,10,10,0,831,0,0,12,11,1,919,0,0,22,21,1,1750,0,0,0,0,0,0,0,0,0,0,0,0,0,0
3986,3986,Glenn Whelan,1549,2010,Stoke City,14,6,8,584,0,0,15,8,7,765,0,0,29,14,15,1349,0,0,0,0,0,0,0,0,0,0,0,0,0,0
3987,3987,Danny Pugh,2756,2010,Stoke City,5,1,4,158,0,0,5,4,1,364,0,0,10,5,5,522,0,0,0,0,0,0,0,0,0,0,0,0,0,0
3988,3988,Gary Neville,1105,2010,Manchester United,0,0,0,0,0,0,3,3,0,207,0,0,3,3,0,207,0,0,0,0,0,0,0,0,0,0,0,0,0,0
3989,3989,Rio Ferdinand,1294,2010,Manchester United,10,10,0,900,0,0,9,9,0,810,0,0,19,19,0,1710,0,0,0,0,0,0,0,0,0,0,0,0,0,0
3990,3990,Darren Fletcher,1730,2010,Manchester United,11,11,0,934,1,0,15,13,2,1174,1,0,26,24,2,2108,2,0,0,0,0,0,1,1,0,0,0,0,0,0
3991,3991,Gabriel Obertan,2283,2010,Manchester United,4,2,2,201,0,0,3,1,2,81,0,0,7,3,4,282,0,0,0,0,0,0,0,0,0,0,0,0,0,0
3992,3992,Federico Macheda,2019,2010,Manchester United,4,1,3,107,0,0,3,1,2,110,1,0,7,2,5,217,1,0,0,0,0,0,0,0,0,0,0,0,0,0
3993,3993,Ryan Shawcross,1547,2015,Stoke City,10,10,0,900,0,0,10,10,0,840,0,0,20,20,0,1740,0,0,0,0,0,0,0,0,0,0,0,0,0,0
3994,3994,Geoff Cameron,1548,2015,Stoke City,15,14,1,1173,0,0,15,13,2,1195,0,0,30,27,3,2368,0,0,0,0,0,0,0,0,0,0,0,0,0,0
3995,3995,Marco van Ginkel,2757,2015,Stoke City,9,4,5,422,0,0,8,4,4,329,0,0,17,8,9,751,0,0,0,0,0,0,0,0,0,0,0,0,0,0
3996,3996,Marc Wilson,1546,2015,Stoke City,3,1,2,198,0,0,1,0,1,60,0,0,4,1,3,258,0,0,0,0,0,0,0,0,0,0,0,0,0,0
3997,3997,Charlie Adam,1554,2015,Stoke City,11,6,5,557,0,0,11,6,5,544,1,0,22,12,10,1101,1,0,0,0,0,0,1,1,0,0,0,0,0,0
3998,3998,Fernando,1592,2015,Manchester City,13,8,5,850,1,0,11,9,2,862,1,0,24,17,7,1712,2,0,0,0,0,1,1,2,0,0,0,0,0,0
3999,3999,Cameron Humphreys,2758,2015,Manchester City,0,0,0,0,0,0,0,0,0,0,0,0,0,0,0,0,0,0,0,0,0,0,0,0,0,0,0,0,0,0
4000,4000,Manu García,2759,2015,Manchester City,1,0,1,10,0,0,0,0,0,0,0,0,1,0,1,10,0,0,0,0,0,0,0,0,0,0,0,0,0,0
4001,4001,Steven Taylor,2014,2004,Newcastle United,8,6,2,622,0,0,4,4,0,316,0,0,12,10,2,938,0,0,0,0,0,0,0,0,0,0,0,0,0,0
4002,4002,Charles N'Zogbia,2016,2004,Newcastle United,6,3,3,289,0,0,7,4,3,425,0,0,13,7,6,714,0,0,0,0,0,0,0,0,0,0,0,0,0,0
4003,4003,Stan Lazaridis,2624,2004,Birmingham City,11,10,1,808,0,0,8,4,4,448,0,0,19,14,5,1256,0,0,0,0,0,0,0,0,0,0,0,0,0,0
4004,4004,Jussi Jääskeläinen,1710,2012,West Ham United,19,19,0,1710,0,0,19,19,0,1710,0,0,38,38,0,3420,0,0,0,0,0,0,0,0,0,0,0,0,0,0
4005,4005,Winston Reid,2638,2012,West Ham United,19,19,0,1710,1,0,17,17,0,1435,0,0,36,36,0,3145,1,0,0,0,0,0,0,0,0,0,0,0,0,0
4006,4006,George McCartney,1340,2012,West Ham United,7,5,2,487,0,0,5,4,1,391,0,0,12,9,3,878,0,0,0,0,0,0,0,0,0,0,0,0,0,0
4007,4007,Joey O'Brien,2412,2012,West Ham United,17,16,1,1414,2,0,16,16,0,1309,0,0,33,32,1,2723,2,0,1,0,1,1,0,1,0,0,0,0,0,0
4008,4008,James Collins,1618,2012,West Ham United,15,15,0,1321,0,0,14,14,0,1175,0,0,29,29,0,2496,0,0,0,0,0,0,0,0,0,0,0,0,0,0
4009,4009,Kevin Nolan,2396,2012,West Ham United,18,18,0,1518,8,0,17,17,0,1471,2,0,35,35,0,2989,10,0,4,3,7,5,2,7,0,0,0,0,0,0
4010,4010,Matthew Jarvis,2627,2012,West Ham United,15,14,1,1252,1,0,17,15,2,1313,1,0,32,29,3,2565,2,0,0,0,0,1,1,2,0,0,0,0,0,0
4011,4011,Yossi Benayoun,1892,2012,West Ham United,3,2,1,213,0,0,3,2,1,102,0,0,6,4,2,315,0,0,0,0,0,0,0,0,0,0,0,0,0,0
4012,4012,Mark Noble,2204,2012,West Ham United,16,14,2,1321,4,0,12,11,1,966,0,0,28,25,3,2287,4,0,0,0,0,3,0,3,3,0,3,0,0,0
4013,4013,Momo Diamé,2060,2012,West Ham United,17,16,1,1377,3,0,16,15,1,1231,0,0,33,31,2,2608,3,0,0,0,0,3,0,3,0,0,0,0,0,0
4014,4014,Jordan Spence,2760,2012,West Ham United,4,0,4,22,0,0,0,0,0,0,0,0,4,0,4,22,0,0,0,0,0,0,0,0,0,0,0,0,0,0
4015,4015,Gary O'Neil,1389,2012,West Ham United,12,8,4,647,1,0,12,9,3,795,0,0,24,17,7,1442,1,0,0,0,0,0,0,0,0,0,0,0,0,0
4016,4016,Carlton Cole,2326,2012,West Ham United,11,6,5,591,2,0,16,8,8,793,0,0,27,14,13,1384,2,0,0,0,0,2,0,2,0,0,0,0,0,0
4017,4017,Raphael Spiegel,2761,2012,West Ham United,0,0,0,0,0,0,0,0,0,0,0,0,0,0,0,0,0,0,0,0,0,0,0,0,0,0,0,0,0,0
4018,4018,Leo Chambers,2762,2012,West Ham United,0,0,0,0,0,0,0,0,0,0,0,0,0,0,0,0,0,0,0,0,0,0,0,0,0,0,0,0,0,0
4019,4019,Modibo Maïga,2763,2012,West Ham United,9,1,8,172,2,0,8,1,7,236,0,0,17,2,15,408,2,0,0,0,0,0,0,0,0,0,0,0,0,0
4020,4020,Robert Hall,2764,2012,West Ham United,1,0,1,12,0,0,0,0,0,0,0,0,1,0,1,12,0,0,0,0,0,0,0,0,0,0,0,0,0,0
4021,4021,David James,1385,2000,Aston Villa,19,19,0,1710,0,0,17,17,0,1530,0,0,36,36,0,3240,0,0,0,0,0,0,0,0,0,0,0,0,0,0
4022,4022,Gareth Southgate,1331,2000,Aston Villa,17,17,0,1464,1,0,13,13,0,1109,1,0,30,30,0,2573,2,0,0,0,0,1,1,2,0,0,0,0,0,0
4023,4023,Alpay Özalan,2765,2000,Aston Villa,16,16,0,1345,0,0,15,15,0,1330,0,0,31,31,0,2675,0,0,0,0,0,0,0,0,0,0,0,0,0,0
4024,4024,Alan Wright,2766,2000,Aston Villa,18,17,1,1537,1,0,16,16,0,1395,0,0,34,33,1,2932,1,0,0,0,0,0,0,0,0,0,0,0,0,0
4025,4025,Ian Taylor,2767,2000,Aston Villa,15,12,3,1064,4,0,13,12,1,1047,0,0,28,24,4,2111,4,0,3,0,3,3,0,3,0,0,0,0,0,0
4026,4026,Gareth Barry,1418,2000,Aston Villa,15,14,1,1231,0,0,13,13,0,1090,0,0,28,27,1,2321,0,0,0,0,0,0,0,0,0,0,0,0,0,0
4027,4027,Lee Hendrie,1797,2000,Aston Villa,16,15,1,1276,2,0,14,10,4,1016,4,0,30,25,5,2292,6,0,3,2,5,2,3,5,0,0,0,0,0,0
4028,4028,Steve Stone,1071,2000,Aston Villa,17,17,0,1430,1,0,15,14,1,1168,1,0,32,31,1,2598,2,0,0,0,0,1,0,1,0,0,0,0,0,0
4029,4029,Dion Dublin,2768,2000,Aston Villa,17,14,3,1280,5,0,14,13,1,1180,3,0,31,27,4,2460,8,0,0,0,0,4,2,6,1,0,1,0,0,0
4030,4030,Paul Merson,2769,2000,Aston Villa,19,19,0,1710,4,0,17,17,0,1474,2,0,36,36,0,3184,6,0,3,3,6,2,2,4,0,0,0,0,0,0
4031,4031,Julian Joachim,2770,2000,Aston Villa,11,7,4,718,4,0,8,3,5,379,3,0,19,10,9,1097,7,0,3,0,3,3,2,5,0,0,0,0,0,0
4032,4032,George Boateng,1333,2000,Aston Villa,15,13,2,1145,0,0,17,15,2,1323,1,0,32,28,4,2468,1,0,0,0,0,0,0,0,0,0,0,0,0,0
4033,4033,Darius Vassell,1798,2000,Aston Villa,11,2,9,357,1,0,12,3,9,468,3,0,23,5,18,825,4,0,0,0,0,0,2,2,0,0,0,0,0,0
4034,4034,Jens Lehmann,1522,2003,Arsenal FC,19,19,0,1710,0,0,19,19,0,1710,0,0,38,38,0,3420,0,0,0,0,0,0,0,0,0,0,0,0,0,0
4035,4035,Ashley Cole,1523,2003,Arsenal FC,16,16,0,1401,0,0,16,16,0,1440,0,0,32,32,0,2841,0,0,0,0,0,0,0,0,0,0,0,0,0,0
4036,4036,Lauren,1602,2003,Arsenal FC,16,16,0,1410,0,0,16,14,2,1333,0,0,32,30,2,2743,0,0,0,0,0,0,0,0,0,0,0,0,0,0
4037,4037,Sol Campbell,1388,2003,Arsenal FC,18,18,0,1620,1,0,17,17,0,1530,0,0,35,35,0,3150,1,0,0,0,0,1,0,1,0,0,0,0,0,0
4038,4038,Kolo Touré,1415,2003,Arsenal FC,18,18,0,1620,0,0,19,18,1,1564,1,0,37,36,1,3184,1,0,0,0,0,0,0,0,0,0,0,0,0,0
4039,4039,Patrick Vieira,1524,2003,Arsenal FC,15,15,0,1285,1,0,14,14,0,1260,2,0,29,29,0,2545,3,0,3,0,3,1,2,3,0,0,0,0,0,0
4040,4040,Robert Pirés,1603,2003,Arsenal FC,19,17,2,1446,7,0,17,16,1,1399,7,0,36,33,3,2845,14,0,0,6,6,5,3,8,0,0,0,0,0,0
4041,4041,Freddie Ljungberg,1525,2003,Arsenal FC,16,14,2,1155,2,0,14,13,1,1074,2,0,30,27,3,2229,4,0,3,3,6,1,2,3,0,0,0,0,0,0
4042,4042,Ray Parlour,1334,2003,Arsenal FC,12,7,5,663,0,0,13,9,4,852,0,0,25,16,9,1515,0,0,0,0,0,0,0,0,0,0,0,0,0,0
4043,4043,Reyes,1604,2003,Arsenal FC,7,3,4,293,0,0,6,4,2,362,2,0,13,7,6,655,2,0,0,4,4,0,2,2,0,0,0,0,0,0
4044,4044,Thierry Henry,2357,2003,Arsenal FC,19,19,0,1710,22,0,18,18,0,1620,8,0,37,37,0,3330,30,0,7,1,8,11,6,17,6,1,7,0,0,0
4045,4045,Martin Keown,2355,2003,Arsenal FC,5,1,4,156,0,0,5,2,3,186,0,0,10,3,7,342,0,0,0,0,0,0,0,0,0,0,0,0,0,0
4046,4046,Gaël Clichy,1230,2003,Arsenal FC,4,3,1,286,0,0,8,4,4,370,0,0,12,7,5,656,0,0,0,0,0,0,0,0,0,0,0,0,0,0
4047,4047,Jérémie Aliadiére,1530,2003,Arsenal FC,4,1,3,87,0,0,6,2,4,174,0,0,10,3,7,261,0,0,0,0,0,0,0,0,0,0,0,0,0,0
4048,4048,Salif Diao,1992,2004,Birmingham City,1,1,0,90,0,0,1,1,0,68,0,0,2,2,0,158,0,0,0,0,0,0,0,0,0,0,0,0,0,0
4049,4049,Robbie Blake,2551,2004,Birmingham City,4,1,3,143,2,0,7,1,6,192,0,0,11,2,9,335,2,0,0,0,0,1,0,1,1,0,1,0,0,0
4050,4050,Edwin van der Sar,1077,2004,Fulham FC,17,16,1,1413,0,0,14,14,0,1260,0,0,31,30,1,2673,0,0,0,0,0,0,0,0,0,0,0,0,0,0
4051,4051,Lee Clark,2017,2004,Fulham FC,9,7,2,700,1,0,6,6,0,540,0,0,15,13,2,1240,1,0,1,0,1,1,0,1,0,0,0,0,0,0
4052,4052,Brian McBride,1088,2004,Fulham FC,16,8,8,845,4,0,13,5,8,494,2,0,29,13,16,1339,6,0,0,0,0,2,2,4,0,0,0,0,0,0
4053,4053,Artur Boruc,1000,2016,AFC Bournemouth,19,19,0,1710,0,0,16,16,0,1440,0,0,35,35,0,3150,0,0,0,0,0,0,0,0,0,0,0,0,0,0
4054,4054,Simon Francis,1001,2016,AFC Bournemouth,18,18,0,1553,0,0,16,16,0,1396,0,0,34,34,0,2949,0,0,0,0,0,0,0,0,0,0,0,0,0,0
4055,4055,Steve Cook,1002,2016,AFC Bournemouth,19,19,0,1710,2,0,19,19,0,1710,0,0,38,38,0,3420,2,0,0,0,0,2,0,2,0,0,0,0,0,0
4056,4056,Charlie Daniels,1003,2016,AFC Bournemouth,17,17,0,1530,3,0,17,17,0,1530,1,0,34,34,0,3060,4,0,0,0,0,2,0,2,0,0,0,0,0,0
4057,4057,Adam Smith,1004,2016,AFC Bournemouth,19,18,1,1642,1,0,17,16,1,1457,0,0,36,34,2,3099,1,0,0,0,0,0,0,0,0,0,0,0,0,0
4058,4058,Dan Gosling,1005,2016,AFC Bournemouth,12,7,5,630,2,0,15,7,8,727,0,0,27,14,13,1357,2,0,0,0,0,1,0,1,0,0,0,0,0,0
4059,4059,Harry Arter,1007,2016,AFC Bournemouth,17,16,1,1439,0,0,18,17,1,1533,1,0,35,33,2,2972,1,0,0,0,0,0,0,0,0,0,0,0,0,0
4060,4060,Jack Wilshere,1694,2016,AFC Bournemouth,14,11,3,967,0,0,13,11,2,945,0,0,27,22,5,1912,0,0,0,0,0,0,0,0,0,0,0,0,0,0
4061,4061,Callum Wilson,1039,2016,AFC Bournemouth,11,9,2,800,4,0,9,7,2,566,2,0,20,16,4,1366,6,0,3,0,3,1,2,3,2,1,3,0,0,0
4062,4062,Joshua King,1040,2016,AFC Bournemouth,18,17,1,1418,7,0,18,14,4,1303,9,0,36,31,5,2721,16,0,6,5,11,6,6,12,0,2,2,0,0,0
4063,4063,Jordon Ibe,1042,2016,AFC Bournemouth,15,7,8,587,0,0,10,6,4,470,0,0,25,13,12,1057,0,0,0,0,0,0,0,0,0,0,0,0,0,0
4064,4064,Benik Afobe,1043,2016,AFC Bournemouth,15,6,9,652,3,0,16,8,8,801,3,0,31,14,17,1453,6,0,1,0,1,1,2,3,0,0,0,0,0,0
4065,4065,Max Gradel,2771,2016,AFC Bournemouth,7,0,7,99,0,0,4,0,4,26,0,0,11,0,11,125,0,0,0,0,0,0,0,0,0,0,0,0,0,0
4066,4066,Ryan Fraser,1041,2016,AFC Bournemouth,14,8,6,781,2,0,14,11,3,987,1,0,28,19,9,1768,3,0,0,0,0,0,0,0,0,0,0,0,0,0
4067,4067,Adam Federici,1014,2016,AFC Bournemouth,0,0,0,0,0,0,2,2,0,180,0,0,2,2,0,180,0,0,0,0,0,0,0,0,0,0,0,0,0,0
4068,4068,Tyrone Mings,2772,2016,AFC Bournemouth,3,1,2,158,0,0,4,4,0,348,0,0,7,5,2,506,0,0,0,0,0,0,0,0,0,0,0,0,0,0
4069,4069,Lys Mousset,1044,2016,AFC Bournemouth,6,2,4,162,0,0,5,1,4,103,0,0,11,3,8,265,0,0,0,0,0,0,0,0,0,0,0,0,0,0
4070,4070,Hugo Lloris,1160,2016,Tottenham Hotspur,17,17,0,1530,0,0,17,17,0,1475,0,0,34,34,0,3005,0,0,0,0,0,0,0,0,0,0,0,0,0,0
4071,4071,Kyle Walker,1196,2016,Tottenham Hotspur,18,16,2,1374,0,0,15,15,0,1330,0,0,33,31,2,2704,0,0,0,0,0,0,0,0,0,0,0,0,0,0
4072,4072,Danny Rose,1399,2016,Tottenham Hotspur,10,10,0,887,2,0,8,8,0,646,0,0,18,18,0,1533,2,0,4,0,4,2,0,2,0,0,0,0,0,0
4073,4073,Jan Vertonghen,1161,2016,Tottenham Hotspur,18,18,0,1570,0,0,15,15,0,1327,0,0,33,33,0,2897,0,0,0,0,0,0,0,0,0,0,0,0,0,0
4074,4074,Eric Dier,1162,2016,Tottenham Hotspur,19,18,1,1625,1,0,17,16,1,1419,1,0,36,34,2,3044,2,0,0,0,0,0,1,1,0,0,0,0,0,0
4075,4075,Victor Wanyama,1864,2016,Tottenham Hotspur,18,17,1,1538,3,0,18,18,0,1478,1,0,36,35,1,3016,4,0,3,0,3,2,0,2,0,0,0,0,0,0
4076,4076,Mousa Dembélé,1172,2016,Tottenham Hotspur,15,13,2,1081,1,0,15,11,4,985,0,0,30,24,6,2066,1,0,0,0,0,1,0,1,0,0,0,0,0,0
4077,4077,Dele Alli,1915,2016,Tottenham Hotspur,19,17,2,1506,9,0,18,18,0,1539,9,0,37,35,2,3045,18,0,0,1,1,4,3,7,1,0,1,0,0,0
4078,4078,Christian Eriksen,1165,2016,Tottenham Hotspur,18,18,0,1588,5,0,18,18,0,1579,3,0,36,36,0,3167,8,0,0,3,3,2,2,4,0,0,0,0,0,0
4079,4079,Heung-min Son,1859,2016,Tottenham Hotspur,16,10,6,883,4,0,18,13,5,1185,10,0,34,23,11,2068,14,0,0,1,1,0,4,4,0,0,0,0,0,0
4080,4080,Érik Lamela,1168,2016,Tottenham Hotspur,4,3,1,286,0,0,5,3,2,307,1,0,9,6,3,593,1,0,0,1,1,0,1,1,0,0,0,0,0,0
4081,4081,Moussa Sissoko,1858,2016,Tottenham Hotspur,11,3,8,331,0,0,14,5,9,571,0,0,25,8,17,902,0,0,0,0,0,0,0,0,0,0,0,0,0,0
4082,4082,Vincent Janssen,2773,2016,Tottenham Hotspur,11,4,7,384,2,0,16,3,13,448,0,0,27,7,20,832,2,0,0,0,0,1,0,1,1,0,1,0,0,0
4083,4083,Michel Vorm,1174,2016,Tottenham Hotspur,2,2,0,180,0,0,3,2,1,235,0,0,5,4,1,415,0,0,0,0,0,0,0,0,0,0,0,0,0,0
4084,4084,Kieran Trippier,1487,2016,Tottenham Hotspur,5,3,2,274,0,0,7,3,4,292,0,0,12,6,6,566,0,0,0,0,0,0,0,0,0,0,0,0,0,0
4085,4085,Kevin Wimmer,1902,2016,Tottenham Hotspur,1,0,1,41,0,0,4,4,0,316,0,0,5,4,1,357,0,0,0,0,0,0,0,0,0,0,0,0,0,0
4086,4086,Ben Davies,1164,2016,Tottenham Hotspur,11,8,3,772,0,0,12,10,2,963,1,0,23,18,5,1735,1,0,0,0,0,0,0,0,0,0,0,0,0,0
4087,4087,Harry Winks,1857,2016,Tottenham Hotspur,12,2,10,295,1,0,9,1,8,182,0,0,21,3,18,477,1,0,0,0,0,1,0,1,0,0,0,0,0,0
4088,4088,Maik Taylor,2501,2005,Birmingham City,17,17,0,1530,0,0,17,17,0,1530,0,0,34,34,0,3060,0,0,0,0,0,0,0,0,0,0,0,0,0,0
4089,4089,Martin Taylor,1345,2005,Birmingham City,12,11,1,990,0,0,9,9,0,810,0,0,21,20,1,1800,0,0,0,0,0,0,0,0,0,0,0,0,0,0
4090,4090,Kenny Cunningham,1511,2005,Birmingham City,15,15,0,1321,0,0,16,16,0,1415,0,0,31,31,0,2736,0,0,0,0,0,0,0,0,0,0,0,0,0,0
4091,4091,Matthew Upson,1279,2005,Birmingham City,12,12,0,1078,1,0,12,12,0,1002,0,0,24,24,0,2080,1,0,0,0,0,0,0,0,0,0,0,0,0,0
4092,4092,Jamie Clapham,1513,2005,Birmingham City,8,7,1,604,1,0,8,6,2,601,0,0,16,13,3,1205,1,0,0,0,0,1,0,1,0,0,0,0,0,0
4093,4093,Jermaine Pennant,1514,2005,Birmingham City,19,18,1,1555,2,0,19,17,2,1587,0,0,38,35,3,3142,2,0,0,0,0,1,0,1,0,0,0,0,0,0
4094,4094,Jiří Jarošík,2774,2005,Birmingham City,12,10,2,905,2,0,12,9,3,755,3,0,24,19,5,1660,5,0,3,1,4,2,2,4,0,0,0,0,0,0
4095,4095,Nicky Butt,1115,2005,Birmingham City,14,12,2,1069,3,0,10,10,0,900,0,0,24,22,2,1969,3,0,3,0,3,3,0,3,0,0,0,0,0,0
4096,4096,Damien Johnson,2503,2005,Birmingham City,16,16,0,1375,0,0,15,15,0,1329,0,0,31,31,0,2704,0,0,0,0,0,0,0,0,0,0,0,0,0,0
4097,4097,Stephen Clemence,1516,2005,Birmingham City,8,7,1,434,0,0,7,6,1,519,0,0,15,13,2,953,0,0,0,0,0,0,0,0,0,0,0,0,0,0
4098,4098,Emile Heskey,1519,2005,Birmingham City,17,17,0,1382,2,0,17,17,0,1450,2,0,34,34,0,2832,4,0,3,0,3,2,1,3,0,0,0,0,0,0
4099,4099,Marcos Painter,2775,2005,Birmingham City,2,1,1,96,0,0,2,1,1,109,0,0,4,2,2,205,0,0,0,0,0,0,0,0,0,0,0,0,0,0
4100,4100,Neil Kilkenny,2776,2005,Birmingham City,9,1,8,248,0,0,9,5,4,427,0,0,18,6,12,675,0,0,0,0,0,0,0,0,0,0,0,0,0,0
4101,4101,Walter Pandiani,1518,2005,Birmingham City,8,3,5,348,2,0,9,4,5,372,0,0,17,7,10,720,2,0,1,0,1,2,0,2,0,0,0,0,0,0
4102,4102,Kieran Richardson,1898,2005,Manchester United,11,7,4,694,1,0,11,5,6,466,0,0,22,12,10,1160,1,0,0,0,0,0,0,0,0,0,0,0,0,0
4103,4103,Ole Gunnar Solskjær,1116,2005,Manchester United,2,0,2,52,0,0,1,0,1,7,0,0,3,0,3,59,0,0,0,0,0,0,0,0,0,0,0,0,0,0
4104,4104,Wayne Hennessey,1018,2017,Crystal Palace,13,13,0,1170,0,0,14,14,0,1260,0,0,27,27,0,2430,0,0,0,0,0,0,0,0,0,0,0,0,0,0
4105,4105,James Tomkins,1281,2017,Crystal Palace,15,14,1,1218,2,0,13,13,0,1170,1,0,28,27,1,2388,3,0,0,0,0,0,1,1,0,0,0,0,0,0
4106,4106,Scott Dann,1020,2017,Crystal Palace,10,9,1,805,1,0,7,7,0,630,0,0,17,16,1,1435,1,0,0,0,0,1,0,1,0,0,0,0,0,0
4107,4107,Yohan Cabaye,1029,2017,Crystal Palace,15,14,1,1157,0,0,16,14,2,1231,0,0,31,28,3,2388,0,0,0,0,0,0,0,0,0,0,0,0,0,0
4108,4108,Chung-yong Lee,2126,2017,Crystal Palace,5,0,5,57,0,0,2,1,1,74,0,0,7,1,6,131,0,0,0,0,0,0,0,0,0,0,0,0,0,0
4109,4109,Pape Souaré,1021,2017,Crystal Palace,1,0,1,8,0,0,0,0,0,0,0,0,1,0,1,8,0,0,0,0,0,0,0,0,0,0,0,0,0,0
4110,4110,Damien Delaney,1022,2017,Crystal Palace,1,0,1,5,0,0,1,1,0,90,0,0,2,1,1,95,0,0,0,0,0,0,0,0,0,0,0,0,0,0
4111,4111,Sullay Kaikai,2777,2017,Crystal Palace,0,0,0,0,0,0,1,0,1,13,0,0,1,0,1,13,0,0,0,0,0,0,0,0,0,0,0,0,0,0
4112,4112,Gabriel Jesus,1841,2017,Manchester City,13,7,6,644,6,0,15,11,4,938,7,0,28,18,10,1582,13,0,0,3,3,1,4,5,0,0,0,0,0,0
4113,4113,Yaya Touré,1359,2017,Manchester City,5,1,4,159,0,0,5,0,5,69,0,0,10,1,9,228,0,0,0,0,0,0,0,0,0,0,0,0,0,0
4114,4114,Tosin Adarabioyo,2778,2017,Manchester City,0,0,0,0,0,0,0,0,0,0,0,0,0,0,0,0,0,0,0,0,0,0,0,0,0,0,0,0,0,0
4115,4115,Zoumana Camara,2779,2003,Leeds United,7,7,0,630,0,0,6,6,0,540,1,0,13,13,0,1170,1,0,0,0,0,0,1,1,0,0,0,0,0,0
4116,4116,David Batty,2694,2003,Leeds United,7,5,2,446,0,0,3,3,0,210,0,0,10,8,2,656,0,0,0,0,0,0,0,0,0,0,0,0,0,0
4117,4117,Salomon Olembé,2344,2003,Leeds United,6,5,1,440,0,0,6,3,3,400,0,0,12,8,4,840,0,0,0,0,0,0,0,0,0,0,0,0,0,0
4118,4118,Simon Johnson,2780,2003,Leeds United,3,2,1,157,0,0,3,0,3,32,0,0,6,2,4,189,0,0,0,0,0,0,0,0,0,0,0,0,0,0
4119,4119,Mark Viduka,1299,2003,Leeds United,12,12,0,989,6,0,14,14,0,1241,5,0,26,26,0,2230,11,0,3,3,6,3,4,7,1,1,2,0,0,0
4120,4120,Aaron Lennon,1052,2003,Leeds United,5,0,5,81,0,0,6,0,6,125,0,0,11,0,11,206,0,0,0,0,0,0,0,0,0,0,0,0,0,0
4121,4121,Lamine Sakho,2781,2003,Leeds United,8,5,3,435,0,0,9,4,5,347,1,0,17,9,8,782,1,0,0,0,0,0,1,1,0,0,0,0,0,0
4122,4122,Tim Howard,1743,2003,Manchester United,17,17,0,1530,0,0,15,15,0,1350,0,0,32,32,0,2880,0,0,0,0,0,0,0,0,0,0,0,0,0,0
4123,4123,Gary Neville,1105,2003,Manchester United,15,15,0,1340,2,0,15,15,0,1350,0,0,30,30,0,2690,2,0,3,0,3,1,0,1,0,0,0,0,0,0
4124,4124,Phil Neville,1114,2003,Manchester United,15,14,1,1194,0,0,16,15,1,1314,0,0,31,29,2,2508,0,0,0,0,0,0,0,0,0,0,0,0,0,0
4125,4125,Mikaël Silvestre,1106,2003,Manchester United,17,17,0,1401,0,0,17,16,1,1448,0,0,34,33,1,2849,0,0,0,0,0,0,0,0,0,0,0,0,0,0
4126,4126,Rio Ferdinand,1294,2003,Manchester United,10,10,0,900,0,0,10,10,0,860,0,0,20,20,0,1760,0,0,0,0,0,0,0,0,0,0,0,0,0,0
4127,4127,Roy Keane,1111,2003,Manchester United,14,11,3,1028,1,0,14,14,0,1168,2,0,28,25,3,2196,3,0,0,3,3,0,2,2,0,0,0,0,0,0
4128,4128,Paul Scholes,1112,2003,Manchester United,14,10,4,963,6,0,14,14,0,1227,3,0,28,24,4,2190,9,0,0,3,3,2,2,4,0,0,0,0,0,0
4129,4129,Quinton Fortune,2782,2003,Manchester United,12,10,2,960,0,0,11,8,3,660,0,0,23,18,5,1620,0,0,0,0,0,0,0,0,0,0,0,0,0,0
4130,4130,Darren Fletcher,1730,2003,Manchester United,7,5,2,496,0,0,15,12,3,999,0,0,22,17,5,1495,0,0,0,0,0,0,0,0,0,0,0,0,0,0
4131,4131,Cristiano Ronaldo,1726,2003,Manchester United,16,9,7,889,2,0,13,6,7,667,2,0,29,15,14,1556,4,0,0,0,0,0,2,2,0,0,0,0,0,0
4132,4132,Ruud van Nistelrooy,1453,2003,Manchester United,16,16,0,1420,9,0,16,15,1,1333,11,0,32,31,1,2753,20,0,4,3,7,5,3,8,0,0,0,0,0,0
4133,4133,John O'Shea,1729,2003,Manchester United,15,15,0,1271,1,0,18,17,1,1547,1,0,33,32,1,2818,2,0,3,0,3,1,1,2,0,0,0,0,0,0
4134,4134,Nicky Butt,1115,2003,Manchester United,11,8,3,703,1,0,10,4,6,405,0,0,21,12,9,1108,1,0,0,0,0,1,0,1,0,0,0,0,0,0
4135,4135,Diego Forlán,2783,2003,Manchester United,13,6,7,600,4,0,11,4,7,471,0,0,24,10,14,1071,4,0,0,0,0,2,0,2,0,0,0,0,0,0
4136,4136,Ahmed Elmohamady,1690,2016,Hull City,16,14,2,1289,0,0,17,14,3,1292,0,0,33,28,5,2581,0,0,0,0,0,0,0,0,0,0,0,0,0,0
4137,4137,Robert Snodgrass,2207,2016,Hull City,11,10,1,908,5,0,9,9,0,804,2,0,20,19,1,1712,7,0,3,1,4,4,2,6,2,0,2,0,0,0
4138,4138,Jake Livermore,1657,2016,Hull City,11,10,1,888,1,0,10,10,0,835,0,0,21,20,1,1723,1,0,0,0,0,1,0,1,0,0,0,0,0,0
4139,4139,Markus Henriksen,2784,2016,Hull City,7,3,4,279,0,0,8,3,5,355,0,0,15,6,9,634,0,0,0,0,0,0,0,0,0,0,0,0,0,0
4140,4140,James Weir,2785,2016,Hull City,0,0,0,0,0,0,0,0,0,0,0,0,0,0,0,0,0,0,0,0,0,0,0,0,0,0,0,0,0,0
4141,4141,Julian Speroni,2249,2016,Crystal Palace,0,0,0,0,0,0,0,0,0,0,0,0,0,0,0,0,0,0,0,0,0,0,0,0,0,0,0,0,0,0
4142,4142,Michael Phillips,2786,2016,Crystal Palace,0,0,0,0,0,0,0,0,0,0,0,0,0,0,0,0,0,0,0,0,0,0,0,0,0,0,0,0,0,0
4143,4143,Arbeloa,2744,2016,West Ham United,3,1,2,256,0,0,0,0,0,0,0,0,3,1,2,256,0,0,0,0,0,0,0,0,0,0,0,0,0,0
4144,4144,Simone Zaza,2787,2016,West Ham United,4,3,1,280,0,0,4,2,2,180,0,0,8,5,3,460,0,0,0,0,0,0,0,0,0,0,0,0,0,0
4145,4145,Sofiane Féghouli,2788,2016,West Ham United,10,5,5,524,2,0,11,6,5,589,1,0,21,11,10,1113,3,0,0,0,0,2,1,3,0,0,0,0,0,0
4146,4146,Sam Byram,1823,2016,West Ham United,10,8,2,702,0,0,8,5,3,544,0,0,18,13,5,1246,0,0,0,0,0,0,0,0,0,0,0,0,0,0
4147,4147,Reece Oxford,2789,2016,West Ham United,0,0,0,0,0,0,0,0,0,0,0,0,0,0,0,0,0,0,0,0,0,0,0,0,0,0,0,0,0,0
4148,4148,Cédric Soares,1910,2016,Southampton FC,15,15,0,1318,0,0,15,15,0,1202,0,0,30,30,0,2520,0,0,0,0,0,0,0,0,0,0,0,0,0,0
4149,4149,Ryan Bertrand,1148,2016,Southampton FC,12,12,0,1068,0,0,16,16,0,1440,2,0,28,28,0,2508,2,0,0,0,0,0,1,1,0,0,0,0,0,0
4150,4150,Jake Hesketh,2790,2016,Southampton FC,0,0,0,0,0,0,0,0,0,0,0,0,0,0,0,0,0,0,0,0,0,0,0,0,0,0,0,0,0,0
4151,4151,Maik Taylor,2501,2003,Birmingham City,17,17,0,1530,0,0,17,17,0,1530,0,0,34,34,0,3060,0,0,0,0,0,0,0,0,0,0,0,0,0,0
4152,4152,Jeff Kenna,2620,2003,Birmingham City,8,6,2,488,2,0,9,8,1,714,0,0,17,14,3,1202,2,0,3,0,3,2,0,2,0,0,0,0,0,0
4153,4153,Kenny Cunningham,1511,2003,Birmingham City,18,18,0,1617,0,0,18,18,0,1620,0,0,36,36,0,3237,0,0,0,0,0,0,0,0,0,0,0,0,0,0
4154,4154,Darren Purse,1318,2003,Birmingham City,5,5,0,450,0,0,4,4,0,360,0,0,9,9,0,810,0,0,0,0,0,0,0,0,0,0,0,0,0,0
4155,4155,Robbie Savage,1309,2003,Birmingham City,15,15,0,1284,1,0,16,16,0,1390,2,0,31,31,0,2674,3,0,0,0,0,0,1,1,0,1,1,0,0,0
4156,4156,David Dunn,1456,2003,Birmingham City,10,10,0,871,1,0,11,10,1,918,1,0,21,20,1,1789,2,0,3,3,6,1,1,2,1,0,1,0,0,0
4157,4157,Damien Johnson,2503,2003,Birmingham City,17,17,0,1503,1,0,18,18,0,1572,0,0,35,35,0,3075,1,0,0,0,0,1,0,1,0,0,0,0,0,0
4158,4158,Jamie Clapham,1513,2003,Birmingham City,11,10,1,914,0,0,14,12,2,1101,0,0,25,22,3,2015,0,0,0,0,0,0,0,0,0,0,0,0,0,0
4159,4159,Stephen Clemence,1516,2003,Birmingham City,17,16,1,1328,2,0,18,16,2,1398,0,0,35,32,3,2726,2,0,0,0,0,2,0,2,0,0,0,0,0,0
4160,4160,Geoff Horsfield,1326,2003,Birmingham City,1,1,0,68,0,0,2,1,1,78,0,0,3,2,1,146,0,0,0,0,0,0,0,0,0,0,0,0,0,0
4161,4161,Christophe Dugarry,2791,2003,Birmingham City,7,6,1,511,1,0,7,6,1,494,0,0,14,12,2,1005,1,0,0,0,0,0,0,0,0,0,0,0,0,0
4162,4162,Olivier Tebily,1520,2003,Birmingham City,15,10,5,954,0,0,12,7,5,599,0,0,27,17,10,1553,0,0,0,0,0,0,0,0,0,0,0,0,0,0
4163,4163,Paul Devlin,2623,2003,Birmingham City,1,0,1,19,0,0,1,0,1,3,0,0,2,0,2,22,0,0,0,0,0,0,0,0,0,0,0,0,0,0
4164,4164,Stern John,1971,2003,Birmingham City,15,1,14,272,1,0,14,6,8,559,3,0,29,7,22,831,4,0,1,2,3,1,2,3,0,0,0,0,0,0
4165,4165,Stephen Carr,1780,2003,Tottenham Hotspur,16,16,0,1381,0,0,16,16,0,1440,1,0,32,32,0,2821,1,0,0,0,0,0,0,0,0,0,0,0,0,0
4166,4166,Goran Bunjevčević,1937,2003,Tottenham Hotspur,3,1,2,93,0,0,4,2,2,220,0,0,7,3,4,313,0,0,0,0,0,0,0,0,0,0,0,0,0,0
4167,4167,Gary Doherty,2792,2003,Tottenham Hotspur,7,7,0,630,0,0,10,9,1,821,0,0,17,16,1,1451,0,0,0,0,0,0,0,0,0,0,0,0,0,0
4168,4168,Hélder Postiga,2793,2003,Tottenham Hotspur,11,4,7,472,1,0,8,5,3,427,0,0,19,9,10,899,1,0,0,0,0,0,0,0,0,0,0,0,0,0
4169,4169,Dean Marney,1253,2003,Tottenham Hotspur,1,0,1,5,0,0,2,1,1,86,0,0,3,1,2,91,0,0,0,0,0,0,0,0,0,0,0,0,0,0
4170,4170,Bobby Zamora,1943,2003,Tottenham Hotspur,8,4,4,352,0,0,8,2,6,263,0,0,16,6,10,615,0,0,0,0,0,0,0,0,0,0,0,0,0,0
4171,4171,Nigel Martyn,1290,2003,Everton FC,17,16,1,1505,0,0,14,14,0,1260,0,0,31,30,1,2765,0,0,0,0,0,0,0,0,0,0,0,0,0,0
4172,4172,Steve Watson,2794,2003,Everton FC,12,12,0,965,4,0,8,7,1,506,1,0,20,19,1,1471,5,0,0,0,0,1,1,2,0,0,0,0,0,0
4173,4173,Alan Stubbs,2795,2003,Everton FC,15,14,1,1273,0,0,10,9,1,763,0,0,25,23,2,2036,0,0,0,0,0,0,0,0,0,0,0,0,0,0
4174,4174,David Unsworth,2582,2003,Everton FC,14,11,3,1086,3,0,9,8,1,697,0,0,23,19,4,1783,3,0,0,0,0,1,0,1,0,0,0,0,0,0
4175,4175,Joseph Yobo,1801,2003,Everton FC,14,13,1,1175,1,0,11,11,0,990,1,0,25,24,1,2165,2,0,0,0,0,0,0,0,0,0,0,0,0,0
4176,4176,Tony Hibbert,1744,2003,Everton FC,13,12,1,1097,0,0,10,10,0,900,0,0,23,22,1,1997,0,0,0,0,0,0,0,0,0,0,0,0,0,0
4177,4177,Thomas Gravesen,2796,2003,Everton FC,15,14,1,1234,1,0,12,12,0,1056,1,0,27,26,1,2290,2,0,0,0,0,0,1,1,0,0,0,0,0,0
4178,4178,Lee Carsley,1803,2003,Everton FC,10,8,2,687,0,0,9,7,2,674,1,0,19,15,4,1361,1,0,0,0,0,0,1,1,0,0,0,0,0,0
4179,4179,Tomasz Radzinski,1935,2003,Everton FC,18,13,5,1305,6,0,13,12,1,1003,2,0,31,25,6,2308,8,0,4,0,4,6,0,6,0,0,0,0,0,0
4180,4180,Duncan Ferguson,1805,2003,Everton FC,11,8,3,720,3,0,7,3,4,326,2,0,18,11,7,1046,5,0,1,0,1,2,0,2,1,0,1,0,0,0
4181,4181,James McFadden,1413,2003,Everton FC,9,6,3,541,0,0,13,5,8,493,0,0,22,11,11,1034,0,0,0,0,0,0,0,0,0,0,0,0,0,0
4182,4182,Kevin Kilbane,1103,2003,Everton FC,16,13,3,1236,2,0,11,10,1,858,1,0,27,23,4,2094,3,0,0,0,0,1,0,1,0,0,0,0,0,0
4183,4183,Tobias Linderoth,2797,2003,Everton FC,13,10,3,932,0,0,11,10,1,757,0,0,24,20,4,1689,0,0,0,0,0,0,0,0,0,0,0,0,0,0
4184,4184,Wayne Rooney,1058,2003,Everton FC,17,13,4,1173,3,0,13,9,4,922,6,0,30,22,8,2095,9,0,6,4,10,3,5,8,0,0,0,0,0,0
4185,4185,Roque Junior,2798,2003,Leeds United,2,2,0,180,0,0,3,3,0,242,0,0,5,5,0,422,0,0,0,0,0,0,0,0,0,0,0,0,0,0
4186,4186,Nigel Martyn,1290,2001,Leeds United,15,15,0,1350,0,0,15,15,0,1350,0,0,30,30,0,2700,0,0,0,0,0,0,0,0,0,0,0,0,0,0
4187,4187,Ian Harte,1291,2001,Leeds United,15,15,0,1350,4,0,14,12,2,1160,1,0,29,27,2,2510,5,0,0,0,0,1,1,2,1,0,1,0,0,0
4188,4188,Danny Mills,1292,2001,Leeds United,10,10,0,900,0,0,11,11,0,990,1,0,21,21,0,1890,1,0,0,0,0,0,0,0,0,0,0,0,0,0
4189,4189,Dominic Matteo,1293,2001,Leeds United,12,12,0,1080,0,0,12,12,0,1035,0,0,24,24,0,2115,0,0,0,0,0,0,0,0,0,0,0,0,0,0
4190,4190,Rio Ferdinand,1294,2001,Leeds United,13,13,0,1170,0,0,12,12,0,1080,0,0,25,25,0,2250,0,0,0,0,0,0,0,0,0,0,0,0,0,0
4191,4191,Olivier Dacourt,1295,2001,Leeds United,7,7,0,525,0,0,9,8,1,598,0,0,16,15,1,1123,0,0,0,0,0,0,0,0,0,0,0,0,0,0
4192,4192,Harry Kewell,1296,2001,Leeds United,13,13,0,1015,5,0,11,10,1,900,3,0,24,23,1,1915,8,0,3,0,3,2,2,4,0,0,0,0,0,0
4193,4193,Lee Bowyer,1297,2001,Leeds United,9,8,1,744,3,0,11,11,0,990,2,0,20,19,1,1734,5,0,0,6,6,2,2,4,0,0,0,0,0,0
4194,4194,Eirik Bakke,1298,2001,Leeds United,13,6,7,772,1,0,7,7,0,545,1,0,20,13,7,1317,2,0,0,0,0,1,1,2,0,0,0,0,0,0
4195,4195,Robbie Keane,1126,2001,Leeds United,12,6,6,590,1,0,7,4,3,484,2,0,19,10,9,1074,3,0,0,0,0,0,2,2,0,0,0,0,0,0
4196,4196,Mark Viduka,1299,2001,Leeds United,14,14,0,1258,6,0,14,14,0,1260,5,0,28,28,0,2518,11,0,0,6,6,4,4,8,0,0,0,0,0,0
4197,4197,Seth Johnson,2292,2001,Leeds United,7,6,1,494,0,0,5,4,1,360,0,0,12,10,2,854,0,0,0,0,0,0,0,0,0,0,0,0,0,0
4198,4198,David Batty,2694,2001,Leeds United,13,11,2,976,0,0,15,11,4,1033,0,0,28,22,6,2009,0,0,0,0,0,0,0,0,0,0,0,0,0,0
4199,4199,Alan Smith,1300,2001,Leeds United,9,6,3,571,3,0,9,8,1,678,1,0,18,14,4,1249,4,0,3,0,3,2,1,3,0,0,0,0,0,0
4200,4200,Neil Sullivan,2076,2001,Tottenham Hotspur,15,15,0,1350,0,0,14,14,0,1260,0,0,29,29,0,2610,0,0,0,0,0,0,0,0,0,0,0,0,0,0
4201,4201,Mauricio Taricco,1118,2001,Tottenham Hotspur,14,14,0,1232,0,0,15,15,0,1239,0,0,29,29,0,2471,0,0,0,0,0,0,0,0,0,0,0,0,0,0
4202,4202,Chris Perry,1954,2001,Tottenham Hotspur,15,14,1,1179,0,0,17,15,2,1419,0,0,32,29,3,2598,0,0,0,0,0,0,0,0,0,0,0,0,0,0
4203,4203,Ledley King,1119,2001,Tottenham Hotspur,15,15,0,1350,0,0,17,17,0,1485,0,0,32,32,0,2835,0,0,0,0,0,0,0,0,0,0,0,0,0,0
4204,4204,Dean Richards,2799,2001,Tottenham Hotspur,13,13,0,1170,2,0,11,11,0,945,0,0,24,24,0,2115,2,0,3,0,3,2,0,2,0,0,0,0,0,0
4205,4205,Steffen Freund,2079,2001,Tottenham Hotspur,11,11,0,912,0,0,9,8,1,766,0,0,20,19,1,1678,0,0,0,0,0,0,0,0,0,0,0,0,0,0
4206,4206,Gustavo Poyet,1128,2001,Tottenham Hotspur,14,12,2,1115,5,0,19,19,0,1640,5,0,33,31,2,2755,10,0,4,0,4,4,2,6,0,0,0,0,0,0
4207,4207,Christian Ziege,1129,2001,Tottenham Hotspur,13,13,0,1164,3,0,14,14,0,1193,2,0,27,27,0,2357,5,0,0,0,0,2,1,3,0,0,0,0,0,0
4208,4208,Les Ferdinand,2083,2001,Tottenham Hotspur,15,13,2,1008,7,0,10,9,1,743,2,0,25,22,3,1751,9,0,6,3,9,6,2,8,0,0,0,0,0,0
4209,4209,Teddy Sheringham,1076,2001,Tottenham Hotspur,15,15,0,1344,6,0,18,17,1,1548,4,0,33,32,1,2892,10,0,3,0,3,4,3,7,1,2,3,0,0,0
4210,4210,Darren Anderton,2082,2001,Tottenham Hotspur,17,16,1,1418,2,0,17,16,1,1426,2,0,34,32,2,2844,4,0,0,0,0,1,2,3,0,0,0,0,0,0
4211,4211,Simon Davies,1125,2001,Tottenham Hotspur,13,12,1,1050,4,0,17,9,8,908,0,0,30,21,9,1958,4,0,0,0,0,1,0,1,0,0,0,0,0,0
4212,4212,Serhiy Rebrov,2081,2001,Tottenham Hotspur,15,5,10,456,1,0,15,4,11,486,0,0,30,9,21,942,1,0,0,0,0,0,0,0,0,0,0,0,0,0
4213,4213,Toby Alderweireld,1147,2016,Tottenham Hotspur,15,15,0,1309,0,0,15,15,0,1295,1,0,30,30,0,2604,1,0,0,0,0,0,0,0,0,0,0,0,0,0
4214,4214,Harry Kane,1169,2016,Tottenham Hotspur,16,15,1,1335,17,0,14,14,0,1201,12,0,30,29,1,2536,29,0,9,1,10,8,5,13,4,1,5,0,0,0
4215,4215,Joshua Onomah,2800,2016,Tottenham Hotspur,5,0,5,18,0,0,0,0,0,0,0,0,5,0,5,18,0,0,0,0,0,0,0,0,0,0,0,0,0,0
4216,4216,Georges-Kévin N'Koudou,2801,2016,Tottenham Hotspur,3,0,3,12,0,0,5,0,5,37,0,0,8,0,8,49,0,0,0,0,0,0,0,0,0,0,0,0,0,0
4217,4217,Noor Husin,2802,2016,Crystal Palace,0,0,0,0,0,0,0,0,0,0,0,0,0,0,0,0,0,0,0,0,0,0,0,0,0,0,0,0,0,0
4218,4218,Aaron Wan-Bissaka,2702,2016,Crystal Palace,0,0,0,0,0,0,0,0,0,0,0,0,0,0,0,0,0,0,0,0,0,0,0,0,0,0,0,0,0,0
4219,4219,Phil Jones,1650,2016,Manchester United,8,8,0,685,0,0,10,10,0,900,0,0,18,18,0,1585,0,0,0,0,0,0,0,0,0,0,0,0,0,0
4220,4220,Matteo Darmian,2187,2016,Manchester United,7,6,1,529,0,0,11,9,2,805,0,0,18,15,3,1334,0,0,0,0,0,0,0,0,0,0,0,0,0,0
4221,4221,Bastian Schweinsteiger,2803,2016,Manchester United,0,0,0,0,0,0,0,0,0,0,0,0,0,0,0,0,0,0,0,0,0,0,0,0,0,0,0,0,0,0
4222,4222,Clint Hill,2540,2011,Queens Park Rangers,12,10,2,916,0,0,10,9,1,789,0,0,22,19,3,1705,0,0,0,0,0,0,0,0,0,0,0,0,0,0
4223,4223,Taye Taïwo,2804,2011,Queens Park Rangers,7,6,1,566,0,0,8,7,1,627,1,0,15,13,2,1193,1,0,0,0,0,0,0,0,0,0,0,0,0,0
4224,4224,Nedum Onuoha,2533,2011,Queens Park Rangers,8,8,0,720,0,0,8,8,0,720,0,0,16,16,0,1440,0,0,0,0,0,0,0,0,0,0,0,0,0,0
4225,4225,Samba Diakité,2541,2011,Queens Park Rangers,5,5,0,430,1,0,4,4,0,302,0,0,9,9,0,732,1,0,3,0,3,1,0,1,0,0,0,0,0,0
4226,4226,Jamie Mackie,2534,2011,Queens Park Rangers,15,12,3,1037,3,0,16,12,4,1148,4,0,31,24,7,2185,7,0,3,1,4,2,2,4,0,0,0,0,0,0
4227,4227,Bobby Zamora,1943,2011,Queens Park Rangers,8,8,0,683,2,0,6,6,0,504,0,0,14,14,0,1187,2,0,1,0,1,2,0,2,0,0,0,0,0,0
4228,4228,Radek Černý,2805,2011,Queens Park Rangers,2,2,0,180,0,0,3,3,0,270,0,0,5,5,0,450,0,0,0,0,0,0,0,0,0,0,0,0,0,0
4229,4229,Daniel Gabbidon,2464,2011,Queens Park Rangers,7,7,0,630,0,0,10,8,2,794,0,0,17,15,2,1424,0,0,0,0,0,0,0,0,0,0,0,0,0,0
4230,4230,Michel Vorm,1174,2011,Swansea City,19,19,0,1710,0,0,18,18,0,1620,0,0,37,37,0,3330,0,0,0,0,0,0,0,0,0,0,0,0,0,0
4231,4231,Ashley Williams,1061,2011,Swansea City,19,19,0,1710,0,0,18,18,0,1620,1,0,37,37,0,3330,1,0,0,0,0,0,0,0,0,0,0,0,0,0
4232,4232,Neil Taylor,1695,2011,Swansea City,18,17,1,1570,0,0,18,18,0,1515,0,0,36,35,1,3085,0,0,0,0,0,0,0,0,0,0,0,0,0,0
4233,4233,Steven Caulker,2806,2011,Swansea City,13,13,0,1170,0,0,13,13,0,1170,0,0,26,26,0,2340,0,0,0,0,0,0,0,0,0,0,0,0,0,0
4234,4234,Àngel Rangel,1696,2011,Swansea City,17,16,1,1387,0,0,17,16,1,1485,0,0,34,32,2,2872,0,0,0,0,0,0,0,0,0,0,0,0,0,0
4235,4235,Leon Britton,1707,2011,Swansea City,17,17,0,1495,0,0,19,18,1,1523,0,0,36,35,1,3018,0,0,0,0,0,0,0,0,0,0,0,0,0,0
4236,4236,Scott Sinclair,1420,2011,Swansea City,19,18,1,1596,7,0,19,17,2,1526,1,0,38,35,3,3122,8,0,1,0,1,6,1,7,4,0,4,0,0,0
4237,4237,Joe Allen,1430,2011,Swansea City,17,14,3,1329,2,0,19,17,2,1571,2,0,36,31,5,2900,4,0,0,0,0,1,0,1,0,0,0,0,0,0
4238,4238,Gylfi Sigurðsson,1055,2011,Swansea City,9,8,1,740,1,0,9,9,0,759,6,0,18,17,1,1499,7,0,0,0,0,1,4,5,0,0,0,0,0,0
4239,4239,Danny Graham,2317,2011,Swansea City,18,15,3,1322,9,0,18,17,1,1524,3,0,36,32,4,2846,12,0,6,3,9,4,2,6,1,0,1,0,0,0
4240,4240,Wayne Routledge,1758,2011,Swansea City,14,9,5,714,0,0,14,8,6,745,1,0,28,17,11,1459,1,0,0,0,0,0,0,0,0,0,0,0,0,0
4241,4241,Alan Tate,2807,2011,Swansea City,0,0,0,0,0,0,5,1,4,163,0,0,5,1,4,163,0,0,0,0,0,0,0,0,0,0,0,0,0,0
4242,4242,Nathan Dyer,1702,2011,Swansea City,17,15,2,1286,4,0,17,14,3,1116,1,0,34,29,5,2402,5,0,0,0,0,1,1,2,0,0,0,0,0,0
4243,4243,Luke Moore,1796,2011,Swansea City,11,3,8,332,1,0,9,0,9,191,1,0,20,3,17,523,2,0,3,0,3,1,0,1,0,0,0,0,0,0
4244,4244,Gerhard Tremmel,1706,2011,Swansea City,0,0,0,0,0,0,1,1,0,90,0,0,1,1,0,90,0,0,0,0,0,0,0,0,0,0,0,0,0,0
4245,4245,Garry Monk,2808,2011,Swansea City,9,7,2,634,0,0,7,7,0,630,0,0,16,14,2,1264,0,0,0,0,0,0,0,0,0,0,0,0,0,0
4246,4246,Josh McEachran,2809,2011,Swansea City,2,1,1,82,0,0,2,0,2,43,0,0,4,1,3,125,0,0,0,0,0,0,0,0,0,0,0,0,0,0
4247,4247,Mark Gower,2810,2011,Swansea City,10,7,3,638,0,0,10,7,3,493,0,0,20,14,6,1131,0,0,0,0,0,0,0,0,0,0,0,0,0,0
4248,4248,David James,1385,2008,Portsmouth FC,18,18,0,1620,0,0,18,18,0,1620,0,0,36,36,0,3240,0,0,0,0,0,0,0,0,0,0,0,0,0,0
4249,4249,Younès Kaboul,2408,2008,Portsmouth FC,10,7,3,675,1,0,10,10,0,796,0,0,20,17,3,1471,1,0,0,0,0,1,0,1,0,0,0,0,0,0
4250,4250,Glen Johnson,1386,2008,Portsmouth FC,14,14,0,1260,2,0,15,15,0,1341,1,0,29,29,0,2601,3,0,0,0,0,2,0,2,0,0,0,0,0,0
4251,4251,Sylvain Distin,1015,2008,Portsmouth FC,19,19,0,1710,0,0,19,19,0,1710,0,0,38,38,0,3420,0,0,0,0,0,0,0,0,0,0,0,0,0,0
4252,4252,Noé Pamarot,1387,2008,Portsmouth FC,6,5,1,451,0,0,10,6,4,565,0,0,16,11,5,1016,0,0,0,0,0,0,0,0,0,0,0,0,0,0
4253,4253,Nadir Belhadj,2811,2008,Portsmouth FC,15,11,4,1046,1,0,14,10,4,900,1,0,29,21,8,1946,2,0,0,0,0,1,1,2,0,0,0,0,0,0
4254,4254,Papa Bouba Diop,1757,2008,Portsmouth FC,7,7,0,569,0,0,9,8,1,762,0,0,16,15,1,1331,0,0,0,0,0,0,0,0,0,0,0,0,0,0
4255,4255,Richard Hughes,2812,2008,Portsmouth FC,10,10,0,806,0,0,10,7,3,557,0,0,20,17,3,1363,0,0,0,0,0,0,0,0,0,0,0,0,0,0
4256,4256,Sean Davis,1087,2008,Portsmouth FC,16,15,1,1342,1,0,16,16,0,1383,0,0,32,31,1,2725,1,0,3,0,3,1,0,1,0,0,0,0,0,0
4257,4257,Peter Crouch,1273,2008,Portsmouth FC,19,19,0,1686,7,0,19,19,0,1674,3,0,38,38,0,3360,10,0,3,1,4,6,2,8,0,0,0,0,0,0
4258,4258,John Utaka,2813,2008,Portsmouth FC,9,2,7,358,1,0,9,2,7,349,0,0,18,4,14,707,1,0,0,0,0,1,0,1,0,0,0,0,0,0
4259,4259,Armand Traoré,1238,2008,Portsmouth FC,11,7,4,649,1,0,8,7,1,624,0,0,19,14,5,1273,1,0,0,0,0,0,0,0,0,0,0,0,0,0
4260,4260,David Nugent,2519,2008,Portsmouth FC,7,6,1,511,1,0,9,7,2,554,2,0,16,13,3,1065,3,0,0,0,0,1,1,2,0,0,0,0,0,0
4261,4261,Nwankwo Kanu,1324,2008,Portsmouth FC,9,2,7,274,1,0,8,1,7,165,0,0,17,3,14,439,1,0,3,0,3,1,0,1,0,0,0,0,0,0
4262,4262,Sam Ricketts,2489,2008,Hull City,15,14,1,1281,0,0,14,13,1,1250,0,0,29,27,2,2531,0,0,0,0,0,0,0,0,0,0,0,0,0,0
4263,4263,Stylianos Giannakopoulos,1717,2008,Hull City,1,0,1,22,0,0,1,0,1,8,0,0,2,0,2,30,0,0,0,0,0,0,0,0,0,0,0,0,0,0
4264,4264,Dean Windass,2814,2008,Hull City,2,0,2,40,0,0,3,1,2,77,0,0,5,1,4,117,0,0,0,0,0,0,0,0,0,0,0,0,0,0
4265,4265,David Luiz,1471,2012,Chelsea FC,15,15,0,1338,1,0,14,13,1,1204,1,0,29,28,1,2542,2,0,0,0,0,0,1,1,0,0,0,0,0,0
4266,4266,Victor Moses,1434,2012,Chelsea FC,8,2,6,256,0,0,14,9,5,775,1,0,22,11,11,1031,1,0,0,0,0,0,1,1,0,0,0,0,0,0
4267,4267,Hugo Lloris,1160,2012,Tottenham Hotspur,14,14,0,1260,0,0,13,13,0,1170,0,0,27,27,0,2430,0,0,0,0,0,0,0,0,0,0,0,0,0,0
4268,4268,Jan Vertonghen,1161,2012,Tottenham Hotspur,17,17,0,1530,1,0,17,17,0,1530,4,0,34,34,0,3060,5,0,3,0,3,1,4,5,0,0,0,0,0,0
4269,4269,Michael Dawson,1267,2012,Tottenham Hotspur,12,12,0,1036,1,0,15,11,4,975,0,0,27,23,4,2011,1,0,0,0,0,1,0,1,0,0,0,0,0,0
4270,4270,Kyle Walker,1196,2012,Tottenham Hotspur,18,18,0,1609,0,0,18,18,0,1552,0,0,36,36,0,3161,0,0,0,0,0,0,0,0,0,0,0,0,0,0
4271,4271,Benoît Assou-Ekotto,1269,2012,Tottenham Hotspur,9,7,2,664,1,0,6,5,1,476,0,0,15,12,3,1140,1,0,0,0,0,1,0,1,0,0,0,0,0,0
4272,4272,Tom Huddlestone,1270,2012,Tottenham Hotspur,11,5,6,494,0,0,9,6,3,538,0,0,20,11,9,1032,0,0,0,0,0,0,0,0,0,0,0,0,0,0
4273,4273,Aaron Lennon,1052,2012,Tottenham Hotspur,16,16,0,1384,3,0,18,17,1,1452,1,0,34,33,1,2836,4,0,0,3,3,1,1,2,0,0,0,0,0,0
4274,4274,Scott Parker,1282,2012,Tottenham Hotspur,10,7,3,591,0,0,11,8,3,775,0,0,21,15,6,1366,0,0,0,0,0,0,0,0,0,0,0,0,0,0
4275,4275,Gareth Bale,1274,2012,Tottenham Hotspur,15,15,0,1350,8,0,18,18,0,1575,13,0,33,33,0,2925,21,0,9,7,16,5,6,11,0,0,0,0,0,0
4276,4276,Lewis Holtby,2815,2012,Tottenham Hotspur,4,2,2,242,0,0,7,2,5,264,0,0,11,4,7,506,0,0,0,0,0,0,0,0,0,0,0,0,0,0
4277,4277,Emmanuel Adebayor,1235,2012,Tottenham Hotspur,15,8,7,841,2,0,10,10,0,829,3,0,25,18,7,1670,5,0,0,3,3,2,3,5,0,0,0,0,0,0
4278,4278,Gylfi Sigurðsson,1055,2012,Tottenham Hotspur,17,8,9,747,1,0,16,4,12,476,2,0,33,12,21,1223,3,0,1,1,2,1,2,3,0,0,0,0,0,0
4279,4279,Clint Dempsey,1565,2012,Tottenham Hotspur,15,13,2,1121,3,0,14,9,5,877,4,0,29,22,7,1998,7,0,1,0,1,2,2,4,0,0,0,0,0,0
4280,4280,Brad Friedel,1343,2012,Tottenham Hotspur,5,5,0,450,0,0,6,6,0,540,0,0,11,11,0,990,0,0,0,0,0,0,0,0,0,0,0,0,0,0
4281,4281,Kyle Naughton,2273,2012,Tottenham Hotspur,5,5,0,409,0,0,9,8,1,653,0,0,14,13,1,1062,0,0,0,0,0,0,0,0,0,0,0,0,0,0
4282,4282,Steven Caulker,2806,2012,Tottenham Hotspur,10,9,1,854,1,0,8,8,0,720,1,0,18,17,1,1574,2,0,0,0,0,1,1,2,0,0,0,0,0,0
4283,4283,Tom Carroll,2816,2012,Tottenham Hotspur,3,0,3,35,0,0,4,0,4,40,0,0,7,0,7,75,0,0,0,0,0,0,0,0,0,0,0,0,0,0
4284,4284,Jermain Defoe,1127,2012,Tottenham Hotspur,17,13,4,1179,5,0,17,14,3,1233,6,0,34,27,7,2412,11,0,3,0,3,4,3,7,0,0,0,0,0,0
4285,4285,Fábio Aurélio,2054,2008,Liverpool FC,12,10,2,929,0,0,12,9,3,806,2,0,24,19,5,1735,2,0,0,0,0,0,1,1,0,0,0,0,0,0
4286,4286,Arbeloa,2744,2008,Liverpool FC,15,15,0,1319,1,0,14,14,0,1260,0,0,29,29,0,2579,1,0,0,0,0,0,0,0,0,0,0,0,0,0
4287,4287,Fernando Torres,1539,2008,Liverpool FC,11,10,1,885,7,0,13,10,3,847,7,0,24,20,4,1732,14,0,0,6,6,5,5,10,0,0,0,0,0,0
4288,4288,Brad Friedel,1343,2008,Aston Villa,16,16,0,1440,0,0,17,17,0,1530,0,0,33,33,0,2970,0,0,0,0,0,0,0,0,0,0,0,0,0,0
4289,4289,Luke Young,1952,2008,Aston Villa,14,13,1,1146,1,0,15,15,0,1270,0,0,29,28,1,2416,1,0,0,0,0,1,0,1,0,0,0,0,0,0
4290,4290,Curtis Davies,2224,2008,Aston Villa,14,14,0,1240,1,0,16,15,1,1274,0,0,30,29,1,2514,1,0,0,0,0,1,0,1,0,0,0,0,0,0
4291,4291,Carlos Cuéllar,1401,2008,Aston Villa,12,10,2,905,0,0,13,11,2,957,0,0,25,21,4,1862,0,0,0,0,0,0,0,0,0,0,0,0,0,0
4292,4292,Gareth Barry,1418,2008,Aston Villa,16,16,0,1440,3,0,17,17,0,1494,2,0,33,33,0,2934,5,0,1,3,4,2,2,4,2,2,4,0,0,0
4293,4293,Ashley Young,1619,2008,Aston Villa,15,15,0,1341,2,0,16,16,0,1420,5,0,31,31,0,2761,7,0,0,3,3,1,4,5,0,0,0,0,0,0
4294,4294,James Milner,1189,2008,Aston Villa,16,14,2,1275,1,0,16,13,3,1243,2,0,32,27,5,2518,3,0,0,0,0,0,2,2,0,0,0,0,0,0
4295,4295,Stilian Petrov,1620,2008,Aston Villa,15,15,0,1301,1,0,16,16,0,1427,0,0,31,31,0,2728,1,0,0,0,0,1,0,1,0,0,0,0,0,0
4296,4296,Nigel Reo-Coker,2494,2008,Aston Villa,11,8,3,741,0,0,13,9,4,869,1,0,24,17,7,1610,1,0,0,0,0,0,1,1,0,0,0,0,0,0
4297,4297,John Carew,1621,2008,Aston Villa,13,7,6,769,6,0,13,10,3,952,5,0,26,17,9,1721,11,0,6,1,7,3,4,7,0,0,0,0,0,0
4298,4298,Emile Heskey,1519,2008,Aston Villa,7,5,2,429,1,0,7,6,1,491,1,0,14,11,3,920,2,0,0,3,3,1,1,2,0,0,0,0,0,0
4299,4299,Brad Guzan,1435,2008,Aston Villa,0,0,0,0,0,0,1,0,1,25,0,0,1,0,1,25,0,0,0,0,0,0,0,0,0,0,0,0,0,0
4300,4300,Craig Gardner,1403,2008,Aston Villa,6,2,4,166,0,0,8,1,7,142,0,0,14,3,11,308,0,0,0,0,0,0,0,0,0,0,0,0,0,0
4301,4301,Gabriel Agbonlahor,1442,2008,Aston Villa,15,15,0,1300,6,0,16,15,1,1376,5,0,31,30,1,2676,11,0,0,0,0,2,1,3,0,0,0,0,0,0
4302,4302,Costel Pantilimon,1354,2015,Sunderland AFC,8,8,0,720,0,0,9,9,0,810,0,0,17,17,0,1530,0,0,0,0,0,0,0,0,0,0,0,0,0,0
4303,4303,Billy Jones,1733,2015,Sunderland AFC,11,11,0,990,1,0,13,12,1,1043,0,0,24,23,1,2033,1,0,0,0,0,0,0,0,0,0,0,0,0,0
4304,4304,Younès Kaboul,2408,2015,Sunderland AFC,11,10,1,962,0,0,12,12,0,1063,0,0,23,22,1,2025,0,0,0,0,0,0,0,0,0,0,0,0,0,0
4305,4305,John O'Shea,1729,2015,Sunderland AFC,13,11,2,905,0,0,15,12,3,1103,0,0,28,23,5,2008,0,0,0,0,0,0,0,0,0,0,0,0,0,0
4306,4306,DeAndre Yedlin,1175,2015,Sunderland AFC,13,12,1,1027,0,0,10,9,1,785,0,0,23,21,2,1812,0,0,0,0,0,0,0,0,0,0,0,0,0,0
4307,4307,Lee Cattermole,1687,2015,Sunderland AFC,17,15,2,1342,0,0,14,12,2,885,0,0,31,27,4,2227,0,0,0,0,0,0,0,0,0,0,0,0,0,0
4308,4308,Adam Johnson,1405,2015,Sunderland AFC,8,5,3,486,1,0,11,6,5,657,1,0,19,11,8,1143,2,0,0,0,0,1,0,1,1,0,1,0,0,0
4309,4309,Ola Toivonen,2817,2015,Sunderland AFC,7,5,2,351,0,0,5,4,1,312,0,0,12,9,3,663,0,0,0,0,0,0,0,0,0,0,0,0,0,0
4310,4310,Yann M'Vila,2818,2015,Sunderland AFC,19,19,0,1688,0,0,18,17,1,1501,1,0,37,36,1,3189,1,0,0,0,0,0,1,1,0,0,0,0,0,0
4311,4311,Jeremain Lens,2819,2015,Sunderland AFC,10,7,3,652,1,0,10,7,3,675,2,0,20,14,6,1327,3,0,0,1,1,0,2,2,0,0,0,0,0,0
4312,4312,Steven Fletcher,1408,2015,Sunderland AFC,7,6,1,500,2,0,9,5,4,514,2,0,16,11,5,1014,4,0,0,0,0,1,1,2,0,0,0,0,0,0
4313,4313,Sebastián Coates,2526,2015,Sunderland AFC,9,7,2,666,0,0,7,7,0,563,0,0,16,14,2,1229,0,0,0,0,0,0,0,0,0,0,0,0,0,0
4314,4314,Sebastian Larsson,1402,2015,Sunderland AFC,8,2,6,166,0,0,10,4,6,382,0,0,18,6,12,548,0,0,0,0,0,0,0,0,0,0,0,0,0,0
4315,4315,Jermain Defoe,1127,2015,Sunderland AFC,18,15,3,1356,4,0,15,13,2,1194,11,0,33,28,5,2550,15,0,4,5,9,3,7,10,0,1,1,0,0,0
4316,4316,Vito Mannone,2261,2015,Sunderland AFC,11,11,0,990,0,0,8,8,0,720,0,0,19,19,0,1710,0,0,0,0,0,0,0,0,0,0,0,0,0,0
4317,4317,Patrick van Aanholt,2254,2015,Sunderland AFC,16,16,0,1440,4,0,17,17,0,1530,2,0,33,33,0,2970,6,0,1,0,1,4,2,6,0,0,0,0,0,0
4318,4318,Jordi Gómez,2059,2015,Sunderland AFC,3,2,1,149,0,0,3,3,0,207,0,0,6,5,1,356,0,0,0,0,0,0,0,0,0,0,0,0,0,0
4319,4319,Duncan Watmore,2820,2015,Sunderland AFC,12,3,9,465,2,0,11,4,7,441,1,0,23,7,16,906,3,0,0,0,0,0,0,0,0,0,0,0,0,0
4320,4320,Rob Elliot,2456,2015,Newcastle United,11,11,0,990,0,0,10,10,0,900,0,0,21,21,0,1890,0,0,0,0,0,0,0,0,0,0,0,0,0,0
4321,4321,Paul Dummett,2467,2015,Newcastle United,13,13,0,1053,1,0,10,10,0,844,0,0,23,23,0,1897,1,0,1,0,1,1,0,1,0,0,0,0,0,0
4322,4322,Florian Thauvin,2821,2015,Newcastle United,6,2,4,275,0,0,7,1,6,145,0,0,13,3,10,420,0,0,0,0,0,0,0,0,0,0,0,0,0,0
4323,4323,Scott Carson,1999,2007,Aston Villa,18,18,0,1620,0,0,17,17,0,1530,0,0,35,35,0,3150,0,0,0,0,0,0,0,0,0,0,0,0,0,0
4324,4324,Wilfred Bouma,2707,2007,Aston Villa,19,19,0,1606,1,0,19,19,0,1665,0,0,38,38,0,3271,1,0,0,0,0,1,0,1,0,0,0,0,0,0
4325,4325,Olof Mellberg,1790,2007,Aston Villa,17,16,1,1435,1,0,17,17,0,1530,1,0,34,33,1,2965,2,0,0,0,0,1,0,1,0,0,0,0,0,0
4326,4326,Martin Laursen,2124,2007,Aston Villa,19,19,0,1666,3,0,19,19,0,1703,3,0,38,38,0,3369,6,0,3,0,3,2,3,5,0,0,0,0,0,0
4327,4327,Zat Knight,1755,2007,Aston Villa,13,13,0,1114,1,0,14,12,2,1124,0,0,27,25,2,2238,1,0,0,0,0,1,0,1,0,0,0,0,0,0
4328,4328,Gareth Barry,1418,2007,Aston Villa,19,19,0,1710,5,0,18,18,0,1610,4,0,37,37,0,3320,9,0,1,1,2,3,2,5,3,2,5,0,0,0
4329,4329,Ashley Young,1619,2007,Aston Villa,19,19,0,1680,4,0,18,18,0,1610,4,0,37,37,0,3290,8,0,1,0,1,2,3,5,0,0,0,0,0,0
4330,4330,Nigel Reo-Coker,2494,2007,Aston Villa,18,18,0,1587,0,0,18,18,0,1549,0,0,36,36,0,3136,0,0,0,0,0,0,0,0,0,0,0,0,0,0
4331,4331,Craig Gardner,1403,2007,Aston Villa,12,9,3,794,2,0,11,6,5,538,1,0,23,15,8,1332,3,0,3,0,3,2,0,2,0,0,0,0,0,0
4332,4332,Luke Moore,1796,2007,Aston Villa,8,6,2,503,0,0,7,2,5,339,1,0,15,8,7,842,1,0,0,1,1,0,1,1,0,0,0,0,0,0
4333,4333,Gabriel Agbonlahor,1442,2007,Aston Villa,18,18,0,1618,5,0,19,19,0,1661,6,0,37,37,0,3279,11,0,0,6,6,1,3,4,0,0,0,0,0,0
4334,4334,Stilian Petrov,1620,2007,Aston Villa,14,11,3,848,0,0,14,11,3,996,1,0,28,22,6,1844,1,0,0,0,0,0,0,0,0,0,0,0,0,0
4335,4335,Marlon Harewood,1942,2007,Aston Villa,11,0,11,235,1,0,12,1,11,267,4,0,23,1,22,502,5,0,0,0,0,0,1,1,0,0,0,0,0,0
4336,4336,Christian Ziege,1129,2000,Liverpool FC,8,5,3,461,0,0,7,6,1,503,1,0,15,11,4,964,1,0,0,0,0,0,0,0,0,0,0,0,0,0
4337,4337,Nick Barmby,2133,2000,Liverpool FC,14,11,3,1016,2,0,11,9,2,769,0,0,25,20,5,1785,2,0,0,0,0,1,0,1,0,0,0,0,0,0
4338,4338,Paul Gerrard,2822,2000,Everton FC,16,16,0,1439,0,0,15,15,0,1350,0,0,31,31,0,2789,0,0,0,0,0,0,0,0,0,0,0,0,0,0
4339,4339,Michael Ball,2823,2000,Everton FC,14,14,0,1260,3,0,14,14,0,1224,0,0,28,28,0,2484,3,0,1,0,1,3,0,3,2,0,2,0,0,0
4340,4340,Steve Watson,2794,2000,Everton FC,18,18,0,1564,0,0,15,15,0,1350,0,0,33,33,0,2914,0,0,0,0,0,0,0,0,0,0,0,0,0,0
4341,4341,David Weir,1800,2000,Everton FC,19,19,0,1629,1,0,17,17,0,1530,0,0,36,36,0,3159,1,0,0,0,0,0,0,0,0,0,0,0,0,0
4342,4342,Abel Xavier,2824,2000,Everton FC,4,3,1,251,0,0,7,7,0,630,0,0,11,10,1,881,0,0,0,0,0,0,0,0,0,0,0,0,0,0
4343,4343,Alex Nyarko,2825,2000,Everton FC,8,7,1,600,0,0,13,11,2,975,1,0,21,18,3,1575,1,0,0,0,0,0,0,0,0,0,0,0,0,0
4344,4344,Idan Tal,1721,2000,Everton FC,10,4,6,461,2,0,12,8,4,658,0,0,22,12,10,1119,2,0,1,0,1,2,0,2,0,0,0,0,0,0
4345,4345,Paul Gascoigne,2826,2000,Everton FC,7,5,2,416,0,0,7,5,2,474,0,0,14,10,4,890,0,0,0,0,0,0,0,0,0,0,0,0,0,0
4346,4346,Mark Pembridge,1933,2000,Everton FC,10,9,1,788,0,0,11,11,0,916,0,0,21,20,1,1704,0,0,0,0,0,0,0,0,0,0,0,0,0,0
4347,4347,Thomas Gravesen,2796,2000,Everton FC,16,15,1,1367,2,0,15,14,1,1231,0,0,31,29,2,2598,2,0,0,0,0,0,0,0,0,0,0,0,0,0
4348,4348,Kevin Campbell,1601,2000,Everton FC,16,15,1,1371,4,0,13,12,1,1083,5,0,29,27,2,2454,9,0,3,3,6,2,4,6,0,0,0,0,0,0
4349,4349,Gary Naysmith,1804,2000,Everton FC,10,10,0,839,1,0,10,7,3,712,1,0,20,17,3,1551,2,0,0,3,3,1,1,2,0,0,0,0,0,0
4350,4350,Joe-Max Moore,2827,2000,Everton FC,9,5,4,470,0,0,12,3,9,388,0,0,21,8,13,858,0,0,0,0,0,0,0,0,0,0,0,0,0,0
4351,4351,Beram Kayal,2486,2017,Brighton & Hove Albion,9,2,7,234,0,0,10,6,4,506,0,0,19,8,11,740,0,0,0,0,0,0,0,0,0,0,0,0,0,0
4352,4352,Matt Butcher,2828,2017,AFC Bournemouth,0,0,0,0,0,0,0,0,0,0,0,0,0,0,0,0,0,0,0,0,0,0,0,0,0,0,0,0,0,0
4353,4353,Phil Gilchrist,2829,2000,Leicester City,5,2,3,246,0,0,6,4,2,384,0,0,11,6,5,630,0,0,0,0,0,0,0,0,0,0,0,0,0,0
4354,4354,Matt Elliott,2716,2000,Leicester City,17,17,0,1441,2,0,17,17,0,1530,0,0,34,34,0,2971,2,0,0,0,0,1,0,1,0,0,0,0,0,0
4355,4355,Darren Eadie,2830,2000,Leicester City,12,7,5,654,0,0,12,9,3,802,2,0,24,16,8,1456,2,0,0,3,3,0,1,1,0,0,0,0,0,0
4356,4356,Muzzy Izzet,2682,2000,Leicester City,15,15,0,1218,5,0,12,12,0,1019,2,0,27,27,0,2237,7,0,0,0,0,3,2,5,1,1,2,0,0,0
4357,4357,Arnar Gunnlaugsson,2831,2000,Leicester City,10,3,7,395,3,0,7,0,7,174,0,0,17,3,14,569,3,0,3,0,3,2,0,2,0,0,0,0,0,0
4358,4358,Simon Royce,2832,2000,Leicester City,8,7,1,674,0,0,11,9,2,869,0,0,19,16,3,1543,0,0,0,0,0,0,0,0,0,0,0,0,0,0
4359,4359,Steve Guppy,2648,2000,Leicester City,14,9,5,976,1,0,14,8,6,731,0,0,28,17,11,1707,1,0,0,0,0,1,0,1,0,0,0,0,0,0
4360,4360,Gary Walsh,2833,2000,Bradford City,8,8,0,720,0,0,7,7,0,630,0,0,15,15,0,1350,0,0,0,0,0,0,0,0,0,0,0,0,0,0
4361,4361,Andy O'Brien,2160,2000,Bradford City,8,8,0,639,0,0,10,9,1,861,0,0,18,17,1,1500,0,0,0,0,0,0,0,0,0,0,0,0,0,0
4362,4362,Robert Molenaar,2834,2000,Bradford City,10,10,0,829,0,0,7,7,0,604,1,0,17,17,0,1433,1,0,0,0,0,0,0,0,0,0,0,0,0,0
4363,4363,Wayne Jacobs,2835,2000,Bradford City,10,9,1,776,1,0,6,5,1,481,1,0,16,14,2,1257,2,0,0,0,0,1,0,1,0,0,0,0,0,0
4364,4364,Peter Atherton,2836,2000,Bradford City,12,12,0,1057,0,0,11,11,0,974,0,0,23,23,0,2031,0,0,0,0,0,0,0,0,0,0,0,0,0,0
4365,4365,Billy McKinlay,2837,2000,Bradford City,5,4,1,362,0,0,6,6,0,540,0,0,11,10,1,902,0,0,0,0,0,0,0,0,0,0,0,0,0,0
4366,4366,Stuart McCall,2838,2000,Bradford City,17,16,1,1449,1,0,14,14,0,1254,0,0,31,30,1,2703,1,0,0,0,0,1,0,1,0,0,0,0,0,0
4367,4367,Dean Windass,2814,2000,Bradford City,10,9,1,812,2,0,12,11,1,998,1,0,22,20,2,1810,3,0,0,0,0,1,1,2,0,0,0,0,0,0
4368,4368,Dean Saunders,2839,2000,Bradford City,4,0,4,68,0,0,6,4,2,331,0,0,10,4,6,399,0,0,0,0,0,0,0,0,0,0,0,0,0,0
4369,4369,Eoin Jess,2840,2000,Bradford City,7,7,0,630,1,0,6,6,0,514,2,0,13,13,0,1144,3,0,0,0,0,1,2,3,0,0,0,0,0,0
4370,4370,Robbie Blake,2551,2000,Bradford City,9,6,3,554,4,0,8,4,4,361,0,0,17,10,7,915,4,0,0,0,0,2,0,2,2,0,2,0,0,0
4371,4371,Andrew Myers,2841,2000,Bradford City,9,7,2,647,0,0,8,5,3,505,1,0,17,12,5,1152,1,0,0,0,0,0,1,1,0,0,0,0,0,0
4372,4372,Isaiah Rankin,2842,2000,Bradford City,0,0,0,0,0,0,1,0,1,3,0,0,1,0,1,3,0,0,0,0,0,0,0,0,0,0,0,0,0,0
4373,4373,Stan Collymore,2843,2000,Bradford City,4,4,0,341,2,0,3,1,2,120,0,0,7,5,2,461,2,0,0,0,0,2,0,2,0,0,0,0,0,0
4374,4374,Pepe Reina,1775,2019,Aston Villa,5,5,0,450,0,0,7,7,0,630,0,0,12,12,0,1080,0,0,0,0,0,0,0,0,0,0,0,0,0,0
4375,4375,Ezri Konsa,2844,2019,Aston Villa,12,12,0,1036,0,0,13,12,1,1007,1,0,25,24,1,2043,1,0,0,0,0,0,1,1,0,0,0,0,0,0
4376,4376,Matt Targett,1158,2019,Aston Villa,14,13,1,1104,1,0,14,14,0,1191,0,0,28,27,1,2295,1,0,3,0,3,1,0,1,0,0,0,0,0,0
4377,4377,Ahmed Elmohamady,1690,2019,Aston Villa,11,6,5,568,0,0,7,5,2,458,1,0,18,11,7,1026,1,0,0,1,1,0,1,1,0,0,0,0,0,0
4378,4378,Tyrone Mings,2772,2019,Aston Villa,16,16,0,1373,1,0,17,17,0,1530,1,0,33,33,0,2903,2,0,3,1,4,1,1,2,0,0,0,0,0,0
4379,4379,Douglas Luiz,2845,2019,Aston Villa,18,15,3,1359,2,0,18,13,5,1249,1,0,36,28,8,2608,3,0,0,0,0,1,0,1,0,0,0,0,0,0
4380,4380,John McGinn,2846,2019,Aston Villa,15,14,1,1160,1,0,13,13,0,1157,2,0,28,27,1,2317,3,0,0,0,0,1,2,3,0,0,0,0,0,0
4381,4381,Conor Hourihane,2847,2019,Aston Villa,13,10,3,826,2,0,14,8,6,713,1,0,27,18,9,1539,3,0,3,0,3,2,0,2,0,0,0,0,0,0
4382,4382,Jack Grealish,1870,2019,Aston Villa,18,18,0,1620,3,0,18,18,0,1614,5,0,36,36,0,3234,8,0,0,1,1,1,3,4,0,0,0,0,0,0
4383,4383,Trezeguet,2848,2019,Aston Villa,17,8,9,880,4,0,17,12,5,1107,2,0,34,20,14,1987,6,0,3,0,3,3,1,4,0,0,0,0,0,0
4384,4384,Mbwana Samatta,2849,2019,Aston Villa,7,5,2,438,0,0,7,6,1,508,1,0,14,11,3,946,1,0,0,0,0,0,0,0,0,0,0,0,0,0
4385,4385,Frédéric Guilbert,2850,2019,Aston Villa,11,9,2,861,0,0,14,13,1,1180,0,0,25,22,3,2041,0,0,0,0,0,0,0,0,0,0,0,0,0,0
4386,4386,Henri Lansbury,2851,2019,Aston Villa,4,0,4,14,0,0,6,2,4,178,0,0,10,2,8,192,0,0,0,0,0,0,0,0,0,0,0,0,0,0
4387,4387,Marvelous Nakamba,2852,2019,Aston Villa,16,8,8,867,0,0,13,11,2,968,0,0,29,19,10,1835,0,0,0,0,0,0,0,0,0,0,0,0,0,0
4388,4388,Keinan Davis,2853,2019,Aston Villa,10,3,7,291,0,0,8,1,7,247,0,0,18,4,14,538,0,0,0,0,0,0,0,0,0,0,0,0,0,0
4389,4389,Ørjan Nyland,2854,2019,Aston Villa,4,4,0,360,0,0,3,1,2,177,0,0,7,5,2,537,0,0,0,0,0,0,0,0,0,0,0,0,0,0
4390,4390,Kortney Hause,2155,2019,Aston Villa,9,9,0,810,1,0,9,8,1,734,0,0,18,17,1,1544,1,0,0,0,0,1,0,1,0,0,0,0,0,0
4391,4391,Anwar El Ghazi,2855,2019,Aston Villa,18,15,3,1209,4,0,16,11,5,852,0,0,34,26,8,2061,4,0,0,0,0,1,0,1,1,0,1,0,0,0
4392,4392,Jota,2856,2019,Aston Villa,5,2,3,167,0,0,5,2,3,166,0,0,10,4,6,333,0,0,0,0,0,0,0,0,0,0,0,0,0,0
4393,4393,Indiana Vassilev,2857,2019,Aston Villa,2,0,2,19,0,0,2,0,2,28,0,0,4,0,4,47,0,0,0,0,0,0,0,0,0,0,0,0,0,0
4394,4394,Matt Macey,2858,2019,Arsenal FC,0,0,0,0,0,0,0,0,0,0,0,0,0,0,0,0,0,0,0,0,0,0,0,0,0,0,0,0,0,0
4395,4395,Matt Smith,2859,2019,Arsenal FC,0,0,0,0,0,0,0,0,0,0,0,0,0,0,0,0,0,0,0,0,0,0,0,0,0,0,0,0,0,0
4396,4396,Mark Schwarzer,1328,2005,Middlesbrough FC,15,15,0,1350,0,0,12,12,0,1080,0,0,27,27,0,2430,0,0,0,0,0,0,0,0,0,0,0,0,0,0
4397,4397,Franck Queudrue,1329,2005,Middlesbrough FC,15,15,0,1172,1,0,14,11,3,982,2,0,29,26,3,2154,3,0,0,0,0,1,0,1,0,0,0,0,0,0
4398,4398,Chris Riggott,1330,2005,Middlesbrough FC,11,11,0,927,0,0,11,11,0,945,0,0,22,22,0,1872,0,0,0,0,0,0,0,0,0,0,0,0,0,0
4399,4399,Matthew Bates,1887,2005,Middlesbrough FC,6,4,2,328,0,0,10,8,2,720,0,0,16,12,4,1048,0,0,0,0,0,0,0,0,0,0,0,0,0,0
4400,4400,David Wheater,2218,2005,Middlesbrough FC,2,2,0,180,0,0,4,2,2,214,0,0,6,4,2,394,0,0,0,0,0,0,0,0,0,0,0,0,0,0
4401,4401,Ray Parlour,1334,2005,Middlesbrough FC,7,6,1,566,0,0,6,5,1,394,0,0,13,11,2,960,0,0,0,0,0,0,0,0,0,0,0,0,0,0
4402,4402,Doriva,1338,2005,Middlesbrough FC,14,9,5,850,0,0,13,10,3,929,0,0,27,19,8,1779,0,0,0,0,0,0,0,0,0,0,0,0,0,0
4403,4403,Adam Johnson,1405,2005,Middlesbrough FC,6,4,2,364,0,0,7,4,3,344,1,0,13,8,5,708,1,0,0,0,0,0,1,1,0,0,0,0,0,0
4404,4404,Jimmy Floyd Hasselbaink,1337,2005,Middlesbrough FC,13,6,7,564,6,0,9,6,3,538,4,0,22,12,10,1102,10,0,3,0,3,3,2,5,1,0,1,0,0,0
4405,4405,Massimo Maccarone,1888,2005,Middlesbrough FC,10,3,7,409,2,0,7,3,4,305,0,0,17,6,11,714,2,0,0,0,0,0,0,0,1,0,1,0,0,0
4406,4406,Mark Viduka,1299,2005,Middlesbrough FC,14,11,3,926,3,0,13,8,5,745,4,0,27,19,8,1671,7,0,3,0,3,3,3,6,0,0,0,0,0,0
4407,4407,Andrew Taylor,2574,2005,Middlesbrough FC,4,2,2,238,0,0,9,5,4,590,0,0,13,7,6,828,0,0,0,0,0,0,0,0,0,0,0,0,0,0
4408,4408,Jason Kennedy,2860,2005,Middlesbrough FC,2,0,2,30,0,0,1,1,0,85,0,0,3,1,2,115,0,0,0,0,0,0,0,0,0,0,0,0,0,0
4409,4409,Malcolm Christie,2137,2005,Middlesbrough FC,2,1,1,116,0,0,4,2,2,175,0,0,6,3,3,291,0,0,0,0,0,0,0,0,0,0,0,0,0,0
4410,4410,Shaka Hislop,1064,2005,West Ham United,7,7,0,600,0,0,8,8,0,720,0,0,15,15,0,1320,0,0,0,0,0,0,0,0,0,0,0,0,0,0
4411,4411,Daniel Gabbidon,2464,2005,West Ham United,15,15,0,1343,0,0,16,15,1,1338,0,0,31,30,1,2681,0,0,0,0,0,0,0,0,0,0,0,0,0,0
4412,4412,Lionel Scaloni,2861,2005,West Ham United,7,7,0,630,0,0,5,5,0,403,0,0,12,12,0,1033,0,0,0,0,0,0,0,0,0,0,0,0,0,0
4413,4413,Nigel Reo-Coker,2494,2005,West Ham United,17,17,0,1470,2,0,13,13,0,1170,3,0,30,30,0,2640,5,0,0,6,6,2,3,5,0,0,0,0,0,0
4414,4414,Shaun Newton,2862,2005,West Ham United,11,2,9,276,1,0,14,5,9,527,0,0,25,7,18,803,1,0,3,0,3,1,0,1,0,0,0,0,0,0
4415,4415,Teddy Sheringham,1076,2005,West Ham United,14,9,5,869,5,0,11,6,5,523,1,0,25,15,10,1392,6,0,3,0,3,3,0,3,1,0,1,0,0,0
4416,4416,Yaniv Katan,2863,2005,West Ham United,4,1,3,66,0,0,2,1,1,82,0,0,6,2,4,148,0,0,0,0,0,0,0,0,0,0,0,0,0,0
4417,4417,Dean Ashton,2245,2005,West Ham United,5,5,0,372,3,0,5,3,2,285,0,0,10,8,2,657,3,0,0,0,0,2,0,2,0,0,0,0,0,0
4418,4418,Ashley Cole,1523,2005,Arsenal FC,6,5,1,506,0,0,5,4,1,385,0,0,11,9,2,891,0,0,0,0,0,0,0,0,0,0,0,0,0,0
4419,4419,Lauren,1602,2005,Arsenal FC,10,10,0,900,0,0,11,11,0,973,0,0,21,21,0,1873,0,0,0,0,0,0,0,0,0,0,0,0,0,0
4420,4420,Sol Campbell,1388,2005,Arsenal FC,9,9,0,766,2,0,11,11,0,989,0,0,20,20,0,1755,2,0,0,0,0,1,0,1,0,0,0,0,0,0
4421,4421,Reyes,1604,2005,Arsenal FC,13,13,0,1016,1,0,13,9,4,776,4,0,26,22,4,1792,5,0,0,3,3,0,2,2,0,0,0,0,0,0
4422,4422,Dennis Bergkamp,1527,2005,Arsenal FC,15,4,11,553,2,0,8,3,5,366,0,0,23,7,16,919,2,0,0,0,0,1,0,1,0,0,0,0,0,0
4423,4423,Olivier Tebily,1520,2005,Birmingham City,7,6,1,475,0,0,9,6,3,570,0,0,16,12,4,1045,0,0,0,0,0,0,0,0,0,0,0,0,0,0
4424,4424,Julian Gray,2653,2005,Birmingham City,11,9,2,859,0,0,10,9,1,835,1,0,21,18,3,1694,1,0,0,3,3,0,1,1,0,0,0,0,0,0
4425,4425,Stan Lazaridis,2624,2005,Birmingham City,9,6,3,671,0,0,8,5,3,507,0,0,17,11,6,1178,0,0,0,0,0,0,0,0,0,0,0,0,0,0
4426,4426,Mikael Forssell,1965,2005,Birmingham City,14,6,8,782,3,0,13,4,9,513,0,0,27,10,17,1295,3,0,3,0,3,2,0,2,2,0,2,0,0,0
4427,4427,Grétar Steinsson,2410,2010,Bolton Wanderers,13,13,0,1144,1,0,10,10,0,845,0,0,23,23,0,1989,1,0,0,0,0,0,0,0,0,0,0,0,0,0
4428,4428,Ricardo Gardner,2411,2010,Bolton Wanderers,2,1,1,134,0,0,3,2,1,187,0,0,5,3,2,321,0,0,0,0,0,0,0,0,0,0,0,0,0,0
4429,4429,Tamir Cohen,2671,2010,Bolton Wanderers,2,0,2,25,1,0,6,3,3,298,0,0,8,3,5,323,1,0,3,0,3,1,0,1,0,0,0,0,0,0
4430,4430,Joshua Vela,2495,2010,Bolton Wanderers,0,0,0,0,0,0,0,0,0,0,0,0,0,0,0,0,0,0,0,0,0,0,0,0,0,0,0,0,0,0
4431,4431,Pablo Zabaleta,1355,2010,Manchester City,15,12,3,1094,1,0,11,9,2,853,1,0,26,21,5,1947,2,0,0,0,0,0,0,0,0,0,0,0,0,0
4432,4432,Reece Wabara,2864,2010,Manchester City,0,0,0,0,0,0,1,0,1,3,0,0,1,0,1,3,0,0,0,0,0,0,0,0,0,0,0,0,0,0
4433,4433,Shay Given,1581,2010,Manchester City,0,0,0,0,0,0,0,0,0,0,0,0,0,0,0,0,0,0,0,0,0,0,0,0,0,0,0,0,0,0
4434,4434,Jussi Jääskeläinen,1710,2005,Bolton Wanderers,19,19,0,1710,0,0,18,18,0,1620,0,0,37,37,0,3330,0,0,0,0,0,0,0,0,0,0,0,0,0,0
4435,4435,Nicky Hunt,1711,2005,Bolton Wanderers,10,5,5,557,0,0,9,6,3,593,0,0,19,11,8,1150,0,0,0,0,0,0,0,0,0,0,0,0,0,0
4436,4436,Radhi Jaïdi,2502,2005,Bolton Wanderers,7,6,1,477,1,0,8,8,0,662,2,0,15,14,1,1139,3,0,0,0,0,1,1,2,0,0,0,0,0,0
4437,4437,Tal Ben Haim,1715,2005,Bolton Wanderers,19,17,2,1531,0,0,15,14,1,1219,0,0,34,31,3,2750,0,0,0,0,0,0,0,0,0,0,0,0,0,0
4438,4438,Kevin Nolan,2396,2005,Bolton Wanderers,19,18,1,1606,6,0,16,16,0,1418,3,0,35,34,1,3024,9,0,9,3,12,3,3,6,0,0,0,0,0,0
4439,4439,Gary Speed,1716,2005,Bolton Wanderers,16,14,2,1183,1,0,14,14,0,1203,3,0,30,28,2,2386,4,0,0,3,3,0,2,2,0,2,2,0,0,0
4440,4440,Stylianos Giannakopoulos,1717,2005,Bolton Wanderers,18,14,4,1264,5,0,16,15,1,1276,4,0,34,29,5,2540,9,0,0,0,0,2,2,4,0,0,0,0,0,0
4441,4441,Jay Jay Okocha,2865,2005,Bolton Wanderers,12,9,3,854,0,0,14,9,5,729,1,0,26,18,8,1583,1,0,0,0,0,0,0,0,0,0,0,0,0,0
4442,4442,Henrik Pedersen,1722,2005,Bolton Wanderers,11,8,3,817,1,0,9,6,3,544,0,0,20,14,6,1361,1,0,0,0,0,0,0,0,0,0,0,0,0,0
4443,4443,Kevin Davies,1718,2005,Bolton Wanderers,19,19,0,1565,4,0,17,17,0,1486,3,0,36,36,0,3051,7,0,0,0,0,2,2,4,0,0,0,0,0,0
4444,4444,El-Hadji Diouf,1719,2005,Bolton Wanderers,10,8,2,702,3,0,9,8,1,621,0,0,19,16,3,1323,3,0,0,0,0,3,0,3,0,0,0,0,0,0
4445,4445,Iván Campo,1713,2005,Bolton Wanderers,8,6,2,532,0,0,6,1,5,276,2,0,14,7,7,808,2,0,0,0,0,0,1,1,0,0,0,0,0,0
4446,4446,Abdoulaye Faye,1714,2005,Bolton Wanderers,13,11,2,1026,1,0,14,12,2,979,0,0,27,23,4,2005,1,0,0,0,0,1,0,1,0,0,0,0,0,0
4447,4447,Jared Borgetti,2866,2005,Bolton Wanderers,11,3,8,351,2,0,8,2,6,192,0,0,19,5,14,543,2,0,0,0,0,1,0,1,0,0,0,0,0,0
4448,4448,Łukasz Fabiański,1227,2010,Arsenal FC,7,7,0,630,0,0,7,7,0,630,0,0,14,14,0,1260,0,0,0,0,0,0,0,0,0,0,0,0,0,0
4449,4449,Bacary Sagna,1596,2010,Arsenal FC,16,16,0,1440,0,0,17,17,0,1530,1,0,33,33,0,2970,1,0,0,0,0,0,1,1,0,0,0,0,0,0
4450,4450,Laurent Koscielny,1497,2010,Arsenal FC,15,15,0,1269,2,0,15,15,0,1350,0,0,30,30,0,2619,2,0,3,0,3,2,0,2,0,0,0,0,0,0
4451,4451,Johan Djourou,1229,2010,Arsenal FC,11,10,1,936,0,0,11,10,1,859,1,0,22,20,2,1795,1,0,0,0,0,0,0,0,0,0,0,0,0,0
4452,4452,Gaël Clichy,1230,2010,Arsenal FC,17,17,0,1530,0,0,16,16,0,1440,0,0,33,33,0,2970,0,0,0,0,0,0,0,0,0,0,0,0,0,0
4453,4453,Cesc Fàbregas,1526,2010,Arsenal FC,13,11,2,970,1,0,12,11,1,917,2,0,25,22,3,1887,3,0,0,0,0,0,1,1,0,0,0,0,0,0
4454,4454,Samir Nasri,1358,2010,Arsenal FC,14,14,0,1141,6,0,16,14,2,1248,4,0,30,28,2,2389,10,0,3,0,3,4,2,6,1,0,1,0,0,0
4455,4455,Alex Song,1233,2010,Arsenal FC,18,17,1,1495,3,0,13,13,0,1135,1,0,31,30,1,2630,4,0,3,0,3,2,0,2,0,0,0,0,0,0
4456,4456,Jack Wilshere,1694,2010,Arsenal FC,17,16,1,1350,0,0,18,15,3,1310,1,0,35,31,4,2660,1,0,0,0,0,0,0,0,0,0,0,0,0,0
4457,4457,Robin van Persie,1528,2010,Arsenal FC,13,9,4,884,7,0,12,10,2,884,11,0,25,19,6,1768,18,0,0,1,1,3,5,8,1,1,2,0,0,0
4458,4458,Theo Walcott,1237,2010,Arsenal FC,15,12,3,1005,4,0,13,7,6,691,5,0,28,19,9,1696,9,0,0,1,1,1,4,5,0,0,0,0,0,0
4459,4459,Abou Diaby,2434,2010,Arsenal FC,8,5,3,459,1,0,8,8,0,560,1,0,16,13,3,1019,2,0,0,0,0,0,1,1,0,0,0,0,0,0
4460,4460,Tomáš Rosický,1509,2010,Arsenal FC,9,4,5,386,0,0,12,4,8,541,0,0,21,8,13,927,0,0,0,0,0,0,0,0,0,0,0,0,0,0
4461,4461,Marouane Chamakh,1031,2010,Arsenal FC,15,8,7,781,4,0,14,10,4,1063,3,0,29,18,11,1844,7,0,3,0,3,2,1,3,0,0,0,0,0,0
4462,4462,Wojciech Szczęsny,1507,2010,Arsenal FC,8,8,0,720,0,0,7,7,0,630,0,0,15,15,0,1350,0,0,0,0,0,0,0,0,0,0,0,0,0,0
4463,4463,Sébastien Squillaci,2867,2010,Arsenal FC,11,10,1,877,1,0,11,10,1,942,0,0,22,20,2,1819,1,0,3,0,3,1,0,1,0,0,0,0,0,0
4464,4464,Andrey Arshavin,2750,2010,Arsenal FC,18,11,7,1074,2,0,19,14,5,1120,4,0,37,25,12,2194,6,0,0,3,3,1,3,4,1,0,1,0,0,0
4465,4465,Nicklas Bendtner,1236,2010,Arsenal FC,11,2,9,315,0,0,6,1,5,182,2,0,17,3,14,497,2,0,0,0,0,0,1,1,0,0,0,0,0,0
4466,4466,Petr Čech,1531,2010,Chelsea FC,19,19,0,1710,0,0,19,19,0,1710,0,0,38,38,0,3420,0,0,0,0,0,0,0,0,0,0,0,0,0,0
4467,4467,Branislav Ivanović,1532,2010,Chelsea FC,16,15,1,1363,2,0,18,17,1,1465,2,0,34,32,2,2828,4,0,0,3,3,2,1,3,0,0,0,0,0,0
4468,4468,Ashley Cole,1523,2010,Chelsea FC,19,19,0,1676,0,0,19,19,0,1710,0,0,38,38,0,3386,0,0,0,0,0,0,0,0,0,0,0,0,0,0
4469,4469,Paulo Ferreira,1761,2010,Chelsea FC,12,7,5,609,0,0,9,5,4,431,0,0,21,12,9,1040,0,0,0,0,0,0,0,0,0,0,0,0,0,0
4470,4470,John Terry,1534,2010,Chelsea FC,16,16,0,1440,1,0,17,17,0,1522,2,0,33,33,0,2962,3,0,0,0,0,1,2,3,0,0,0,0,0,0
4471,4471,Michael Essien,1763,2010,Chelsea FC,17,16,1,1384,1,0,16,16,0,1418,2,0,33,32,1,2802,3,0,3,0,3,1,1,2,0,0,0,0,0,0
4472,4472,Frank Lampard,1536,2010,Chelsea FC,13,13,0,1126,5,0,11,10,1,899,5,0,24,23,1,2025,10,0,3,0,3,4,1,5,2,2,4,0,0,0
4473,4473,John Mikel Obi,1769,2010,Chelsea FC,13,13,0,1091,0,0,15,15,0,1128,0,0,28,28,0,2219,0,0,0,0,0,0,0,0,0,0,0,0,0,0
4474,4474,Florent Malouda,2270,2010,Chelsea FC,19,17,2,1429,11,0,19,16,3,1378,2,0,38,33,5,2807,13,0,6,0,6,6,1,7,0,0,0,0,0,0
4475,4475,Didier Drogba,1766,2010,Chelsea FC,19,16,3,1481,8,0,17,14,3,1309,4,0,36,30,6,2790,12,0,0,2,2,3,4,7,2,0,2,0,0,0
4476,4476,Salomon Kalou,1770,2010,Chelsea FC,15,6,9,647,4,0,16,10,6,917,6,0,31,16,15,1564,10,0,3,1,4,2,3,5,0,0,0,0,0,0
4477,4477,Bosingwa,2268,2010,Chelsea FC,9,7,2,616,0,0,11,6,5,646,0,0,20,13,7,1262,0,0,0,0,0,0,0,0,0,0,0,0,0,0
4478,4478,Ramires,2460,2010,Chelsea FC,14,10,4,878,1,0,15,12,3,1065,1,0,29,22,7,1943,2,0,0,0,0,0,0,0,0,0,0,0,0,0
4479,4479,Ross Turnbull,2217,2010,Chelsea FC,0,0,0,0,0,0,0,0,0,0,0,0,0,0,0,0,0,0,0,0,0,0,0,0,0,0,0,0,0,0
4480,4480,Patrick van Aanholt,2254,2010,Chelsea FC,0,0,0,0,0,0,0,0,0,0,0,0,0,0,0,0,0,0,0,0,0,0,0,0,0,0,0,0,0,0
4481,4481,Jeffrey Bruma,2868,2010,Chelsea FC,2,1,1,108,0,0,0,0,0,0,0,0,2,1,1,108,0,0,0,0,0,0,0,0,0,0,0,0,0,0
4482,4482,Josh McEachran,2809,2010,Chelsea FC,4,1,3,103,0,0,5,0,5,69,0,0,9,1,8,172,0,0,0,0,0,0,0,0,0,0,0,0,0,0
4483,4483,Kelvin Davis,1143,2012,Southampton FC,6,5,1,494,0,0,4,4,0,360,0,0,10,9,1,854,0,0,0,0,0,0,0,0,0,0,0,0,0,0
4484,4484,Nathaniel Clyne,1144,2012,Southampton FC,17,17,0,1530,1,0,17,17,0,1491,0,0,34,34,0,3021,1,0,0,0,0,1,0,1,0,0,0,0,0,0
4485,4485,Jos Hooiveld,2869,2012,Southampton FC,11,9,2,834,0,0,14,14,0,1198,0,0,25,23,2,2032,0,0,0,0,0,0,0,0,0,0,0,0,0,0
4486,4486,José Fonte,1146,2012,Southampton FC,15,13,2,1233,2,0,12,12,0,1080,0,0,27,25,2,2313,2,0,1,0,1,2,0,2,0,0,0,0,0,0
4487,4487,Danny Fox,2870,2012,Southampton FC,11,9,2,724,0,0,9,5,4,500,1,0,20,14,6,1224,1,0,0,0,0,0,0,0,0,0,0,0,0,0
4488,4488,Morgan Schneiderlin,1051,2012,Southampton FC,19,19,0,1680,3,0,17,17,0,1530,2,0,36,36,0,3210,5,0,0,0,0,3,2,5,0,0,0,0,0,0
4489,4489,Steven Davis,1149,2012,Southampton FC,15,11,4,1017,1,0,17,11,6,1051,1,0,32,22,10,2068,2,0,0,0,0,0,1,1,0,0,0,0,0,0
4490,4490,James Ward-Prowse,1150,2012,Southampton FC,8,1,7,198,0,0,7,3,4,284,0,0,15,4,11,482,0,0,0,0,0,0,0,0,0,0,0,0,0,0
4491,4491,Adam Lallana,1190,2012,Southampton FC,15,14,1,1110,1,0,15,12,3,1129,2,0,30,26,4,2239,3,0,0,0,0,1,0,1,0,0,0,0,0,0
4492,4492,Jason Puncheon,1026,2012,Southampton FC,16,14,2,1134,2,0,16,11,5,933,3,0,32,25,7,2067,5,0,3,2,5,2,2,4,0,0,0,0,0,0
4493,4493,Rickie Lambert,2597,2012,Southampton FC,19,19,0,1638,7,0,19,16,3,1494,8,0,38,35,3,3132,15,0,4,4,8,5,7,12,1,2,3,0,0,0
4494,4494,Guly,2871,2012,Southampton FC,9,3,6,312,0,0,9,5,4,446,0,0,18,8,10,758,0,0,0,0,0,0,0,0,0,0,0,0,0,0
4495,4495,Jay Rodriguez,1247,2012,Southampton FC,16,9,7,920,3,0,19,15,4,1260,3,0,35,24,11,2180,6,0,0,0,0,1,3,4,0,0,0,0,0,0
4496,4496,Emmanuel Mayuka,2872,2012,Southampton FC,6,1,5,148,0,0,5,0,5,75,0,0,11,1,10,223,0,0,0,0,0,0,0,0,0,0,0,0,0,0
4497,4497,Paulo Gazzaniga,1156,2012,Southampton FC,5,5,0,450,0,0,4,4,0,360,0,0,9,9,0,810,0,0,0,0,0,0,0,0,0,0,0,0,0,0
4498,4498,Frazer Richardson,2873,2012,Southampton FC,3,1,2,71,0,0,2,1,1,95,0,0,5,2,3,166,0,0,0,0,0,0,0,0,0,0,0,0,0,0
4499,4499,Danny Seaborne,2874,2012,Southampton FC,0,0,0,0,0,0,0,0,0,0,0,0,0,0,0,0,0,0,0,0,0,0,0,0,0,0,0,0,0,0
4500,4500,Tadanari Lee,2875,2012,Southampton FC,0,0,0,0,0,0,0,0,0,0,0,0,0,0,0,0,0,0,0,0,0,0,0,0,0,0,0,0,0,0
4501,4501,Anders Lindegaard,2319,2012,Manchester United,5,5,0,450,0,0,5,5,0,450,0,0,10,10,0,900,0,0,0,0,0,0,0,0,0,0,0,0,0,0
4502,4502,Rafael,1787,2012,Manchester United,13,12,1,1102,1,0,15,15,0,1216,2,0,28,27,1,2318,3,0,0,0,0,0,2,2,0,0,0,0,0,0
4503,4503,Patrice Evra,1724,2012,Manchester United,17,17,0,1530,2,0,17,17,0,1530,2,0,34,34,0,3060,4,0,0,0,0,1,1,2,0,0,0,0,0,0
4504,4504,Rio Ferdinand,1294,2012,Manchester United,12,11,1,995,1,0,16,15,1,1329,0,0,28,26,2,2324,1,0,3,0,3,1,0,1,0,0,0,0,0,0
4505,4505,Nemanja Vidić,1725,2012,Manchester United,11,10,1,898,1,0,8,8,0,720,0,0,19,18,1,1618,1,0,0,0,0,0,0,0,0,0,0,0,0,0
4506,4506,Antonio Valencia,1641,2012,Manchester United,13,10,3,954,0,0,17,14,3,1252,1,0,30,24,6,2206,1,0,0,0,0,0,1,1,0,0,0,0,0,0
4507,4507,Michael Carrick,1627,2012,Manchester United,17,15,2,1356,0,0,19,19,0,1689,1,0,36,34,2,3045,1,0,0,0,0,0,1,1,0,0,0,0,0,0
4508,4508,Tom Cleverley,2091,2012,Manchester United,10,8,2,658,1,0,12,10,2,797,1,0,22,18,4,1455,2,0,0,0,0,0,0,0,0,0,0,0,0,0
4509,4509,Shinji Kagawa,2321,2012,Manchester United,10,8,2,638,5,0,10,9,1,688,1,0,20,17,3,1326,6,0,0,0,0,2,1,3,0,0,0,0,0,0
4510,4510,Danny Welbeck,1506,2012,Manchester United,14,9,5,841,1,0,13,4,9,452,0,0,27,13,14,1293,1,0,0,0,0,0,0,0,0,0,0,0,0,0
4511,4511,Robin van Persie,1528,2012,Manchester United,19,17,2,1549,12,0,19,18,1,1574,14,0,38,35,3,3123,26,0,3,14,17,8,9,17,0,3,3,0,0,0
4512,4512,Paul Scholes,1112,2012,Manchester United,8,6,2,475,1,0,8,2,6,292,0,0,16,8,8,767,1,0,0,0,0,1,0,1,0,0,0,0,0,0
4513,4513,Javier Hernández,2257,2012,Manchester United,9,4,5,395,4,0,13,5,8,548,6,0,22,9,13,943,10,0,3,6,9,2,3,5,0,0,0,0,0,0
4514,4514,Nani,2258,2012,Manchester United,5,2,3,221,1,0,6,5,1,409,0,0,11,7,4,630,1,0,0,0,0,0,0,0,0,0,0,0,0,0
4515,4515,De Gea,1638,2012,Manchester United,14,14,0,1260,0,0,14,14,0,1260,0,0,28,28,0,2520,0,0,0,0,0,0,0,0,0,0,0,0,0,0
4516,4516,Jonny Evans,1216,2012,Manchester United,12,11,1,994,2,0,11,10,1,908,1,0,23,21,2,1902,3,0,0,0,0,2,1,3,0,0,0,0,0,0
4517,4517,Ryan Giggs,1110,2012,Manchester United,11,8,3,698,1,0,11,4,7,463,1,0,22,12,10,1161,2,0,0,0,0,1,0,1,0,0,0,0,0,0
4518,4518,Nick Powell,2876,2012,Manchester United,2,0,2,30,1,0,0,0,0,0,0,0,2,0,2,30,1,0,0,0,0,0,0,0,0,0,0,0,0,0
4519,4519,Anders Lindegaard,2319,2011,Manchester United,4,4,0,360,0,0,4,4,0,360,0,0,8,8,0,720,0,0,0,0,0,0,0,0,0,0,0,0,0,0
4520,4520,Ji-Sung Park,1788,2011,Manchester United,7,5,2,474,2,0,9,5,4,432,0,0,16,10,6,906,2,0,0,0,0,1,0,1,0,0,0,0,0,0
4521,4521,Darron Gibson,2538,2011,Manchester United,1,1,0,90,0,0,0,0,0,0,0,0,1,1,0,90,0,0,0,0,0,0,0,0,0,0,0,0,0,0
4522,4522,Ezekiel Fryers,2127,2011,Manchester United,2,0,2,67,0,0,0,0,0,0,0,0,2,0,2,67,0,0,0,0,0,0,0,0,0,0,0,0,0,0
4523,4523,Federico Macheda,2019,2011,Manchester United,3,0,3,45,0,0,0,0,0,0,0,0,3,0,3,45,0,0,0,0,0,0,0,0,0,0,0,0,0,0
4524,4524,Mame Diouf,1584,2011,Manchester United,0,0,0,0,0,0,0,0,0,0,0,0,0,0,0,0,0,0,0,0,0,0,0,0,0,0,0,0,0,0
4525,4525,Ali Al Habsi,2877,2011,Wigan Athletic,19,19,0,1710,0,0,19,19,0,1710,0,0,38,38,0,3420,0,0,0,0,0,0,0,0,0,0,0,0,0,0
4526,4526,Antolín Alcaráz,2235,2011,Wigan Athletic,12,12,0,1080,1,0,13,13,0,1094,1,0,25,25,0,2174,2,0,0,3,3,1,1,2,0,0,0,0,0,0
4527,4527,Gary Caldwell,2673,2011,Wigan Athletic,18,18,0,1620,1,0,18,18,0,1620,2,0,36,36,0,3240,3,0,0,3,3,1,2,3,0,0,0,0,0,0
4528,4528,Ronnie Stam,2878,2011,Wigan Athletic,11,7,4,649,0,0,9,6,3,574,0,0,20,13,7,1223,0,0,0,0,0,0,0,0,0,0,0,0,0,0
4529,4529,Maynor Figueroa,2057,2011,Wigan Athletic,19,18,1,1641,0,0,19,19,0,1710,0,0,38,37,1,3351,0,0,0,0,0,0,0,0,0,0,0,0,0,0
4530,4530,James McCarthy,1053,2011,Wigan Athletic,17,17,0,1494,0,0,16,16,0,1390,0,0,33,33,0,2884,0,0,0,0,0,0,0,0,0,0,0,0,0,0
4531,4531,Jordi Gómez,2059,2011,Wigan Athletic,15,12,3,889,2,0,13,12,1,911,3,0,28,24,4,1800,5,0,1,3,4,2,2,4,0,2,2,0,0,0
4532,4532,David Jones,1490,2011,Wigan Athletic,8,7,1,620,0,0,8,6,2,544,0,0,16,13,3,1164,0,0,0,0,0,0,0,0,0,0,0,0,0,0
4533,4533,Momo Diamé,2060,2011,Wigan Athletic,14,9,5,820,2,0,12,9,3,775,1,0,26,18,8,1595,3,0,0,0,0,1,1,2,0,0,0,0,0,0
4534,4534,Victor Moses,1434,2011,Wigan Athletic,19,17,2,1563,3,0,19,19,0,1652,3,0,38,36,2,3215,6,0,0,1,1,1,3,4,0,0,0,0,0,0
4535,4535,Conor Sammon,2879,2011,Wigan Athletic,12,5,7,453,0,0,13,3,10,432,0,0,25,8,17,885,0,0,0,0,0,0,0,0,0,0,0,0,0,0
4536,4536,James McArthur,1023,2011,Wigan Athletic,14,9,5,860,1,0,17,9,8,902,2,0,31,18,13,1762,3,0,0,3,3,1,1,2,0,0,0,0,0,0
4537,4537,Franco Di Santo,2272,2011,Wigan Athletic,17,12,5,1046,4,0,15,12,3,993,3,0,32,24,8,2039,7,0,0,3,3,2,3,5,0,0,0,0,0,0
4538,4538,Hugo Rodallega,2061,2011,Wigan Athletic,13,4,9,583,1,0,10,7,3,664,1,0,23,11,12,1247,2,0,0,0,0,0,0,0,0,0,0,0,0,0
4539,4539,Mike Pollitt,2880,2011,Wigan Athletic,0,0,0,0,0,0,0,0,0,0,0,0,0,0,0,0,0,0,0,0,0,0,0,0,0,0,0,0,0,0
4540,4540,Steve Gohouri,2881,2011,Wigan Athletic,5,5,0,406,0,0,5,3,2,305,0,0,10,8,2,711,0,0,0,0,0,0,0,0,0,0,0,0,0,0
4541,4541,Crusat,2882,2011,Wigan Athletic,9,3,6,280,1,0,6,1,5,206,0,0,15,4,11,486,1,0,0,0,0,1,0,1,0,0,0,0,0,0
4542,4542,Ben Watson,2025,2011,Wigan Athletic,9,6,3,537,1,0,12,8,4,729,2,0,21,14,7,1266,3,0,0,1,1,1,2,3,1,1,2,0,0,0
4543,4543,Phil Bardsley,1409,2006,Aston Villa,7,7,0,617,0,0,6,6,0,530,0,0,13,13,0,1147,0,0,0,0,0,0,0,0,0,0,0,0,0,0
4544,4544,John Carew,1621,2006,Aston Villa,6,6,0,496,1,0,5,5,0,410,2,0,11,11,0,906,3,0,3,0,3,1,2,3,0,0,0,0,0,0
4545,4545,Patrik Berger,2689,2006,Aston Villa,9,3,6,363,1,0,4,2,2,194,1,0,13,5,8,557,2,0,0,0,0,0,1,1,0,0,0,0,0,0
4546,4546,Pepe Reina,1775,2006,Liverpool FC,17,17,0,1530,0,0,18,18,0,1620,0,0,35,35,0,3150,0,0,0,0,0,0,0,0,0,0,0,0,0,0
4547,4547,Steve Finnan,2883,2006,Liverpool FC,16,16,0,1440,0,0,17,16,1,1449,0,0,33,32,1,2889,0,0,0,0,0,0,0,0,0,0,0,0,0,0
4548,4548,Daniel Agger,1776,2006,Liverpool FC,15,13,2,1200,2,0,12,10,2,964,0,0,27,23,4,2164,2,0,0,0,0,1,0,1,0,0,0,0,0,0
4549,4549,John Arne Riise,2362,2006,Liverpool FC,17,16,1,1447,1,0,16,13,3,1131,0,0,33,29,4,2578,1,0,0,0,0,0,0,0,0,0,0,0,0,0
4550,4550,Fábio Aurélio,2054,2006,Liverpool FC,9,5,4,499,0,0,8,5,3,514,0,0,17,10,7,1013,0,0,0,0,0,0,0,0,0,0,0,0,0,0
4551,4551,Jamie Carragher,1778,2006,Liverpool FC,18,17,1,1506,1,0,17,17,0,1474,0,0,35,34,1,2980,1,0,0,0,0,0,0,0,0,0,0,0,0,0
4552,4552,Steven Gerrard,1424,2006,Liverpool FC,19,18,1,1568,6,0,17,17,0,1512,1,0,36,35,1,3080,7,0,3,0,3,3,0,3,1,0,1,0,0,0
4553,4553,Javier Mascherano,1893,2006,Liverpool FC,4,4,0,353,0,0,3,3,0,265,0,0,7,7,0,618,0,0,0,0,0,0,0,0,0,0,0,0,0,0
4554,4554,Mohamed Sissoko,2745,2006,Liverpool FC,6,5,1,416,0,0,10,10,0,812,0,0,16,15,1,1228,0,0,0,0,0,0,0,0,0,0,0,0,0,0
4555,4555,Craig Bellamy,2012,2006,Liverpool FC,11,8,3,684,2,0,16,15,1,1233,5,0,27,23,4,1917,7,0,1,0,1,2,2,4,0,0,0,0,0,0
4556,4556,Dirk Kuyt,1894,2006,Liverpool FC,18,14,4,1402,9,0,16,13,3,1179,3,0,34,27,7,2581,12,0,0,3,3,5,2,7,0,0,0,0,0,0
4557,4557,Xabi Alonso,1891,2006,Liverpool FC,16,14,2,1299,3,0,16,15,1,1361,1,0,32,29,3,2660,4,0,0,0,0,1,1,2,0,1,1,0,0,0
4558,4558,Jermaine Pennant,1514,2006,Liverpool FC,16,13,3,1161,1,0,18,7,11,808,0,0,34,20,14,1969,1,0,0,0,0,0,0,0,0,0,0,0,0,0
4559,4559,Robbie Fowler,2691,2006,Liverpool FC,9,2,7,264,2,0,7,4,3,341,1,0,16,6,10,605,3,0,0,1,1,1,1,2,2,1,3,0,0,0
4560,4560,Marcus Hahnemann,2588,2009,Wolverhampton Wanderers,13,13,0,1170,0,0,11,11,0,990,0,0,24,24,0,2160,0,0,0,0,0,0,0,0,0,0,0,0,0,0
4561,4561,George Elokobi,2884,2009,Wolverhampton Wanderers,11,9,2,831,0,0,10,7,3,719,0,0,21,16,5,1550,0,0,0,0,0,0,0,0,0,0,0,0,0,0
4562,4562,Jody Craddock,1093,2009,Wolverhampton Wanderers,17,17,0,1530,2,0,15,15,0,1350,3,0,32,32,0,2880,5,0,0,1,1,1,2,3,0,0,0,0,0,0
4563,4563,Christophe Berra,2885,2009,Wolverhampton Wanderers,16,16,0,1396,0,0,15,15,0,1350,0,0,31,31,0,2746,0,0,0,0,0,0,0,0,0,0,0,0,0,0
4564,4564,Michael Mancienne,2886,2009,Wolverhampton Wanderers,15,11,4,935,0,0,14,10,4,966,0,0,29,21,8,1901,0,0,0,0,0,0,0,0,0,0,0,0,0,0
4565,4565,Ronald Zubar,2887,2009,Wolverhampton Wanderers,11,11,0,990,0,0,11,11,0,980,1,0,22,22,0,1970,1,0,0,0,0,0,0,0,0,0,0,0,0,0
4566,4566,Kevin Foley,2888,2009,Wolverhampton Wanderers,13,12,1,990,0,0,11,10,1,900,0,0,24,22,2,1890,0,0,0,0,0,0,0,0,0,0,0,0,0,0
4567,4567,Dave Edwards,2889,2009,Wolverhampton Wanderers,10,8,2,624,1,0,9,7,2,665,0,0,19,15,4,1289,1,0,0,0,0,0,0,0,0,0,0,0,0,0
4568,4568,David Jones,1490,2009,Wolverhampton Wanderers,9,7,2,637,1,0,10,8,2,704,0,0,19,15,4,1341,1,0,3,0,3,1,0,1,0,0,0,0,0,0
4569,4569,Matthew Jarvis,2627,2009,Wolverhampton Wanderers,17,15,2,1295,0,0,16,14,2,1282,3,0,33,29,4,2577,3,0,0,1,1,0,2,2,0,0,0,0,0,0
4570,4570,Kevin Doyle,2594,2009,Wolverhampton Wanderers,18,18,0,1580,3,0,15,14,1,1227,6,0,33,32,1,2807,9,0,0,3,3,2,6,8,1,0,1,0,0,0
4571,4571,Nenad Milijaš,2890,2009,Wolverhampton Wanderers,12,7,5,640,2,0,6,5,1,325,0,0,18,12,6,965,2,0,0,0,0,1,0,1,0,0,0,0,0,0
4572,4572,Chris Iwelumo,2891,2009,Wolverhampton Wanderers,8,1,7,215,0,0,6,1,5,188,0,0,14,2,12,403,0,0,0,0,0,0,0,0,0,0,0,0,0,0
4573,4573,Liam Lawrence,2536,2009,Stoke City,15,9,6,898,1,0,10,5,5,484,0,0,25,14,11,1382,1,0,0,0,0,0,0,0,0,0,0,0,0,0
4574,4574,Ricardo Carvalho,1760,2008,Chelsea FC,7,7,0,552,0,0,5,4,1,413,1,0,12,11,1,965,1,0,0,0,0,0,1,1,0,0,0,0,0,0
4575,4575,Deco,2892,2008,Chelsea FC,12,8,4,722,1,0,12,9,3,824,2,0,24,17,7,1546,3,0,0,3,3,0,1,1,0,0,0,0,0,0
4576,4576,Salomon Kalou,1770,2008,Chelsea FC,13,7,6,701,3,0,14,10,4,798,4,0,27,17,10,1499,7,0,1,3,4,2,3,5,0,0,0,0,0,0
4577,4577,Belletti,2432,2008,Chelsea FC,9,1,8,277,2,0,11,4,7,432,1,0,20,5,15,709,3,0,0,0,0,2,0,2,0,0,0,0,0,0
4578,4578,Scott Sinclair,1420,2008,Chelsea FC,1,0,1,5,0,0,1,0,1,11,0,0,2,0,2,16,0,0,0,0,0,0,0,0,0,0,0,0,0,0
4579,4579,Edwin van der Sar,1077,2001,Fulham FC,18,18,0,1620,0,0,16,16,0,1440,0,0,34,34,0,3060,0,0,0,0,0,0,0,0,0,0,0,0,0,0
4580,4580,Steve Finnan,2883,2001,Fulham FC,18,18,0,1620,0,0,17,17,0,1530,0,0,35,35,0,3150,0,0,0,0,0,0,0,0,0,0,0,0,0,0
4581,4581,Rufus Brevett,2893,2001,Fulham FC,17,16,1,1447,0,0,15,15,0,1323,0,0,32,31,1,2770,0,0,0,0,0,0,0,0,0,0,0,0,0,0
4582,4582,Andy Melville,2894,2001,Fulham FC,16,16,0,1440,0,0,16,16,0,1440,0,0,32,32,0,2880,0,0,0,0,0,0,0,0,0,0,0,0,0,0
4583,4583,Alain Goma,1080,2001,Fulham FC,16,16,0,1365,0,0,14,13,1,1150,0,0,30,29,1,2515,0,0,0,0,0,0,0,0,0,0,0,0,0,0
4584,4584,John Collins,2895,2001,Fulham FC,15,12,3,1069,0,0,16,15,1,1355,0,0,31,27,4,2424,0,0,0,0,0,0,0,0,0,0,0,0,0,0
4585,4585,Boa Morte,1085,2001,Fulham FC,10,7,3,758,0,0,12,7,5,632,1,0,22,14,8,1390,1,0,0,1,1,0,1,1,0,0,0,0,0,0
4586,4586,Steed Malbranque,1086,2001,Fulham FC,18,16,2,1484,4,0,16,14,2,1285,4,0,34,30,4,2769,8,0,3,3,6,3,2,5,0,0,0,0,0,0
4587,4587,Sylvain Legwinski,1083,2001,Fulham FC,16,15,1,1221,2,0,14,12,2,1115,1,0,30,27,3,2336,3,0,0,0,0,0,1,1,0,0,0,0,0,0
4588,4588,Steve Marlet,2896,2001,Fulham FC,12,7,5,666,3,0,11,11,0,959,3,0,23,18,5,1625,6,0,3,0,3,1,3,4,0,0,0,0,0,0
4589,4589,Barry Hayles,2897,2001,Fulham FC,18,16,2,1403,8,0,15,10,5,933,0,0,33,26,7,2336,8,0,1,0,1,5,0,5,0,0,0,0,0,0
4590,4590,Louis Saha,1727,2001,Fulham FC,18,14,4,1334,3,0,16,12,4,1135,5,0,34,26,8,2469,8,0,0,1,1,2,5,7,0,1,1,0,0,0
4591,4591,Matt Oakley,1573,2001,Southampton FC,12,11,1,999,1,0,14,14,0,1144,0,0,26,25,1,2143,1,0,0,0,0,1,0,1,0,0,0,0,0,0
4592,4592,Jo Tessem,2696,2001,Southampton FC,10,4,6,428,0,0,12,3,9,474,2,0,22,7,15,902,2,0,0,2,2,0,2,2,0,0,0,0,0,0
4593,4593,Dan Petrescu,2898,2001,Southampton FC,1,0,1,20,0,0,1,0,1,35,0,0,2,0,2,55,0,0,0,0,0,0,0,0,0,0,0,0,0,0
4594,4594,Paul Williams,2097,2001,Southampton FC,13,13,0,1170,0,0,14,13,1,1179,0,0,27,26,1,2349,0,0,0,0,0,0,0,0,0,0,0,0,0,0
4595,4595,Jerzy Dudek,2899,2001,West Ham United,1,1,0,90,0,0,0,0,0,0,0,0,1,1,0,90,0,0,0,0,0,0,0,0,0,0,0,0,0,0
4596,4596,Stéphane Henchoz,2360,2001,West Ham United,1,1,0,90,0,0,0,0,0,0,0,0,1,1,0,90,0,0,0,0,0,0,0,0,0,0,0,0,0,0
4597,4597,Sami Hyypiä,2361,2001,West Ham United,1,1,0,90,0,0,0,0,0,0,0,0,1,1,0,90,0,0,0,0,0,0,0,0,0,0,0,0,0,0
4598,4598,John Arne Riise,2362,2001,West Ham United,1,1,0,90,0,0,0,0,0,0,0,0,1,1,0,90,0,0,0,0,0,0,0,0,0,0,0,0,0,0
4599,4599,Jamie Carragher,1778,2001,West Ham United,1,1,0,90,0,0,0,0,0,0,0,0,1,1,0,90,0,0,0,0,0,0,0,0,0,0,0,0,0,0
4600,4600,Vladimír Šmicer,2692,2001,West Ham United,1,1,0,75,0,0,0,0,0,0,0,0,1,1,0,75,0,0,0,0,0,0,0,0,0,0,0,0,0,0
4601,4601,Danny Murphy,1398,2001,West Ham United,1,1,0,59,0,0,0,0,0,0,0,0,1,1,0,59,0,0,0,0,0,0,0,0,0,0,0,0,0,0
4602,4602,Patrik Berger,2689,2001,West Ham United,1,1,0,90,0,0,0,0,0,0,0,0,1,1,0,90,0,0,0,0,0,0,0,0,0,0,0,0,0,0
4603,4603,Gary McAllister,2693,2001,West Ham United,1,1,0,45,0,0,0,0,0,0,0,0,1,1,0,45,0,0,0,0,0,0,0,0,0,0,0,0,0,0
4604,4604,Emile Heskey,1519,2001,West Ham United,1,1,0,90,0,0,0,0,0,0,0,0,1,1,0,90,0,0,0,0,0,0,0,0,0,0,0,0,0,0
4605,4605,Nicolas Anelka,1720,2001,West Ham United,1,1,0,90,0,0,0,0,0,0,0,0,1,1,0,90,0,0,0,0,0,0,0,0,0,0,0,0,0,0
4606,4606,Steven Gerrard,1424,2001,West Ham United,1,0,1,45,0,0,0,0,0,0,0,0,1,0,1,45,0,0,0,0,0,0,0,0,0,0,0,0,0,0
4607,4607,Michael Owen,1949,2001,West Ham United,1,0,1,31,0,0,0,0,0,0,0,0,1,0,1,31,0,0,0,0,0,0,0,0,0,0,0,0,0,0
4608,4608,Jari Litmanen,2900,2001,West Ham United,1,0,1,15,0,0,0,0,0,0,0,0,1,0,1,15,0,0,0,0,0,0,0,0,0,0,0,0,0,0
4609,4609,Dean Richards,2799,2003,Tottenham Hotspur,12,12,0,1080,0,0,11,11,0,990,0,0,23,23,0,2070,0,0,0,0,0,0,0,0,0,0,0,0,0,0
4610,4610,Darren Anderton,2082,2003,Tottenham Hotspur,11,8,3,751,0,0,9,8,1,688,1,0,20,16,4,1439,1,0,0,0,0,0,1,1,0,0,0,0,0,0
4611,4611,Stéphane Dalmat,2901,2003,Tottenham Hotspur,10,7,3,542,3,0,12,5,7,577,0,0,22,12,10,1119,3,0,0,0,0,1,0,1,0,0,0,0,0,0
4612,4612,Michael Oakes,2902,2003,Wolverhampton Wanderers,11,11,0,990,0,0,10,10,0,900,0,0,21,21,0,1890,0,0,0,0,0,0,0,0,0,0,0,0,0,0
4613,4613,Denis Irwin,1454,2003,Wolverhampton Wanderers,17,16,1,1411,0,0,15,14,1,1251,0,0,32,30,2,2662,0,0,0,0,0,0,0,0,0,0,0,0,0,0
4614,4614,Lee Naylor,2903,2003,Wolverhampton Wanderers,19,19,0,1691,0,0,19,18,1,1523,0,0,38,37,1,3214,0,0,0,0,0,0,0,0,0,0,0,0,0,0
4615,4615,Paul Butler,2904,2003,Wolverhampton Wanderers,19,19,0,1710,1,0,18,18,0,1620,0,0,37,37,0,3330,1,0,0,0,0,1,0,1,0,0,0,0,0,0
4616,4616,Jody Craddock,1093,2003,Wolverhampton Wanderers,16,15,1,1351,0,0,16,16,0,1440,1,0,32,31,1,2791,1,0,0,0,0,0,1,1,0,0,0,0,0,0
4617,4617,Alex Rae,1097,2003,Wolverhampton Wanderers,16,12,4,1154,2,0,17,15,2,1372,3,0,33,27,6,2526,5,0,0,0,0,2,1,3,0,0,0,0,0,0
4618,4618,Paul Ince,2905,2003,Wolverhampton Wanderers,15,15,0,1350,1,0,17,17,0,1530,1,0,32,32,0,2880,2,0,0,0,0,1,1,2,0,0,0,0,0,0
4619,4619,Colin Cameron,2906,2003,Wolverhampton Wanderers,15,11,4,1038,3,0,15,14,1,1184,1,0,30,25,5,2222,4,0,3,0,3,1,1,2,1,0,1,0,0,0
4620,4620,Mark Kennedy,2907,2003,Wolverhampton Wanderers,14,14,0,1227,0,0,17,14,3,1308,2,0,31,28,3,2535,2,0,0,0,0,0,1,1,0,0,0,0,0,0
4621,4621,Nathan Blake,2908,2003,Wolverhampton Wanderers,6,5,1,508,1,0,7,5,2,494,0,0,13,10,3,1002,1,0,0,0,0,1,0,1,0,0,0,0,0,0
4622,4622,Henri Camara,1818,2003,Wolverhampton Wanderers,15,15,0,1337,5,0,15,14,1,1252,2,0,30,29,1,2589,7,0,3,0,3,3,2,5,0,0,0,0,0,0
4623,4623,Kenny Miller,1577,2003,Wolverhampton Wanderers,11,9,2,712,2,0,14,8,6,713,0,0,25,17,8,1425,2,0,4,0,4,2,0,2,0,0,0,0,0,0
4624,4624,Dean Sturridge,1312,2003,Wolverhampton Wanderers,1,0,1,30,0,0,4,2,2,169,0,0,5,2,3,199,0,0,0,0,0,0,0,0,0,0,0,0,0,0
4625,4625,Chris Smalling,1640,2011,Manchester United,8,6,2,529,1,0,10,7,3,676,0,0,18,13,5,1205,1,0,0,0,0,1,0,1,0,0,0,0,0,0
4626,4626,Anderson,2018,2011,Manchester United,5,4,1,337,2,0,4,3,1,285,0,0,9,7,2,622,2,0,0,0,0,1,0,1,0,0,0,0,0,0
4627,4627,Fábio,2320,2011,Manchester United,2,1,1,91,0,0,3,1,2,156,0,0,5,2,3,247,0,0,0,0,0,0,0,0,0,0,0,0,0,0
4628,4628,Michael Dawson,1267,2011,Tottenham Hotspur,4,4,0,360,0,0,3,2,1,188,0,0,7,6,1,548,0,0,0,0,0,0,0,0,0,0,0,0,0,0
4629,4629,Benoît Assou-Ekotto,1269,2011,Tottenham Hotspur,17,17,0,1518,2,0,17,17,0,1444,0,0,34,34,0,2962,2,0,0,0,0,1,0,1,0,0,0,0,0,0
4630,4630,Niko Kranjčar,1276,2011,Tottenham Hotspur,7,5,2,343,1,0,5,4,1,302,0,0,12,9,3,645,1,0,0,0,0,0,0,0,0,0,0,0,0,0
4631,4631,Vedran Ćorluka,1268,2011,Tottenham Hotspur,2,1,1,91,0,0,1,0,1,44,0,0,3,1,2,135,0,0,0,0,0,0,0,0,0,0,0,0,0,0
4632,4632,Tom Huddlestone,1270,2011,Tottenham Hotspur,1,0,1,44,0,0,1,0,1,16,0,0,2,0,2,60,0,0,0,0,0,0,0,0,0,0,0,0,0,0
4633,4633,Roman Pavlyuchenko,2528,2011,Tottenham Hotspur,3,0,3,110,1,0,2,0,2,17,0,0,5,0,5,127,1,0,3,0,3,1,0,1,0,0,0,0,0,0
4634,4634,Gomes,1266,2011,Tottenham Hotspur,0,0,0,0,0,0,0,0,0,0,0,0,0,0,0,0,0,0,0,0,0,0,0,0,0,0,0,0,0,0
4635,4635,Sébastien Bassong,1370,2011,Tottenham Hotspur,2,0,2,29,0,0,3,1,2,193,0,0,5,1,4,222,0,0,0,0,0,0,0,0,0,0,0,0,0,0
4636,4636,Jermaine Jenas,1275,2011,Tottenham Hotspur,0,0,0,0,0,0,0,0,0,0,0,0,0,0,0,0,0,0,0,0,0,0,0,0,0,0,0,0,0,0
4637,4637,Andros Townsend,1176,2011,Tottenham Hotspur,0,0,0,0,0,0,0,0,0,0,0,0,0,0,0,0,0,0,0,0,0,0,0,0,0,0,0,0,0,0
4638,4638,Bernd Leno,1469,2018,Arsenal FC,16,15,1,1395,0,0,16,16,0,1440,0,0,32,31,1,2835,0,0,0,0,0,0,0,0,0,0,0,0,0,0
4639,4639,Sokratis Papastathopoulos,2215,2018,Arsenal FC,13,13,0,1119,0,0,12,12,0,1080,1,0,25,25,0,2199,1,0,0,0,0,0,0,0,0,0,0,0,0,0
4640,4640,Laurent Koscielny,1497,2018,Arsenal FC,6,5,1,484,2,0,11,8,3,844,1,0,17,13,4,1328,3,0,0,0,0,0,1,1,0,0,0,0,0,0
4641,4641,Nacho Monreal,1498,2018,Arsenal FC,10,9,1,781,1,0,12,12,0,1080,0,0,22,21,1,1861,1,0,0,0,0,1,0,1,0,0,0,0,0,0
4642,4642,Sead Kolašinac,2216,2018,Arsenal FC,14,13,1,1127,0,0,10,9,1,764,0,0,24,22,2,1891,0,0,0,0,0,0,0,0,0,0,0,0,0,0
4643,4643,Aaron Ramsey,1501,2018,Arsenal FC,14,8,6,689,2,0,14,6,8,638,2,0,28,14,14,1327,4,0,0,0,0,1,1,2,0,0,0,0,0,0
4644,4644,Mesut Özil,1500,2018,Arsenal FC,14,13,1,1139,4,0,10,7,3,602,1,0,24,20,4,1741,5,0,0,0,0,3,0,3,0,0,0,0,0,0
4645,4645,Ainsley Maitland-Niles,1473,2018,Arsenal FC,7,5,2,462,0,0,9,6,3,577,1,0,16,11,5,1039,1,0,0,0,0,0,1,1,0,0,0,0,0,0
4646,4646,Granit Xhaka,1475,2018,Arsenal FC,15,15,0,1317,2,0,14,14,0,1185,2,0,29,29,0,2502,4,0,0,0,0,2,2,4,0,0,0,0,0,0
4647,4647,Alexandre Lacazette,1481,2018,Arsenal FC,19,15,4,1403,9,0,16,12,4,1100,4,0,35,27,8,2503,13,0,1,3,4,5,3,8,0,0,0,0,0,0
4648,4648,Pierre-Emerick Aubameyang,1476,2018,Arsenal FC,19,16,3,1418,13,0,17,14,3,1313,9,0,36,30,6,2731,22,0,0,6,6,6,6,12,4,0,4,0,0,0
4649,4649,Denis Suárez,2909,2018,Arsenal FC,2,0,2,29,0,0,2,0,2,38,0,0,4,0,4,67,0,0,0,0,0,0,0,0,0,0,0,0,0,0
4650,4650,Alex Iwobi,1462,2018,Arsenal FC,18,7,11,742,1,0,17,15,2,1230,2,0,35,22,13,1972,3,0,0,0,0,0,2,2,0,0,0,0,0,0
4651,4651,Eddie Nketiah,2512,2018,Arsenal FC,1,0,1,4,0,0,4,0,4,59,1,0,5,0,5,63,1,0,0,0,0,0,0,0,0,0,0,0,0,0
4652,4652,Petr Čech,1531,2018,Arsenal FC,4,4,0,315,0,0,3,3,0,270,0,0,7,7,0,585,0,0,0,0,0,0,0,0,0,0,0,0,0,0
4653,4653,Shkodran Mustafi,1483,2018,Arsenal FC,15,15,0,1263,0,0,16,16,0,1354,2,0,31,31,0,2617,2,0,0,0,0,0,2,2,0,0,0,0,0,0
4654,4654,Mohamed Elneny,1865,2018,Arsenal FC,5,3,2,214,0,0,3,2,1,167,0,0,8,5,3,381,0,0,0,0,0,0,0,0,0,0,0,0,0,0
4655,4655,Mattéo Guendouzi,1485,2018,Arsenal FC,14,10,4,971,0,0,19,13,6,1172,0,0,33,23,10,2143,0,0,0,0,0,0,0,0,0,0,0,0,0,0
4656,4656,De Gea,1638,2018,Manchester United,19,19,0,1710,0,0,19,19,0,1710,0,0,38,38,0,3420,0,0,0,0,0,0,0,0,0,0,0,0,0,0
4657,4657,Victor Lindelöf,1639,2018,Manchester United,13,12,1,1112,1,0,17,17,0,1490,0,0,30,29,1,2602,1,0,1,0,1,1,0,1,0,0,0,0,0,0
4658,4658,Chris Smalling,1640,2018,Manchester United,13,13,0,1138,0,0,11,11,0,990,1,0,24,24,0,2128,1,0,0,0,0,0,0,0,0,0,0,0,0,0
4659,4659,Ashley Young,1619,2018,Manchester United,14,13,1,1207,1,0,16,15,1,1394,1,0,30,28,2,2601,2,0,0,0,0,1,0,1,0,0,0,0,0,0
4660,4660,Diogo Dalot,2910,2018,Manchester United,7,6,1,525,0,0,9,6,3,490,0,0,16,12,4,1015,0,0,0,0,0,0,0,0,0,0,0,0,0,0
4661,4661,Luke Shaw,2576,2018,Manchester United,13,13,0,1170,1,0,16,16,0,1422,0,0,29,29,0,2592,1,0,0,0,0,0,0,0,0,0,0,0,0,0
4662,4662,Paul Pogba,1642,2018,Manchester United,18,17,1,1517,10,0,17,17,0,1494,3,0,35,34,1,3011,13,0,3,0,3,6,1,7,5,2,7,0,0,0
4663,4663,Fred,2911,2018,Manchester United,9,7,2,577,1,0,8,6,2,468,0,0,17,13,4,1045,1,0,0,0,0,1,0,1,0,0,0,0,0,0
4664,4664,Nemanja Matić,1537,2018,Manchester United,12,12,0,1051,1,0,16,16,0,1390,0,0,28,28,0,2441,1,0,0,0,0,1,0,1,0,0,0,0,0,0
4665,4665,Romelu Lukaku,1645,2018,Manchester United,16,10,6,982,4,0,16,12,4,1148,8,0,32,22,10,2130,12,0,3,0,3,2,4,6,0,0,0,0,0,0
4666,4666,Marcus Rashford,1648,2018,Manchester United,17,15,2,1293,4,0,16,11,5,1069,6,0,33,26,7,2362,10,0,0,9,9,1,4,5,0,0,0,0,0,0
4667,4667,Anthony Martial,1647,2018,Manchester United,11,8,3,743,4,0,16,10,6,880,6,0,27,18,9,1623,10,0,0,0,0,2,3,5,0,1,1,0,0,0
4668,4668,Mason Greenwood,2912,2018,Manchester United,2,1,1,105,0,0,1,0,1,10,0,0,3,1,2,115,0,0,0,0,0,0,0,0,0,0,0,0,0,0
4669,4669,Sergio Romero,2192,2018,Manchester United,0,0,0,0,0,0,0,0,0,0,0,0,0,0,0,0,0,0,0,0,0,0,0,0,0,0,0,0,0,0
4670,4670,Eric Bailly,2755,2018,Manchester United,5,5,0,360,0,0,7,3,4,290,0,0,12,8,4,650,0,0,0,0,0,0,0,0,0,0,0,0,0,0
4671,4671,Marcos Rojo,1651,2018,Manchester United,5,2,3,211,0,0,0,0,0,0,0,0,5,2,3,211,0,0,0,0,0,0,0,0,0,0,0,0,0,0
4672,4672,Andreas Pereira,2190,2018,Manchester United,10,5,5,521,1,0,5,1,4,74,0,0,15,6,9,595,1,0,0,0,0,1,0,1,0,0,0,0,0,0
4673,4673,Scott McTominay,1652,2018,Manchester United,7,4,3,345,0,0,9,5,4,517,2,0,16,9,7,862,2,0,0,0,0,0,2,2,0,0,0,0,0,0
4674,4674,Bryan Hughes,1957,2003,Birmingham City,13,8,5,834,3,0,13,9,4,846,0,0,26,17,9,1680,3,0,0,0,0,2,0,2,0,0,0,0,0,0
4675,4675,Mikael Forssell,1965,2003,Birmingham City,17,17,0,1495,9,0,15,15,0,1311,8,0,32,32,0,2806,17,0,4,3,7,5,3,8,1,0,1,0,0,0
4676,4676,Clinton Morrison,1521,2003,Birmingham City,16,11,5,1022,1,0,15,8,7,776,3,0,31,19,12,1798,4,0,0,0,0,1,2,3,0,0,0,0,0,0
4677,4677,Darren Carter,1515,2003,Birmingham City,2,0,2,3,0,0,3,1,2,71,0,0,5,1,4,74,0,0,0,0,0,0,0,0,0,0,0,0,0,0
4678,4678,Jovan Kirovski,2913,2003,Birmingham City,2,0,2,30,0,0,4,0,4,40,0,0,6,0,6,70,0,0,0,0,0,0,0,0,0,0,0,0,0,0
4679,4679,Antti Niemi,1559,2003,Southampton FC,12,12,0,1080,0,0,14,14,0,1260,0,0,26,26,0,2340,0,0,0,0,0,0,0,0,0,0,0,0,0,0
4680,4680,Jason Dodd,2046,2003,Southampton FC,14,14,0,1206,1,0,13,12,1,1087,0,0,27,26,1,2293,1,0,0,0,0,1,0,1,0,0,0,0,0,0
4681,4681,Michael Svensson,2914,2003,Southampton FC,14,14,0,1260,1,0,11,11,0,990,1,0,25,25,0,2250,2,0,0,0,0,1,0,1,0,0,0,0,0,0
4682,4682,Fitz Hall,2024,2003,Southampton FC,4,3,1,340,0,0,6,3,3,320,0,0,10,6,4,660,0,0,0,0,0,0,0,0,0,0,0,0,0,0
4683,4683,Danny Higginbotham,1990,2003,Southampton FC,11,10,1,946,0,0,14,12,2,1162,0,0,25,22,3,2108,0,0,0,0,0,0,0,0,0,0,0,0,0,0
4684,4684,Anders Svensson,2053,2003,Southampton FC,14,6,8,710,0,0,14,10,4,659,0,0,28,16,12,1369,0,0,0,0,0,0,0,0,0,0,0,0,0,0
4685,4685,Rory Delap,1993,2003,Southampton FC,13,12,1,1059,1,0,14,14,0,1121,0,0,27,26,1,2180,1,0,3,0,3,1,0,1,0,0,0,0,0,0
4686,4686,David Prutton,2915,2003,Southampton FC,11,10,1,922,0,0,14,11,3,1052,1,0,25,21,4,1974,1,0,0,0,0,0,0,0,0,0,0,0,0,0
4687,4687,Fabrice Fernandes,2695,2003,Southampton FC,12,10,2,859,1,0,13,9,4,728,0,0,25,19,6,1587,1,0,1,0,1,1,0,1,0,0,0,0,0,0
4688,4688,James Beattie,2050,2003,Southampton FC,17,14,3,1323,8,0,18,16,2,1462,6,0,35,30,5,2785,14,0,3,1,4,5,4,9,2,0,2,0,0,0
4689,4689,Brett Ormerod,2607,2003,Southampton FC,12,7,5,617,3,0,9,7,2,577,2,0,21,14,7,1194,5,0,3,0,3,2,2,4,0,0,0,0,0,0
4690,4690,Neil McCann,2916,2003,Southampton FC,10,4,6,392,0,0,7,4,3,365,0,0,17,8,9,757,0,0,0,0,0,0,0,0,0,0,0,0,0,0
4691,4691,Kevin Phillips,1100,2003,Southampton FC,17,14,3,1240,4,0,15,12,3,1170,9,0,32,26,6,2410,13,0,1,0,1,1,2,3,0,0,0,0,0,0
4692,4692,Marians Pahars,2051,2003,Southampton FC,5,4,1,328,2,0,9,2,7,256,0,0,14,6,8,584,2,0,0,0,0,1,0,1,0,0,0,0,0,0
4693,4693,Nedum Onuoha,2533,2005,Manchester City,6,5,1,435,0,0,4,3,1,285,0,0,10,8,2,720,0,0,0,0,0,0,0,0,0,0,0,0,0,0
4694,4694,Richard Dunne,1617,2005,Manchester City,14,14,0,1239,2,0,18,17,1,1554,1,0,32,31,1,2793,3,0,0,0,0,2,1,3,0,0,0,0,0,0
4695,4695,Joey Barton,1876,2005,Manchester City,15,15,0,1329,2,0,15,15,0,1350,4,0,30,30,0,2679,6,0,0,1,1,0,2,2,1,0,1,0,0,0
4696,4696,Kiki Musampa,2917,2005,Manchester City,13,11,2,960,0,0,13,12,1,947,0,0,26,23,3,1907,0,0,0,0,0,0,0,0,0,0,0,0,0,0
4697,4697,Darius Vassell,1798,2005,Manchester City,18,18,0,1469,5,0,17,17,0,1484,3,0,35,35,0,2953,8,0,0,3,3,1,2,3,0,0,0,0,0,0
4698,4698,Zat Knight,1755,2008,Aston Villa,6,6,0,510,1,0,6,6,0,540,0,0,12,12,0,1050,1,0,1,0,1,1,0,1,0,0,0,0,0,0
4699,4699,Danny Pugh,2756,2008,Stoke City,8,5,3,466,0,0,9,4,5,466,0,0,17,9,8,932,0,0,0,0,0,0,0,0,0,0,0,0,0,0
4700,4700,Steve Simonsen,2918,2008,Stoke City,1,0,1,24,0,0,4,3,1,245,0,0,5,3,2,269,0,0,0,0,0,0,0,0,0,0,0,0,0,0
4701,4701,Mark Schwarzer,1328,2001,Middlesbrough FC,12,12,0,1080,0,0,9,9,0,810,0,0,21,21,0,1890,0,0,0,0,0,0,0,0,0,0,0,0,0,0
4702,4702,Franck Queudrue,1329,2001,Middlesbrough FC,15,15,0,1272,2,0,12,12,0,1006,0,0,27,27,0,2278,2,0,1,0,1,2,0,2,0,0,0,0,0,0
4703,4703,Ugo Ehiogu,2134,2001,Middlesbrough FC,14,14,0,1260,1,0,14,14,0,1229,0,0,28,28,0,2489,1,0,3,0,3,1,0,1,0,0,0,0,0,0
4704,4704,Gareth Southgate,1331,2001,Middlesbrough FC,18,18,0,1620,1,0,18,18,0,1620,0,0,36,36,0,3240,1,0,0,0,0,0,0,0,0,0,0,0,0,0
4705,4705,Robbie Stockdale,2697,2001,Middlesbrough FC,14,14,0,1206,0,0,13,11,2,1045,1,0,27,25,2,2251,1,0,0,0,0,0,0,0,0,0,0,0,0,0
4706,4706,Robbie Mustoe,2919,2001,Middlesbrough FC,18,16,2,1358,1,0,17,14,3,1318,1,0,35,30,5,2676,2,0,0,3,3,0,1,1,0,0,0,0,0,0
4707,4707,Paul Ince,2905,2001,Middlesbrough FC,15,15,0,1350,1,0,15,15,0,1350,1,0,30,30,0,2700,2,0,0,0,0,1,1,2,0,0,0,0,0,0
4708,4708,Jonathan Greening,1321,2001,Middlesbrough FC,18,18,0,1543,0,0,17,17,0,1414,1,0,35,35,0,2957,1,0,0,3,3,0,1,1,0,0,0,0,0,0
4709,4709,Benito Carbone,2920,2001,Middlesbrough FC,8,8,0,655,1,0,4,4,0,360,0,0,12,12,0,1015,1,0,0,0,0,1,0,1,0,0,0,0,0,0
4710,4710,Alen Bokšić,2699,2001,Middlesbrough FC,12,10,2,943,4,0,10,10,0,848,4,0,22,20,2,1791,8,0,0,7,7,1,4,5,1,1,2,0,0,0
4711,4711,Noel Whelan,2075,2001,Middlesbrough FC,10,9,1,717,1,0,8,8,0,644,3,0,18,17,1,1361,4,0,0,4,4,1,3,4,0,0,0,0,0,0
4712,4712,David Murphy,2135,2001,Middlesbrough FC,3,0,3,80,0,0,2,0,2,15,0,0,5,0,5,95,0,0,0,0,0,0,0,0,0,0,0,0,0,0
4713,4713,Dean Windass,2814,2001,Middlesbrough FC,15,6,9,571,1,0,12,2,10,226,0,0,27,8,19,797,1,0,1,0,1,1,0,1,0,0,0,0,0,0
4714,4714,Szilárd Németh,2139,2001,Middlesbrough FC,9,4,5,405,3,0,11,7,4,593,0,0,20,11,9,998,3,0,3,0,3,2,0,2,0,0,0,0,0,0
4715,4715,Sean Davis,1087,2001,Fulham FC,16,12,4,1060,0,0,11,10,1,841,0,0,27,22,5,1901,0,0,0,0,0,0,0,0,0,0,0,0,0,0
4716,4716,Robert Green,1277,2014,Queens Park Rangers,18,18,0,1564,0,0,18,18,0,1620,0,0,36,36,0,3184,0,0,0,0,0,0,0,0,0,0,0,0,0,0
4717,4717,Steven Caulker,2806,2014,Queens Park Rangers,19,18,1,1620,1,0,16,16,0,1396,0,0,35,34,1,3016,1,0,0,0,0,1,0,1,0,0,0,0,0,0
4718,4718,Clint Hill,2540,2014,Queens Park Rangers,10,8,2,800,0,0,9,7,2,608,1,0,19,15,4,1408,1,0,0,0,0,0,1,1,0,0,0,0,0,0
4719,4719,Nedum Onuoha,2533,2014,Queens Park Rangers,11,11,0,901,0,0,12,11,1,1034,0,0,23,22,1,1935,0,0,0,0,0,0,0,0,0,0,0,0,0,0
4720,4720,Richard Dunne,1617,2014,Queens Park Rangers,13,12,1,1018,0,0,10,10,0,856,0,0,23,22,1,1874,0,0,0,0,0,0,0,0,0,0,0,0,0,0
4721,4721,Matt Phillips,1660,2014,Queens Park Rangers,13,8,5,858,1,0,12,12,0,962,2,0,25,20,5,1820,3,0,0,0,0,1,1,2,0,0,0,0,0,0
4722,4722,Joey Barton,1876,2014,Queens Park Rangers,15,14,1,1248,0,0,13,13,0,1160,1,0,28,27,1,2408,1,0,0,0,0,0,0,0,0,0,0,0,0,0
4723,4723,Leroy Fer,1375,2014,Queens Park Rangers,14,13,1,1148,4,0,15,14,1,1219,2,0,29,27,2,2367,6,0,3,0,3,4,2,6,0,0,0,0,0,0
4724,4724,Karl Henry,2921,2014,Queens Park Rangers,16,14,2,1317,0,0,17,13,4,1188,0,0,33,27,6,2505,0,0,0,0,0,0,0,0,0,0,0,0,0,0
4725,4725,Junior Hoilett,2535,2014,Queens Park Rangers,12,5,7,458,0,0,10,4,6,424,0,0,22,9,13,882,0,0,0,0,0,0,0,0,0,0,0,0,0,0
4726,4726,Charlie Austin,1245,2014,Queens Park Rangers,19,19,0,1689,10,0,16,16,0,1394,8,0,35,35,0,3083,18,0,9,0,9,6,5,11,1,2,3,0,0,0
4727,4727,Alex McCarthy,1032,2014,Queens Park Rangers,2,1,1,146,0,0,1,1,0,90,0,0,3,2,1,236,0,0,0,0,0,0,0,0,0,0,0,0,0,0
4728,4728,Suk-young Yun,2922,2014,Queens Park Rangers,11,9,2,780,0,0,12,10,2,946,0,0,23,19,4,1726,0,0,0,0,0,0,0,0,0,0,0,0,0,0
4729,4729,Reece Grego-Cox,2923,2014,Queens Park Rangers,2,0,2,46,0,0,2,1,1,95,0,0,4,1,3,141,0,0,0,0,0,0,0,0,0,0,0,0,0,0
4730,4730,Darnell Furlong,2924,2014,Queens Park Rangers,1,1,0,90,0,0,2,2,0,136,0,0,3,3,0,226,0,0,0,0,0,0,0,0,0,0,0,0,0,0
4731,4731,Shaun Wright-Phillips,1683,2014,Queens Park Rangers,1,0,1,1,0,0,3,1,2,124,0,0,4,1,3,125,0,0,0,0,0,0,0,0,0,0,0,0,0,0
4732,4732,Michael Doughty,2925,2014,Queens Park Rangers,0,0,0,0,0,0,3,0,3,51,0,0,3,0,3,51,0,0,0,0,0,0,0,0,0,0,0,0,0,0
4733,4733,Brandon Comley,2926,2014,Queens Park Rangers,0,0,0,0,0,0,1,0,1,10,0,0,1,0,1,10,0,0,0,0,0,0,0,0,0,0,0,0,0,0
4734,4734,Tim Krul,1822,2014,Newcastle United,15,15,0,1350,0,0,15,15,0,1350,0,0,30,30,0,2700,0,0,0,0,0,0,0,0,0,0,0,0,0,0
4735,4735,Fabricio Coloccini,2278,2014,Newcastle United,17,17,0,1530,0,0,15,15,0,1338,1,0,32,32,0,2868,1,0,0,0,0,0,0,0,0,0,0,0,0,0
4736,4736,Ryan Taylor,2341,2014,Newcastle United,7,6,1,488,0,0,7,5,2,420,0,0,14,11,3,908,0,0,0,0,0,0,0,0,0,0,0,0,0,0
4737,4737,Daryl Janmaat,1929,2014,Newcastle United,18,18,0,1580,1,0,19,19,0,1675,0,0,37,37,0,3255,1,0,0,0,0,1,0,1,0,0,0,0,0,0
4738,4738,Paul Dummett,2467,2014,Newcastle United,12,12,0,1052,0,0,13,12,1,1058,0,0,25,24,1,2110,0,0,0,0,0,0,0,0,0,0,0,0,0,0
4739,4739,Moussa Sissoko,1858,2014,Newcastle United,17,17,0,1530,4,0,17,17,0,1523,0,0,34,34,0,3053,4,0,3,0,3,3,0,3,0,0,0,0,0,0
4740,4740,Jack Colback,1404,2014,Newcastle United,17,17,0,1530,4,0,18,18,0,1599,0,0,35,35,0,3129,4,0,0,0,0,3,0,3,0,0,0,0,0,0
4741,4741,Ayoze Pérez,2288,2014,Newcastle United,18,11,7,1126,4,0,18,14,4,1244,3,0,36,25,11,2370,7,0,4,3,7,4,2,6,0,0,0,0,0,0
4742,4742,Jonás Gutiérrez,2398,2014,Newcastle United,5,3,2,313,1,0,5,3,2,321,0,0,10,6,4,634,1,0,0,0,0,0,0,0,0,0,0,0,0,0
4743,4743,Rémy Cabella,2927,2014,Newcastle United,15,11,4,921,0,0,16,10,6,1022,1,0,31,21,10,1943,1,0,0,0,0,0,1,1,0,0,0,0,0,0
4744,4744,Emmanuel Rivière,2634,2014,Newcastle United,11,9,2,703,0,0,12,6,6,511,1,0,23,15,8,1214,1,0,0,0,0,0,1,1,0,0,0,0,0,0
4745,4745,Rolando Aarons,2284,2014,Newcastle United,3,0,3,102,1,0,1,0,1,26,0,0,4,0,4,128,1,0,0,0,0,1,0,1,0,0,0,0,0,0
4746,4746,Papiss Demba Cissé,2282,2014,Newcastle United,12,6,6,620,6,0,10,5,5,531,5,0,22,11,11,1151,11,0,4,2,6,4,4,8,0,1,1,0,0,0
4747,4747,Sammy Ameobi,2459,2014,Newcastle United,12,8,4,751,0,0,13,7,6,670,2,0,25,15,10,1421,2,0,0,0,0,0,1,1,0,0,0,0,0,0
4748,4748,Freddie Woodman,2630,2014,Newcastle United,0,0,0,0,0,0,0,0,0,0,0,0,0,0,0,0,0,0,0,0,0,0,0,0,0,0,0,0,0,0
4749,4749,Vurnon Anita,2281,2014,Newcastle United,10,9,1,682,0,0,9,8,1,593,0,0,19,17,2,1275,0,0,0,0,0,0,0,0,0,0,0,0,0,0
4750,4750,Mehdi Abeid,2928,2014,Newcastle United,7,4,3,350,0,0,6,3,3,312,0,0,13,7,6,662,0,0,0,0,0,0,0,0,0,0,0,0,0,0
4751,4751,Yoan Gouffran,2454,2014,Newcastle United,14,10,4,823,1,0,17,14,3,1151,1,0,31,24,7,1974,2,0,0,0,0,1,0,1,0,0,0,0,0,0
4752,4752,Jamaal Lascelles,2631,2019,Newcastle United,12,12,0,1010,1,0,12,12,0,1069,0,0,24,24,0,2079,1,0,0,0,0,1,0,1,0,0,0,0,0,0
4753,4753,Sung-yueng Ki,1698,2019,Newcastle United,1,0,1,17,0,0,2,1,1,119,0,0,3,1,2,136,0,0,0,0,0,0,0,0,0,0,0,0,0,0
4754,4754,Yoshinori Mutō,2929,2019,Newcastle United,2,1,1,98,0,0,6,1,5,109,0,0,8,2,6,207,0,0,0,0,0,0,0,0,0,0,0,0,0,0
4755,4755,Steven Alzate,2930,2019,Brighton & Hove Albion,9,6,3,581,0,0,10,6,4,602,0,0,19,12,7,1183,0,0,0,0,0,0,0,0,0,0,0,0,0,0
4756,4756,Gaëtan Bong,2483,2019,Brighton & Hove Albion,2,0,2,3,0,0,2,0,2,53,0,0,4,0,4,56,0,0,0,0,0,0,0,0,0,0,0,0,0,0
4757,4757,Tudor Băluţă,2931,2019,Brighton & Hove Albion,0,0,0,0,0,0,0,0,0,0,0,0,0,0,0,0,0,0,0,0,0,0,0,0,0,0,0,0,0,0
4758,4758,Martin Dúbravka,2466,2017,Newcastle United,6,6,0,540,0,0,6,6,0,540,0,0,12,12,0,1080,0,0,0,0,0,0,0,0,0,0,0,0,0,0
4759,4759,Paul Dummett,2467,2017,Newcastle United,11,11,0,875,0,0,9,8,1,728,0,0,20,19,1,1603,0,0,0,0,0,0,0,0,0,0,0,0,0,0
4760,4760,Jamaal Lascelles,2631,2017,Newcastle United,17,16,1,1488,2,0,16,16,0,1440,1,0,33,32,1,2928,3,0,3,3,6,2,1,3,0,0,0,0,0,0
4761,4761,Kenedy,2932,2017,Newcastle United,6,6,0,504,2,0,7,7,0,526,0,0,13,13,0,1030,2,0,0,0,0,1,0,1,0,0,0,0,0,0
4762,4762,Mikel Merino,2933,2017,Newcastle United,13,7,6,693,1,0,11,7,4,650,0,0,24,14,10,1343,1,0,3,0,3,1,0,1,0,0,0,0,0,0
4763,4763,Massadio Haïdara,2280,2017,Newcastle United,1,0,1,3,0,0,1,1,0,90,0,0,2,1,1,93,0,0,0,0,0,0,0,0,0,0,0,0,0,0
4764,4764,Michel Vorm,1174,2013,Swansea City,13,13,0,1170,0,0,13,13,0,1170,0,0,26,26,0,2340,0,0,0,0,0,0,0,0,0,0,0,0,0,0
4765,4765,Jordi Amat,2934,2013,Swansea City,9,6,3,643,0,0,8,7,1,603,0,0,17,13,4,1246,0,0,0,0,0,0,0,0,0,0,0,0,0,0
4766,4766,Chico,2935,2013,Swansea City,16,16,0,1440,2,0,15,14,1,1333,1,0,31,30,1,2773,3,0,1,1,2,1,1,2,0,0,0,0,0,0
4767,4767,Dwight Tiendalli,2936,2013,Swansea City,5,5,0,437,0,0,5,4,1,313,0,0,10,9,1,750,0,0,0,0,0,0,0,0,0,0,0,0,0,0
4768,4768,Ben Davies,1164,2013,Swansea City,18,18,0,1581,1,0,16,14,2,1292,1,0,34,32,2,2873,2,0,0,0,0,0,1,1,0,0,0,0,0,0
4769,4769,Jonjo Shelvey,1699,2013,Swansea City,14,13,1,1101,4,0,18,16,2,1375,2,0,32,29,3,2476,6,0,0,3,3,3,1,4,0,0,0,0,0,0
4770,4770,Jonathan de Guzmán,2937,2013,Swansea City,17,15,2,1271,4,0,17,11,6,1081,0,0,34,26,8,2352,4,0,0,0,0,2,0,2,0,0,0,0,0,0
4771,4771,Cañas,2938,2013,Swansea City,10,7,3,680,0,0,13,12,1,988,0,0,23,19,4,1668,0,0,0,0,0,0,0,0,0,0,0,0,0,0
4772,4772,Michu,2939,2013,Swansea City,8,7,1,640,1,0,9,8,1,648,1,0,17,15,2,1288,2,0,1,0,1,1,1,2,0,0,0,0,0,0
4773,4773,Nathan Dyer,1702,2013,Swansea City,14,9,5,913,3,0,13,10,3,837,3,0,27,19,8,1750,6,0,0,0,0,2,2,4,0,0,0,0,0,0
4774,4774,Wayne Routledge,1758,2013,Swansea City,19,17,2,1427,2,0,16,15,1,1282,0,0,35,32,3,2709,2,0,0,0,0,1,0,1,0,0,0,0,0,0
4775,4775,Pozuelo,2940,2013,Swansea City,10,3,7,372,0,0,12,4,8,500,0,0,22,7,15,872,0,0,0,0,0,0,0,0,0,0,0,0,0,0
4776,4776,Wilfried Bony,1597,2013,Swansea City,17,14,3,1274,10,0,17,13,4,1196,7,0,34,27,7,2470,17,0,0,3,3,3,6,9,2,2,4,0,0,0
4777,4777,Gerhard Tremmel,1706,2013,Swansea City,6,6,0,540,0,0,6,6,0,540,0,0,12,12,0,1080,0,0,0,0,0,0,0,0,0,0,0,0,0,0
4778,4778,Neil Taylor,1695,2013,Swansea City,5,1,4,157,0,0,5,5,0,433,0,0,10,6,4,590,0,0,0,0,0,0,0,0,0,0,0,0,0,0
4779,4779,Daniel Alfei,2941,2013,Swansea City,0,0,0,0,0,0,0,0,0,0,0,0,0,0,0,0,0,0,0,0,0,0,0,0,0,0,0,0,0,0
4780,4780,Leon Britton,1707,2013,Swansea City,14,14,0,1209,0,0,11,9,2,814,0,0,25,23,2,2023,0,0,0,0,0,0,0,0,0,0,0,0,0,0
4781,4781,Álvaro,2942,2013,Swansea City,5,2,3,127,0,0,7,3,4,284,0,0,12,5,7,411,0,0,0,0,0,0,0,0,0,0,0,0,0,0
4782,4782,Wojciech Szczęsny,1507,2013,Arsenal FC,19,19,0,1710,0,0,18,18,0,1620,0,0,37,37,0,3330,0,0,0,0,0,0,0,0,0,0,0,0,0,0
4783,4783,Bacary Sagna,1596,2013,Arsenal FC,17,16,1,1441,1,0,18,18,0,1620,0,0,35,34,1,3061,1,0,0,0,0,0,0,0,0,0,0,0,0,0
4784,4784,Per Mertesacker,1496,2013,Arsenal FC,19,19,0,1710,1,0,16,16,0,1440,1,0,35,35,0,3150,2,0,0,0,0,1,0,1,0,0,0,0,0,0
4785,4785,Laurent Koscielny,1497,2013,Arsenal FC,16,16,0,1417,2,0,16,16,0,1348,0,0,32,32,0,2765,2,0,0,0,0,1,0,1,0,0,0,0,0,0
4786,4786,Kieran Gibbs,1508,2013,Arsenal FC,12,11,1,922,0,0,16,13,3,1208,0,0,28,24,4,2130,0,0,0,0,0,0,0,0,0,0,0,0,0,0
4787,4787,Jack Wilshere,1694,2013,Arsenal FC,11,10,1,831,1,0,13,9,4,890,2,0,24,19,5,1721,3,0,0,1,1,1,2,3,0,0,0,0,0,0
4788,4788,Mesut Özil,1500,2013,Arsenal FC,12,12,0,1035,5,0,14,13,1,1115,0,0,26,25,1,2150,5,0,0,0,0,1,0,1,0,0,0,0,0,0
4789,4789,Aaron Ramsey,1501,2013,Arsenal FC,11,9,2,833,3,0,12,11,1,931,7,0,23,20,3,1764,10,0,0,0,0,1,4,5,0,0,0,0,0,0
4790,4790,Mathieu Flamini,1510,2013,Arsenal FC,12,8,4,750,1,0,15,10,5,864,1,0,27,18,9,1614,2,0,1,0,1,1,0,1,0,0,0,0,0,0
4791,4791,Olivier Giroud,1504,2013,Arsenal FC,17,17,0,1499,10,0,19,19,0,1582,6,0,36,36,0,3081,16,0,6,3,9,7,4,11,1,0,1,0,0,0
4792,4792,Serge Gnabry,2943,2013,Arsenal FC,3,2,1,161,0,0,6,3,3,324,1,0,9,5,4,485,1,0,0,0,0,0,1,1,0,0,0,0,0,0
4793,4793,Nacho Monreal,1498,2013,Arsenal FC,11,7,4,632,0,0,12,6,6,550,0,0,23,13,10,1182,0,0,0,0,0,0,0,0,0,0,0,0,0,0
4794,4794,Carl Jenkinson,2752,2013,Arsenal FC,7,3,4,384,0,0,7,4,3,415,1,0,14,7,7,799,1,0,0,0,0,0,0,0,0,0,0,0,0,0
4795,4795,Mikel Arteta,1802,2013,Arsenal FC,16,14,2,1237,0,0,15,13,2,1194,2,0,31,27,4,2431,2,0,0,0,0,0,1,1,0,2,2,0,0,0
4796,4796,Łukasz Fabiański,1227,2013,Arsenal FC,0,0,0,0,0,0,1,1,0,90,0,0,1,1,0,90,0,0,0,0,0,0,0,0,0,0,0,0,0,0
4797,4797,Thomas Vermaelen,2749,2013,Arsenal FC,7,4,3,383,0,0,7,3,4,399,0,0,14,7,7,782,0,0,0,0,0,0,0,0,0,0,0,0,0,0
4798,4798,Nicklas Bendtner,1236,2013,Arsenal FC,4,1,3,116,2,0,5,0,5,40,0,0,9,1,8,156,2,0,0,0,0,2,0,2,0,0,0,0,0,0
4799,4799,Ryo Miyaichi,2497,2013,Arsenal FC,1,0,1,17,0,0,0,0,0,0,0,0,1,0,1,17,0,0,0,0,0,0,0,0,0,0,0,0,0,0
4800,4800,Jason Steele,2944,2018,Brighton & Hove Albion,0,0,0,0,0,0,0,0,0,0,0,0,0,0,0,0,0,0,0,0,0,0,0,0,0,0,0,0,0,0
4801,4801,Kasper Schmeichel,2435,2018,Leicester City,19,19,0,1710,0,0,19,19,0,1710,0,0,38,38,0,3420,0,0,0,0,0,0,0,0,0,0,0,0,0,0
4802,4802,Ben Chilwell,2436,2018,Leicester City,18,18,0,1620,0,0,18,18,0,1620,0,0,36,36,0,3240,0,0,0,0,0,0,0,0,0,0,0,0,0,0
4803,4803,Wes Morgan,2446,2018,Leicester City,9,9,0,810,1,0,13,12,1,1164,2,0,22,21,1,1974,3,0,0,3,3,1,2,3,0,0,0,0,0,0
4804,4804,Jonny Evans,1216,2018,Leicester City,12,12,0,1074,1,0,12,9,3,921,0,0,24,21,3,1995,1,0,0,0,0,1,0,1,0,0,0,0,0,0
4805,4805,Ricardo Pereira,2438,2018,Leicester City,17,17,0,1526,2,0,18,18,0,1599,0,0,35,35,0,3125,2,0,3,0,3,2,0,2,0,0,0,0,0,0
4806,4806,James Maddison,2440,2018,Leicester City,18,18,0,1535,3,0,18,17,1,1377,4,0,36,35,1,2912,7,0,0,1,1,1,2,3,0,1,1,0,0,0
4807,4807,Marc Albrighton,1448,2018,Leicester City,14,10,4,797,1,0,13,8,5,829,1,0,27,18,9,1626,2,0,0,0,0,1,0,1,0,0,0,0,0,0
4808,4808,Iborra,2570,2018,Leicester City,3,2,1,152,0,0,5,1,4,74,0,0,8,3,5,226,0,0,0,0,0,0,0,0,0,0,0,0,0,0
4809,4809,Nampalys Mendy,2945,2018,Leicester City,16,11,5,1006,0,0,15,12,3,1083,0,0,31,23,8,2089,0,0,0,0,0,0,0,0,0,0,0,0,0,0
4810,4810,Demarai Gray,2568,2018,Leicester City,17,11,6,1069,1,0,17,12,5,924,3,0,34,23,11,1993,4,0,0,3,3,1,2,3,0,0,0,0,0,0
4811,4811,Shinji Okazaki,2668,2018,Leicester City,13,0,13,127,0,0,8,1,7,143,0,0,21,1,20,270,0,0,0,0,0,0,0,0,0,0,0,0,0,0
4812,4812,Wilfred Ndidi,2442,2018,Leicester City,19,19,0,1624,2,0,19,18,1,1675,0,0,38,37,1,3299,2,0,1,0,1,1,0,1,0,0,0,0,0,0
4813,4813,Jamie Vardy,2443,2018,Leicester City,17,16,1,1442,8,0,17,14,3,1317,10,0,34,30,4,2759,18,0,0,7,7,2,6,8,1,3,4,0,0,0
4814,4814,Kelechi Iheanacho,1590,2018,Leicester City,14,4,10,410,1,0,16,5,11,520,0,0,30,9,21,930,1,0,0,0,0,1,0,1,0,0,0,0,0,0
4815,4815,Danny Ward,2444,2018,Leicester City,0,0,0,0,0,0,0,0,0,0,0,0,0,0,0,0,0,0,0,0,0,0,0,0,0,0,0,0,0,0
4816,4816,Danny Simpson,2395,2018,Leicester City,2,0,2,26,0,0,4,3,1,265,0,0,6,3,3,291,0,0,0,0,0,0,0,0,0,0,0,0,0,0
4817,4817,Çağlar Söyüncü,2437,2018,Leicester City,4,2,2,192,0,0,2,2,0,180,0,0,6,4,2,372,0,0,0,0,0,0,0,0,0,0,0,0,0,0
4818,4818,Christian Fuchs,2564,2018,Leicester City,1,1,0,90,0,0,2,1,1,116,0,0,3,2,1,206,0,0,0,0,0,0,0,0,0,0,0,0,0,0
4819,4819,Adrián,2309,2017,West Ham United,11,11,0,990,0,0,9,9,0,810,0,0,20,20,0,1800,0,0,0,0,0,0,0,0,0,0,0,0,0,0
4820,4820,Aaron Cresswell,2199,2017,West Ham United,19,19,0,1694,1,0,18,17,1,1469,0,0,37,36,1,3163,1,0,0,0,0,0,0,0,0,0,0,0,0,0
4821,4821,Pablo Zabaleta,1355,2017,West Ham United,19,19,0,1710,0,0,19,19,0,1671,0,0,38,38,0,3381,0,0,0,0,0,0,0,0,0,0,0,0,0,0
4822,4822,Angelo Ogbonna,2201,2017,West Ham United,17,17,0,1530,0,0,16,16,0,1440,1,0,33,33,0,2970,1,0,0,0,0,0,1,1,0,0,0,0,0,0
4823,4823,Arthur Masuaku,2209,2017,West Ham United,15,12,3,989,0,0,13,10,3,949,0,0,28,22,6,1938,0,0,0,0,0,0,0,0,0,0,0,0,0,0
4824,4824,Declan Rice,2206,2017,West Ham United,11,7,4,652,0,0,16,9,7,862,0,0,27,16,11,1514,0,0,0,0,0,0,0,0,0,0,0,0,0,0
4825,4825,Cheikhou Kouyaté,2311,2017,West Ham United,18,18,0,1571,2,0,16,15,1,1322,0,0,34,33,1,2893,2,0,1,0,1,1,0,1,0,0,0,0,0,0
4826,4826,Manuel Lanzini,2351,2017,West Ham United,14,12,2,1063,3,0,14,12,2,1074,2,0,28,24,4,2137,5,0,0,0,0,1,0,1,0,0,0,0,0,0
4827,4827,Mark Noble,2204,2017,West Ham United,16,15,1,1337,1,0,14,14,0,1157,3,0,30,29,1,2494,4,0,1,0,1,1,2,3,1,1,2,0,0,0
4828,4828,João Mário,2946,2017,West Ham United,9,8,1,709,1,0,5,5,0,408,1,0,14,13,1,1117,2,0,0,0,0,1,1,2,0,0,0,0,0,0
4829,4829,Marko Arnautović,1552,2017,West Ham United,17,16,1,1371,6,0,15,13,2,1100,5,0,32,29,3,2471,11,0,3,0,3,2,4,6,0,0,0,0,0,0
4830,4830,Andy Carroll,1779,2017,West Ham United,10,4,6,541,3,0,7,3,4,291,0,0,17,7,10,832,3,0,4,0,4,3,0,3,0,0,0,0,0,0
4831,4831,Joe Hart,1363,2017,West Ham United,9,9,0,810,0,0,10,10,0,900,0,0,19,19,0,1710,0,0,0,0,0,0,0,0,0,0,0,0,0,0
4832,4832,Patrice Evra,1724,2017,West Ham United,1,1,0,66,0,0,4,2,2,163,0,0,5,3,2,229,0,0,0,0,0,0,0,0,0,0,0,0,0,0
4833,4833,Pedro Obiang,2639,2017,West Ham United,10,9,1,770,1,0,11,9,2,794,1,0,21,18,3,1564,2,0,0,0,0,1,1,2,0,0,0,0,0,0
4834,4834,Edimilson Fernandes,2643,2017,West Ham United,6,3,3,353,0,0,8,6,2,493,0,0,14,9,5,846,0,0,0,0,0,0,0,0,0,0,0,0,0,0
4835,4835,Josh Cullen,2947,2017,West Ham United,1,0,1,1,0,0,1,0,1,5,0,0,2,0,2,6,0,0,0,0,0,0,0,0,0,0,0,0,0,0
4836,4836,Jordan Hugill,2948,2017,West Ham United,2,0,2,12,0,0,1,0,1,10,0,0,3,0,3,22,0,0,0,0,0,0,0,0,0,0,0,0,0,0
4837,4837,Eric Bailly,2755,2017,Manchester United,7,6,1,549,0,0,7,5,2,452,1,0,14,11,3,1001,1,0,0,0,0,0,1,1,0,0,0,0,0,0
4838,4838,Daley Blind,2186,2017,Manchester United,3,3,0,257,0,0,4,1,3,104,0,0,7,4,3,361,0,0,0,0,0,0,0,0,0,0,0,0,0,0
4839,4839,James Collins,1618,2008,West Ham United,9,8,1,737,0,0,9,9,0,679,0,0,18,17,1,1416,0,0,0,0,0,0,0,0,0,0,0,0,0,0
4840,4840,Jack Collison,1285,2008,West Ham United,10,8,2,760,2,0,10,8,2,715,1,0,20,16,4,1475,3,0,3,0,3,2,1,3,0,0,0,0,0,0
4841,4841,Boa Morte,1085,2008,West Ham United,10,6,4,523,0,0,15,7,8,695,0,0,25,13,12,1218,0,0,0,0,0,0,0,0,0,0,0,0,0,0
4842,4842,Savio Nsereko,2949,2008,West Ham United,5,1,4,150,0,0,5,0,5,88,0,0,10,1,9,238,0,0,0,0,0,0,0,0,0,0,0,0,0,0
4843,4843,Matt Duke,1605,2008,Hull City,5,5,0,450,0,0,5,5,0,450,0,0,10,10,0,900,0,0,0,0,0,0,0,0,0,0,0,0,0,0
4844,4844,Kevin Kilbane,1103,2008,Hull City,9,8,1,702,0,0,7,7,0,613,0,0,16,15,1,1315,0,0,0,0,0,0,0,0,0,0,0,0,0,0
4845,4845,Manucho,2950,2008,Hull City,6,1,5,215,0,0,7,5,2,437,2,0,13,6,7,652,2,0,0,3,3,0,2,2,0,0,0,0,0,0
4846,4846,Craig Fagan,1576,2008,Hull City,11,7,4,611,1,0,11,8,3,810,2,0,22,15,7,1421,3,0,0,1,1,1,1,2,0,0,0,0,0,0
4847,4847,Muzzy Izzet,2682,2004,Birmingham City,5,5,0,396,0,0,5,5,0,446,1,0,10,10,0,842,1,0,0,1,1,0,1,1,0,0,0,0,0,0
4848,4848,Andy Johnson,1322,2008,Fulham FC,14,14,0,1176,6,0,12,11,1,1002,1,0,26,25,1,2178,7,0,0,0,0,3,1,4,0,0,0,0,0,0
4849,4849,Craig Gordon,1691,2009,Sunderland AFC,13,13,0,1170,0,0,13,13,0,1147,0,0,26,26,0,2317,0,0,0,0,0,0,0,0,0,0,0,0,0,0
4850,4850,Michael Turner,1371,2009,Sunderland AFC,15,15,0,1342,1,0,14,14,0,1216,0,0,29,29,0,2558,1,0,0,0,0,0,0,0,0,0,0,0,0,0
4851,4851,Anton Ferdinand,1686,2009,Sunderland AFC,12,9,3,877,0,0,12,10,2,896,0,0,24,19,5,1773,0,0,0,0,0,0,0,0,0,0,0,0,0,0
4852,4852,Paulo da Silva,2951,2009,Sunderland AFC,8,7,1,624,0,0,7,4,3,446,0,0,15,11,4,1070,0,0,0,0,0,0,0,0,0,0,0,0,0,0
4853,4853,Steed Malbranque,1086,2009,Sunderland AFC,15,14,1,1112,0,0,16,16,0,974,0,0,31,30,1,2086,0,0,0,0,0,0,0,0,0,0,0,0,0,0
4854,4854,Kieran Richardson,1898,2009,Sunderland AFC,13,13,0,1164,1,0,16,15,1,1257,0,0,29,28,1,2421,1,0,1,0,1,1,0,1,0,0,0,0,0,0
4855,4855,Jordan Henderson,1426,2009,Sunderland AFC,16,10,6,1006,0,0,16,12,4,1088,1,0,32,22,10,2094,1,0,0,0,0,0,1,1,0,0,0,0,0,0
4856,4856,David Meyler,2225,2009,Sunderland AFC,5,5,0,395,0,0,4,3,1,248,0,0,9,8,1,643,0,0,0,0,0,0,0,0,0,0,0,0,0,0
4857,4857,Lee Cattermole,1687,2009,Sunderland AFC,13,10,3,822,0,0,9,9,0,712,0,0,22,19,3,1534,0,0,0,0,0,0,0,0,0,0,0,0,0,0
4858,4858,Fraizer Campbell,1027,2009,Sunderland AFC,14,9,5,901,3,0,16,9,7,919,1,0,30,18,12,1820,4,0,0,0,0,2,1,3,0,0,0,0,0,0
4859,4859,Darren Bent,1958,2009,Sunderland AFC,19,19,0,1681,16,0,18,18,0,1619,8,0,37,37,0,3300,24,0,6,6,12,9,7,16,4,1,5,0,0,0
4860,4860,Phil Bardsley,1409,2009,Sunderland AFC,12,7,5,668,0,0,13,10,3,938,0,0,25,17,8,1606,0,0,0,0,0,0,0,0,0,0,0,0,0,0
4861,4861,Boudewijn Zenden,1336,2009,Sunderland AFC,10,0,10,193,1,0,10,1,9,311,1,0,20,1,19,504,2,0,0,0,0,0,0,0,0,0,0,0,0,0
4862,4862,Kenwyne Jones,1222,2009,Sunderland AFC,17,14,3,1187,6,0,15,10,5,1043,3,0,32,24,8,2230,9,0,4,0,4,5,3,8,1,0,1,0,0,0
4863,4863,Jimmy Walker,2952,2009,Tottenham Hotspur,1,1,0,90,0,0,1,1,0,90,0,0,2,2,0,180,0,0,0,0,0,0,0,0,0,0,0,0,0,0
4864,4864,Younès Kaboul,2408,2009,Tottenham Hotspur,5,3,2,335,0,0,5,5,0,450,0,0,10,8,2,785,0,0,0,0,0,0,0,0,0,0,0,0,0,0
4865,4865,Sébastien Bassong,1370,2009,Tottenham Hotspur,13,12,1,1087,1,0,14,12,2,1119,0,0,27,24,3,2206,1,0,3,0,3,1,0,1,0,0,0,0,0,0
4866,4866,David Bentley,2011,2009,Tottenham Hotspur,6,4,2,399,1,0,8,6,2,495,0,0,14,10,4,894,1,0,0,0,0,0,0,0,0,0,0,0,0,0
4867,4867,Roman Pavlyuchenko,2528,2009,Tottenham Hotspur,9,5,4,484,3,0,7,3,4,262,2,0,16,8,8,746,5,0,0,0,0,1,0,1,0,0,0,0,0,0
4868,4868,Eiður Guðjohnsen,2373,2009,Tottenham Hotspur,6,1,5,136,0,0,5,2,3,247,1,0,11,3,8,383,1,0,0,0,0,0,1,1,0,0,0,0,0,0
4869,4869,David Luiz,1471,2010,Chelsea FC,7,6,1,548,2,0,5,5,0,406,0,0,12,11,1,954,2,0,0,0,0,2,0,2,0,0,0,0,0,0
4870,4870,Ryan Bertrand,1148,2010,Chelsea FC,1,0,1,34,0,0,0,0,0,0,0,0,1,0,1,34,0,0,0,0,0,0,0,0,0,0,0,0,0,0
4871,4871,Fernando Torres,1539,2010,Chelsea FC,8,5,3,447,1,0,6,3,3,316,0,0,14,8,6,763,1,0,0,0,0,0,0,0,0,0,0,0,0,0
4872,4872,Nicolas Anelka,1720,2010,Chelsea FC,17,13,4,1146,1,0,15,14,1,1216,5,0,32,27,5,2362,6,0,0,0,0,0,1,1,0,0,0,0,0,0
4873,4873,Yossi Benayoun,1892,2010,Chelsea FC,5,1,4,181,0,0,2,0,2,23,1,0,7,1,6,204,1,0,0,0,0,0,0,0,0,0,0,0,0,0
4874,4874,Yuriy Zhirkov,2953,2010,Chelsea FC,7,3,4,302,0,0,5,3,2,303,0,0,12,6,6,605,0,0,0,0,0,0,0,0,0,0,0,0,0,0
4875,4875,Craig Gardner,1403,2010,Birmingham City,14,13,1,1190,6,0,15,12,3,1086,2,0,29,25,4,2276,8,0,5,0,5,4,1,5,1,0,1,0,0,0
4876,4876,Ugo Ehiogu,2134,2004,Middlesbrough FC,7,6,1,438,0,0,3,3,0,270,0,0,10,9,1,708,0,0,0,0,0,0,0,0,0,0,0,0,0,0
4877,4877,Stuart Parnaby,1881,2004,Middlesbrough FC,9,8,1,676,0,0,10,8,2,649,0,0,19,16,3,1325,0,0,0,0,0,0,0,0,0,0,0,0,0,0
4878,4878,Szilárd Németh,2139,2004,Middlesbrough FC,16,11,5,1015,2,0,15,7,8,698,2,0,31,18,13,1713,4,0,0,0,0,1,1,2,0,0,0,0,0,0
4879,4879,Radek Černý,2805,2004,Tottenham Hotspur,2,1,1,116,0,0,1,1,0,90,0,0,3,2,1,206,0,0,0,0,0,0,0,0,0,0,0,0,0,0
4880,4880,Erik Edman,2196,2004,Tottenham Hotspur,13,13,0,1126,0,0,15,15,0,1258,1,0,28,28,0,2384,1,0,0,0,0,0,1,1,0,0,0,0,0,0
4881,4881,Michael Dawson,1267,2004,Tottenham Hotspur,2,2,0,180,0,0,3,3,0,270,0,0,5,5,0,450,0,0,0,0,0,0,0,0,0,0,0,0,0,0
4882,4882,Stephen Kelly,1121,2004,Tottenham Hotspur,7,7,0,630,1,0,10,6,4,651,0,0,17,13,4,1281,1,0,0,0,0,0,0,0,0,0,0,0,0,0
4883,4883,Andy Reid,1220,2004,Tottenham Hotspur,7,7,0,591,1,0,6,6,0,486,0,0,13,13,0,1077,1,0,0,0,0,0,0,0,0,0,0,0,0,0
4884,4884,Mido,2636,2004,Tottenham Hotspur,5,3,2,262,2,0,4,1,3,117,0,0,9,4,5,379,2,0,0,0,0,2,0,2,0,0,0,0,0,0
4885,4885,Joe Cole,1630,2006,Chelsea FC,7,1,6,214,0,0,6,2,4,257,0,0,13,3,10,471,0,0,0,0,0,0,0,0,0,0,0,0,0,0
4886,4886,Michael Ballack,2271,2006,Chelsea FC,12,10,2,945,2,0,14,13,1,1110,3,0,26,23,3,2055,5,0,0,3,3,0,2,2,0,0,0,0,0,0
4887,4887,Ricardo Rocha,2954,2006,Tottenham Hotspur,4,4,0,360,0,0,5,5,0,406,0,0,9,9,0,766,0,0,0,0,0,0,0,0,0,0,0,0,0,0
4888,4888,Paul Stalteri,2955,2006,Tottenham Hotspur,3,0,3,19,0,0,3,1,2,161,1,0,6,1,5,180,1,0,0,3,3,0,1,1,0,0,0,0,0,0
4889,4889,Jermaine Jenas,1275,2006,Tottenham Hotspur,11,11,0,990,4,0,13,12,1,1082,2,0,24,23,1,2072,6,0,1,3,4,2,2,4,0,0,0,0,0,0
4890,4890,Mido,2636,2006,Tottenham Hotspur,5,4,1,343,1,0,7,3,4,308,0,0,12,7,5,651,1,0,3,0,3,1,0,1,0,0,0,0,0,0
4891,4891,Didier Zokora,2465,2006,Tottenham Hotspur,16,13,3,1142,0,0,15,13,2,1165,0,0,31,26,5,2307,0,0,0,0,0,0,0,0,0,0,0,0,0,0
4892,4892,Adel Taarabt,2165,2006,Tottenham Hotspur,0,0,0,0,0,0,2,0,2,29,0,0,2,0,2,29,0,0,0,0,0,0,0,0,0,0,0,0,0,0
4893,4893,Kepa,1853,2019,Chelsea FC,16,16,0,1440,0,0,17,17,0,1530,0,0,33,33,0,2970,0,0,0,0,0,0,0,0,0,0,0,0,0,0
4894,4894,Antonio Rüdiger,1845,2019,Chelsea FC,10,10,0,900,0,0,10,9,1,810,2,0,20,19,1,1710,2,0,0,1,1,0,2,2,0,0,0,0,0,0
4895,4895,Marcos Alonso,1846,2019,Chelsea FC,8,7,1,695,2,0,10,8,2,736,2,0,18,15,3,1431,4,0,3,1,4,1,2,3,0,0,0,0,0,0
4896,4896,Andreas Christensen,1854,2019,Chelsea FC,10,10,0,808,0,0,11,11,0,946,0,0,21,21,0,1754,0,0,0,0,0,0,0,0,0,0,0,0,0,0
4897,4897,Azpilicueta,1535,2019,Chelsea FC,17,17,0,1530,1,0,19,19,0,1700,1,0,36,36,0,3230,2,0,0,0,0,1,1,2,0,0,0,0,0,0
4898,4898,N'Golo Kanté,1848,2019,Chelsea FC,11,10,1,816,1,0,11,10,1,917,2,0,22,20,2,1733,3,0,0,0,0,0,1,1,0,0,0,0,0,0
4899,4899,Ross Barkley,1754,2019,Chelsea FC,11,8,3,640,1,0,10,5,5,464,0,0,21,13,8,1104,1,0,0,0,0,0,0,0,0,0,0,0,0,0
4900,4900,Mason Mount,2956,2019,Chelsea FC,18,15,3,1415,4,0,19,17,2,1459,3,0,37,32,5,2874,7,0,3,0,3,4,1,5,0,0,0,0,0,0
4901,4901,Willian,1538,2019,Chelsea FC,18,14,4,1274,4,0,18,15,3,1330,5,0,36,29,7,2604,9,0,3,0,3,1,3,4,2,2,4,0,0,0
4902,4902,Olivier Giroud,1504,2019,Chelsea FC,9,8,1,613,5,0,9,4,5,386,3,0,18,12,6,999,8,0,3,3,6,3,2,5,0,0,0,0,0,0
4903,4903,Christian Pulišić,2957,2019,Chelsea FC,12,10,2,870,2,0,13,9,4,857,7,0,25,19,6,1727,9,0,0,0,0,1,2,3,0,0,0,0,0,0
4904,4904,Mateo Kovačić,1849,2019,Chelsea FC,15,10,5,994,0,0,16,13,3,1079,1,0,31,23,8,2073,1,0,0,0,0,0,0,0,0,0,0,0,0,0
4905,4905,Billy Gilmour,2958,2019,Chelsea FC,5,1,4,112,0,0,1,1,0,80,0,0,6,2,4,192,0,0,0,0,0,0,0,0,0,0,0,0,0,0
4906,4906,Tammy Abraham,2959,2019,Chelsea FC,16,10,6,957,5,0,18,15,3,1265,10,0,34,25,9,2222,15,0,0,6,6,3,5,8,0,0,0,0,0,0
4907,4907,Pedro,1851,2019,Chelsea FC,8,5,3,408,1,0,3,3,0,254,0,0,11,8,3,662,1,0,0,0,0,0,0,0,0,0,0,0,0,0
4908,4908,Willy Caballero,1588,2019,Chelsea FC,3,3,0,270,0,0,2,2,0,180,0,0,5,5,0,450,0,0,0,0,0,0,0,0,0,0,0,0,0,0
4909,4909,Kurt Zouma,1903,2019,Chelsea FC,14,12,2,1128,0,0,14,13,1,1214,0,0,28,25,3,2342,0,0,0,0,0,0,0,0,0,0,0,0,0,0
4910,4910,Reece James,2960,2019,Chelsea FC,11,8,3,761,0,0,13,8,5,752,0,0,24,16,8,1513,0,0,0,0,0,0,0,0,0,0,0,0,0,0
4911,4911,Jorginho,1847,2019,Chelsea FC,15,14,1,1201,3,0,16,13,3,1183,1,0,31,27,4,2384,4,0,0,0,0,3,1,4,3,0,3,0,0,0
4912,4912,Ruben Loftus-Cheek,1852,2019,Chelsea FC,3,1,2,86,0,0,4,1,3,119,0,0,7,2,5,205,0,0,0,0,0,0,0,0,0,0,0,0,0,0
4913,4913,Taylor Harwood-Bellis,2961,2019,Manchester City,0,0,0,0,0,0,0,0,0,0,0,0,0,0,0,0,0,0,0,0,0,0,0,0,0,0,0,0,0,0
4914,4914,Thomas Doyle,2962,2019,Manchester City,1,0,1,15,0,0,0,0,0,0,0,0,1,0,1,15,0,0,0,0,0,0,0,0,0,0,0,0,0,0
4915,4915,Cole Palmer,2963,2019,Manchester City,0,0,0,0,0,0,0,0,0,0,0,0,0,0,0,0,0,0,0,0,0,0,0,0,0,0,0,0,0,0
4916,4916,Sander Westerveld,2687,2005,Portsmouth FC,3,3,0,270,0,0,3,3,0,270,0,0,6,6,0,540,0,0,0,0,0,0,0,0,0,0,0,0,0,0
4917,4917,Dejan Stefanović,1066,2005,Portsmouth FC,16,16,0,1365,0,0,12,11,1,1007,0,0,28,27,1,2372,0,0,0,0,0,0,0,0,0,0,0,0,0,0
4918,4918,Andy O'Brien,2160,2005,Portsmouth FC,13,13,0,1170,0,0,16,16,0,1440,0,0,29,29,0,2610,0,0,0,0,0,0,0,0,0,0,0,0,0,0
4919,4919,Brian Priske,2964,2005,Portsmouth FC,15,13,2,1241,0,0,15,13,2,1188,0,0,30,26,4,2429,0,0,0,0,0,0,0,0,0,0,0,0,0,0
4920,4920,Grégory Vignal,2645,2005,Portsmouth FC,6,6,0,510,0,0,8,7,1,662,0,0,14,13,1,1172,0,0,0,0,0,0,0,0,0,0,0,0,0,0
4921,4921,Jhon Viáfara,2965,2005,Portsmouth FC,5,3,2,265,0,0,9,7,2,658,1,0,14,10,4,923,1,0,0,0,0,0,1,1,0,0,0,0,0,0
4922,4922,Laurent Robert,2034,2005,Portsmouth FC,8,7,1,657,0,0,9,6,3,500,1,0,17,13,4,1157,1,0,0,0,0,0,0,0,0,0,0,0,0,0
4923,4923,Richard Hughes,2812,2005,Portsmouth FC,15,11,4,939,0,0,11,10,1,882,0,0,26,21,5,1821,0,0,0,0,0,0,0,0,0,0,0,0,0,0
4924,4924,Gary O'Neil,1389,2005,Portsmouth FC,18,18,0,1562,3,0,18,18,0,1569,3,0,36,36,0,3131,6,0,6,0,6,3,2,5,0,0,0,0,0,0
4925,4925,Azar Karadaş,2966,2005,Portsmouth FC,7,2,5,210,1,0,10,2,8,277,0,0,17,4,13,487,1,0,1,0,1,1,0,1,0,0,0,0,0,0
4926,4926,Lomana LuaLua,1074,2005,Portsmouth FC,13,12,1,1067,4,0,12,12,0,1041,3,0,25,24,1,2108,7,0,2,0,2,4,3,7,0,0,0,0,0,0
4927,4927,Svetoslav Todorov,2967,2005,Portsmouth FC,11,3,8,502,3,0,13,3,10,517,1,0,24,6,18,1019,4,0,4,0,4,3,0,3,0,0,0,0,0,0
4928,4928,Vincent Péricard,2968,2005,Portsmouth FC,3,1,2,58,0,0,3,2,1,152,0,0,6,3,3,210,0,0,0,0,0,0,0,0,0,0,0,0,0,0
4929,4929,Peter Whittingham,2969,2005,Aston Villa,2,2,0,159,0,0,2,2,0,162,0,0,4,4,0,321,0,0,0,0,0,0,0,0,0,0,0,0,0,0
4930,4930,Ulises De la Cruz,1794,2005,Aston Villa,3,2,1,203,0,0,4,2,2,201,0,0,7,4,3,404,0,0,0,0,0,0,0,0,0,0,0,0,0,0
4931,4931,Mendieta,2296,2004,Middlesbrough FC,3,3,0,183,0,0,4,4,0,337,0,0,7,7,0,520,0,0,0,0,0,0,0,0,0,0,0,0,0,0
4932,4932,Julian Speroni,2249,2004,Crystal Palace,3,3,0,270,0,0,3,3,0,270,0,0,6,6,0,540,0,0,0,0,0,0,0,0,0,0,0,0,0,0
4933,4933,Mark Hudson,2970,2004,Crystal Palace,4,4,0,360,1,0,3,3,0,270,0,0,7,7,0,630,1,0,0,0,0,1,0,1,0,0,0,0,0,0
4934,4934,Shaun Derry,2164,2004,Crystal Palace,2,1,1,77,0,0,5,0,5,38,0,0,7,1,6,115,0,0,0,0,0,0,0,0,0,0,0,0,0,0
4935,4935,Iván Kaviedes,2971,2004,Crystal Palace,3,1,2,96,0,0,1,0,1,6,0,0,4,1,3,102,0,0,0,0,0,0,0,0,0,0,0,0,0,0
4936,4936,Wilson Palacios,1271,2007,Wigan Athletic,9,9,0,810,0,0,7,7,0,604,0,0,16,16,0,1414,0,0,0,0,0,0,0,0,0,0,0,0,0,0
4937,4937,Antoine Sibierski,1810,2007,Wigan Athletic,15,6,9,553,2,0,15,4,11,460,2,0,30,10,20,1013,4,0,3,3,6,1,1,2,1,0,1,0,0,0
4938,4938,Marlon King,2119,2007,Wigan Athletic,8,4,4,353,0,0,7,4,3,313,1,0,15,8,7,666,1,0,0,0,0,0,1,1,0,1,1,0,0,0
4939,4939,Marcus Hahnemann,2588,2007,Reading FC,19,19,0,1710,0,0,17,17,0,1516,0,0,36,36,0,3226,0,0,0,0,0,0,0,0,0,0,0,0,0,0
4940,4940,Nicky Shorey,1731,2007,Reading FC,19,19,0,1690,2,0,15,15,0,1350,1,0,34,34,0,3040,3,0,0,0,0,0,0,0,0,0,0,0,0,0
4941,4941,Ívar Ingimarsson,2590,2007,Reading FC,18,17,1,1549,1,0,14,14,0,1260,1,0,32,31,1,2809,2,0,0,0,0,1,1,2,0,0,0,0,0,0
4942,4942,Liam Rosenior,1756,2007,Reading FC,8,7,1,571,0,0,8,7,1,579,0,0,16,14,2,1150,0,0,0,0,0,0,0,0,0,0,0,0,0,0
4943,4943,André Bikey,2548,2007,Reading FC,11,6,5,683,3,0,11,8,3,684,0,0,22,14,8,1367,3,0,3,0,3,3,0,3,0,0,0,0,0,0
4944,4944,Michael Duberry,2291,2007,Reading FC,6,6,0,479,0,0,6,5,1,467,0,0,12,11,1,946,0,0,0,0,0,0,0,0,0,0,0,0,0,0
4945,4945,Stephen Hunt,2596,2007,Reading FC,19,19,0,1698,3,0,16,16,0,1437,2,0,35,35,0,3135,5,0,6,1,7,3,1,4,1,1,2,0,0,0
4946,4946,James Harper,2591,2007,Reading FC,19,19,0,1662,2,0,17,17,0,1509,4,0,36,36,0,3171,6,0,3,3,6,1,3,4,0,0,0,0,0,0
4947,4947,Leroy Lita,2593,2007,Reading FC,6,5,1,409,0,0,8,5,3,483,1,0,14,10,4,892,1,0,0,0,0,0,0,0,0,0,0,0,0,0
4948,4948,Kevin Doyle,2594,2007,Reading FC,19,19,0,1665,2,0,15,13,2,1168,4,0,34,32,2,2833,6,0,3,0,3,2,1,3,0,0,0,0,0,0
4949,4949,Dave Kitson,1995,2007,Reading FC,17,14,3,1290,4,0,15,12,3,1085,6,0,32,26,6,2375,10,0,0,1,1,3,4,7,0,0,0,0,0,0
4950,4950,Glen Little,2595,2007,Reading FC,1,0,1,30,0,0,1,0,1,21,0,0,2,0,2,51,0,0,0,0,0,0,0,0,0,0,0,0,0,0
4951,4951,Shane Long,1154,2007,Reading FC,15,4,11,417,2,0,12,3,9,325,1,0,27,7,20,742,3,0,3,0,3,2,0,2,0,0,0,0,0,0
4952,4952,Craig Moore,2972,2005,Newcastle United,4,4,0,360,0,0,4,4,0,360,0,0,8,8,0,720,0,0,0,0,0,0,0,0,0,0,0,0,0,0
4953,4953,Michael Chopra,1226,2005,Newcastle United,8,4,4,423,0,0,5,2,3,171,1,0,13,6,7,594,1,0,0,0,0,0,1,1,0,0,0,0,0,0
4954,4954,Lenny Pidgeley,2973,2005,Chelsea FC,0,0,0,0,0,0,1,1,0,90,0,0,1,1,0,90,0,0,0,0,0,0,0,0,0,0,0,0,0,0
4955,4955,Glen Johnson,1386,2005,Chelsea FC,2,2,0,150,0,0,2,2,0,180,0,0,4,4,0,330,0,0,0,0,0,0,0,0,0,0,0,0,0,0
4956,4956,Ricardo Carvalho,1760,2005,Chelsea FC,12,11,1,958,1,0,12,11,1,1026,0,0,24,22,2,1984,1,0,0,0,0,0,0,0,0,0,0,0,0,0
4957,4957,William Gallas,2040,2005,Chelsea FC,17,16,1,1470,5,0,17,17,0,1457,0,0,34,33,1,2927,5,0,3,0,3,4,0,4,0,0,0,0,0,0
4958,4958,Paulo Ferreira,1761,2005,Chelsea FC,9,8,1,751,0,0,12,10,2,915,0,0,21,18,3,1666,0,0,0,0,0,0,0,0,0,0,0,0,0,0
4959,4959,Robert Huth,1884,2005,Chelsea FC,3,3,0,237,0,0,10,4,6,296,0,0,13,7,6,533,0,0,0,0,0,0,0,0,0,0,0,0,0,0
4960,4960,Maniche,2974,2005,Chelsea FC,4,1,3,135,0,0,4,2,2,268,0,0,8,3,5,403,0,0,0,0,0,0,0,0,0,0,0,0,0,0
4961,4961,Joe Cole,1630,2005,Chelsea FC,16,13,3,1068,4,0,18,13,5,1044,4,0,34,26,8,2112,8,0,0,3,3,1,1,2,0,0,0,0,0,0
4962,4962,Damien Duff,1348,2005,Chelsea FC,13,7,6,698,1,0,15,11,4,904,2,0,28,18,10,1602,3,0,0,0,0,0,1,1,0,0,0,0,0,0
4963,4963,Lassana Diarra,2975,2005,Chelsea FC,1,0,1,6,0,0,2,2,0,180,0,0,3,2,1,186,0,0,0,0,0,0,0,0,0,0,0,0,0,0
4964,4964,Arjen Robben,1767,2005,Chelsea FC,14,11,3,871,2,0,14,10,4,939,4,0,28,21,7,1810,6,0,0,3,3,0,3,3,0,0,0,0,0,0
4965,4965,Jimmy Smith,2976,2005,Chelsea FC,0,0,0,0,0,0,1,0,1,9,0,0,1,0,1,9,0,0,0,0,0,0,0,0,0,0,0,0,0,0
4966,4966,Shaun Wright-Phillips,1683,2005,Chelsea FC,15,7,8,631,0,0,12,3,9,375,0,0,27,10,17,1006,0,0,0,0,0,0,0,0,0,0,0,0,0,0
4967,4967,Carlton Cole,2326,2005,Chelsea FC,3,0,3,39,0,0,6,0,6,184,0,0,9,0,9,223,0,0,0,0,0,0,0,0,0,0,0,0,0,0
4968,4968,Radostin Kishishev,1668,2004,Charlton Athletic,15,11,4,915,0,0,14,14,0,1110,0,0,29,25,4,2025,0,0,0,0,0,0,0,0,0,0,0,0,0,0
4969,4969,Talal El-Karkouri,1959,2004,Charlton Athletic,16,13,3,1198,5,0,14,13,1,1181,0,0,30,26,4,2379,5,0,3,0,3,4,0,4,0,0,0,0,0,0
4970,4970,Jerome Thomas,1736,2004,Charlton Athletic,13,12,1,934,2,0,10,8,2,692,1,0,23,20,3,1626,3,0,0,0,0,2,0,2,0,0,0,0,0,0
4971,4971,Paul Konchesky,1560,2004,Charlton Athletic,16,8,8,817,1,0,11,6,5,639,0,0,27,14,13,1456,1,0,0,0,0,0,0,0,0,0,0,0,0,0
4972,4972,Jason Euell,1886,2004,Charlton Athletic,15,4,11,559,2,0,11,3,8,375,0,0,26,7,19,934,2,0,0,0,0,1,0,1,0,0,0,0,0,0
4973,4973,Alan Stubbs,2795,2004,Everton FC,16,15,1,1243,1,0,14,13,1,1140,0,0,30,28,2,2383,1,0,0,0,0,1,0,1,0,0,0,0,0,0
4974,4974,Thomas Gravesen,2796,2004,Everton FC,11,11,0,972,1,0,10,9,1,842,3,0,21,20,1,1814,4,0,0,3,3,1,3,4,0,2,2,0,0,0
4975,4975,Richard Wright,2977,2004,Everton FC,2,2,0,180,0,0,5,4,1,405,0,0,7,6,1,585,0,0,0,0,0,0,0,0,0,0,0,0,0,0
4976,4976,James McFadden,1413,2004,Everton FC,14,3,11,331,0,0,8,3,5,335,1,0,22,6,16,666,1,0,0,0,0,0,0,0,0,0,0,0,0,0
4977,4977,Ron Vlaar,1436,2012,Aston Villa,13,13,0,1131,1,0,14,14,0,1260,1,0,27,27,0,2391,2,0,0,1,1,1,1,2,0,0,0,0,0,0
4978,4978,Yacouba Sylla,1445,2012,Aston Villa,6,4,2,341,0,0,5,3,2,255,0,0,11,7,4,596,0,0,0,0,0,0,0,0,0,0,0,0,0,0
4979,4979,Joe Bennett,2978,2012,Aston Villa,11,10,1,925,0,0,13,11,2,944,0,0,24,21,3,1869,0,0,0,0,0,0,0,0,0,0,0,0,0,0
4980,4980,Charles N'Zogbia,2016,2012,Aston Villa,10,6,4,556,2,0,11,5,6,439,0,0,21,11,10,995,2,0,0,0,0,1,0,1,0,0,0,0,0,0
4981,4981,Simon Dawkins,2979,2012,Aston Villa,2,0,2,32,0,0,2,0,2,40,0,0,4,0,4,72,0,0,0,0,0,0,0,0,0,0,0,0,0,0
4982,4982,Samir Carruthers,2670,2012,Aston Villa,0,0,0,0,0,0,0,0,0,0,0,0,0,0,0,0,0,0,0,0,0,0,0,0,0,0,0,0,0,0
4983,4983,Stéphane M'bia,2980,2012,Queens Park Rangers,15,15,0,1189,0,0,14,14,0,1196,0,0,29,29,0,2385,0,0,0,0,0,0,0,0,0,0,0,0,0,0
4984,4984,Hugo Lloris,1160,2019,Tottenham Hotspur,11,11,0,990,0,0,10,10,0,818,0,0,21,21,0,1808,0,0,0,0,0,0,0,0,0,0,0,0,0,0
4985,4985,Davinson Sánchez,1856,2019,Tottenham Hotspur,15,15,0,1306,0,0,14,12,2,1125,0,0,29,27,2,2431,0,0,0,0,0,0,0,0,0,0,0,0,0,0
4986,4986,Eric Dier,1162,2019,Tottenham Hotspur,12,8,4,742,0,0,7,7,0,600,0,0,19,15,4,1342,0,0,0,0,0,0,0,0,0,0,0,0,0,0
4987,4987,Serge Aurier,1863,2019,Tottenham Hotspur,17,17,0,1508,1,0,16,14,2,1257,0,0,33,31,2,2765,1,0,0,0,0,1,0,1,0,0,0,0,0,0
4988,4988,Ben Davies,1164,2019,Tottenham Hotspur,9,7,2,646,0,0,9,9,0,786,0,0,18,16,2,1432,0,0,0,0,0,0,0,0,0,0,0,0,0,0
4989,4989,Harry Winks,1857,2019,Tottenham Hotspur,17,14,3,1184,0,0,14,12,2,1044,0,0,31,26,5,2228,0,0,0,0,0,0,0,0,0,0,0,0,0,0
4990,4990,Moussa Sissoko,1858,2019,Tottenham Hotspur,15,15,0,1350,2,0,14,13,1,1106,0,0,29,28,1,2456,2,0,0,0,0,0,0,0,0,0,0,0,0,0
4991,4991,Heung-min Son,1859,2019,Tottenham Hotspur,16,15,1,1349,7,0,14,13,1,1176,4,0,30,28,2,2525,11,0,3,3,6,4,4,8,0,0,0,0,0,0
4992,4992,Harry Kane,1169,2019,Tottenham Hotspur,15,15,0,1345,9,0,14,14,0,1245,9,0,29,29,0,2590,18,0,3,1,4,4,5,9,0,2,2,0,0,0
4993,4993,Érik Lamela,1168,2019,Tottenham Hotspur,13,5,8,519,1,0,12,7,5,692,1,0,25,12,13,1211,2,0,0,0,0,0,1,1,0,0,0,0,0,0
4994,4994,Steven Bergwijn,2981,2019,Tottenham Hotspur,7,3,4,281,3,0,7,5,2,423,0,0,14,8,6,704,3,0,0,0,0,3,0,3,0,0,0,0,0,0
4995,4995,Giovani Lo Celso,2982,2019,Tottenham Hotspur,13,8,5,806,0,0,15,7,8,681,0,0,28,15,13,1487,0,0,0,0,0,0,0,0,0,0,0,0,0,0
4996,4996,Gedson Fernandes,2983,2019,Tottenham Hotspur,4,0,4,44,0,0,3,0,3,18,0,0,7,0,7,62,0,0,0,0,0,0,0,0,0,0,0,0,0,0
4997,4997,Paulo Gazzaniga,1156,2019,Tottenham Hotspur,8,8,0,720,0,0,10,9,1,892,0,0,18,17,1,1612,0,0,0,0,0,0,0,0,0,0,0,0,0,0
4998,4998,Toby Alderweireld,1147,2019,Tottenham Hotspur,15,15,0,1350,1,0,18,18,0,1608,1,0,33,33,0,2958,2,0,3,0,3,1,1,2,0,0,0,0,0,0
4999,4999,Jan Vertonghen,1161,2019,Tottenham Hotspur,9,8,1,690,0,0,14,11,3,957,1,0,23,19,4,1647,1,0,0,3,3,0,1,1,0,0,0,0,0,0
5000,5000,Tanguy NDombèlé,2984,2019,Tottenham Hotspur,9,4,5,381,2,0,12,8,4,629,0,0,21,12,9,1010,2,0,0,0,0,2,0,2,0,0,0,0,0,0
5001,5001,Oliver Skipp,2985,2019,Tottenham Hotspur,4,0,4,18,0,0,3,1,2,57,0,0,7,1,6,75,0,0,0,0,0,0,0,0,0,0,0,0,0,0
5002,5002,Harvey White,2986,2019,Tottenham Hotspur,0,0,0,0,0,0,0,0,0,0,0,0,0,0,0,0,0,0,0,0,0,0,0,0,0,0,0,0,0,0
5003,5003,Ryan Sessegnon,2987,2019,Tottenham Hotspur,3,2,1,161,0,0,3,2,1,181,0,0,6,4,2,342,0,0,0,0,0,0,0,0,0,0,0,0,0,0
5004,5004,De Gea,1638,2019,Manchester United,19,19,0,1710,0,0,19,19,0,1710,0,0,38,38,0,3420,0,0,0,0,0,0,0,0,0,0,0,0,0,0
5005,5005,Victor Lindelöf,1639,2019,Manchester United,18,18,0,1576,1,0,17,17,0,1518,0,0,35,35,0,3094,1,0,0,0,0,1,0,1,0,0,0,0,0,0
5006,5006,Harry Maguire,2229,2019,Manchester United,19,19,0,1710,0,0,19,19,0,1710,1,0,38,38,0,3420,1,0,0,0,0,0,0,0,0,0,0,0,0,0
5007,5007,Luke Shaw,2576,2019,Manchester United,13,10,3,864,0,0,11,10,1,870,0,0,24,20,4,1734,0,0,0,0,0,0,0,0,0,0,0,0,0,0
5008,5008,Aaron Wan-Bissaka,2702,2019,Manchester United,18,17,1,1574,0,0,17,17,0,1497,0,0,35,34,1,3071,0,0,0,0,0,0,0,0,0,0,0,0,0,0
5009,5009,Fred,2911,2019,Manchester United,15,11,4,1068,0,0,14,12,2,1091,0,0,29,23,6,2159,0,0,0,0,0,0,0,0,0,0,0,0,0,0
5010,5010,Bruno Fernandes,2988,2019,Manchester United,7,7,0,612,2,0,7,7,0,581,6,0,14,14,0,1193,8,0,0,2,2,1,4,5,1,3,4,0,0,0
5011,5011,Scott McTominay,1652,2019,Manchester United,13,9,4,800,2,0,14,11,3,972,1,0,27,20,7,1772,3,0,0,0,0,1,1,2,0,0,0,0,0,0
5012,5012,Anthony Martial,1647,2019,Manchester United,16,15,1,1273,11,0,16,16,0,1367,6,0,32,31,1,2640,17,0,0,0,0,4,3,7,0,0,0,0,0,0
5013,5013,Marcus Rashford,1648,2019,Manchester United,15,15,0,1257,12,0,16,16,0,1398,5,0,31,31,0,2655,17,0,6,0,6,8,3,11,5,1,6,0,0,0
5014,5014,Daniel James,2989,2019,Manchester United,17,12,5,1131,2,0,16,14,2,1160,1,0,33,26,7,2291,3,0,0,0,0,1,1,2,0,0,0,0,0,0
5015,5015,Eric Bailly,2755,2019,Manchester United,2,0,2,56,0,0,2,1,1,91,0,0,4,1,3,147,0,0,0,0,0,0,0,0,0,0,0,0,0,0
5016,5016,Paul Pogba,1642,2019,Manchester United,8,7,1,637,0,0,8,6,2,567,1,0,16,13,3,1204,1,0,0,0,0,0,0,0,0,0,0,0,0,0
5017,5017,Nemanja Matić,1537,2019,Manchester United,9,9,0,764,0,0,12,9,3,819,0,0,21,18,3,1583,0,0,0,0,0,0,0,0,0,0,0,0,0,0
5018,5018,Odion Ighalo,2990,2019,Manchester United,5,0,5,37,0,0,6,0,6,55,0,0,11,0,11,92,0,0,0,0,0,0,0,0,0,0,0,0,0,0
5019,5019,Mason Greenwood,2912,2019,Manchester United,16,7,9,748,7,0,15,5,10,563,3,0,31,12,19,1311,10,0,2,0,2,4,2,6,0,0,0,0,0,0
5020,5020,Sergio Romero,2192,2019,Manchester United,0,0,0,0,0,0,0,0,0,0,0,0,0,0,0,0,0,0,0,0,0,0,0,0,0,0,0,0,0,0
5021,5021,Brandon Williams,2991,2019,Manchester United,8,6,2,512,0,0,9,5,4,494,1,0,17,11,6,1006,1,0,0,0,0,0,0,0,0,0,0,0,0,0
5022,5022,Mata,1643,2019,Manchester United,11,5,6,468,0,0,8,3,5,285,0,0,19,8,11,753,0,0,0,0,0,0,0,0,0,0,0,0,0,0
5023,5023,Jesse Lingard,1646,2019,Manchester United,10,5,5,454,0,0,12,4,8,477,1,0,22,9,13,931,1,0,0,0,0,0,0,0,0,0,0,0,0,0
5024,5024,Petr Čech,1531,2011,Chelsea FC,16,16,0,1440,0,0,18,18,0,1620,0,0,34,34,0,3060,0,0,0,0,0,0,0,0,0,0,0,0,0,0
5025,5025,Branislav Ivanović,1532,2011,Chelsea FC,14,13,1,1137,1,0,15,13,2,1126,2,0,29,26,3,2263,3,0,0,0,0,1,1,2,0,0,0,0,0,0
5026,5026,Ashley Cole,1523,2011,Chelsea FC,15,15,0,1350,0,0,17,16,1,1440,0,0,32,31,1,2790,0,0,0,0,0,0,0,0,0,0,0,0,0,0
5027,5027,David Luiz,1471,2011,Chelsea FC,10,8,2,794,2,0,10,10,0,855,0,0,20,18,2,1649,2,0,0,0,0,1,0,1,0,0,0,0,0,0
5028,5028,John Terry,1534,2011,Chelsea FC,16,16,0,1440,5,0,15,15,0,1350,1,0,31,31,0,2790,6,0,0,0,0,3,1,4,0,0,0,0,0,0
5029,5029,Ramires,2460,2011,Chelsea FC,16,15,1,1316,3,0,14,13,1,1161,2,0,30,28,2,2477,5,0,0,0,0,0,1,1,0,0,0,0,0,0
5030,5030,Frank Lampard,1536,2011,Chelsea FC,15,11,4,1028,5,0,15,15,0,1223,6,0,30,26,4,2251,11,0,6,6,12,4,3,7,2,1,3,0,0,0
5031,5031,Mata,1643,2011,Chelsea FC,17,14,3,1299,6,0,17,15,2,1225,0,0,34,29,5,2524,6,0,3,0,3,3,0,3,0,0,0,0,0,0
5032,5032,John Mikel Obi,1769,2011,Chelsea FC,11,8,3,645,0,0,11,7,4,678,0,0,22,15,7,1323,0,0,0,0,0,0,0,0,0,0,0,0,0,0
5033,5033,Florent Malouda,2270,2011,Chelsea FC,14,6,8,614,2,0,12,5,7,543,0,0,26,11,15,1157,2,0,3,0,3,1,0,1,0,0,0,0,0,0
5034,5034,Didier Drogba,1766,2011,Chelsea FC,15,10,5,971,4,0,9,6,3,556,1,0,24,16,8,1527,5,0,3,0,3,2,1,3,1,0,1,0,0,0
5035,5035,Raúl Meireles,2992,2011,Chelsea FC,13,11,2,900,2,0,15,12,3,1033,0,0,28,23,5,1933,2,0,0,0,0,1,0,1,0,0,0,0,0,0
5036,5036,Fernando Torres,1539,2011,Chelsea FC,16,9,7,901,4,0,16,11,5,1056,2,0,32,20,12,1957,6,0,0,0,0,1,0,1,0,0,0,0,0,0
5037,5037,Daniel Sturridge,1428,2011,Chelsea FC,15,13,2,1079,4,0,15,15,0,1189,7,0,30,28,2,2268,11,0,0,1,1,3,4,7,0,0,0,0,0,0
5038,5038,Ross Turnbull,2217,2011,Chelsea FC,1,1,0,90,0,0,1,1,0,90,0,0,2,2,0,180,0,0,0,0,0,0,0,0,0,0,0,0,0,0
5039,5039,Bosingwa,2268,2011,Chelsea FC,14,12,2,1060,1,0,13,12,1,1114,0,0,27,24,3,2174,1,0,0,0,0,1,0,1,0,0,0,0,0,0
5040,5040,Oriol Romeu,1243,2011,Chelsea FC,7,5,2,450,0,0,9,6,3,504,0,0,16,11,5,954,0,0,0,0,0,0,0,0,0,0,0,0,0,0
5041,5041,Nicolas Anelka,1720,2011,Chelsea FC,4,2,2,204,1,0,5,1,4,210,0,0,9,3,6,414,1,0,0,0,0,1,0,1,0,0,0,0,0,0
5042,5042,Pepe Reina,1775,2011,Liverpool FC,17,17,0,1530,0,0,17,17,0,1530,0,0,34,34,0,3060,0,0,0,0,0,0,0,0,0,0,0,0,0,0
5043,5043,Glen Johnson,1386,2011,Liverpool FC,10,10,0,900,0,0,13,12,1,1052,1,0,23,22,1,1952,1,0,0,3,3,0,1,1,0,0,0,0,0,0
5044,5044,José Enrique,2394,2011,Liverpool FC,17,16,1,1450,0,0,18,17,1,1542,0,0,35,33,2,2992,0,0,0,0,0,0,0,0,0,0,0,0,0,0
5045,5045,Daniel Agger,1776,2011,Liverpool FC,12,10,2,915,1,0,15,14,1,1226,0,0,27,24,3,2141,1,0,0,0,0,0,0,0,0,0,0,0,0,0
5046,5046,Martin Škrtel,1423,2011,Liverpool FC,18,17,1,1590,1,0,16,16,0,1431,1,0,34,33,1,3021,2,0,0,0,0,0,0,0,0,0,0,0,0,0
5047,5047,Maxi Rodríguez,2993,2011,Liverpool FC,6,5,1,420,1,0,6,5,1,379,3,0,12,10,2,799,4,0,1,0,1,1,2,3,0,0,0,0,0,0
5048,5048,Lucas Leiva,1429,2011,Liverpool FC,6,6,0,507,0,0,6,6,0,538,0,0,12,12,0,1045,0,0,0,0,0,0,0,0,0,0,0,0,0,0
5049,5049,Charlie Adam,1554,2011,Liverpool FC,13,13,0,1118,1,0,15,14,1,1120,1,0,28,27,1,2238,2,0,0,0,0,0,1,1,0,1,1,0,0,0
5050,5050,Luis Suárez,1427,2011,Liverpool FC,16,15,1,1336,5,0,15,14,1,1218,6,0,31,29,2,2554,11,0,4,0,4,4,1,5,0,0,0,0,0,0
5051,5051,Dirk Kuyt,1894,2011,Liverpool FC,18,12,6,1140,0,0,16,10,6,865,2,0,34,22,12,2005,2,0,0,0,0,0,0,0,0,0,0,0,0,0
5052,5052,Craig Bellamy,2012,2011,Liverpool FC,10,3,7,317,3,0,17,9,8,925,3,0,27,12,15,1242,6,0,0,0,0,3,1,4,0,0,0,0,0,0
5053,5053,Jordan Henderson,1426,2011,Liverpool FC,18,16,2,1267,2,0,19,15,4,1395,0,0,37,31,6,2662,2,0,0,0,0,1,0,1,0,0,0,0,0,0
5054,5054,Stewart Downing,1335,2011,Liverpool FC,19,16,3,1420,0,0,17,12,5,1055,0,0,36,28,8,2475,0,0,0,0,0,0,0,0,0,0,0,0,0,0
5055,5055,Andy Carroll,1779,2011,Liverpool FC,17,10,7,1017,0,0,18,11,7,1049,4,0,35,21,14,2066,4,0,0,3,3,0,3,3,0,0,0,0,0,0
5056,5056,Doni,2994,2011,Liverpool FC,2,2,0,180,0,0,2,2,0,180,0,0,4,4,0,360,0,0,0,0,0,0,0,0,0,0,0,0,0,0
5057,5057,Jamie Carragher,1778,2011,Liverpool FC,11,11,0,990,0,0,10,8,2,735,0,0,21,19,2,1725,0,0,0,0,0,0,0,0,0,0,0,0,0,0
5058,5058,Martin Kelly,1034,2011,Liverpool FC,7,7,0,570,0,0,5,5,0,394,0,0,12,12,0,964,0,0,0,0,0,0,0,0,0,0,0,0,0,0
5059,5059,Jay Spearing,2995,2011,Liverpool FC,7,7,0,623,0,0,9,8,1,697,0,0,16,15,1,1320,0,0,0,0,0,0,0,0,0,0,0,0,0,0
5060,5060,Kazaiah Sterling,2996,2017,Tottenham Hotspur,0,0,0,0,0,0,0,0,0,0,0,0,0,0,0,0,0,0,0,0,0,0,0,0,0,0,0,0,0,0
5061,5061,Vincent Kompany,1414,2017,Manchester City,6,6,0,540,1,0,10,10,0,767,0,0,16,16,0,1307,1,0,0,0,0,1,0,1,0,0,0,0,0,0
5062,5062,Aymeric Laporte,2413,2017,Manchester City,5,5,0,450,0,0,4,4,0,357,0,0,9,9,0,807,0,0,0,0,0,0,0,0,0,0,0,0,0,0
5063,5063,Phil Foden,1844,2017,Manchester City,4,0,4,37,0,0,1,0,1,8,0,0,5,0,5,45,0,0,0,0,0,0,0,0,0,0,0,0,0,0
5064,5064,Daley Blind,2186,2014,Manchester United,14,14,0,1181,0,0,11,11,0,990,2,0,25,25,0,2171,2,0,0,2,2,0,2,2,0,0,0,0,0,0
5065,5065,Wayne Rooney,1058,2014,Manchester United,15,15,0,1334,11,0,18,18,0,1574,1,0,33,33,0,2908,12,0,0,0,0,5,0,5,1,0,1,0,0,0
5066,5066,Ángel Di María,2997,2014,Manchester United,13,10,3,791,2,0,14,10,4,855,1,0,27,20,7,1646,3,0,0,0,0,2,0,2,0,0,0,0,0,0
5067,5067,Víctor Valdés,2998,2014,Manchester United,1,0,1,17,0,0,1,1,0,90,0,0,2,1,1,107,0,0,0,0,0,0,0,0,0,0,0,0,0,0
5068,5068,Phil Jones,1650,2014,Manchester United,10,10,0,799,0,0,12,12,0,1080,0,0,22,22,0,1879,0,0,0,0,0,0,0,0,0,0,0,0,0,0
5069,5069,Andreas Pereira,2190,2014,Manchester United,1,0,1,13,0,0,0,0,0,0,0,0,1,0,1,13,0,0,0,0,0,0,0,0,0,0,0,0,0,0
5070,5070,Boaz Myhill,1663,2014,West Bromwich Albion,6,5,1,484,0,0,5,5,0,450,0,0,11,10,1,934,0,0,0,0,0,0,0,0,0,0,0,0,0,0
5071,5071,Jonas Olsson,1771,2014,West Bromwich Albion,6,3,3,313,0,0,7,6,1,510,1,0,13,9,4,823,1,0,0,3,3,0,1,1,0,0,0,0,0,0
5072,5072,Joleon Lescott,1365,2014,West Bromwich Albion,17,17,0,1530,0,0,17,17,0,1530,1,0,34,34,0,3060,1,0,0,0,0,0,1,1,0,0,0,0,0,0
5073,5073,Gareth McAuley,1732,2014,West Bromwich Albion,11,11,0,990,0,0,13,13,0,1170,1,0,24,24,0,2160,1,0,0,0,0,0,0,0,0,0,0,0,0,0
5074,5074,Craig Dawson,1655,2014,West Bromwich Albion,15,15,0,1350,2,0,14,14,0,1241,0,0,29,29,0,2591,2,0,0,0,0,2,0,2,0,0,0,0,0,0
5075,5075,Claudio Yacob,1661,2014,West Bromwich Albion,9,7,2,640,0,0,11,9,2,812,0,0,20,16,4,1452,0,0,0,0,0,0,0,0,0,0,0,0,0,0
5076,5076,Craig Gardner,1403,2014,West Bromwich Albion,18,14,4,1251,2,0,17,16,1,1432,1,0,35,30,5,2683,3,0,3,0,3,2,0,2,0,0,0,0,0,0
5077,5077,Chris Brunt,1658,2014,West Bromwich Albion,18,17,1,1476,1,0,16,16,0,1419,1,0,34,33,1,2895,2,0,0,0,0,0,0,0,0,0,0,0,0,0
5078,5078,Youssuf Mulumbu,1773,2014,West Bromwich Albion,8,4,4,409,0,0,9,6,3,499,0,0,17,10,7,908,0,0,0,0,0,0,0,0,0,0,0,0,0,0
5079,5079,Saido Berahino,1905,2014,West Bromwich Albion,19,18,1,1580,11,0,19,14,5,1349,3,0,38,32,6,2929,14,0,7,1,8,7,3,10,3,1,4,0,0,0
5080,5080,Andre Wisdom,2625,2014,West Bromwich Albion,12,12,0,1051,0,0,12,10,2,920,0,0,24,22,2,1971,0,0,0,0,0,0,0,0,0,0,0,0,0,0
5081,5081,Chris Baird,1562,2014,West Bromwich Albion,8,3,5,264,0,0,11,6,5,539,0,0,19,9,10,803,0,0,0,0,0,0,0,0,0,0,0,0,0,0
5082,5082,Brown Ideye,2999,2014,West Bromwich Albion,13,8,5,737,3,0,11,5,6,560,1,0,24,13,11,1297,4,0,3,1,4,2,1,3,0,0,0,0,0,0
5083,5083,Jack Rose,3000,2014,West Bromwich Albion,0,0,0,0,0,0,0,0,0,0,0,0,0,0,0,0,0,0,0,0,0,0,0,0,0,0,0,0,0,0
5084,5084,Stéphane Sessègnon,1406,2014,West Bromwich Albion,15,10,5,853,1,0,13,10,3,911,0,0,28,20,8,1764,1,0,0,0,0,1,0,1,0,0,0,0,0,0
5085,5085,Victor Anichebe,1751,2014,West Bromwich Albion,10,5,5,584,2,0,11,6,5,448,1,0,21,11,10,1032,3,0,0,0,0,0,1,1,0,0,0,0,0,0
5086,5086,Callum McManaman,3001,2014,West Bromwich Albion,4,3,1,197,0,0,4,2,2,150,0,0,8,5,3,347,0,0,0,0,0,0,0,0,0,0,0,0,0,0
5087,5087,Víctor Valdés,2998,2016,Middlesbrough FC,14,14,0,1260,0,0,14,14,0,1260,0,0,28,28,0,2520,0,0,0,0,0,0,0,0,0,0,0,0,0,0
5088,5088,George Friend,3002,2016,Middlesbrough FC,12,9,3,967,0,0,12,11,1,993,0,0,24,20,4,1960,0,0,0,0,0,0,0,0,0,0,0,0,0,0
5089,5089,Daniel Ayala,3003,2016,Middlesbrough FC,5,4,1,345,1,0,9,7,2,572,0,0,14,11,3,917,1,0,0,0,0,1,0,1,0,0,0,0,0,0
5090,5090,Ben Gibson,3004,2016,Middlesbrough FC,19,19,0,1710,1,0,19,19,0,1710,0,0,38,38,0,3420,1,0,0,0,0,0,0,0,0,0,0,0,0,0
5091,5091,Barragán,3005,2016,Middlesbrough FC,14,14,0,1183,0,0,12,12,0,1013,0,0,26,26,0,2196,0,0,0,0,0,0,0,0,0,0,0,0,0,0
5092,5092,Adam Clayton,3006,2016,Middlesbrough FC,18,18,0,1528,0,0,16,14,2,1278,0,0,34,32,2,2806,0,0,0,0,0,0,0,0,0,0,0,0,0,0
5093,5093,Stewart Downing,1335,2016,Middlesbrough FC,16,11,5,1104,1,0,14,13,1,1108,0,0,30,24,6,2212,1,0,0,0,0,0,0,0,0,0,0,0,0,0
5094,5094,Adam Forshaw,3007,2016,Middlesbrough FC,17,15,2,1355,0,0,17,15,2,1345,0,0,34,30,4,2700,0,0,0,0,0,0,0,0,0,0,0,0,0,0
5095,5095,Álvaro Negredo,1360,2016,Middlesbrough FC,19,18,1,1571,6,0,17,15,2,1309,3,0,36,33,3,2880,9,0,1,0,1,5,3,8,2,0,2,0,0,0
5096,5096,Viktor Fischer,3008,2016,Middlesbrough FC,7,4,3,254,0,0,6,2,4,184,0,0,13,6,7,438,0,0,0,0,0,0,0,0,0,0,0,0,0,0
5097,5097,Cristhian Stuani,3009,2016,Middlesbrough FC,10,9,1,686,1,0,13,7,6,675,3,0,23,16,7,1361,4,0,0,0,0,1,2,3,0,0,0,0,0,0
5098,5098,Marten de Roon,3010,2016,Middlesbrough FC,17,16,1,1392,2,0,16,16,0,1385,2,0,33,32,1,2777,4,0,3,1,4,1,1,2,0,0,0,0,0,0
5099,5099,Gastón Ramírez,2226,2016,Middlesbrough FC,12,10,2,821,2,0,12,10,2,799,0,0,24,20,4,1620,2,0,3,0,3,2,0,2,0,0,0,0,0,0
5100,5100,Adama Traoré,1871,2016,Middlesbrough FC,15,7,8,766,0,0,12,9,3,771,0,0,27,16,11,1537,0,0,0,0,0,0,0,0,0,0,0,0,0,0
5101,5101,Brad Guzan,1435,2016,Middlesbrough FC,5,5,0,450,0,0,5,5,0,450,0,0,10,10,0,900,0,0,0,0,0,0,0,0,0,0,0,0,0,0
5102,5102,Calum Chambers,1470,2016,Middlesbrough FC,13,13,0,1170,1,0,11,11,0,990,0,0,24,24,0,2160,1,0,0,0,0,1,0,1,0,0,0,0,0,0
5103,5103,Jordan Rhodes,3011,2016,Middlesbrough FC,4,0,4,50,0,0,2,2,0,158,0,0,6,2,4,208,0,0,0,0,0,0,0,0,0,0,0,0,0,0
5104,5104,Emilio N'Sue,3012,2016,Middlesbrough FC,1,1,0,90,0,0,3,3,0,232,0,0,4,4,0,322,0,0,0,0,0,0,0,0,0,0,0,0,0,0
5105,5105,Jonathan Benteke,3013,2016,Crystal Palace,0,0,0,0,0,0,1,0,1,6,0,0,1,0,1,6,0,0,0,0,0,0,0,0,0,0,0,0,0,0
5106,5106,Luke Dreher,3014,2016,Crystal Palace,0,0,0,0,0,0,0,0,0,0,0,0,0,0,0,0,0,0,0,0,0,0,0,0,0,0,0,0,0,0
5107,5107,Tom Cleverley,2091,2017,Watford FC,11,11,0,908,1,0,12,11,1,1001,0,0,23,22,1,1909,1,0,3,0,3,1,0,1,0,0,0,0,0,0
5108,5108,Nathaniel Chalobah,2330,2017,Watford FC,3,3,0,250,0,0,3,2,1,198,0,0,6,5,1,448,0,0,0,0,0,0,0,0,0,0,0,0,0,0
5109,5109,Nordin Amrabat,3015,2017,Watford FC,2,2,0,118,0,0,1,1,0,82,0,0,3,3,0,200,0,0,0,0,0,0,0,0,0,0,0,0,0,0
5110,5110,Costel Pantilimon,1354,2017,Watford FC,0,0,0,0,0,0,0,0,0,0,0,0,0,0,0,0,0,0,0,0,0,0,0,0,0,0,0,0,0,0
5111,5111,Ben Watson,2025,2017,Watford FC,3,3,0,223,0,0,5,3,2,236,0,0,8,6,2,459,0,0,0,0,0,0,0,0,0,0,0,0,0,0
5112,5112,Isaac Success,2331,2017,Watford FC,0,0,0,0,0,0,0,0,0,0,0,0,0,0,0,0,0,0,0,0,0,0,0,0,0,0,0,0,0,0
5113,5113,Liam Rosenior,1756,2017,Brighton & Hove Albion,1,0,1,28,0,0,2,1,1,134,0,0,3,1,2,162,0,0,0,0,0,0,0,0,0,0,0,0,0,0
5114,5114,Jamie Murphy,3016,2017,Brighton & Hove Albion,2,0,2,75,0,0,2,1,1,91,0,0,4,1,3,166,0,0,0,0,0,0,0,0,0,0,0,0,0,0
5115,5115,Niki Mäenpää,3017,2017,Brighton & Hove Albion,0,0,0,0,0,0,0,0,0,0,0,0,0,0,0,0,0,0,0,0,0,0,0,0,0,0,0,0,0,0
5116,5116,Uwe Hünemeier,3018,2017,Brighton & Hove Albion,1,0,1,17,0,0,0,0,0,0,0,0,1,0,1,17,0,0,0,0,0,0,0,0,0,0,0,0,0,0
5117,5117,Jiří Skalák,3019,2017,Brighton & Hove Albion,0,0,0,0,0,0,0,0,0,0,0,0,0,0,0,0,0,0,0,0,0,0,0,0,0,0,0,0,0,0
5118,5118,Steven Sidwell,1622,2017,Brighton & Hove Albion,0,0,0,0,0,0,0,0,0,0,0,0,0,0,0,0,0,0,0,0,0,0,0,0,0,0,0,0,0,0
5119,5119,Paul Jones,2044,2000,Southampton FC,17,17,0,1530,0,0,15,15,0,1350,0,0,32,32,0,2880,0,0,0,0,0,0,0,0,0,0,0,0,0,0
5120,5120,Dean Richards,2799,2000,Southampton FC,15,15,0,1324,0,0,12,12,0,1080,1,0,27,27,0,2404,1,0,0,1,1,0,1,1,0,0,0,0,0,0
5121,5121,Jason Dodd,2046,2000,Southampton FC,16,14,2,1248,0,0,12,12,0,1069,1,0,28,26,2,2317,1,0,0,0,0,0,1,1,0,0,0,0,0,0
5122,5122,Claus Lundekvam,2047,2000,Southampton FC,18,18,0,1551,0,0,17,17,0,1530,0,0,35,35,0,3081,0,0,0,0,0,0,0,0,0,0,0,0,0,0
5123,5123,Wayne Bridge,1768,2000,Southampton FC,18,18,0,1620,0,0,17,17,0,1530,0,0,35,35,0,3150,0,0,0,0,0,0,0,0,0,0,0,0,0,0
5124,5124,Chris Marsden,2048,2000,Southampton FC,10,9,1,696,0,0,11,8,3,736,0,0,21,17,4,1432,0,0,0,0,0,0,0,0,0,0,0,0,0,0
5125,5125,Mark Draper,2049,2000,Southampton FC,9,4,5,476,0,0,13,12,1,1083,1,0,22,16,6,1559,1,0,0,3,3,0,1,1,0,0,0,0,0,0
5126,5126,Kevin Davies,1718,2000,Southampton FC,11,8,3,641,1,0,14,11,3,991,0,0,25,19,6,1632,1,0,0,0,0,0,0,0,0,0,0,0,0,0
5127,5127,James Beattie,2050,2000,Southampton FC,18,14,4,1295,9,0,16,13,3,1128,2,0,34,27,7,2423,11,0,9,0,9,7,2,9,0,0,0,0,0,0
5128,5128,Marians Pahars,2051,2000,Southampton FC,17,16,1,1426,7,0,10,7,3,653,2,0,27,23,4,2079,9,0,1,1,2,3,2,5,0,0,0,0,0,0
5129,5129,Jo Tessem,2696,2000,Southampton FC,16,13,3,1260,3,0,15,12,3,1026,1,0,31,25,6,2286,4,0,3,1,4,2,1,3,0,0,0,0,0,0
5130,5130,Taher El-Khalej,2045,2000,Southampton FC,15,10,5,1010,1,0,14,12,2,1050,0,0,29,22,7,2060,1,0,0,0,0,0,0,0,0,0,0,0,0,0
5131,5131,Trond Soltvedt,3020,2000,Southampton FC,3,1,2,142,0,0,2,1,1,134,1,0,5,2,3,276,1,0,0,0,0,0,1,1,0,0,0,0,0,0
5132,5132,Uwe Rösler,3021,2000,Southampton FC,8,3,5,288,0,0,11,3,8,380,0,0,19,6,13,668,0,0,0,0,0,0,0,0,0,0,0,0,0,0
5133,5133,Alton Thelwell,3022,2000,Tottenham Hotspur,8,5,3,526,0,0,7,7,0,585,0,0,15,12,3,1111,0,0,0,0,0,0,0,0,0,0,0,0,0,0
5134,5134,Ledley King,1119,2000,Tottenham Hotspur,8,8,0,695,0,0,8,8,0,649,1,0,16,16,0,1344,1,0,0,0,0,0,1,1,0,0,0,0,0,0
5135,5135,Stephen Clemence,1516,2000,Tottenham Hotspur,15,14,1,1287,0,0,11,10,1,901,1,0,26,24,2,2188,1,0,0,0,0,0,0,0,0,0,0,0,0,0
5136,5136,Chris Armstrong,2584,2000,Tottenham Hotspur,5,0,5,87,1,0,4,3,1,276,1,0,9,3,6,363,2,0,3,0,3,1,0,1,0,0,0,0,0,0
5137,5137,Willem Korsten,3023,2000,Tottenham Hotspur,4,3,1,277,2,0,9,5,4,462,1,0,13,8,5,739,3,0,0,0,0,2,1,3,0,0,0,0,0,0
5138,5138,Gary Doherty,2792,2000,Tottenham Hotspur,9,8,1,728,1,0,10,7,3,677,2,0,19,15,4,1405,3,0,0,3,3,1,2,3,0,0,0,0,0,0
5139,5139,Mark Fish,1671,2001,Charlton Athletic,13,13,0,1170,0,0,10,10,0,791,0,0,23,23,0,1961,0,0,0,0,0,0,0,0,0,0,0,0,0,0
5140,5140,Mark Kinsella,1677,2001,Charlton Athletic,8,7,1,623,0,0,7,5,2,474,0,0,15,12,3,1097,0,0,0,0,0,0,0,0,0,0,0,0,0,0
5141,5141,Claus Jensen,1674,2001,Charlton Athletic,8,7,1,632,0,0,9,8,1,696,1,0,17,15,2,1328,1,0,0,0,0,0,0,0,0,0,0,0,0,0
5142,5142,John Robinson,1678,2001,Charlton Athletic,15,11,4,1014,1,0,11,4,7,399,0,0,26,15,11,1413,1,0,0,0,0,0,0,0,0,0,0,0,0,0
5143,5143,Jonatan Johansson,1676,2001,Charlton Athletic,15,11,4,1055,5,0,11,8,3,699,0,0,26,19,7,1754,5,0,1,0,1,4,0,4,0,0,0,0,0,0
5144,5144,Shaun Bartlett,1675,2001,Charlton Athletic,9,6,3,463,1,0,4,3,1,214,0,0,13,9,4,677,1,0,0,0,0,0,0,0,0,0,0,0,0,0
5145,5145,Stephen Wright,3024,2001,Liverpool FC,4,3,1,249,0,0,8,7,1,653,0,0,12,10,2,902,0,0,0,0,0,0,0,0,0,0,0,0,0,0
5146,5146,Jamie Redknapp,1123,2001,Liverpool FC,2,0,2,33,0,0,2,2,0,150,1,0,4,2,2,183,1,0,0,0,0,0,1,1,0,0,0,0,0,0
5147,5147,Dietmar Hamann,2690,2001,Liverpool FC,16,16,0,1431,1,0,13,13,0,1170,0,0,29,29,0,2601,1,0,0,0,0,0,0,0,0,0,0,0,0,0
5148,5148,Robbie Fowler,2691,2001,Liverpool FC,5,4,1,306,0,0,4,3,1,271,3,0,9,7,2,577,3,0,0,0,0,0,1,1,0,0,0,0,0,0
5149,5149,Alessandro Pistone,1799,2003,Leeds United,1,1,0,90,0,0,0,0,0,0,0,0,1,1,0,90,0,0,0,0,0,0,0,0,0,0,0,0,0,0
5150,5150,Gary Naysmith,1804,2003,Leeds United,1,1,0,90,0,0,0,0,0,0,0,0,1,1,0,90,0,0,0,0,0,0,0,0,0,0,0,0,0,0
5151,5151,Alex Nyarko,2825,2003,Leeds United,1,0,1,35,0,0,0,0,0,0,0,0,1,0,1,35,0,0,0,0,0,0,0,0,0,0,0,0,0,0
5152,5152,Danny Rose,1399,2019,Tottenham Hotspur,7,6,1,519,0,0,5,4,1,375,0,0,12,10,2,894,0,0,0,0,0,0,0,0,0,0,0,0,0,0
5153,5153,Christian Eriksen,1165,2019,Tottenham Hotspur,8,3,5,397,0,0,12,7,5,694,2,0,20,10,10,1091,2,0,0,0,0,0,2,2,0,0,0,0,0,0
5154,5154,Victor Wanyama,1864,2019,Tottenham Hotspur,1,0,1,1,0,0,1,0,1,23,0,0,2,0,2,24,0,0,0,0,0,0,0,0,0,0,0,0,0,0
5155,5155,Dele Alli,1915,2019,Tottenham Hotspur,11,11,0,916,5,0,14,10,4,936,3,0,25,21,4,1852,8,0,4,1,5,4,3,7,0,1,1,0,0,0
5156,5156,Lucas,1861,2019,Tottenham Hotspur,17,14,3,1160,1,0,18,11,7,1086,3,0,35,25,10,2246,4,0,0,1,1,0,2,2,0,0,0,0,0,0
5157,5157,Stuart Armstrong,2158,2019,Southampton FC,15,8,7,744,1,0,15,11,4,972,4,0,30,19,11,1716,5,0,0,0,0,0,2,2,0,0,0,0,0,0
5158,5158,Harry Lewis,3025,2019,Southampton FC,0,0,0,0,0,0,0,0,0,0,0,0,0,0,0,0,0,0,0,0,0,0,0,0,0,0,0,0,0,0
5159,5159,Kevin Danso,3026,2019,Southampton FC,3,2,1,180,0,0,3,1,2,113,0,0,6,3,3,293,0,0,0,0,0,0,0,0,0,0,0,0,0,0
5160,5160,Yan Valery,3027,2019,Southampton FC,6,5,1,400,0,0,5,5,0,384,0,0,11,10,1,784,0,0,0,0,0,0,0,0,0,0,0,0,0,0
5161,5161,Roberto Firmino,1186,2018,Liverpool FC,16,16,0,1347,7,0,18,15,3,1273,5,0,34,31,3,2620,12,0,0,0,0,5,2,7,1,0,1,0,0,0
5162,5162,Dejan Lovren,1179,2018,Liverpool FC,7,6,1,541,1,0,6,5,1,445,0,0,13,11,2,986,1,0,0,0,0,1,0,1,0,0,0,0,0,0
5163,5163,Harry Maguire,2229,2018,Leicester City,15,15,0,1350,0,0,16,16,0,1335,3,0,31,31,0,2685,3,0,0,4,4,0,2,2,0,0,0,0,0,0
5164,5164,Hamza Choudhury,2447,2018,Leicester City,4,4,0,308,0,0,5,3,2,288,0,0,9,7,2,596,0,0,0,0,0,0,0,0,0,0,0,0,0,0
5165,5165,Harvey Barnes,2441,2018,Leicester City,9,6,3,601,0,0,7,5,2,406,1,0,16,11,5,1007,1,0,0,1,1,0,1,1,0,0,0,0,0,0
5166,5166,Ben Foster,1653,2015,West Bromwich Albion,8,8,0,720,0,0,7,7,0,630,0,0,15,15,0,1350,0,0,0,0,0,0,0,0,0,0,0,0,0,0
5167,5167,Jonas Olsson,1771,2015,West Bromwich Albion,14,13,1,966,0,0,14,12,2,1051,1,0,28,25,3,2017,1,0,0,0,0,0,1,1,0,0,0,0,0,0
5168,5168,Jonny Evans,1216,2015,West Bromwich Albion,15,15,0,1309,1,0,15,15,0,1284,0,0,30,30,0,2593,1,0,3,0,3,1,0,1,0,0,0,0,0,0
5169,5169,Gareth McAuley,1732,2015,West Bromwich Albion,16,16,0,1440,1,0,18,18,0,1620,0,0,34,34,0,3060,1,0,0,0,0,1,0,1,0,0,0,0,0,0
5170,5170,Craig Dawson,1655,2015,West Bromwich Albion,19,19,0,1675,2,0,19,19,0,1710,2,0,38,38,0,3385,4,0,0,1,1,0,2,2,0,0,0,0,0,0
5171,5171,Claudio Yacob,1661,2015,West Bromwich Albion,17,16,1,1417,0,0,17,17,0,1436,0,0,34,33,1,2853,0,0,0,0,0,0,0,0,0,0,0,0,0,0
5172,5172,Darren Fletcher,1730,2015,West Bromwich Albion,19,19,0,1710,1,0,19,19,0,1666,0,0,38,38,0,3376,1,0,3,0,3,1,0,1,0,0,0,0,0,0
5173,5173,Stéphane Sessègnon,1406,2015,West Bromwich Albion,14,12,2,977,1,0,11,9,2,783,1,0,25,21,4,1760,2,0,0,0,0,1,1,2,0,0,0,0,0,0
5174,5174,Sandro,2409,2015,West Bromwich Albion,4,1,3,102,0,0,8,4,4,279,0,0,12,5,7,381,0,0,0,0,0,0,0,0,0,0,0,0,0,0
5175,5175,James McClean,1407,2015,West Bromwich Albion,17,13,4,1158,1,0,18,15,3,1312,1,0,35,28,7,2470,2,0,1,1,2,1,1,2,0,0,0,0,0,0
5176,5176,Salomón Rondón,1659,2015,West Bromwich Albion,16,16,0,1327,4,0,18,14,4,1239,5,0,34,30,4,2566,9,0,4,9,13,4,5,9,0,0,0,0,0,0
5177,5177,Craig Gardner,1403,2015,West Bromwich Albion,18,10,8,1078,1,0,16,10,6,957,2,0,34,20,14,2035,3,0,0,1,1,1,2,3,0,0,0,0,0,0
5178,5178,Victor Anichebe,1751,2015,West Bromwich Albion,5,1,4,173,0,0,5,2,3,192,0,0,10,3,7,365,0,0,0,0,0,0,0,0,0,0,0,0,0,0
5179,5179,Saido Berahino,1905,2015,West Bromwich Albion,16,8,8,849,3,0,15,9,6,894,1,0,31,17,14,1743,4,0,3,3,6,2,1,3,0,0,0,0,0,0
5180,5180,Boaz Myhill,1663,2015,West Bromwich Albion,11,11,0,990,0,0,12,12,0,1080,0,0,23,23,0,2070,0,0,0,0,0,0,0,0,0,0,0,0,0,0
5181,5181,James Chester,2223,2015,West Bromwich Albion,6,3,3,400,0,0,7,6,1,562,0,0,13,9,4,962,0,0,0,0,0,0,0,0,0,0,0,0,0,0
5182,5182,Alex Pritchard,3028,2015,West Bromwich Albion,1,0,1,17,0,0,1,0,1,44,0,0,2,0,2,61,0,0,0,0,0,0,0,0,0,0,0,0,0,0
5183,5183,Rickie Lambert,2597,2015,West Bromwich Albion,11,3,8,322,1,0,8,2,6,294,0,0,19,5,14,616,1,0,0,0,0,0,0,0,1,0,1,0,0,0
5184,5184,Sung-yueng Ki,1698,2015,Swansea City,12,9,3,838,1,0,16,12,4,1013,1,0,28,21,7,1851,2,0,3,0,3,1,0,1,0,0,0,0,0,0
5185,5185,Jordi Amat,2934,2015,Swansea City,3,2,1,183,0,0,5,3,2,278,0,0,8,5,3,461,0,0,0,0,0,0,0,0,0,0,0,0,0,0
5186,5186,Alberto Paloschi,3029,2015,Swansea City,4,4,0,299,0,0,6,3,3,370,2,0,10,7,3,669,2,0,0,1,1,0,2,2,0,0,0,0,0,0
5187,5187,Modou Barrow,1705,2015,Swansea City,14,3,11,450,0,0,8,3,5,331,1,0,22,6,16,781,1,0,0,0,0,0,1,1,0,0,0,0,0,0
5188,5188,Ryan Nelsen,2007,2007,Blackburn Rovers,10,10,0,900,0,0,11,11,0,990,0,0,21,21,0,1890,0,0,0,0,0,0,0,0,0,0,0,0,0,0
5189,5189,Robbie Savage,1309,2007,Blackburn Rovers,6,5,1,388,0,0,5,4,1,330,0,0,11,9,2,718,0,0,0,0,0,0,0,0,0,0,0,0,0,0
5190,5190,Tugay Kerimoğlu,1136,2007,Blackburn Rovers,13,7,6,744,2,0,6,4,2,338,0,0,19,11,8,1082,2,0,0,0,0,0,0,0,0,0,0,0,0,0
5191,5191,Kasper Schmeichel,2435,2007,Manchester City,3,3,0,270,0,0,4,4,0,360,0,0,7,7,0,630,0,0,0,0,0,0,0,0,0,0,0,0,0,0
5192,5192,Micah Richards,1364,2007,Manchester City,13,13,0,1170,0,0,12,12,0,1080,0,0,25,25,0,2250,0,0,0,0,0,0,0,0,0,0,0,0,0,0
5193,5193,Vedran Ćorluka,1268,2007,Manchester City,18,18,0,1540,0,0,17,16,1,1432,0,0,35,34,1,2972,0,0,0,0,0,0,0,0,0,0,0,0,0,0
5194,5194,Richard Dunne,1617,2007,Manchester City,17,17,0,1494,0,0,19,19,0,1649,0,0,36,36,0,3143,0,0,0,0,0,0,0,0,0,0,0,0,0,0
5195,5195,Javi Garrido,1381,2007,Manchester City,12,9,3,841,0,0,15,12,3,1052,0,0,27,21,6,1893,0,0,0,0,0,0,0,0,0,0,0,0,0,0
5196,5196,Michael Johnson,3030,2007,Manchester City,13,13,0,1092,2,0,10,10,0,841,0,0,23,23,0,1933,2,0,6,0,6,2,0,2,0,0,0,0,0,0
5197,5197,Stephen Ireland,1809,2007,Manchester City,16,16,0,1247,4,0,17,16,1,1324,0,0,33,32,1,2571,4,0,6,0,6,4,0,4,0,0,0,0,0,0
5198,5198,Elano,3031,2007,Manchester City,18,16,2,1307,4,0,16,13,3,1145,4,0,34,29,5,2452,8,0,3,0,3,1,2,3,0,2,2,0,0,0
5199,5199,Martin Petrov,2492,2007,Manchester City,17,17,0,1507,3,0,17,17,0,1471,2,0,34,34,0,2978,5,0,0,0,0,2,2,4,0,0,0,0,0,0
5200,5200,Dietmar Hamann,2690,2007,Manchester City,13,13,0,1111,0,0,16,13,3,1097,0,0,29,26,3,2208,0,0,0,0,0,0,0,0,0,0,0,0,0,0
5201,5201,Rolando Bianchi,3032,2007,Manchester City,8,4,4,402,1,0,11,3,8,359,3,0,19,7,12,761,4,0,0,0,0,1,3,4,0,0,0,0,0,0
5202,5202,Nedum Onuoha,2533,2007,Manchester City,8,7,1,632,1,0,8,6,2,588,0,0,16,13,3,1220,1,0,3,0,3,1,0,1,0,0,0,0,0,0
5203,5203,Géovanni,1613,2007,Manchester City,10,1,9,236,1,0,9,1,8,163,2,0,19,2,17,399,3,0,3,0,3,1,1,2,0,0,0,0,0,0
5204,5204,Émile Mpenza,3033,2007,Manchester City,10,6,4,511,1,0,5,2,3,232,1,0,15,8,7,743,2,0,0,0,0,1,1,2,0,0,0,0,0,0
5205,5205,Łukasz Fabiański,1227,2019,West Ham United,13,13,0,1170,0,0,12,12,0,949,0,0,25,25,0,2119,0,0,0,0,0,0,0,0,0,0,0,0,0,0
5206,5206,Moritz Leitner,3034,2019,Norwich City,4,4,0,307,0,0,5,3,2,379,0,0,9,7,2,686,0,0,0,0,0,0,0,0,0,0,0,0,0,0
5207,5207,Theo Walcott,1237,2019,Everton FC,14,10,4,697,1,0,11,7,4,599,1,0,25,17,8,1296,2,0,1,3,4,1,1,2,0,0,0,0,0,0
5208,5208,Oumar Niasse,1059,2019,Everton FC,1,0,1,2,0,0,2,0,2,17,0,0,3,0,3,19,0,0,0,0,0,0,0,0,0,0,0,0,0,0
5209,5209,Matt Ritchie,1008,2019,Newcastle United,9,7,2,705,2,0,9,7,2,611,0,0,18,14,4,1316,2,0,0,0,0,1,0,1,0,0,0,0,0,0
5210,5210,Matthew Longstaff,3035,2019,Newcastle United,4,2,2,189,1,0,5,4,1,384,1,0,9,6,3,573,2,0,3,0,3,1,1,2,0,0,0,0,0,0
5211,5211,Florian Lejeune,2577,2019,Newcastle United,3,3,0,254,0,0,3,1,2,187,2,0,6,4,2,441,2,0,0,1,1,0,1,1,0,0,0,0,0,0
5212,5212,Liam Gibson,3036,2019,Newcastle United,0,0,0,0,0,0,0,0,0,0,0,0,0,0,0,0,0,0,0,0,0,0,0,0,0,0,0,0,0,0
5213,5213,Tom Allan,3037,2019,Newcastle United,0,0,0,0,0,0,0,0,0,0,0,0,0,0,0,0,0,0,0,0,0,0,0,0,0,0,0,0,0,0
5214,5214,Bernardo Espinosa,3038,2016,Middlesbrough FC,5,5,0,443,0,0,6,5,1,532,0,0,11,10,1,975,0,0,0,0,0,0,0,0,0,0,0,0,0,0
5215,5215,Rudy Gestede,1874,2016,Middlesbrough FC,8,1,7,143,1,0,8,3,5,381,0,0,16,4,12,524,1,0,0,0,0,0,0,0,0,0,0,0,0,0
5216,5216,Fábio,2320,2016,Middlesbrough FC,12,11,1,931,0,0,12,10,2,918,0,0,24,21,3,1849,0,0,0,0,0,0,0,0,0,0,0,0,0,0
5217,5217,Grant Leadbitter,1219,2016,Middlesbrough FC,8,3,5,340,0,0,5,4,1,367,1,0,13,7,6,707,1,0,0,0,0,0,1,1,0,0,0,0,0,0
5218,5218,James Collins,1618,2016,West Ham United,11,10,1,818,0,0,11,9,2,836,2,0,22,19,3,1654,2,0,0,0,0,0,2,2,0,0,0,0,0,0
5219,5219,Jonathan Calleri,3039,2016,West Ham United,8,3,5,369,0,0,8,1,7,166,1,0,16,4,12,535,1,0,0,0,0,0,0,0,0,0,0,0,0,0
5220,5220,Chris Herd,3040,2011,Aston Villa,10,10,0,837,0,0,9,9,0,694,1,0,19,19,0,1531,1,0,0,0,0,0,1,1,0,0,0,0,0,0
5221,5221,Darren Bent,1958,2011,Aston Villa,11,11,0,969,7,0,11,10,1,892,2,0,22,21,1,1861,9,0,0,0,0,3,1,4,1,1,2,0,0,0
5222,5222,John Ruddy,1367,2011,Norwich City,18,18,0,1620,0,0,19,19,0,1710,0,0,37,37,0,3330,0,0,0,0,0,0,0,0,0,0,0,0,0,0
5223,5223,Russell Martin,1368,2011,Norwich City,15,13,2,1315,2,0,18,17,1,1535,0,0,33,30,3,2850,2,0,0,0,0,1,0,1,0,0,0,0,0,0
5224,5224,Leon Barnett,3041,2011,Norwich City,9,7,2,663,1,0,8,6,2,592,0,0,17,13,4,1255,1,0,0,0,0,1,0,1,0,0,0,0,0,0
5225,5225,Marc Tierney,3042,2011,Norwich City,8,8,0,720,0,0,9,9,0,810,0,0,17,17,0,1530,0,0,0,0,0,0,0,0,0,0,0,0,0,0
5226,5226,Kyle Naughton,2273,2011,Norwich City,17,14,3,1350,0,0,15,15,0,1350,0,0,32,29,3,2700,0,0,0,0,0,0,0,0,0,0,0,0,0,0
5227,5227,Bradley Johnson,1373,2011,Norwich City,14,13,1,1114,1,0,14,12,2,993,1,0,28,25,3,2107,2,0,0,0,0,0,0,0,0,0,0,0,0,0
5228,5228,Anthony Pilkington,1376,2011,Norwich City,14,12,2,963,3,0,16,11,5,1009,5,0,30,23,7,1972,8,0,0,0,0,1,5,6,0,0,0,0,0,0
5229,5229,Wes Hoolahan,1383,2011,Norwich City,16,12,4,1178,2,0,17,13,4,1101,2,0,33,25,8,2279,4,0,0,1,1,2,2,4,0,0,0,0,0,0
5230,5230,Elliott Bennett,3043,2011,Norwich City,17,10,7,1001,0,0,16,12,4,1011,1,0,33,22,11,2012,1,0,0,3,3,0,1,1,0,0,0,0,0,0
5231,5231,Steve Morison,3044,2011,Norwich City,16,10,6,946,4,0,18,12,6,1152,5,0,34,22,12,2098,9,0,0,7,7,2,3,5,0,0,0,0,0,0
5232,5232,Grant Holt,1446,2011,Norwich City,19,12,7,1164,9,0,17,12,5,1088,6,0,36,24,12,2252,15,0,8,1,9,8,5,13,2,0,2,0,0,0
5233,5233,Andrew Crofts,3045,2011,Norwich City,13,7,6,650,0,0,11,6,5,637,0,0,24,13,11,1287,0,0,0,0,0,0,0,0,0,0,0,0,0,0
5234,5234,David Fox,3046,2011,Norwich City,14,14,0,1077,0,0,14,9,5,858,0,0,28,23,5,1935,0,0,0,0,0,0,0,0,0,0,0,0,0,0
5235,5235,Simeon Jackson,3047,2011,Norwich City,12,6,6,489,2,0,10,4,6,454,1,0,22,10,12,943,3,0,1,0,1,1,1,2,0,0,0,0,0,0
5236,5236,Declan Rudd,2629,2011,Norwich City,1,1,0,90,0,0,1,0,1,9,0,0,2,1,1,99,0,0,0,0,0,0,0,0,0,0,0,0,0,0
5237,5237,Ritchie De Laet,2514,2011,Norwich City,4,4,0,302,1,0,2,2,0,180,0,0,6,6,0,482,1,0,0,0,0,1,0,1,0,0,0,0,0,0
5238,5238,Andrew Surman,1006,2011,Norwich City,13,10,3,921,2,0,12,11,1,992,2,0,25,21,4,1913,4,0,0,0,0,1,2,3,0,0,0,0,0,0
5239,5239,Aaron Wilbraham,3048,2011,Norwich City,4,1,3,133,0,0,7,1,6,173,1,0,11,2,9,306,1,0,0,0,0,0,0,0,0,0,0,0,0,0
5240,5240,Nathan Doyle,3049,2008,Hull City,2,2,0,157,0,0,1,0,1,56,0,0,3,2,1,213,0,0,0,0,0,0,0,0,0,0,0,0,0,0
5241,5241,Ryan France,3050,2008,Hull City,1,1,0,83,0,0,1,0,1,9,0,0,2,1,1,92,0,0,0,0,0,0,0,0,0,0,0,0,0,0
5242,5242,Johan Djourou,1229,2008,Arsenal FC,6,5,1,494,0,0,9,8,1,709,0,0,15,13,2,1203,0,0,0,0,0,0,0,0,0,0,0,0,0,0
5243,5243,Abou Diaby,2434,2008,Arsenal FC,13,8,5,708,1,0,10,7,3,669,2,0,23,15,8,1377,3,0,0,0,0,0,1,1,0,0,0,0,0,0
5244,5244,Ed de Goey,3051,2000,Chelsea FC,8,8,0,675,0,0,6,6,0,540,0,0,14,14,0,1215,0,0,0,0,0,0,0,0,0,0,0,0,0,0
5245,5245,Frank Leboeuf,3052,2000,Chelsea FC,11,11,0,967,0,0,13,11,2,941,0,0,24,22,2,1908,0,0,0,0,0,0,0,0,0,0,0,0,0,0
5246,5246,Marcel Desailly,2614,2000,Chelsea FC,17,17,0,1515,1,0,17,17,0,1485,1,0,34,34,0,3000,2,0,0,1,1,1,1,2,0,0,0,0,0,0
5247,5247,Mario Melchiot,1512,2000,Chelsea FC,16,14,2,1293,0,0,14,13,1,1135,0,0,30,27,3,2428,0,0,0,0,0,0,0,0,0,0,0,0,0,0
5248,5248,John Terry,1534,2000,Chelsea FC,11,10,1,909,0,0,10,8,2,768,1,0,21,18,3,1677,1,0,0,1,1,0,1,1,0,0,0,0,0,0
5249,5249,Jon Harley,3053,2000,Chelsea FC,3,2,1,194,0,0,7,4,3,324,0,0,10,6,4,518,0,0,0,0,0,0,0,0,0,0,0,0,0,0
5250,5250,Gustavo Poyet,1128,2000,Chelsea FC,15,13,2,1151,7,0,13,8,5,775,4,0,28,21,7,1926,11,0,4,0,4,5,1,6,0,0,0,0,0,0
5251,5251,Dennis Wise,3054,2000,Chelsea FC,18,17,1,1531,1,0,17,17,0,1530,2,0,35,34,1,3061,3,0,0,0,0,1,1,2,0,0,0,0,0,0
5252,5252,Samuele Dalla Bona,3055,2000,Chelsea FC,14,14,0,1200,1,0,14,11,3,965,1,0,28,25,3,2165,2,0,0,0,0,0,1,1,0,0,0,0,0,0
5253,5253,Eiður Guðjohnsen,2373,2000,Chelsea FC,14,8,6,727,6,0,15,9,6,839,4,0,29,17,12,1566,10,0,3,0,3,3,2,5,0,0,0,0,0,0
5254,5254,Gianfranco Zola,2617,2000,Chelsea FC,19,17,2,1434,8,0,16,13,3,1086,1,0,35,30,5,2520,9,0,0,0,0,4,1,5,0,0,0,0,0,0
5255,5255,Winston Bogarde,3056,2000,Chelsea FC,5,1,4,143,0,0,4,1,3,174,0,0,9,2,7,317,0,0,0,0,0,0,0,0,0,0,0,0,0,0
5256,5256,Slaviša Jokanović,3057,2000,Chelsea FC,9,2,7,317,0,0,9,5,4,443,0,0,18,7,11,760,0,0,0,0,0,0,0,0,0,0,0,0,0,0
5257,5257,Jody Morris,2293,2000,Chelsea FC,10,5,5,519,0,0,11,8,3,811,0,0,21,13,8,1330,0,0,0,0,0,0,0,0,0,0,0,0,0,0
5258,5258,Dan Petrescu,2898,2000,Bradford City,8,7,1,592,0,0,7,7,0,520,1,0,15,14,1,1112,1,0,0,1,1,0,1,1,0,0,0,0,0,0
5259,5259,Jamie Lawrence,3058,2000,Bradford City,8,6,2,575,1,0,6,6,0,540,0,0,14,12,2,1115,1,0,0,0,0,1,0,1,0,0,0,0,0,0
5260,5260,Lee Sharpe,3059,2000,Bradford City,5,3,2,279,0,0,4,3,1,172,0,0,9,6,3,451,0,0,0,0,0,0,0,0,0,0,0,0,0,0
5261,5261,Benito Carbone,2920,2000,Bradford City,15,15,0,1297,3,0,10,8,2,719,2,0,25,23,2,2016,5,0,1,0,1,1,1,2,0,0,0,0,0,0
5262,5262,Ian Nolan,3060,2000,Bradford City,10,7,3,699,0,0,10,9,1,806,0,0,20,16,4,1505,0,0,0,0,0,0,0,0,0,0,0,0,0,0
5263,5263,Peter Beagrie,3061,2000,Bradford City,7,5,2,482,1,0,9,3,6,317,0,0,16,8,8,799,1,0,3,0,3,1,0,1,0,0,0,0,0,0
5264,5264,Maik Taylor,2501,2002,Fulham FC,8,8,0,720,0,0,8,7,1,658,0,0,16,15,1,1378,0,0,0,0,0,0,0,0,0,0,0,0,0,0
5265,5265,Steve Finnan,2883,2002,Fulham FC,15,15,0,1350,0,0,13,13,0,1170,0,0,28,28,0,2520,0,0,0,0,0,0,0,0,0,0,0,0,0,0
5266,5266,Andy Melville,2894,2002,Fulham FC,11,11,0,966,0,0,11,10,1,949,0,0,22,21,1,1915,0,0,0,0,0,0,0,0,0,0,0,0,0,0
5267,5267,Martin Djetou,1079,2002,Fulham FC,12,11,1,973,1,0,9,7,2,536,0,0,21,18,3,1509,1,0,3,0,3,1,0,1,0,0,0,0,0,0
5268,5268,Alain Goma,1080,2002,Fulham FC,14,14,0,1215,0,0,13,13,0,1170,0,0,27,27,0,2385,0,0,0,0,0,0,0,0,0,0,0,0,0,0
5269,5269,Jon Harley,3053,2002,Fulham FC,6,6,0,540,1,0,3,3,0,270,0,0,9,9,0,810,1,0,3,0,3,1,0,1,0,0,0,0,0,0
5270,5270,Boa Morte,1085,2002,Fulham FC,12,10,2,838,0,0,12,11,1,953,2,0,24,21,3,1791,2,0,0,1,1,0,2,2,0,0,0,0,0,0
5271,5271,Steed Malbranque,1086,2002,Fulham FC,18,17,1,1471,3,0,15,14,1,1228,3,0,33,31,2,2699,6,0,0,0,0,2,2,4,3,0,3,0,0,0
5272,5272,Sean Davis,1087,2002,Fulham FC,12,12,0,1057,2,0,12,12,0,1072,1,0,24,24,0,2129,3,0,3,1,4,1,1,2,0,0,0,0,0,0
5273,5273,Steve Marlet,2896,2002,Fulham FC,13,13,0,1122,2,0,12,12,0,968,2,0,25,25,0,2090,4,0,0,0,0,1,1,2,1,0,1,0,0,0
5274,5274,Louis Saha,1727,2002,Fulham FC,9,8,1,585,4,0,7,4,3,481,1,0,16,12,4,1066,5,0,3,3,6,4,1,5,1,1,2,0,0,0
5275,5275,Zat Knight,1755,2002,Fulham FC,9,8,1,739,0,0,5,2,3,275,0,0,14,10,4,1014,0,0,0,0,0,0,0,0,0,0,0,0,0,0
5276,5276,Bjarne Goldbæk,3062,2002,Fulham FC,4,3,1,276,0,0,4,3,1,277,0,0,8,6,2,553,0,0,0,0,0,0,0,0,0,0,0,0,0,0
5277,5277,Facundo Sava,3063,2002,Fulham FC,10,8,2,673,3,0,9,5,4,389,2,0,19,13,6,1062,5,0,3,0,3,2,1,3,0,0,0,0,0,0
5278,5278,Peter Enckelman,1131,2002,Aston Villa,15,15,0,1350,0,0,17,17,0,1530,0,0,32,32,0,2880,0,0,0,0,0,0,0,0,0,0,0,0,0,0
5279,5279,Olof Mellberg,1790,2002,Aston Villa,18,18,0,1620,0,0,19,19,0,1710,1,0,37,37,0,3330,1,0,0,0,0,0,1,1,0,0,0,0,0,0
5280,5280,Jlloyd Samuel,1789,2002,Aston Villa,18,16,2,1491,0,0,19,16,3,1472,0,0,37,32,5,2963,0,0,0,0,0,0,0,0,0,0,0,0,0,0
5281,5281,Ronny Johnsen,2031,2002,Aston Villa,13,12,1,973,0,0,12,12,0,983,0,0,25,24,1,1956,0,0,0,0,0,0,0,0,0,0,0,0,0,0
5282,5282,Rob Edwards,2602,2002,Aston Villa,4,3,1,294,0,0,4,4,0,214,0,0,8,7,1,508,0,0,0,0,0,0,0,0,0,0,0,0,0,0
5283,5283,Gareth Barry,1418,2002,Aston Villa,17,17,0,1476,1,0,17,17,0,1472,2,0,34,34,0,2948,3,0,0,0,0,0,2,2,0,0,0,0,0,0
5284,5284,Thomas Hitzlsperger,1792,2002,Aston Villa,12,11,1,947,1,0,13,12,1,1016,1,0,25,23,2,1963,2,0,3,0,3,1,0,1,0,0,0,0,0,0
5285,5285,Jóhannes Guðjónsson,3064,2002,Aston Villa,5,4,1,277,0,0,6,5,1,513,2,0,11,9,2,790,2,0,0,0,0,0,1,1,0,0,0,0,0,0
5286,5286,Dion Dublin,2768,2002,Aston Villa,13,11,2,963,6,0,14,11,3,990,4,0,27,22,5,1953,10,0,6,2,8,4,3,7,0,1,1,0,0,0
5287,5287,Darius Vassell,1798,2002,Aston Villa,15,13,2,1226,4,0,17,14,3,1188,4,0,32,27,5,2414,8,0,3,0,3,2,2,4,0,1,1,0,0,0
5288,5288,Stefan Moore,3065,2002,Aston Villa,6,3,3,199,1,0,7,4,3,331,0,0,13,7,6,530,1,0,0,0,0,0,0,0,0,0,0,0,0,0
5289,5289,Ulises De la Cruz,1794,2002,Aston Villa,11,8,3,788,1,0,9,4,5,471,0,0,20,12,8,1259,1,0,0,0,0,1,0,1,0,0,0,0,0,0
5290,5290,Lee Hendrie,1797,2002,Aston Villa,14,13,1,1098,3,0,12,8,4,646,1,0,26,21,5,1744,4,0,0,0,0,2,1,3,0,0,0,0,0,0
5291,5291,Peter Crouch,1273,2002,Aston Villa,6,3,3,248,0,0,8,4,4,334,0,0,14,7,7,582,0,0,0,0,0,0,0,0,0,0,0,0,0,0
5292,5292,Jussi Jääskeläinen,1710,2001,Bolton Wanderers,17,17,0,1530,0,0,17,17,0,1530,0,0,34,34,0,3060,0,0,0,0,0,0,0,0,0,0,0,0,0,0
5293,5293,Mike Whitlow,3066,2001,Bolton Wanderers,16,15,1,1381,0,0,13,13,0,1125,0,0,29,28,1,2506,0,0,0,0,0,0,0,0,0,0,0,0,0,0
5294,5294,Djibril Diawara,3067,2001,Bolton Wanderers,6,2,4,282,0,0,3,2,1,191,0,0,9,4,5,473,0,0,0,0,0,0,0,0,0,0,0,0,0,0
5295,5295,Anthony Barness,3068,2001,Bolton Wanderers,12,10,2,856,0,0,13,9,4,933,0,0,25,19,6,1789,0,0,0,0,0,0,0,0,0,0,0,0,0,0
5296,5296,Paul Warhurst,3069,2001,Bolton Wanderers,14,14,0,1087,0,0,11,11,0,853,0,0,25,25,0,1940,0,0,0,0,0,0,0,0,0,0,0,0,0,0
5297,5297,Per Frandsen,3070,2001,Bolton Wanderers,15,12,3,1077,1,0,14,13,1,1089,2,0,29,25,4,2166,3,0,0,0,0,1,0,1,0,0,0,0,0,0
5298,5298,Ricardo Gardner,2411,2001,Bolton Wanderers,16,14,2,1229,2,0,15,15,0,1323,1,0,31,29,2,2552,3,0,3,0,3,2,1,3,0,0,0,0,0,0
5299,5299,Kevin Nolan,2396,2001,Bolton Wanderers,17,17,0,1466,3,0,18,17,1,1566,5,0,35,34,1,3032,8,0,4,1,5,2,4,6,0,0,0,0,0,0
5300,5300,Gareth Farrelly,3071,2001,Bolton Wanderers,8,5,3,442,0,0,10,6,4,665,0,0,18,11,7,1107,0,0,0,0,0,0,0,0,0,0,0,0,0,0
5301,5301,Simon Charlton,2388,2001,Bolton Wanderers,18,17,1,1519,0,0,18,18,0,1539,0,0,36,35,1,3058,0,0,0,0,0,0,0,0,0,0,0,0,0,0
5302,5302,Dean Holdsworth,3072,2001,Bolton Wanderers,16,5,11,626,2,0,15,4,11,498,0,0,31,9,22,1124,2,0,4,0,4,2,0,2,0,0,0,0,0,0
5303,5303,Nicky Southall,3073,2001,Bolton Wanderers,11,5,6,541,0,0,7,5,2,464,1,0,18,10,8,1005,1,0,0,0,0,0,1,1,0,0,0,0,0,0
5304,5304,Jermaine Johnson,3074,2001,Bolton Wanderers,5,2,3,253,0,0,5,2,3,200,0,0,10,4,6,453,0,0,0,0,0,0,0,0,0,0,0,0,0,0
5305,5305,Henrik Pedersen,1722,2001,Bolton Wanderers,4,2,2,184,0,0,7,3,4,310,0,0,11,5,6,494,0,0,0,0,0,0,0,0,0,0,0,0,0,0
5306,5306,Gary Kelly,2290,2001,Leeds United,9,9,0,810,0,0,9,8,1,721,0,0,18,17,1,1531,0,0,0,0,0,0,0,0,0,0,0,0,0,0
5307,5307,Jonathan Woodgate,1882,2001,Leeds United,4,4,0,360,0,0,8,6,2,506,0,0,12,10,2,866,0,0,0,0,0,0,0,0,0,0,0,0,0,0
5308,5308,Jason Wilcox,1301,2001,Leeds United,5,1,4,104,0,0,6,1,5,227,0,0,11,2,9,331,0,0,0,0,0,0,0,0,0,0,0,0,0,0
5309,5309,Shay Given,1581,2002,Newcastle United,19,19,0,1710,0,0,17,17,0,1530,0,0,36,36,0,3240,0,0,0,0,0,0,0,0,0,0,0,0,0,0
5310,5310,Andy O'Brien,2160,2002,Newcastle United,12,12,0,1061,0,0,12,12,0,996,0,0,24,24,0,2057,0,0,0,0,0,0,0,0,0,0,0,0,0,0
5311,5311,Titus Bramble,1411,2002,Newcastle United,8,6,2,596,0,0,8,7,1,645,0,0,16,13,3,1241,0,0,0,0,0,0,0,0,0,0,0,0,0,0
5312,5312,Aaron Hughes,1561,2002,Newcastle United,18,18,0,1620,1,0,15,15,0,1339,0,0,33,33,0,2959,1,0,3,0,3,1,0,1,0,0,0,0,0,0
5313,5313,Olivier Bernard,2032,2002,Newcastle United,16,13,3,1165,1,0,13,10,3,897,1,0,29,23,6,2062,2,0,3,0,3,1,1,2,0,0,0,0,0,0
5314,5314,Nolberto Solano,1791,2002,Newcastle United,17,17,0,1298,4,0,13,11,2,906,3,0,30,28,2,2204,7,0,0,3,3,3,2,5,0,1,1,0,0,0
5315,5315,Jermaine Jenas,1275,2002,Newcastle United,15,10,5,1035,3,0,15,11,4,1058,3,0,30,21,9,2093,6,0,3,4,7,2,3,5,0,0,0,0,0,0
5316,5316,Kieron Dyer,2033,2002,Newcastle United,17,16,1,1403,0,0,16,15,1,1364,2,0,33,31,2,2767,2,0,0,0,0,0,1,1,0,0,0,0,0,0
5317,5317,Laurent Robert,2034,2002,Newcastle United,15,14,1,1140,4,0,10,9,1,794,1,0,25,23,2,1934,5,0,7,0,7,4,1,5,0,0,0,0,0,0
5318,5318,Alan Shearer,1948,2002,Newcastle United,18,18,0,1599,7,0,15,15,0,1286,10,0,33,33,0,2885,17,0,3,4,7,4,6,10,0,2,2,0,0,0
5319,5319,Craig Bellamy,2012,2002,Newcastle United,15,14,1,1271,5,0,12,11,1,1004,3,0,27,25,2,2275,8,0,3,0,3,2,2,4,0,0,0,0,0,0
5320,5320,Gary Speed,1716,2002,Newcastle United,12,11,1,933,1,0,11,11,0,935,1,0,23,22,1,1868,2,0,0,0,0,1,0,1,0,0,0,0,0,0
5321,5321,Shola Ameobi,1950,2002,Newcastle United,15,5,10,520,3,0,13,3,10,420,2,0,28,8,20,940,5,0,0,0,0,2,0,2,0,0,0,0,0,0
5322,5322,Ray Parlour,1334,2002,Arsenal FC,8,5,3,517,0,0,11,9,2,757,0,0,19,14,5,1274,0,0,0,0,0,0,0,0,0,0,0,0,0,0
5323,5323,Paul Jones,2044,2003,Wolverhampton Wanderers,8,8,0,720,0,0,8,8,0,720,0,0,16,16,0,1440,0,0,0,0,0,0,0,0,0,0,0,0,0,0
5324,5324,Isaac Okoronkwo,3075,2003,Wolverhampton Wanderers,4,4,0,360,0,0,3,3,0,270,0,0,7,7,0,630,0,0,0,0,0,0,0,0,0,0,0,0,0,0
5325,5325,Shaun Newton,2862,2003,Wolverhampton Wanderers,15,11,4,973,0,0,13,9,4,744,0,0,28,20,8,1717,0,0,0,0,0,0,0,0,0,0,0,0,0,0
5326,5326,Carl Cort,2162,2003,Wolverhampton Wanderers,8,7,1,635,3,0,8,6,2,519,2,0,16,13,3,1154,5,0,3,1,4,2,1,3,0,0,0,0,0,0
5327,5327,Jussi Jääskeläinen,1710,2003,Bolton Wanderers,19,19,0,1710,0,0,19,19,0,1710,0,0,38,38,0,3420,0,0,0,0,0,0,0,0,0,0,0,0,0,0
5328,5328,Anthony Barness,3068,2003,Bolton Wanderers,7,4,3,440,0,0,8,7,1,545,0,0,15,11,4,985,0,0,0,0,0,0,0,0,0,0,0,0,0,0
5329,5329,Bruno N'Gotty,3076,2003,Bolton Wanderers,16,15,1,1357,2,0,17,17,0,1530,1,0,33,32,1,2887,3,0,0,0,0,1,1,2,0,0,0,0,0,0
5330,5330,Iván Campo,1713,2003,Bolton Wanderers,19,18,1,1556,2,0,19,19,0,1647,2,0,38,37,1,3203,4,0,0,0,0,2,0,2,0,0,0,0,0,0
5331,5331,Nicky Hunt,1711,2003,Bolton Wanderers,17,15,2,1361,1,0,14,13,1,1206,0,0,31,28,3,2567,1,0,0,0,0,1,0,1,0,0,0,0,0,0
5332,5332,Émerson Thome,1102,2003,Bolton Wanderers,14,13,1,1190,0,0,12,12,0,1069,0,0,26,25,1,2259,0,0,0,0,0,0,0,0,0,0,0,0,0,0
5333,5333,Kevin Nolan,2396,2003,Bolton Wanderers,19,19,0,1626,2,0,18,18,0,1488,7,0,37,37,0,3114,9,0,0,9,9,1,7,8,0,0,0,0,0,0
5334,5334,Stylianos Giannakopoulos,1717,2003,Bolton Wanderers,14,7,7,606,0,0,17,10,7,955,2,0,31,17,14,1561,2,0,0,0,0,0,1,1,0,0,0,0,0,0
5335,5335,Per Frandsen,3070,2003,Bolton Wanderers,14,9,5,792,1,0,19,13,6,1124,0,0,33,22,11,1916,1,0,0,0,0,1,0,1,0,0,0,0,0,0
5336,5336,Henrik Pedersen,1722,2003,Bolton Wanderers,17,10,7,899,4,0,16,9,7,853,3,0,33,19,14,1752,7,0,4,0,4,3,2,5,0,0,0,0,0,0
5337,5337,Kevin Davies,1718,2003,Bolton Wanderers,19,19,0,1680,5,0,19,19,0,1626,4,0,38,38,0,3306,9,0,5,6,11,5,4,9,0,0,0,0,0,0
5338,5338,Youri Djorkaeff,3077,2003,Bolton Wanderers,15,14,1,1222,6,0,12,10,2,826,3,0,27,24,3,2048,9,0,0,3,3,4,2,6,1,0,1,0,0,0
5339,5339,Jay Jay Okocha,2865,2003,Bolton Wanderers,18,17,1,1553,0,0,17,16,1,1413,0,0,35,33,2,2966,0,0,0,0,0,0,0,0,0,0,0,0,0,0
5340,5340,Antti Niemi,1559,2002,Southampton FC,13,13,0,1166,0,0,12,12,0,1080,0,0,25,25,0,2246,0,0,0,0,0,0,0,0,0,0,0,0,0,0
5341,5341,Michael Svensson,2914,2002,Southampton FC,16,16,0,1440,0,0,16,15,1,1396,2,0,32,31,1,2836,2,0,0,4,4,0,2,2,0,0,0,0,0,0
5342,5342,Matt Oakley,1573,2002,Southampton FC,15,13,2,1176,0,0,15,14,1,1243,0,0,30,27,3,2419,0,0,0,0,0,0,0,0,0,0,0,0,0,0
5343,5343,Brett Ormerod,2607,2002,Southampton FC,16,13,3,972,4,0,13,7,6,612,1,0,29,20,9,1584,5,0,0,0,0,2,1,3,0,0,0,0,0,0
5344,5344,Danny Higginbotham,1990,2002,Southampton FC,3,0,3,60,0,0,6,3,3,315,0,0,9,3,6,375,0,0,0,0,0,0,0,0,0,0,0,0,0,0
5345,5345,David Prutton,2915,2002,Southampton FC,5,3,2,351,0,0,6,5,1,447,0,0,11,8,3,798,0,0,0,0,0,0,0,0,0,0,0,0,0,0
5346,5346,Russell Hoult,1315,2002,West Bromwich Albion,19,19,0,1710,0,0,17,17,0,1530,0,0,36,36,0,3240,0,0,0,0,0,0,0,0,0,0,0,0,0,0
5347,5347,Ifeanyi Udeze,3078,2002,West Bromwich Albion,8,5,3,392,0,0,2,2,0,115,0,0,10,7,3,507,0,0,0,0,0,0,0,0,0,0,0,0,0,0
5348,5348,Darren Moore,1317,2002,West Bromwich Albion,15,15,0,1202,1,0,13,13,0,1170,1,0,28,28,0,2372,2,0,3,3,6,1,1,2,0,0,0,0,0,0
5349,5349,Phil Gilchrist,2829,2002,West Bromwich Albion,11,11,0,958,0,0,11,11,0,990,0,0,22,22,0,1948,0,0,0,0,0,0,0,0,0,0,0,0,0,0
5350,5350,Lárus Sigurðsson,3079,2002,West Bromwich Albion,13,11,2,991,0,0,15,11,4,1058,0,0,28,22,6,2049,0,0,0,0,0,0,0,0,0,0,0,0,0,0
5351,5351,Derek McInnes,3080,2002,West Bromwich Albion,13,12,1,985,0,0,15,15,0,1279,2,0,28,27,1,2264,2,0,0,0,0,0,1,1,0,0,0,0,0,0
5352,5352,Sean Gregan,3081,2002,West Bromwich Albion,17,17,0,1507,1,0,18,18,0,1590,0,0,35,35,0,3097,1,0,3,0,3,1,0,1,0,0,0,0,0,0
5353,5353,Jason Koumas,2062,2002,West Bromwich Albion,16,14,2,1248,2,0,15,12,3,1020,2,0,31,26,5,2268,4,0,0,1,1,1,2,3,0,0,0,0,0,0
5354,5354,Ronnie Wallwork,1600,2002,West Bromwich Albion,15,12,3,1115,0,0,12,11,1,1001,0,0,27,23,4,2116,0,0,0,0,0,0,0,0,0,0,0,0,0,0
5355,5355,Danny Dichio,3082,2002,West Bromwich Albion,15,10,5,1019,5,0,12,9,3,841,0,0,27,19,8,1860,5,0,3,0,3,5,0,5,0,0,0,0,0,0
5356,5356,Lee Hughes,3083,2002,West Bromwich Albion,10,7,3,583,0,0,12,6,6,499,0,0,22,13,9,1082,0,0,0,0,0,0,0,0,0,0,0,0,0,0
5357,5357,Neil Clement,1320,2002,West Bromwich Albion,17,16,1,1464,2,0,18,17,1,1595,1,0,35,33,2,3059,3,0,0,0,0,2,1,3,0,0,0,0,0,0
5358,5358,Jordão,3084,2002,West Bromwich Albion,1,0,1,4,0,0,2,0,2,23,0,0,3,0,3,27,0,0,0,0,0,0,0,0,0,0,0,0,0,0
5359,5359,Scott Dobie,3085,2002,West Bromwich Albion,15,3,12,479,2,0,15,7,8,706,3,0,30,10,20,1185,5,0,0,0,0,2,1,3,0,0,0,0,0,0
5360,5360,Jon Flanagan,1263,2011,Liverpool FC,3,3,0,270,0,0,2,2,0,116,0,0,5,5,0,386,0,0,0,0,0,0,0,0,0,0,0,0,0,0
5361,5361,Steven Gerrard,1424,2011,Liverpool FC,10,7,3,691,5,0,8,5,3,522,0,0,18,12,6,1213,5,0,0,0,0,2,0,2,0,0,0,0,0,0
5362,5362,Jonjo Shelvey,1699,2011,Liverpool FC,6,3,3,273,1,0,7,5,2,455,0,0,13,8,5,728,1,0,0,0,0,0,0,0,0,0,0,0,0,0
5363,5363,Brad Jones,1431,2011,Liverpool FC,0,0,0,0,0,0,1,0,1,64,0,0,1,0,1,64,0,0,0,0,0,0,0,0,0,0,0,0,0,0
5364,5364,Sebastián Coates,2526,2011,Liverpool FC,2,2,0,180,0,0,5,2,3,304,1,0,7,4,3,484,1,0,0,0,0,0,1,1,0,0,0,0,0,0
5365,5365,Enda Stevens,1972,2011,Aston Villa,0,0,0,0,0,0,0,0,0,0,0,0,0,0,0,0,0,0,0,0,0,0,0,0,0,0,0,0,0,0
5366,5366,Derrick Williams,3086,2011,Aston Villa,0,0,0,0,0,0,0,0,0,0,0,0,0,0,0,0,0,0,0,0,0,0,0,0,0,0,0,0,0,0
5367,5367,Wes Brown,1108,2006,Manchester United,13,9,4,922,0,0,9,8,1,679,0,0,22,17,5,1601,0,0,0,0,0,0,0,0,0,0,0,0,0,0
5368,5368,Ji-Sung Park,1788,2006,Manchester United,8,6,2,521,5,0,6,2,4,252,0,0,14,8,6,773,5,0,0,0,0,3,0,3,0,0,0,0,0,0
5369,5369,Alan Smith,1300,2006,Manchester United,5,3,2,241,0,0,4,3,1,239,0,0,9,6,3,480,0,0,0,0,0,0,0,0,0,0,0,0,0,0
5370,5370,Ole Gunnar Solskjær,1116,2006,Manchester United,11,5,6,516,5,0,8,4,4,401,2,0,19,9,10,917,7,0,0,0,0,2,0,2,0,0,0,0,0,0
5371,5371,Brad Friedel,1343,2006,Blackburn Rovers,19,19,0,1666,0,0,18,18,0,1620,0,0,37,37,0,3286,0,0,0,0,0,0,0,0,0,0,0,0,0,0
5372,5372,Ryan Nelsen,2007,2006,Blackburn Rovers,5,5,0,450,0,0,6,6,0,540,0,0,11,11,0,990,0,0,0,0,0,0,0,0,0,0,0,0,0,0
5373,5373,Aaron Mokoena,2008,2006,Blackburn Rovers,15,8,7,782,0,0,11,9,2,810,0,0,26,17,9,1592,0,0,0,0,0,0,0,0,0,0,0,0,0,0
5374,5374,Christopher Samba,2109,2006,Blackburn Rovers,7,7,0,586,2,0,6,5,1,461,0,0,13,12,1,1047,2,0,0,0,0,2,0,2,0,0,0,0,0,0
5375,5375,Tugay Kerimoğlu,1136,2006,Blackburn Rovers,16,13,3,1113,1,0,14,13,1,1130,0,0,30,26,4,2243,1,0,0,0,0,1,0,1,0,0,0,0,0,0
5376,5376,Brett Emerton,1141,2006,Blackburn Rovers,18,18,0,1620,0,0,15,13,2,1218,0,0,33,31,2,2838,0,0,0,0,0,0,0,0,0,0,0,0,0,0
5377,5377,Morten Gamst Pedersen,2009,2006,Blackburn Rovers,19,19,0,1643,4,0,16,16,0,1377,2,0,35,35,0,3020,6,0,3,0,3,3,1,4,0,0,0,0,0,0
5378,5378,David Dunn,1456,2006,Blackburn Rovers,7,3,4,306,0,0,3,3,0,195,0,0,10,6,4,501,0,0,0,0,0,0,0,0,0,0,0,0,0,0
5379,5379,Stephen Warnock,1616,2006,Blackburn Rovers,7,7,0,630,1,0,5,5,0,450,0,0,12,12,0,1080,1,0,0,0,0,0,0,0,0,0,0,0,0,0
5380,5380,Benny McCarthy,2112,2006,Blackburn Rovers,18,18,0,1592,9,0,17,17,0,1381,9,0,35,35,0,2973,18,0,9,1,10,7,7,14,1,3,4,0,0,0
5381,5381,Matt Derbyshire,2247,2006,Blackburn Rovers,12,5,7,394,2,0,10,3,7,383,3,0,22,8,14,777,5,0,0,0,0,1,1,2,0,0,0,0,0,0
5382,5382,Sergio Peter,3087,2006,Blackburn Rovers,5,0,5,45,0,0,4,1,3,163,0,0,9,1,8,208,0,0,0,0,0,0,0,0,0,0,0,0,0,0
5383,5383,Jason Roberts,1820,2006,Blackburn Rovers,9,4,5,520,3,0,8,4,4,396,1,0,17,8,9,916,4,0,0,0,0,1,0,1,0,0,0,0,0,0
5384,5384,Nigel Reo-Coker,2494,2009,Aston Villa,5,4,1,310,0,0,5,2,3,215,0,0,10,6,4,525,0,0,0,0,0,0,0,0,0,0,0,0,0,0
5385,5385,Shay Given,1581,2009,Manchester City,17,17,0,1530,0,0,17,17,0,1513,0,0,34,34,0,3043,0,0,0,0,0,0,0,0,0,0,0,0,0,0
5386,5386,Wayne Bridge,1768,2009,Manchester City,12,12,0,1044,0,0,10,10,0,763,0,0,22,22,0,1807,0,0,0,0,0,0,0,0,0,0,0,0,0,0
5387,5387,Pablo Zabaleta,1355,2009,Manchester City,13,11,2,1007,0,0,14,12,2,1119,0,0,27,23,4,2126,0,0,0,0,0,0,0,0,0,0,0,0,0,0
5388,5388,Joleon Lescott,1365,2009,Manchester City,8,7,1,665,1,0,9,9,0,810,0,0,17,16,1,1475,1,0,0,0,0,1,0,1,0,0,0,0,0,0
5389,5389,Kolo Touré,1415,2009,Manchester City,17,17,0,1495,1,0,13,13,0,1126,0,0,30,30,0,2621,1,0,0,0,0,1,0,1,0,0,0,0,0,0
5390,5390,Shaun Wright-Phillips,1683,2009,Manchester City,16,9,7,847,3,0,13,9,4,810,1,0,29,18,11,1657,4,0,0,1,1,1,1,2,0,0,0,0,0,0
5391,5391,Gareth Barry,1418,2009,Manchester City,16,16,0,1405,0,0,17,17,0,1501,2,0,33,33,0,2906,2,0,0,1,1,0,2,2,0,0,0,0,0,0
5392,5392,Nigel de Jong,1680,2009,Manchester City,17,16,1,1419,0,0,16,13,3,1129,0,0,33,29,4,2548,0,0,0,0,0,0,0,0,0,0,0,0,0,0
5393,5393,Emmanuel Adebayor,1235,2009,Manchester City,14,14,0,1223,8,0,12,11,1,989,6,0,26,25,1,2212,14,0,3,3,6,4,4,8,0,0,0,0,0,0
5394,5394,Carlos Tévez,1417,2009,Manchester City,17,17,0,1489,15,0,17,14,3,1290,8,0,34,31,3,2779,23,0,3,1,4,7,4,11,4,1,5,0,0,0
5395,5395,Craig Bellamy,2012,2009,Manchester City,17,11,6,1085,4,0,14,14,0,1230,6,0,31,25,6,2315,10,0,0,1,1,3,4,7,0,0,0,0,0,0
5396,5396,Stephen Ireland,1809,2009,Manchester City,11,9,2,758,0,0,10,6,4,603,2,0,21,15,6,1361,2,0,0,0,0,0,1,1,0,0,0,0,0,0
5397,5397,Roque Santa Cruz,2110,2009,Manchester City,7,1,6,173,2,0,12,5,7,465,1,0,19,6,13,638,3,0,3,0,3,2,1,3,0,0,0,0,0,0
5398,5398,Shay Given,1581,2008,Manchester City,7,7,0,630,0,0,8,8,0,720,0,0,15,15,0,1350,0,0,0,0,0,0,0,0,0,0,0,0,0,0
5399,5399,Nedum Onuoha,2533,2008,Manchester City,11,9,2,874,1,0,11,10,1,906,0,0,22,19,3,1780,1,0,0,0,0,0,0,0,0,0,0,0,0,0
5400,5400,Pablo Zabaleta,1355,2008,Manchester City,16,14,2,1304,1,0,12,11,1,1001,0,0,28,25,3,2305,1,0,3,0,3,1,0,1,0,0,0,0,0,0
5401,5401,Richard Dunne,1617,2008,Manchester City,16,16,0,1426,1,0,14,14,0,1260,0,0,30,30,0,2686,1,0,0,0,0,0,0,0,0,0,0,0,0,0
5402,5402,Wayne Bridge,1768,2008,Manchester City,7,7,0,624,0,0,9,9,0,737,0,0,16,16,0,1361,0,0,0,0,0,0,0,0,0,0,0,0,0,0
5403,5403,Vincent Kompany,1414,2008,Manchester City,17,17,0,1516,0,0,16,16,0,1388,1,0,33,33,0,2904,1,0,0,0,0,0,1,1,0,0,0,0,0,0
5404,5404,Stephen Ireland,1809,2008,Manchester City,17,17,0,1493,4,0,16,16,0,1440,5,0,33,33,0,2933,9,0,0,1,1,3,4,7,0,0,0,0,0,0
5405,5405,Elano,3031,2008,Manchester City,14,11,3,1010,5,0,13,9,4,775,1,0,27,20,7,1785,6,0,0,0,0,2,1,3,3,1,4,0,0,0
5406,5406,Nigel de Jong,1680,2008,Manchester City,8,8,0,665,0,0,8,8,0,684,0,0,16,16,0,1349,0,0,0,0,0,0,0,0,0,0,0,0,0,0
5407,5407,Robinho,3088,2008,Manchester City,17,16,1,1422,11,0,14,14,0,1209,3,0,31,30,1,2631,14,0,0,1,1,4,3,7,0,1,1,0,0,0
5408,5408,Felipe Caicedo,3089,2008,Manchester City,7,5,2,337,4,0,10,5,5,487,0,0,17,10,7,824,4,0,3,0,3,3,0,3,0,0,0,0,0,0
5409,5409,Martin Petrov,2492,2008,Manchester City,5,2,3,164,0,0,4,2,2,174,0,0,9,4,5,338,0,0,0,0,0,0,0,0,0,0,0,0,0,0
5410,5410,Gelson Fernandes,3090,2008,Manchester City,10,1,9,243,1,0,6,1,5,229,0,0,16,2,14,472,1,0,0,0,0,0,0,0,0,0,0,0,0,0
5411,5411,Daniel Sturridge,1428,2008,Manchester City,9,2,7,286,3,0,6,1,5,144,1,0,15,3,12,430,4,0,0,0,0,1,0,1,1,0,1,0,0,0
5412,5412,Graham Dorrans,1737,2008,West Bromwich Albion,5,2,3,185,0,0,3,3,0,243,0,0,8,5,3,428,0,0,0,0,0,0,0,0,0,0,0,0,0,0
5413,5413,James Morrison,1735,2008,West Bromwich Albion,15,14,1,1168,2,0,15,15,0,1199,1,0,30,29,1,2367,3,0,0,0,0,1,0,1,0,0,0,0,0,0
5414,5414,Marc-Antoine Fortuné,1742,2008,West Bromwich Albion,9,9,0,745,4,0,8,8,0,683,0,0,17,17,0,1428,4,0,0,0,0,2,0,2,0,0,0,0,0,0
5415,5415,Youssuf Mulumbu,1773,2008,West Bromwich Albion,3,1,2,148,0,0,3,1,2,100,0,0,6,2,4,248,0,0,0,0,0,0,0,0,0,0,0,0,0,0
5416,5416,Jay Simpson,3091,2008,West Bromwich Albion,6,5,1,307,0,0,7,4,3,397,1,0,13,9,4,704,1,0,0,0,0,0,1,1,0,0,0,0,0,0
5417,5417,Adrián,2309,2013,West Ham United,10,10,0,900,0,0,10,10,0,900,0,0,20,20,0,1800,0,0,0,0,0,0,0,0,0,0,0,0,0,0
5418,5418,George McCartney,1340,2013,West Ham United,11,11,0,990,0,0,11,9,2,851,0,0,22,20,2,1841,0,0,0,0,0,0,0,0,0,0,0,0,0,0
5419,5419,James Tomkins,1281,2013,West Ham United,15,15,0,1270,0,0,16,16,0,1349,0,0,31,31,0,2619,0,0,0,0,0,0,0,0,0,0,0,0,0,0
5420,5420,Joey O'Brien,2412,2013,West Ham United,8,6,2,571,0,0,9,7,2,665,0,0,17,13,4,1236,0,0,0,0,0,0,0,0,0,0,0,0,0,0
5421,5421,James Collins,1618,2013,West Ham United,13,13,0,1037,1,0,11,9,2,862,0,0,24,22,2,1899,1,0,0,0,0,1,0,1,0,0,0,0,0,0
5422,5422,Kevin Nolan,2396,2013,West Ham United,17,17,0,1403,5,0,16,16,0,1343,2,0,33,33,0,2746,7,0,0,0,0,2,1,3,0,0,0,0,0,0
5423,5423,Matthew Jarvis,2627,2013,West Ham United,18,13,5,1010,1,0,14,10,4,939,1,0,32,23,9,1949,2,0,0,0,0,1,1,2,0,0,0,0,0,0
5424,5424,Mark Noble,2204,2013,West Ham United,19,19,0,1704,2,0,19,19,0,1651,1,0,38,38,0,3355,3,0,0,0,0,2,0,2,2,0,2,0,0,0
5425,5425,Momo Diamé,2060,2013,West Ham United,18,14,4,1276,2,0,17,15,2,1207,2,0,35,29,6,2483,4,0,0,0,0,1,1,2,0,0,0,0,0,0
5426,5426,Joe Cole,1630,2013,West Ham United,10,5,5,479,3,0,10,1,9,261,0,0,20,6,14,740,3,0,0,0,0,2,0,2,0,0,0,0,0,0
5427,5427,Carlton Cole,2326,2013,West Ham United,13,5,8,487,3,0,13,4,9,362,2,0,26,9,17,849,5,0,0,0,0,2,1,3,0,0,0,0,0,0
5428,5428,Răzvan Raţ,3092,2013,West Ham United,6,5,1,502,0,0,9,6,3,627,0,0,15,11,4,1129,0,0,0,0,0,0,0,0,0,0,0,0,0,0
5429,5429,Guy Demel,3093,2013,West Ham United,16,14,2,1309,1,0,16,16,0,1328,0,0,32,30,2,2637,1,0,0,0,0,1,0,1,0,0,0,0,0,0
5430,5430,Matthew Taylor,1069,2013,West Ham United,10,8,2,701,0,0,10,8,2,710,0,0,20,16,4,1411,0,0,0,0,0,0,0,0,0,0,0,0,0,0
5431,5431,Jussi Jääskeläinen,1710,2013,West Ham United,9,9,0,810,0,0,9,9,0,810,0,0,18,18,0,1620,0,0,0,0,0,0,0,0,0,0,0,0,0,0
5432,5432,Jack Collison,1285,2013,West Ham United,6,3,3,196,0,0,4,3,1,267,0,0,10,6,4,463,0,0,0,0,0,0,0,0,0,0,0,0,0,0
5433,5433,Alou Diarra,3094,2013,West Ham United,1,0,1,8,0,0,2,1,1,105,0,0,3,1,2,113,0,0,0,0,0,0,0,0,0,0,0,0,0,0
5434,5434,Modibo Maïga,2763,2013,West Ham United,7,5,2,508,1,0,7,6,1,498,0,0,14,11,3,1006,1,0,0,0,0,1,0,1,0,0,0,0,0,0
5435,5435,Santi Cazorla,1502,2013,Arsenal FC,17,16,1,1383,3,0,14,14,0,1213,1,0,31,30,1,2596,4,0,0,0,0,2,1,3,0,0,0,0,0,0
5436,5436,Theo Walcott,1237,2013,Arsenal FC,7,4,3,419,1,0,6,5,1,439,4,0,13,9,4,858,5,0,0,0,0,0,3,3,0,0,0,0,0,0
5437,5437,Lukas Podolski,3095,2013,Arsenal FC,10,7,3,629,3,0,10,7,3,544,5,0,20,14,6,1173,8,0,0,0,0,2,0,2,0,0,0,0,0,0
5438,5438,Jonas Lössl,2449,2017,Huddersfield Town,19,19,0,1710,0,0,19,19,0,1710,0,0,38,38,0,3420,0,0,0,0,0,0,0,0,0,0,0,0,0,0
5439,5439,Scott Malone,3096,2017,Huddersfield Town,11,7,4,587,0,0,11,5,6,529,0,0,22,12,10,1116,0,0,0,0,0,0,0,0,0,0,0,0,0,0
5440,5440,Zanka,3097,2017,Huddersfield Town,19,19,0,1710,0,0,19,19,0,1710,0,0,38,38,0,3420,0,0,0,0,0,0,0,0,0,0,0,0,0,0
5441,5441,Christopher Schindler,3098,2017,Huddersfield Town,19,19,0,1710,0,0,18,18,0,1589,0,0,37,37,0,3299,0,0,0,0,0,0,0,0,0,0,0,0,0,0
5442,5442,Florent Hadergjonaj,3099,2017,Huddersfield Town,10,9,1,789,0,0,13,10,3,884,0,0,23,19,4,1673,0,0,0,0,0,0,0,0,0,0,0,0,0,0
5443,5443,Jonathan Hogg,2598,2017,Huddersfield Town,17,16,1,1361,0,0,13,13,0,1076,0,0,30,29,1,2437,0,0,0,0,0,0,0,0,0,0,0,0,0,0
5444,5444,Aaron Mooy,2430,2017,Huddersfield Town,19,19,0,1635,2,0,17,15,2,1435,2,0,36,34,2,3070,4,0,3,0,3,2,0,2,0,1,1,0,0,0
5445,5445,Rajiv van La Parra,3100,2017,Huddersfield Town,16,12,4,1021,2,0,17,14,3,1125,1,0,33,26,7,2146,3,0,3,0,3,1,1,2,1,0,1,0,0,0
5446,5446,Tom Ince,2232,2017,Huddersfield Town,18,16,2,1350,2,0,15,11,4,1106,0,0,33,27,6,2456,2,0,3,0,3,2,0,2,0,0,0,0,0,0
5447,5447,Elias Kachunga,3101,2017,Huddersfield Town,9,8,1,622,0,0,10,9,1,716,1,0,19,17,2,1338,1,0,0,0,0,0,1,1,0,0,0,0,0,0
5448,5448,Laurent Depoitre,3102,2017,Huddersfield Town,15,8,7,824,3,0,18,10,8,985,3,0,33,18,15,1809,6,0,0,1,1,1,2,3,0,0,0,0,0,0
5449,5449,Martin Cranie,3103,2017,Huddersfield Town,1,0,1,29,0,0,2,2,0,151,0,0,3,2,1,180,0,0,0,0,0,0,0,0,0,0,0,0,0,0
5450,5450,Chris Löwe,3104,2017,Huddersfield Town,13,10,3,900,0,0,10,9,1,693,0,0,23,19,4,1593,0,0,0,0,0,0,0,0,0,0,0,0,0,0
5451,5451,Daniel Williams,3105,2017,Huddersfield Town,9,4,5,447,0,0,11,7,4,670,0,0,20,11,9,1117,0,0,0,0,0,0,0,0,0,0,0,0,0,0
5452,5452,Robert Green,1277,2017,Huddersfield Town,0,0,0,0,0,0,0,0,0,0,0,0,0,0,0,0,0,0,0,0,0,0,0,0,0,0,0,0,0,0
5453,5453,Tom Smith,3106,2017,Huddersfield Town,11,10,1,925,0,0,13,11,2,982,0,0,24,21,3,1907,0,0,0,0,0,0,0,0,0,0,0,0,0,0
5454,5454,Collin Quaner,3107,2017,Huddersfield Town,13,6,7,597,0,0,13,7,6,676,0,0,26,13,13,1273,0,0,0,0,0,0,0,0,0,0,0,0,0,0
5455,5455,Steve Mounié,3108,2017,Huddersfield Town,14,12,2,998,3,0,14,9,5,859,4,0,28,21,7,1857,7,0,0,1,1,2,1,3,0,0,0,0,0,0
5456,5456,Nacer Chadli,1170,2017,West Bromwich Albion,1,0,1,11,0,0,4,2,2,233,1,0,5,2,3,244,1,0,0,0,0,0,1,1,0,0,0,0,0,0
5457,5457,Dieumerci Mbokani,2628,2016,Hull City,8,5,3,534,0,0,4,3,1,229,0,0,12,8,4,763,0,0,0,0,0,0,0,0,0,0,0,0,0,0
5458,5458,Joel,1060,2016,Everton FC,11,10,1,926,0,0,9,9,0,810,0,0,20,19,1,1736,0,0,0,0,0,0,0,0,0,0,0,0,0,0
5459,5459,Leighton Baines,1466,2016,Everton FC,17,17,0,1486,2,0,15,15,0,1336,0,0,32,32,0,2822,2,0,1,0,1,1,0,1,2,0,2,0,0,0
5460,5460,Ashley Williams,1061,2016,Everton FC,17,17,0,1530,1,0,19,18,1,1629,0,0,36,35,1,3159,1,0,3,0,3,1,0,1,0,0,0,0,0,0
5461,5461,Phil Jagielka,1048,2016,Everton FC,13,12,1,1080,2,0,14,13,1,1171,1,0,27,25,2,2251,3,0,0,0,0,2,1,3,0,0,0,0,0,0
5462,5462,Séamus Coleman,1467,2016,Everton FC,13,13,0,1147,3,0,13,13,0,1170,1,0,26,26,0,2317,4,0,1,3,4,3,1,4,0,0,0,0,0,0
5463,5463,Ross Barkley,1754,2016,Everton FC,18,18,0,1576,4,0,18,14,4,1332,1,0,36,32,4,2908,5,0,3,1,4,2,1,3,0,0,0,0,0,0
5464,5464,Idrissa Gueye,1054,2016,Everton FC,17,16,1,1415,1,0,16,16,0,1273,0,0,33,32,1,2688,1,0,0,0,0,1,0,1,0,0,0,0,0,0
5465,5465,Gareth Barry,1418,2016,Everton FC,15,9,6,923,1,0,18,14,4,1187,1,0,33,23,10,2110,2,0,0,3,3,1,1,2,0,0,0,0,0,0
5466,5466,Romelu Lukaku,1645,2016,Everton FC,18,18,0,1596,16,0,19,18,1,1671,9,0,37,36,1,3267,25,0,0,0,0,5,3,8,0,1,1,0,0,0
5467,5467,Kevin Mirallas,2238,2016,Everton FC,17,10,7,966,2,0,18,13,5,1114,2,0,35,23,12,2080,4,0,0,0,0,1,2,3,0,0,0,0,0,0
5468,5468,Enner Valencia,2715,2016,Everton FC,11,3,8,427,2,0,10,2,8,279,1,0,21,5,16,706,3,0,0,0,0,1,0,1,0,0,0,0,0,0
5469,5469,Ramiro Funes Mori,3109,2016,Everton FC,13,8,5,814,0,0,10,8,2,724,0,0,23,16,7,1538,0,0,0,0,0,0,0,0,0,0,0,0,0,0
5470,5470,Tom Davies,1063,2016,Everton FC,11,9,2,808,2,0,13,9,4,736,0,0,24,18,6,1544,2,0,0,0,0,1,0,1,0,0,0,0,0,0
5471,5471,Dominic Calvert-Lewin,1056,2016,Everton FC,6,3,3,174,1,0,5,2,3,172,0,0,11,5,6,346,1,0,0,0,0,1,0,1,0,0,0,0,0,0
5472,5472,Mateusz Hewelt,3110,2016,Everton FC,0,0,0,0,0,0,0,0,0,0,0,0,0,0,0,0,0,0,0,0,0,0,0,0,0,0,0,0,0,0
5473,5473,Mason Holgate,1062,2016,Everton FC,9,7,2,619,0,0,9,9,0,754,0,0,18,16,2,1373,0,0,0,0,0,0,0,0,0,0,0,0,0,0
5474,5474,Aaron Lennon,1052,2016,Everton FC,6,4,2,302,0,0,5,2,3,207,0,0,11,6,5,509,0,0,0,0,0,0,0,0,0,0,0,0,0,0
5475,5475,Tom Cleverley,2091,2016,Everton FC,5,2,3,179,0,0,5,2,3,224,0,0,10,4,6,403,0,0,0,0,0,0,0,0,0,0,0,0,0,0
5476,5476,Mark Fish,1671,2003,Charlton Athletic,11,11,0,899,0,0,12,12,0,979,0,0,23,23,0,1878,0,0,0,0,0,0,0,0,0,0,0,0,0,0
5477,5477,Luke Young,1952,2003,Charlton Athletic,11,10,1,944,0,0,13,11,2,967,0,0,24,21,3,1911,0,0,0,0,0,0,0,0,0,0,0,0,0,0
5478,5478,Claus Jensen,1674,2003,Charlton Athletic,16,13,3,1143,1,0,14,13,1,1132,3,0,30,26,4,2275,4,0,0,0,0,0,0,0,0,0,0,0,0,0
5479,5479,Kevin Lisbie,2337,2003,Charlton Athletic,4,3,1,255,3,0,5,2,3,197,1,0,9,5,4,452,4,0,3,0,3,3,0,3,0,0,0,0,0,0
5480,5480,Shaun Bartlett,1675,2003,Charlton Athletic,10,7,3,538,1,0,9,6,3,551,4,0,19,13,6,1089,5,0,0,6,6,1,2,3,0,0,0,0,0,0
5481,5481,Jerzy Dudek,2899,2003,Liverpool FC,13,13,0,1170,0,0,14,14,0,1247,0,0,27,27,0,2417,0,0,0,0,0,0,0,0,0,0,0,0,0,0
5482,5482,Steve Finnan,2883,2003,Liverpool FC,8,6,2,606,0,0,11,10,1,850,0,0,19,16,3,1456,0,0,0,0,0,0,0,0,0,0,0,0,0,0
5483,5483,Sami Hyypiä,2361,2003,Liverpool FC,17,17,0,1530,2,0,18,18,0,1620,2,0,35,35,0,3150,4,0,3,0,3,2,2,4,0,0,0,0,0,0
5484,5484,John Arne Riise,2362,2003,Liverpool FC,14,13,1,1194,0,0,12,7,5,708,0,0,26,20,6,1902,0,0,0,0,0,0,0,0,0,0,0,0,0,0
5485,5485,Harry Kewell,1296,2003,Liverpool FC,16,16,0,1338,3,0,17,17,0,1521,4,0,33,33,0,2859,7,0,0,0,0,2,1,3,0,0,0,0,0,0
5486,5486,Vladimír Šmicer,2692,2003,Liverpool FC,11,9,2,657,1,0,9,6,3,540,2,0,20,15,5,1197,3,0,0,0,0,0,2,2,0,0,0,0,0,0
5487,5487,Steven Gerrard,1424,2003,Liverpool FC,15,15,0,1334,2,0,16,16,0,1403,2,0,31,31,0,2737,4,0,3,1,4,2,1,3,1,0,1,0,0,0
5488,5488,Igor Bišćan,2365,2003,Liverpool FC,14,13,1,1154,0,0,15,14,1,1171,0,0,29,27,2,2325,0,0,0,0,0,0,0,0,0,0,0,0,0,0
5489,5489,Emile Heskey,1519,2003,Liverpool FC,16,11,5,1045,5,0,17,12,5,1164,2,0,33,23,10,2209,7,0,0,0,0,0,1,1,0,0,0,0,0,0
5490,5490,El-Hadji Diouf,1719,2003,Liverpool FC,15,10,5,861,0,0,11,10,1,846,0,0,26,20,6,1707,0,0,0,0,0,0,0,0,0,0,0,0,0,0
5491,5491,Michael Owen,1949,2003,Liverpool FC,13,13,0,1087,9,0,13,13,0,1127,7,0,26,26,0,2214,16,0,1,0,1,6,6,12,2,2,4,0,0,0
5492,5492,Danny Murphy,1398,2003,Liverpool FC,14,8,6,841,2,0,15,9,6,894,3,0,29,17,12,1735,5,0,0,6,6,2,3,5,1,2,3,0,0,0
5493,5493,Anthony Le Tallec,3111,2003,Liverpool FC,7,1,6,189,0,0,5,1,4,135,0,0,12,2,10,324,0,0,0,0,0,0,0,0,0,0,0,0,0,0
5494,5494,Martin Dúbravka,2466,2018,Newcastle United,19,19,0,1710,0,0,19,19,0,1710,0,0,38,38,0,3420,0,0,0,0,0,0,0,0,0,0,0,0,0,0
5495,5495,Ciaran Clark,1437,2018,Newcastle United,6,4,2,416,1,0,5,5,0,441,2,0,11,9,2,857,3,0,0,0,0,0,1,1,0,0,0,0,0,0
5496,5496,Paul Dummett,2467,2018,Newcastle United,13,10,3,979,0,0,13,11,2,1007,0,0,26,21,5,1986,0,0,0,0,0,0,0,0,0,0,0,0,0,0
5497,5497,Jamaal Lascelles,2631,2018,Newcastle United,16,16,0,1308,0,0,16,16,0,1440,0,0,32,32,0,2748,0,0,0,0,0,0,0,0,0,0,0,0,0,0
5498,5498,Matt Ritchie,1008,2018,Newcastle United,19,19,0,1557,1,0,17,16,1,1383,1,0,36,35,1,2940,2,0,3,1,4,1,1,2,1,0,1,0,0,0
5499,5499,DeAndre Yedlin,1175,2018,Newcastle United,16,15,1,1346,0,0,13,13,0,1162,1,0,29,28,1,2508,1,0,0,0,0,0,1,1,0,0,0,0,0,0
5500,5500,Jonjo Shelvey,1699,2018,Newcastle United,8,4,4,403,0,0,8,6,2,541,1,0,16,10,6,944,1,0,0,0,0,0,1,1,0,0,0,0,0,0
5501,5501,Momo Diamé,2060,2018,Newcastle United,13,11,2,960,0,0,16,13,3,1205,0,0,29,24,5,2165,0,0,0,0,0,0,0,0,0,0,0,0,0,0
5502,5502,Kenedy,2932,2018,Newcastle United,13,6,7,611,0,0,12,8,4,733,1,0,25,14,11,1344,1,0,0,0,0,0,1,1,0,0,0,0,0,0
5503,5503,Ayoze Pérez,2288,2018,Newcastle United,19,17,2,1526,9,0,18,17,1,1403,3,0,37,34,3,2929,12,0,6,3,9,5,2,7,0,0,0,0,0,0
5504,5504,Joselu,2195,2018,Newcastle United,9,3,6,308,2,0,7,2,5,278,0,0,16,5,11,586,2,0,0,0,0,2,0,2,0,0,0,0,0,0
5505,5505,Salomón Rondón,1659,2018,Newcastle United,16,15,1,1343,6,0,16,15,1,1266,5,0,32,30,2,2609,11,0,0,3,3,4,4,8,0,0,0,0,0,0
5506,5506,Yoshinori Mutō,2929,2018,Newcastle United,8,2,6,181,0,0,9,3,6,336,1,0,17,5,12,517,1,0,0,0,0,0,0,0,0,0,0,0,0,0
5507,5507,Christian Atsu,2244,2018,Newcastle United,13,7,6,711,1,0,15,8,7,777,0,0,28,15,13,1488,1,0,0,0,0,1,0,1,0,0,0,0,0,0
5508,5508,Karl Darlow,2286,2018,Newcastle United,0,0,0,0,0,0,0,0,0,0,0,0,0,0,0,0,0,0,0,0,0,0,0,0,0,0,0,0,0,0
5509,5509,Fabian Schär,2474,2018,Newcastle United,14,13,1,1173,3,0,10,9,1,829,1,0,24,22,2,2002,4,0,0,0,0,2,0,2,0,0,0,0,0,0
5510,5510,Manquillo,2469,2018,Newcastle United,9,5,4,504,0,0,9,7,2,595,0,0,18,12,6,1099,0,0,0,0,0,0,0,0,0,0,0,0,0,0
5511,5511,Sung-yueng Ki,1698,2018,Newcastle United,10,9,1,824,0,0,8,5,3,478,0,0,18,14,4,1302,0,0,0,0,0,0,0,0,0,0,0,0,0,0
5512,5512,Jan Vertonghen,1161,2018,Tottenham Hotspur,10,10,0,884,0,0,12,12,0,1036,1,0,22,22,0,1920,1,0,0,0,0,0,1,1,0,0,0,0,0,0
5513,5513,Eric Dier,1162,2018,Tottenham Hotspur,9,8,1,674,2,0,11,10,1,836,1,0,20,18,2,1510,3,0,3,0,3,2,1,3,0,0,0,0,0,0
5514,5514,Dele Alli,1915,2018,Tottenham Hotspur,11,9,2,754,1,0,14,13,1,1080,4,0,25,22,3,1834,5,0,0,3,3,1,3,4,0,0,0,0,0,0
5515,5515,Mousa Dembélé,1172,2018,Tottenham Hotspur,3,2,1,162,0,0,7,5,2,355,0,0,10,7,3,517,0,0,0,0,0,0,0,0,0,0,0,0,0,0
5516,5516,Luke Amos,3112,2018,Tottenham Hotspur,0,0,0,0,0,0,1,0,1,2,0,0,1,0,1,2,0,0,0,0,0,0,0,0,0,0,0,0,0,0
5517,5517,Michel Vorm,1174,2018,Tottenham Hotspur,1,1,0,90,0,0,1,1,0,90,0,0,2,2,0,180,0,0,0,0,0,0,0,0,0,0,0,0,0,0
5518,5518,Kyle Walker-Peters,3113,2018,Tottenham Hotspur,4,3,1,272,0,0,2,1,1,102,0,0,6,4,2,374,0,0,0,0,0,0,0,0,0,0,0,0,0,0
5519,5519,Aaron Hughes,1561,2006,Aston Villa,7,7,0,630,0,0,11,7,4,570,0,0,18,14,4,1200,0,0,0,0,0,0,0,0,0,0,0,0,0,0
5520,5520,Chris Sutton,3114,2006,Aston Villa,4,3,1,285,0,0,4,3,1,307,1,0,8,6,2,592,1,0,0,3,3,0,1,1,0,0,0,0,0,0
5521,5521,Mikaël Silvestre,1106,2006,Manchester United,8,4,4,373,0,0,6,2,4,234,1,0,14,6,8,607,1,0,0,0,0,0,1,1,0,0,0,0,0,0
5522,5522,André Gomes,3115,2018,Everton FC,13,12,1,972,1,0,14,12,2,1014,0,0,27,24,3,1986,1,0,0,0,0,1,0,1,0,0,0,0,0,0
5523,5523,Yerry Mina,1459,2018,Everton FC,6,4,2,362,0,0,7,6,1,530,1,0,13,10,3,892,1,0,0,0,0,0,1,1,0,0,0,0,0,0
5524,5524,Ademola Lookman,3116,2018,Everton FC,11,2,9,334,0,0,10,1,9,267,0,0,21,3,18,601,0,0,0,0,0,0,0,0,0,0,0,0,0,0
5525,5525,Brett Emerton,1141,2008,Blackburn Rovers,10,9,1,849,0,0,10,10,0,828,1,0,20,19,1,1677,1,0,0,0,0,0,0,0,0,0,0,0,0,0
5526,5526,Keith Andrews,2656,2008,Blackburn Rovers,17,14,3,1221,1,0,15,12,3,1072,3,0,32,26,6,2293,4,0,1,1,2,1,1,2,0,0,0,0,0,0
5527,5527,Matt Derbyshire,2247,2008,Blackburn Rovers,9,3,6,365,1,0,8,2,6,325,1,0,17,5,12,690,2,0,3,0,3,1,0,1,0,0,0,0,0,0
5528,5528,Johann Vogel,3117,2008,Blackburn Rovers,1,0,1,6,0,0,0,0,0,0,0,0,1,0,1,6,0,0,0,0,0,0,0,0,0,0,0,0,0,0
5529,5529,Aaron Mokoena,2008,2004,Blackburn Rovers,8,8,0,653,0,0,8,8,0,634,0,0,16,16,0,1287,0,0,0,0,0,0,0,0,0,0,0,0,0,0
5530,5530,Ryan Nelsen,2007,2004,Blackburn Rovers,7,7,0,630,0,0,8,8,0,720,0,0,15,15,0,1350,0,0,0,0,0,0,0,0,0,0,0,0,0,0
5531,5531,Gary Flitcroft,1135,2004,Blackburn Rovers,7,6,1,501,0,0,11,10,1,897,0,0,18,16,2,1398,0,0,0,0,0,0,0,0,0,0,0,0,0,0
5532,5532,Morten Gamst Pedersen,2009,2004,Blackburn Rovers,10,10,0,830,3,0,9,9,0,715,1,0,19,19,0,1545,4,0,3,3,6,3,1,4,0,0,0,0,0,0
5533,5533,Jon Stead,1139,2004,Blackburn Rovers,13,8,5,775,0,0,14,10,4,922,2,0,27,18,9,1697,2,0,0,3,3,0,2,2,0,0,0,0,0,0
5534,5534,Fábio Aurélio,2054,2011,Liverpool FC,1,1,0,66,0,0,1,0,1,1,0,0,2,1,1,67,0,0,0,0,0,0,0,0,0,0,0,0,0,0
5535,5535,Raheem Sterling,1203,2011,Liverpool FC,3,0,3,27,0,0,0,0,0,0,0,0,3,0,3,27,0,0,0,0,0,0,0,0,0,0,0,0,0,0
5536,5536,Jack Robinson,3118,2011,Liverpool FC,0,0,0,0,0,0,0,0,0,0,0,0,0,0,0,0,0,0,0,0,0,0,0,0,0,0,0,0,0,0
5537,5537,Mark Schwarzer,1328,2011,Fulham FC,14,14,0,1260,0,0,16,16,0,1440,0,0,30,30,0,2700,0,0,0,0,0,0,0,0,0,0,0,0,0,0
5538,5538,Stephen Kelly,1121,2011,Fulham FC,13,10,3,1031,0,0,11,11,0,990,0,0,24,21,3,2021,0,0,0,0,0,0,0,0,0,0,0,0,0,0
5539,5539,John Arne Riise,2362,2011,Fulham FC,19,19,0,1700,0,0,17,16,1,1440,0,0,36,35,1,3140,0,0,0,0,0,0,0,0,0,0,0,0,0,0
5540,5540,Brede Hangeland,1033,2011,Fulham FC,19,19,0,1710,0,0,19,19,0,1710,0,0,38,38,0,3420,0,0,0,0,0,0,0,0,0,0,0,0,0,0
5541,5541,Aaron Hughes,1561,2011,Fulham FC,9,8,1,650,0,0,10,10,0,900,0,0,19,18,1,1550,0,0,0,0,0,0,0,0,0,0,0,0,0,0
5542,5542,Danny Murphy,1398,2011,Fulham FC,19,18,1,1493,3,0,17,15,2,1252,0,0,36,33,3,2745,3,0,1,0,1,2,0,2,2,0,2,0,0,0
5543,5543,Damien Duff,1348,2011,Fulham FC,13,12,1,1059,1,0,15,11,4,1057,1,0,28,23,5,2116,2,0,0,0,0,0,0,0,0,0,0,0,0,0
5544,5544,Mousa Dembélé,1172,2011,Fulham FC,17,15,2,1404,1,0,19,18,1,1535,1,0,36,33,3,2939,2,0,3,0,3,1,0,1,0,0,0,0,0,0
5545,5545,Alexander Kačaniklić,2555,2011,Fulham FC,2,0,2,57,0,0,2,2,0,146,0,0,4,2,2,203,0,0,0,0,0,0,0,0,0,0,0,0,0,0
5546,5546,Pavel Pogrebnyak,1989,2011,Fulham FC,6,6,0,444,5,0,6,6,0,506,1,0,12,12,0,950,6,0,0,3,3,3,1,4,0,0,0,0,0,0
5547,5547,Clint Dempsey,1565,2011,Fulham FC,19,19,0,1705,12,0,18,18,0,1620,5,0,37,37,0,3325,17,0,4,1,5,7,3,10,0,0,0,0,0,0
5548,5548,Chris Baird,1562,2011,Fulham FC,9,6,3,574,0,0,10,7,3,693,0,0,19,13,6,1267,0,0,0,0,0,0,0,0,0,0,0,0,0,0
5549,5549,Dickson Etuhu,1969,2011,Fulham FC,9,4,5,414,0,0,13,5,8,484,0,0,22,9,13,898,0,0,0,0,0,0,0,0,0,0,0,0,0,0
5550,5550,Kerim Frei,3119,2011,Fulham FC,7,1,6,153,0,0,9,5,4,523,0,0,16,6,10,676,0,0,0,0,0,0,0,0,0,0,0,0,0,0
5551,5551,David Stockdale,2558,2011,Fulham FC,5,5,0,450,0,0,3,3,0,270,0,0,8,8,0,720,0,0,0,0,0,0,0,0,0,0,0,0,0,0
5552,5552,Matthew Briggs,2559,2011,Fulham FC,0,0,0,0,0,0,2,1,1,91,0,0,2,1,1,91,0,0,0,0,0,0,0,0,0,0,0,0,0,0
5553,5553,Pajtim Kasami,2557,2011,Fulham FC,1,0,1,28,0,0,6,3,3,238,0,0,7,3,4,266,0,0,0,0,0,0,0,0,0,0,0,0,0,0
5554,5554,Orlando Sá,3120,2011,Fulham FC,2,0,2,13,0,0,5,3,2,268,1,0,7,3,4,281,1,0,0,0,0,0,1,1,0,0,0,0,0,0
5555,5555,Steve Harper,2231,2006,Newcastle United,10,8,2,808,0,0,8,7,1,634,0,0,18,15,3,1442,0,0,0,0,0,0,0,0,0,0,0,0,0,0
5556,5556,Stephen Carr,1780,2006,Newcastle United,12,12,0,1080,0,0,10,10,0,886,0,0,22,22,0,1966,0,0,0,0,0,0,0,0,0,0,0,0,0,0
5557,5557,Craig Moore,2972,2006,Newcastle United,7,7,0,568,0,0,9,9,0,749,0,0,16,16,0,1317,0,0,0,0,0,0,0,0,0,0,0,0,0,0
5558,5558,Peter Ramage,1947,2006,Newcastle United,9,8,1,680,0,0,11,11,0,937,0,0,20,19,1,1617,0,0,0,0,0,0,0,0,0,0,0,0,0,0
5559,5559,Steven Taylor,2014,2006,Newcastle United,12,11,1,1035,0,0,14,14,0,1260,2,0,26,25,1,2295,2,0,0,3,3,0,1,1,0,0,0,0,0,0
5560,5560,Damien Duff,1348,2006,Newcastle United,10,8,2,747,0,0,11,11,0,893,1,0,21,19,2,1640,1,0,0,0,0,0,1,1,0,0,0,0,0,0
5561,5561,James Milner,1189,2006,Newcastle United,16,14,2,1201,3,0,17,15,2,1301,0,0,33,29,4,2502,3,0,0,0,0,2,0,2,0,0,0,0,0,0
5562,5562,Scott Parker,1282,2006,Newcastle United,16,15,1,1288,3,0,12,12,0,1046,0,0,28,27,1,2334,3,0,0,0,0,2,0,2,0,0,0,0,0,0
5563,5563,Nicky Butt,1115,2006,Newcastle United,16,14,2,1147,0,0,13,12,1,1053,1,0,29,26,3,2200,1,0,0,3,3,0,1,1,0,0,0,0,0,0
5564,5564,Obafemi Martins,3121,2006,Newcastle United,16,16,0,1412,5,0,15,14,1,1274,6,0,31,30,1,2686,11,0,3,0,3,4,3,7,1,0,1,0,0,0
5565,5565,Antoine Sibierski,1810,2006,Newcastle United,11,4,7,573,3,0,14,9,5,785,0,0,25,13,12,1358,3,0,3,0,3,2,0,2,0,0,0,0,0,0
5566,5566,Charles N'Zogbia,2016,2006,Newcastle United,10,7,3,721,0,0,11,3,8,358,0,0,21,10,11,1079,0,0,0,0,0,0,0,0,0,0,0,0,0,0
5567,5567,Shola Ameobi,1950,2006,Newcastle United,5,4,1,300,3,0,7,5,2,458,0,0,12,9,3,758,3,0,3,0,3,3,0,3,1,0,1,0,0,0
5568,5568,Jamie Ashdown,3122,2004,Portsmouth FC,8,8,0,720,0,0,8,8,0,720,0,0,16,16,0,1440,0,0,0,0,0,0,0,0,0,0,0,0,0,0
5569,5569,Linvoy Primus,1065,2004,Portsmouth FC,17,14,3,1373,0,0,18,17,1,1495,1,0,35,31,4,2868,1,0,0,3,3,0,1,1,0,0,0,0,0,0
5570,5570,Dejan Stefanović,1066,2004,Portsmouth FC,16,16,0,1440,0,0,16,16,0,1440,0,0,32,32,0,2880,0,0,0,0,0,0,0,0,0,0,0,0,0,0
5571,5571,David Unsworth,2582,2004,Portsmouth FC,8,8,0,656,2,0,7,7,0,539,0,0,15,15,0,1195,2,0,1,0,1,2,0,2,2,0,2,0,0,0
5572,5572,Arjan de Zeeuw,1067,2004,Portsmouth FC,17,17,0,1408,2,0,15,15,0,1350,1,0,32,32,0,2758,3,0,0,3,3,1,1,2,0,0,0,0,0,0
5573,5573,Nigel Quashie,1068,2004,Portsmouth FC,10,10,0,883,0,0,9,9,0,810,0,0,19,19,0,1693,0,0,0,0,0,0,0,0,0,0,0,0,0,0
5574,5574,Amdy Faye,1070,2004,Portsmouth FC,10,8,2,760,0,0,10,9,1,771,0,0,20,17,3,1531,0,0,0,0,0,0,0,0,0,0,0,0,0,0
5575,5575,Patrik Berger,2689,2004,Portsmouth FC,17,16,1,1302,1,0,15,14,1,1203,2,0,32,30,2,2505,3,0,0,0,0,1,2,3,0,0,0,0,0,0
5576,5576,Gary O'Neil,1389,2004,Portsmouth FC,10,9,1,814,1,0,14,12,2,1072,1,0,24,21,3,1886,2,0,0,0,0,1,1,2,0,0,0,0,0,0
5577,5577,Ricardo Fuller,2500,2004,Portsmouth FC,16,7,9,728,1,0,15,6,9,744,0,0,31,13,18,1472,1,0,0,0,0,1,0,1,0,0,0,0,0,0
5578,5578,Lomana LuaLua,1074,2004,Portsmouth FC,14,10,4,874,4,0,11,10,1,897,2,0,25,20,5,1771,6,0,3,1,4,1,2,3,0,0,0,0,0,0
5579,5579,Andy Griffin,1578,2004,Portsmouth FC,9,7,2,640,0,0,13,11,2,969,0,0,22,18,4,1609,0,0,0,0,0,0,0,0,0,0,0,0,0,0
5580,5580,Eyal Berkovic,3123,2004,Portsmouth FC,8,4,4,330,1,0,3,2,1,115,0,0,11,6,5,445,1,0,0,0,0,1,0,1,0,0,0,0,0,0
5581,5581,Matthew Taylor,1069,2004,Portsmouth FC,16,11,5,1111,1,0,16,10,6,1038,0,0,32,21,11,2149,1,0,0,0,0,1,0,1,0,0,0,0,0,0
5582,5582,David James,1385,2004,Manchester City,18,18,0,1620,0,0,14,14,0,1260,0,0,32,32,0,2880,0,0,0,0,0,0,0,0,0,0,0,0,0,0
5583,5583,Sylvain Distin,1015,2004,Manchester City,18,18,0,1602,1,0,14,14,0,1260,0,0,32,32,0,2862,1,0,0,0,0,1,0,1,0,0,0,0,0,0
5584,5584,Nedum Onuoha,2533,2004,Manchester City,9,4,5,435,0,0,7,6,1,543,0,0,16,10,6,978,0,0,0,0,0,0,0,0,0,0,0,0,0,0
5585,5585,Richard Dunne,1617,2004,Manchester City,17,17,0,1508,1,0,12,12,0,1080,0,0,29,29,0,2588,1,0,0,0,0,0,0,0,0,0,0,0,0,0
5586,5586,Stephen Jordan,2549,2004,Manchester City,8,8,0,631,0,0,7,7,0,630,0,0,15,15,0,1261,0,0,0,0,0,0,0,0,0,0,0,0,0,0
5587,5587,Joey Barton,1876,2004,Manchester City,15,14,1,1236,0,0,12,10,2,906,1,0,27,24,3,2142,1,0,0,3,3,0,1,1,0,0,0,0,0,0
5588,5588,Paul Bosvelt,3124,2004,Manchester City,12,12,0,1037,1,0,11,11,0,970,1,0,23,23,0,2007,2,0,0,0,0,1,0,1,0,0,0,0,0,0
5589,5589,Shaun Wright-Phillips,1683,2004,Manchester City,16,16,0,1440,5,0,13,12,1,1108,5,0,29,28,1,2548,10,0,0,0,0,1,4,5,0,0,0,0,0,0
5590,5590,Antoine Sibierski,1810,2004,Manchester City,16,15,1,1280,2,0,14,14,0,1145,2,0,30,29,1,2425,4,0,0,0,0,1,1,2,1,0,1,0,0,0
5591,5591,Jon Macken,3125,2004,Manchester City,11,6,5,573,1,0,10,8,2,640,0,0,21,14,7,1213,1,0,0,0,0,1,0,1,0,0,0,0,0,0
5592,5592,Nicolas Anelka,1720,2004,Manchester City,10,9,1,808,4,0,6,6,0,433,3,0,16,15,1,1241,7,0,3,0,3,3,2,5,1,1,2,0,0,0
5593,5593,Robbie Fowler,2691,2004,Manchester City,16,14,2,1177,4,0,12,10,2,964,6,0,28,24,4,2141,10,0,1,3,4,2,6,8,1,1,2,0,0,0
5594,5594,Curtis Davies,2224,2007,Aston Villa,5,4,1,362,0,0,7,5,2,451,1,0,12,9,3,813,1,0,0,0,0,0,1,1,0,0,0,0,0,0
5595,5595,John Carew,1621,2007,Aston Villa,15,15,0,1275,9,0,17,17,0,1283,4,0,32,32,0,2558,13,0,1,1,2,4,3,7,1,0,1,0,0,0
5596,5596,Moustapha Salifou,3126,2007,Aston Villa,1,0,1,1,0,0,3,0,3,43,0,0,4,0,4,44,0,0,0,0,0,0,0,0,0,0,0,0,0,0
5597,5597,Shaun Maloney,2738,2007,Aston Villa,11,4,7,440,1,0,11,7,4,554,3,0,22,11,11,994,4,0,3,1,4,1,2,3,0,0,0,0,0,0
5598,5598,Graeme Murty,2589,2007,Reading FC,14,14,0,1201,0,0,12,12,0,1077,0,0,26,26,0,2278,0,0,0,0,0,0,0,0,0,0,0,0,0,0
5599,5599,Kalifa Cissé,3127,2007,Reading FC,11,5,6,500,0,0,10,5,5,548,1,0,21,10,11,1048,1,0,0,0,0,0,1,1,0,0,0,0,0,0
5600,5600,Brynjar Gunnarsson,1988,2007,Reading FC,10,9,1,801,0,0,9,8,1,684,0,0,19,17,2,1485,0,0,0,0,0,0,0,0,0,0,0,0,0,0
5601,5601,Ulises De la Cruz,1794,2007,Reading FC,2,0,2,75,0,0,3,3,0,246,0,0,5,3,2,321,0,0,0,0,0,0,0,0,0,0,0,0,0,0
5602,5602,Bobby Convey,2592,2007,Reading FC,9,6,3,461,0,0,10,5,5,515,0,0,19,11,8,976,0,0,0,0,0,0,0,0,0,0,0,0,0,0
5603,5603,Claudio Bravo,1208,2016,Manchester City,11,11,0,979,0,0,11,11,0,990,0,0,22,22,0,1969,0,0,0,0,0,0,0,0,0,0,0,0,0,0
5604,5604,Bacary Sagna,1596,2016,Manchester City,6,4,2,429,0,0,11,10,1,915,0,0,17,14,3,1344,0,0,0,0,0,0,0,0,0,0,0,0,0,0
5605,5605,İlkay Gündoğan,1200,2016,Manchester City,6,6,0,447,1,0,4,3,1,263,2,0,10,9,1,710,3,0,0,0,0,0,0,0,0,0,0,0,0,0
5606,5606,Aleix García,3128,2016,Manchester City,2,0,2,19,0,0,2,1,1,56,0,0,4,1,3,75,0,0,0,0,0,0,0,0,0,0,0,0,0,0
5607,5607,Leroy Sané,1205,2016,Manchester City,15,13,2,1088,2,0,11,7,4,699,3,0,26,20,6,1787,5,0,0,0,0,2,1,3,0,0,0,0,0,0
5608,5608,Vincent Kompany,1414,2016,Manchester City,6,5,1,426,1,0,5,5,0,397,2,0,11,10,1,823,3,0,0,0,0,0,2,2,0,0,0,0,0,0
5609,5609,Andrew Surman,1006,2016,AFC Bournemouth,9,8,1,747,0,0,13,13,0,1101,0,0,22,21,1,1848,0,0,0,0,0,0,0,0,0,0,0,0,0,0
5610,5610,Junior Stanislas,1009,2016,AFC Bournemouth,11,10,1,793,5,0,10,8,2,683,2,0,21,18,3,1476,7,0,3,0,3,3,2,5,1,1,2,0,0,0
5611,5611,Brad Smith,2369,2016,AFC Bournemouth,2,1,1,69,0,0,3,2,1,202,0,0,5,3,2,271,0,0,0,0,0,0,0,0,0,0,0,0,0,0
5612,5612,Julian Speroni,2249,2013,Crystal Palace,19,19,0,1710,0,0,18,18,0,1620,0,0,37,37,0,3330,0,0,0,0,0,0,0,0,0,0,0,0,0,0
5613,5613,Adrian Mariappa,1917,2013,Crystal Palace,11,10,1,965,1,0,12,12,0,1058,0,0,23,22,1,2023,1,0,0,0,0,1,0,1,0,0,0,0,0,0
5614,5614,Daniel Gabbidon,2464,2013,Crystal Palace,11,11,0,981,1,0,12,11,1,993,0,0,23,22,1,1974,1,0,0,0,0,1,0,1,0,0,0,0,0,0
5615,5615,Dean Moxey,3129,2013,Crystal Palace,12,11,1,885,0,0,8,7,1,633,0,0,20,18,2,1518,0,0,0,0,0,0,0,0,0,0,0,0,0,0
5616,5616,Damien Delaney,1022,2013,Crystal Palace,19,19,0,1666,1,0,18,18,0,1620,0,0,37,37,0,3286,1,0,0,0,0,0,0,0,0,0,0,0,0,0
5617,5617,Mile Jedinak,1030,2013,Crystal Palace,19,19,0,1710,0,0,19,19,0,1679,1,0,38,38,0,3389,1,0,0,3,3,0,1,1,0,1,1,0,0,0
5618,5618,Adlène Guédioura,3130,2013,Crystal Palace,3,3,0,230,0,0,5,1,4,89,0,0,8,4,4,319,0,0,0,0,0,0,0,0,0,0,0,0,0,0
5619,5619,Jason Puncheon,1026,2013,Crystal Palace,17,16,1,1321,4,0,17,13,4,1195,3,0,34,29,5,2516,7,0,10,0,10,4,2,6,1,0,1,0,0,0
5620,5620,Barry Bannan,1975,2013,Crystal Palace,6,6,0,446,0,0,9,7,2,561,1,0,15,13,2,1007,1,0,0,3,3,0,1,1,0,0,0,0,0,0
5621,5621,Marouane Chamakh,1031,2013,Crystal Palace,17,14,3,1280,3,0,15,13,2,1029,2,0,32,27,5,2309,5,0,3,0,3,1,2,3,1,0,1,0,0,0
5622,5622,Cameron Jerome,1783,2013,Crystal Palace,12,9,3,784,1,0,16,11,5,973,1,0,28,20,8,1757,2,0,0,0,0,1,0,1,0,0,0,0,0,0
5623,5623,Campaña,3131,2013,Crystal Palace,3,2,1,144,0,0,3,2,1,166,0,0,6,4,2,310,0,0,0,0,0,0,0,0,0,0,0,0,0,0
5624,5624,Jerome Thomas,1736,2013,Crystal Palace,6,2,4,225,0,0,3,1,2,143,0,0,9,3,6,368,0,0,0,0,0,0,0,0,0,0,0,0,0,0
5625,5625,Dwight Gayle,2477,2013,Crystal Palace,10,3,7,369,3,0,13,5,8,509,4,0,23,8,15,878,7,0,1,3,4,2,3,5,1,0,1,0,0,0
5626,5626,Neil Alexander,3132,2013,Crystal Palace,0,0,0,0,0,0,0,0,0,0,0,0,0,0,0,0,0,0,0,0,0,0,0,0,0,0,0,0,0,0
5627,5627,Stuart O'Keefe,3133,2013,Crystal Palace,8,1,7,206,1,0,4,1,3,183,0,0,12,2,10,389,1,0,0,0,0,0,0,0,0,0,0,0,0,0
5628,5628,Jimmy Kébé,3134,2013,Crystal Palace,2,0,2,42,0,0,4,2,2,148,0,0,6,2,4,190,0,0,0,0,0,0,0,0,0,0,0,0,0,0
5629,5629,Kevin Phillips,1100,2013,Crystal Palace,2,0,2,45,0,0,2,0,2,31,0,0,4,0,4,76,0,0,0,0,0,0,0,0,0,0,0,0,0,0
5630,5630,Ashley Williams,1061,2013,Swansea City,17,17,0,1509,0,0,17,17,0,1530,1,0,34,34,0,3039,1,0,0,0,0,0,0,0,0,0,0,0,0,0
5631,5631,Àngel Rangel,1696,2013,Swansea City,14,14,0,1247,0,0,16,15,1,1386,0,0,30,29,1,2633,0,0,0,0,0,0,0,0,0,0,0,0,0,0
5632,5632,Henri Camara,1818,2007,West Ham United,5,1,4,177,0,0,5,2,3,159,0,0,10,3,7,336,0,0,0,0,0,0,0,0,0,0,0,0,0,0
5633,5633,Ibrahima Sonko,1609,2007,Reading FC,8,7,1,638,0,0,7,7,0,613,0,0,15,14,1,1251,0,0,0,0,0,0,0,0,0,0,0,0,0,0
5634,5634,Andreas Christensen,1854,2012,Chelsea FC,0,0,0,0,0,0,0,0,0,0,0,0,0,0,0,0,0,0,0,0,0,0,0,0,0,0,0,0,0,0
5635,5635,Tony Hibbert,1744,2012,Everton FC,4,3,1,271,0,0,2,1,1,161,0,0,6,4,2,432,0,0,0,0,0,0,0,0,0,0,0,0,0,0
5636,5636,Shane Duffy,2429,2012,Everton FC,0,0,0,0,0,0,1,0,1,1,0,0,1,0,1,1,0,0,0,0,0,0,0,0,0,0,0,0,0,0
5637,5637,Matteo Darmian,2187,2017,Manchester United,3,1,2,92,0,0,5,4,1,352,0,0,8,5,3,444,0,0,0,0,0,0,0,0,0,0,0,0,0,0
5638,5638,Andy King,2523,2017,Leicester City,4,1,3,148,0,0,7,4,3,386,1,0,11,5,6,534,1,0,0,0,0,0,0,0,0,0,0,0,0,0
5639,5639,Ben Chilwell,2436,2017,Leicester City,12,9,3,899,0,0,12,11,1,975,0,0,24,20,4,1874,0,0,0,0,0,0,0,0,0,0,0,0,0,0
5640,5640,Robert Huth,1884,2013,Stoke City,6,6,0,527,0,0,6,6,0,540,0,0,12,12,0,1067,0,0,0,0,0,0,0,0,0,0,0,0,0,0
5641,5641,Stephen Ireland,1809,2013,Stoke City,14,7,7,743,1,0,11,7,4,645,1,0,25,14,11,1388,2,0,0,0,0,1,0,1,0,0,0,0,0,0
5642,5642,Oussama Assaidi,2382,2013,Stoke City,10,5,5,528,3,0,9,7,2,584,1,0,19,12,7,1112,4,0,3,0,3,2,1,3,0,0,0,0,0,0
5643,5643,Kenwyne Jones,1222,2013,Stoke City,3,2,1,176,0,0,4,2,2,205,0,0,7,4,3,381,0,0,0,0,0,0,0,0,0,0,0,0,0,0
5644,5644,Artur Boruc,1000,2013,Southampton FC,14,14,0,1260,0,0,15,15,0,1318,0,0,29,29,0,2578,0,0,0,0,0,0,0,0,0,0,0,0,0,0
5645,5645,Nathaniel Clyne,1144,2013,Southampton FC,14,11,3,1059,0,0,11,9,2,799,0,0,25,20,5,1858,0,0,0,0,0,0,0,0,0,0,0,0,0,0
5646,5646,Dejan Lovren,1179,2013,Southampton FC,17,17,0,1530,0,0,14,14,0,1258,2,0,31,31,0,2788,2,0,0,3,3,0,1,1,0,0,0,0,0,0
5647,5647,José Fonte,1146,2013,Southampton FC,18,17,1,1561,2,0,18,18,0,1620,1,0,36,35,1,3181,3,0,1,3,4,2,1,3,0,0,0,0,0,0
5648,5648,Luke Shaw,2576,2013,Southampton FC,17,17,0,1419,0,0,18,18,0,1576,0,0,35,35,0,2995,0,0,0,0,0,0,0,0,0,0,0,0,0,0
5649,5649,Morgan Schneiderlin,1051,2013,Southampton FC,16,15,1,1326,2,0,17,16,1,1431,0,0,33,31,2,2757,2,0,0,0,0,2,0,2,0,0,0,0,0,0
5650,5650,Victor Wanyama,1864,2013,Southampton FC,10,9,1,752,0,0,13,10,3,909,0,0,23,19,4,1661,0,0,0,0,0,0,0,0,0,0,0,0,0,0
5651,5651,James Ward-Prowse,1150,2013,Southampton FC,16,7,9,753,0,0,18,9,9,852,0,0,34,16,18,1605,0,0,0,0,0,0,0,0,0,0,0,0,0,0
5652,5652,Adam Lallana,1190,2013,Southampton FC,19,19,0,1590,6,0,19,18,1,1507,3,0,38,37,1,3097,9,0,4,1,5,4,2,6,0,0,0,0,0,0
5653,5653,Rickie Lambert,2597,2013,Southampton FC,18,15,3,1355,8,0,19,16,3,1460,5,0,37,31,6,2815,13,0,0,6,6,4,3,7,1,2,3,0,0,0
5654,5654,Jay Rodriguez,1247,2013,Southampton FC,16,14,2,1283,6,0,17,16,1,1288,9,0,33,30,3,2571,15,0,0,5,5,2,7,9,0,0,0,0,0,0
5655,5655,Gastón Ramírez,2226,2013,Southampton FC,10,3,7,347,0,0,8,0,8,165,1,0,18,3,15,512,1,0,0,0,0,0,1,1,0,0,0,0,0,0
5656,5656,Kelvin Davis,1143,2013,Southampton FC,1,1,0,90,0,0,1,1,0,90,0,0,2,2,0,180,0,0,0,0,0,0,0,0,0,0,0,0,0,0
5657,5657,Calum Chambers,1470,2013,Southampton FC,11,8,3,731,0,0,11,10,1,912,0,0,22,18,4,1643,0,0,0,0,0,0,0,0,0,0,0,0,0,0
5658,5658,Jos Hooiveld,2869,2013,Southampton FC,1,1,0,90,0,0,2,2,0,180,0,0,3,3,0,270,0,0,0,0,0,0,0,0,0,0,0,0,0,0
5659,5659,Steven Davis,1149,2013,Southampton FC,16,15,1,1253,2,0,18,13,5,1256,0,0,34,28,6,2509,2,0,0,0,0,1,0,1,0,0,0,0,0,0
5660,5660,Jack Cork,1701,2013,Southampton FC,14,11,3,903,0,0,14,10,4,834,0,0,28,21,7,1737,0,0,0,0,0,0,0,0,0,0,0,0,0,0
5661,5661,Tadanari Lee,2875,2013,Southampton FC,0,0,0,0,0,0,0,0,0,0,0,0,0,0,0,0,0,0,0,0,0,0,0,0,0,0,0,0,0,0
5662,5662,Vito Mannone,2261,2016,Sunderland AFC,5,5,0,450,0,0,4,4,0,360,0,0,9,9,0,810,0,0,0,0,0,0,0,0,0,0,0,0,0,0
5663,5663,Billy Jones,1733,2016,Sunderland AFC,11,11,0,957,0,0,16,14,2,1314,1,0,27,25,2,2271,1,0,0,0,0,0,1,1,0,0,0,0,0,0
5664,5664,Bryan Oviedo,2240,2016,Sunderland AFC,4,4,0,309,0,0,6,6,0,540,0,0,10,10,0,849,0,0,0,0,0,0,0,0,0,0,0,0,0,0
5665,5665,Jason Denayer,3135,2016,Sunderland AFC,13,12,1,973,0,0,11,10,1,907,0,0,24,22,2,1880,0,0,0,0,0,0,0,0,0,0,0,0,0,0
5666,5666,John O'Shea,1729,2016,Sunderland AFC,15,13,2,1042,0,0,13,13,0,1119,0,0,28,26,2,2161,0,0,0,0,0,0,0,0,0,0,0,0,0,0
5667,5667,Lamine Koné,3136,2016,Sunderland AFC,15,14,1,1261,0,0,15,15,0,1284,1,0,30,29,1,2545,1,0,0,0,0,0,1,1,0,0,0,0,0,0
5668,5668,Sebastian Larsson,1402,2016,Sunderland AFC,11,8,3,755,0,0,10,9,1,762,0,0,21,17,4,1517,0,0,0,0,0,0,0,0,0,0,0,0,0,0
5669,5669,Didier Ndong,2367,2016,Sunderland AFC,16,14,2,1293,0,0,15,13,2,1226,1,0,31,27,4,2519,1,0,0,0,0,0,0,0,0,0,0,0,0,0
5670,5670,Darron Gibson,2538,2016,Sunderland AFC,5,4,1,384,0,0,7,3,4,257,0,0,12,7,5,641,0,0,0,0,0,0,0,0,0,0,0,0,0,0
5671,5671,Adnan Januzaj,2259,2016,Sunderland AFC,12,10,2,901,0,0,13,8,5,729,0,0,25,18,7,1630,0,0,0,0,0,0,0,0,0,0,0,0,0,0
5672,5672,Jermain Defoe,1127,2016,Sunderland AFC,19,19,0,1710,8,0,18,18,0,1613,7,0,37,37,0,3323,15,0,1,3,4,5,3,8,3,2,5,0,0,0
5673,5673,Wahbi Khazri,3137,2016,Sunderland AFC,12,4,8,495,1,0,9,3,6,344,0,0,21,7,14,839,1,0,0,0,0,1,0,1,0,0,0,0,0,0
5674,5674,Steven Pienaar,2406,2016,Sunderland AFC,6,4,2,283,0,0,9,6,3,555,0,0,15,10,5,838,0,0,0,0,0,0,0,0,0,0,0,0,0,0
5675,5675,Fabio Borini,1777,2016,Sunderland AFC,12,9,3,842,1,0,12,10,2,899,1,0,24,19,5,1741,2,0,1,0,1,1,0,1,0,0,0,0,0,0
5676,5676,Mika,3138,2016,Sunderland AFC,0,0,0,0,0,0,0,0,0,0,0,0,0,0,0,0,0,0,0,0,0,0,0,0,0,0,0,0,0,0
5677,5677,Joleon Lescott,1365,2016,Sunderland AFC,0,0,0,0,0,0,2,1,1,123,0,0,2,1,1,123,0,0,0,0,0,0,0,0,0,0,0,0,0,0
5678,5678,Manquillo,2469,2016,Sunderland AFC,10,7,3,710,0,0,10,8,2,718,1,0,20,15,5,1428,1,0,0,0,0,0,1,1,0,0,0,0,0,0
5679,5679,George Honeyman,3139,2016,Sunderland AFC,2,0,2,53,0,0,3,2,1,180,0,0,5,2,3,233,0,0,0,0,0,0,0,0,0,0,0,0,0,0
5680,5680,Jack Stephens,2329,2016,Southampton FC,9,8,1,755,0,0,8,7,1,714,0,0,17,15,2,1469,0,0,0,0,0,0,0,0,0,0,0,0,0,0
5681,5681,Manolo Gabbiadini,1913,2016,Southampton FC,6,5,1,386,1,0,5,5,0,345,3,0,11,10,1,731,4,0,0,0,0,1,2,3,0,0,0,0,0,0
5682,5682,Mouez Hassen,3140,2016,Southampton FC,0,0,0,0,0,0,0,0,0,0,0,0,0,0,0,0,0,0,0,0,0,0,0,0,0,0,0,0,0,0
5683,5683,Florin Gardoş,1157,2016,Southampton FC,0,0,0,0,0,0,0,0,0,0,0,0,0,0,0,0,0,0,0,0,0,0,0,0,0,0,0,0,0,0
5684,5684,Josh Sims,3141,2016,Southampton FC,3,1,2,132,0,0,4,0,4,74,0,0,7,1,6,206,0,0,0,0,0,0,0,0,0,0,0,0,0,0
5685,5685,Neil Etheridge,3142,2018,Cardiff City,19,19,0,1710,0,0,19,19,0,1710,0,0,38,38,0,3420,0,0,0,0,0,0,0,0,0,0,0,0,0,0
5686,5686,Lee Peltier,3143,2018,Cardiff City,7,6,1,521,0,0,13,11,2,1022,0,0,20,17,3,1543,0,0,0,0,0,0,0,0,0,0,0,0,0,0
5687,5687,Joe Bennett,2978,2018,Cardiff City,13,13,0,1142,0,0,17,17,0,1499,0,0,30,30,0,2641,0,0,0,0,0,0,0,0,0,0,0,0,0,0
5688,5688,Bruno Écuélé,3144,2018,Cardiff City,19,19,0,1710,0,0,19,18,1,1665,0,0,38,37,1,3375,0,0,0,0,0,0,0,0,0,0,0,0,0,0
5689,5689,Sol Bamba,3145,2018,Cardiff City,14,14,0,1260,2,0,14,14,0,1215,2,0,28,28,0,2475,4,0,3,0,3,1,2,3,0,0,0,0,0,0
5690,5690,Joe Ralls,3146,2018,Cardiff City,15,9,6,848,0,0,13,13,0,1144,0,0,28,22,6,1992,0,0,0,0,0,0,0,0,0,0,0,0,0,0
5691,5691,Aron Gunnarsson,3147,2018,Cardiff City,14,14,0,1240,1,0,14,13,1,1035,0,0,28,27,1,2275,1,0,0,0,0,1,0,1,0,0,0,0,0,0
5692,5692,Josh Murphy,1379,2018,Cardiff City,17,14,3,1123,2,0,12,8,4,702,1,0,29,22,7,1825,3,0,0,0,0,2,0,2,0,0,0,0,0,0
5693,5693,Callum Paterson,3148,2018,Cardiff City,14,11,3,1024,3,0,13,10,3,972,1,0,27,21,6,1996,4,0,3,0,3,3,0,3,0,0,0,0,0,0
5694,5694,Bobby Reid,3149,2018,Cardiff City,11,8,3,725,4,0,16,8,8,697,1,0,27,16,11,1422,5,0,0,0,0,2,0,2,1,0,1,0,0,0
5695,5695,Leandro Bacuna,1438,2018,Cardiff City,6,2,4,302,0,0,5,2,3,252,0,0,11,4,7,554,0,0,0,0,0,0,0,0,0,0,0,0,0,0
5696,5696,Kenneth Zohoré,3150,2018,Cardiff City,11,3,8,388,0,0,8,4,4,358,1,0,19,7,12,746,1,0,0,3,3,0,1,1,0,0,0,0,0,0
5697,5697,Junior Hoilett,2535,2018,Cardiff City,17,10,7,1008,2,0,15,13,2,1134,1,0,32,23,9,2142,3,0,3,0,3,2,0,2,0,0,0,0,0,0
5698,5698,Alex Smithies,3151,2018,Cardiff City,0,0,0,0,0,0,0,0,0,0,0,0,0,0,0,0,0,0,0,0,0,0,0,0,0,0,0,0,0,0
5699,5699,Greg Cunningham,3152,2018,Cardiff City,5,5,0,450,0,0,2,2,0,180,0,0,7,7,0,630,0,0,0,0,0,0,0,0,0,0,0,0,0,0
5700,5700,Nathaniel Mendez-Laing,3153,2018,Cardiff City,9,5,4,443,0,0,11,6,5,542,4,0,20,11,9,985,4,0,0,0,0,0,2,2,0,1,1,0,0,0
5701,5701,Rhys Healey,3154,2018,Cardiff City,1,0,1,17,0,0,2,0,2,32,0,0,3,0,3,49,0,0,0,0,0,0,0,0,0,0,0,0,0,0
5702,5702,Nathaniel Clyne,1144,2018,AFC Bournemouth,7,7,0,579,0,0,7,6,1,567,0,0,14,13,1,1146,0,0,0,0,0,0,0,0,0,0,0,0,0,0
5703,5703,Junior Stanislas,1009,2018,AFC Bournemouth,12,6,6,559,1,0,11,5,6,468,1,0,23,11,12,1027,2,0,3,0,3,1,0,1,1,0,1,0,0,0
5704,5704,Dominic Solanke,1194,2018,AFC Bournemouth,4,1,3,165,0,0,6,1,5,176,0,0,10,2,8,341,0,0,0,0,0,0,0,0,0,0,0,0,0,0
5705,5705,Diego Rico,3155,2018,AFC Bournemouth,4,1,3,148,0,0,8,4,4,459,0,0,12,5,7,607,0,0,0,0,0,0,0,0,0,0,0,0,0,0
5706,5706,Chris Mepham,3156,2018,AFC Bournemouth,6,5,1,437,0,0,7,5,2,413,0,0,13,10,3,850,0,0,0,0,0,0,0,0,0,0,0,0,0,0
5707,5707,John Oster,2704,2007,Reading FC,11,6,5,535,0,0,7,6,1,485,0,0,18,12,6,1020,0,0,0,0,0,0,0,0,0,0,0,0,0,0
5708,5708,Marek Matějovský,3157,2007,Reading FC,8,6,2,542,0,0,6,4,2,352,1,0,14,10,4,894,1,0,0,0,0,0,1,1,0,0,0,0,0,0
5709,5709,Radek Černý,2805,2007,Tottenham Hotspur,6,6,0,540,0,0,7,7,0,630,0,0,13,13,0,1170,0,0,0,0,0,0,0,0,0,0,0,0,0,0
5710,5710,Jonathan Woodgate,1882,2007,Tottenham Hotspur,8,8,0,707,1,0,4,4,0,360,0,0,12,12,0,1067,1,0,0,0,0,1,0,1,0,0,0,0,0,0
5711,5711,Gilberto,3158,2007,Tottenham Hotspur,4,2,2,232,1,0,2,1,1,108,0,0,6,3,3,340,1,0,0,0,0,0,0,0,0,0,0,0,0,0
5712,5712,Kevin-Prince Boateng,3159,2007,Tottenham Hotspur,4,1,3,151,0,0,8,6,2,419,0,0,12,7,5,570,0,0,0,0,0,0,0,0,0,0,0,0,0,0
5713,5713,Franck Queudrue,1329,2007,Birmingham City,8,7,1,644,0,0,8,7,1,606,0,0,16,14,2,1250,0,0,0,0,0,0,0,0,0,0,0,0,0,0
5714,5714,Steve Finnan,2883,2007,Liverpool FC,9,7,2,677,0,0,15,14,1,1279,0,0,24,21,3,1956,0,0,0,0,0,0,0,0,0,0,0,0,0,0
5715,5715,Martin Škrtel,1423,2007,Liverpool FC,7,6,1,561,0,0,7,7,0,630,0,0,14,13,1,1191,0,0,0,0,0,0,0,0,0,0,0,0,0,0
5716,5716,Lucas Leiva,1429,2007,Liverpool FC,9,7,2,598,0,0,9,5,4,508,0,0,18,12,6,1106,0,0,0,0,0,0,0,0,0,0,0,0,0,0
5717,5717,Damien Plessis,3160,2007,Liverpool FC,0,0,0,0,0,0,2,2,0,180,0,0,2,2,0,180,0,0,0,0,0,0,0,0,0,0,0,0,0,0
5718,5718,Peter Crouch,1273,2007,Liverpool FC,13,3,10,391,2,0,8,6,2,530,3,0,21,9,12,921,5,0,1,0,1,2,1,3,0,0,0,0,0,0
5719,5719,Emiliano Insúa,1889,2007,Liverpool FC,1,1,0,90,0,0,2,1,1,116,0,0,3,2,1,206,0,0,0,0,0,0,0,0,0,0,0,0,0,0
5720,5720,Petri Pasanen,3161,2003,Portsmouth FC,7,6,1,535,0,0,5,5,0,405,0,0,12,11,1,940,0,0,0,0,0,0,0,0,0,0,0,0,0,0
5721,5721,Stephen Crainey,3162,2003,Southampton FC,1,1,0,90,0,0,4,4,0,350,0,0,5,5,0,440,0,0,0,0,0,0,0,0,0,0,0,0,0,0
5722,5722,Claus Lundekvam,2047,2003,Southampton FC,15,15,0,1203,0,0,14,14,0,1133,1,0,29,29,0,2336,1,0,0,0,0,0,0,0,0,0,0,0,0,0
5723,5723,Paul Telfer,2105,2003,Southampton FC,18,15,3,1361,0,0,17,16,1,1497,0,0,35,31,4,2858,0,0,0,0,0,0,0,0,0,0,0,0,0,0
5724,5724,John Curtis,2461,2003,Leicester City,8,7,1,663,0,0,7,7,0,544,0,0,15,14,1,1207,0,0,0,0,0,0,0,0,0,0,0,0,0,0
5725,5725,Muzzy Izzet,2682,2003,Leicester City,15,15,0,1308,0,0,15,15,0,1350,2,0,30,30,0,2658,2,0,0,0,0,0,1,1,0,0,0,0,0,0
5726,5726,Lilian Nalis,3163,2003,Leicester City,11,6,5,544,1,0,9,5,4,488,0,0,20,11,9,1032,1,0,0,0,0,1,0,1,0,0,0,0,0,0
5727,5727,Danny Coyne,3164,2003,Leicester City,2,0,2,54,0,0,2,1,1,102,0,0,4,1,3,156,0,0,0,0,0,0,0,0,0,0,0,0,0,0
5728,5728,Alan Rogers,3165,2003,Leicester City,4,3,1,320,0,0,4,4,0,360,0,0,8,7,1,680,0,0,0,0,0,0,0,0,0,0,0,0,0,0
5729,5729,Ryan Giggs,1110,2003,Manchester United,16,13,3,1128,5,0,17,16,1,1408,2,0,33,29,4,2536,7,0,0,0,0,3,1,4,0,0,0,0,0,0
5730,5730,Eric Djemba-Djemba,1793,2003,Manchester United,7,4,3,383,0,0,8,6,2,499,0,0,15,10,5,882,0,0,0,0,0,0,0,0,0,0,0,0,0,0
5731,5731,Héctor Bellerín,1499,2018,Arsenal FC,10,10,0,882,0,0,9,8,1,653,0,0,19,18,1,1535,0,0,0,0,0,0,0,0,0,0,0,0,0,0
5732,5732,Lucas Torreira,1472,2018,Arsenal FC,17,12,5,1231,2,0,17,12,5,1146,0,0,34,24,10,2377,2,0,3,0,3,1,0,1,0,0,0,0,0,0
5733,5733,Emerson,3166,2018,Chelsea FC,4,4,0,360,0,0,6,3,3,300,0,0,10,7,3,660,0,0,0,0,0,0,0,0,0,0,0,0,0,0
5734,5734,Ethan Ampadu,3167,2018,Chelsea FC,0,0,0,0,0,0,0,0,0,0,0,0,0,0,0,0,0,0,0,0,0,0,0,0,0,0,0,0,0,0
5735,5735,Pepe Reina,1775,2010,Liverpool FC,19,19,0,1710,0,0,19,19,0,1710,0,0,38,38,0,3420,0,0,0,0,0,0,0,0,0,0,0,0,0,0
5736,5736,Glen Johnson,1386,2010,Liverpool FC,15,15,0,1350,1,0,13,13,0,1088,1,0,28,28,0,2438,2,0,0,0,0,1,0,1,0,0,0,0,0,0
5737,5737,Daniel Agger,1776,2010,Liverpool FC,7,6,1,558,0,0,9,6,3,534,0,0,16,12,4,1092,0,0,0,0,0,0,0,0,0,0,0,0,0,0
5738,5738,Jamie Carragher,1778,2010,Liverpool FC,13,13,0,1170,0,0,15,15,0,1318,0,0,28,28,0,2488,0,0,0,0,0,0,0,0,0,0,0,0,0,0
5739,5739,Martin Škrtel,1423,2010,Liverpool FC,19,19,0,1710,0,0,19,19,0,1710,2,0,38,38,0,3420,2,0,0,0,0,0,2,2,0,0,0,0,0,0
5740,5740,Steven Gerrard,1424,2010,Liverpool FC,11,10,1,969,1,0,10,10,0,900,3,0,21,20,1,1869,4,0,1,0,1,1,1,2,0,1,1,0,0,0
5741,5741,Lucas Leiva,1429,2010,Liverpool FC,15,14,1,1271,0,0,18,18,0,1587,0,0,33,32,1,2858,0,0,0,0,0,0,0,0,0,0,0,0,0,0
5742,5742,Christian Poulsen,3168,2010,Liverpool FC,5,5,0,381,0,0,7,4,3,360,0,0,12,9,3,741,0,0,0,0,0,0,0,0,0,0,0,0,0,0
5743,5743,Milan Jovanović,3169,2010,Liverpool FC,4,2,2,172,0,0,6,3,3,288,0,0,10,5,5,460,0,0,0,0,0,0,0,0,0,0,0,0,0,0
5744,5744,Dirk Kuyt,1894,2010,Liverpool FC,18,18,0,1563,9,0,15,14,1,1260,4,0,33,32,1,2823,13,0,1,1,2,3,3,6,3,2,5,0,0,0
5745,5745,Maxi Rodríguez,2993,2010,Liverpool FC,15,12,3,1086,6,0,13,12,1,957,4,0,28,24,4,2043,10,0,0,3,3,2,2,4,0,0,0,0,0,0
5746,5746,Ryan Babel,1897,2010,Liverpool FC,4,1,3,125,1,0,5,0,5,69,0,0,9,1,8,194,1,0,0,0,0,0,0,0,0,0,0,0,0,0
5747,5747,Brad Jones,1431,2010,Liverpool FC,0,0,0,0,0,0,0,0,0,0,0,0,0,0,0,0,0,0,0,0,0,0,0,0,0,0,0,0,0,0
5748,5748,Sotirios Kyrgiakos,3170,2010,Liverpool FC,8,5,3,554,2,0,8,5,3,525,0,0,16,10,6,1079,2,0,0,0,0,1,0,1,0,0,0,0,0,0
5749,5749,Martin Kelly,1034,2010,Liverpool FC,6,5,1,457,0,0,5,5,0,403,0,0,11,10,1,860,0,0,0,0,0,0,0,0,0,0,0,0,0,0
5750,5750,Jay Spearing,2995,2010,Liverpool FC,6,5,1,425,0,0,5,5,0,372,0,0,11,10,1,797,0,0,0,0,0,0,0,0,0,0,0,0,0,0
5751,5751,Dani Pacheco,3171,2010,Liverpool FC,0,0,0,0,0,0,1,0,1,4,0,0,1,0,1,4,0,0,0,0,0,0,0,0,0,0,0,0,0,0
5752,5752,Scott Carson,1999,2010,West Bromwich Albion,15,15,0,1350,0,0,17,17,0,1530,0,0,32,32,0,2880,0,0,0,0,0,0,0,0,0,0,0,0,0,0
5753,5753,Jonas Olsson,1771,2010,West Bromwich Albion,13,13,0,1135,1,0,11,11,0,990,0,0,24,24,0,2125,1,0,0,0,0,0,0,0,0,0,0,0,0,0
5754,5754,Nicky Shorey,1731,2010,West Bromwich Albion,15,13,2,1175,0,0,13,12,1,1136,0,0,28,25,3,2311,0,0,0,0,0,0,0,0,0,0,0,0,0,0
5755,5755,Gabriel Tamaş,2729,2010,West Bromwich Albion,14,12,2,1127,0,0,12,10,2,914,0,0,26,22,4,2041,0,0,0,0,0,0,0,0,0,0,0,0,0,0
5756,5756,Gonzalo Jara,1738,2010,West Bromwich Albion,15,13,2,1115,0,0,14,11,3,1055,1,0,29,24,5,2170,1,0,0,0,0,0,0,0,0,0,0,0,0,0
5757,5757,James Morrison,1735,2010,West Bromwich Albion,14,11,3,1017,3,0,17,15,2,1267,1,0,31,26,5,2284,4,0,1,0,1,3,1,4,0,0,0,0,0,0
5758,5758,Chris Brunt,1658,2010,West Bromwich Albion,16,16,0,1428,3,0,18,18,0,1587,1,0,34,34,0,3015,4,0,4,0,4,3,0,3,2,0,2,0,0,0
5759,5759,Graham Dorrans,1737,2010,West Bromwich Albion,10,8,2,705,1,0,11,8,3,715,0,0,21,16,5,1420,1,0,0,0,0,1,0,1,0,0,0,0,0,0
5760,5760,Youssuf Mulumbu,1773,2010,West Bromwich Albion,17,17,0,1425,3,0,17,17,0,1446,3,0,34,34,0,2871,6,0,6,0,6,3,2,5,0,0,0,0,0,0
5761,5761,Peter Odemwingie,1551,2010,West Bromwich Albion,18,17,1,1545,10,0,14,12,2,1136,5,0,32,29,3,2681,15,0,6,0,6,7,4,11,0,2,2,0,0,0
5762,5762,Marc-Antoine Fortuné,1742,2010,West Bromwich Albion,12,6,6,499,2,0,13,8,5,620,0,0,25,14,11,1119,2,0,4,0,4,2,0,2,0,0,0,0,0,0
5763,5763,Somen Tchoyi,1739,2010,West Bromwich Albion,12,2,10,288,1,0,11,5,6,529,5,0,23,7,16,817,6,0,0,2,2,1,2,3,0,0,0,0,0,0
5764,5764,Chris Wood,2348,2010,West Bromwich Albion,0,0,0,0,0,0,1,0,1,7,0,0,1,0,1,7,0,0,0,0,0,0,0,0,0,0,0,0,0,0
5765,5765,Boaz Myhill,1663,2010,West Bromwich Albion,4,4,0,360,0,0,2,2,0,180,0,0,6,6,0,540,0,0,0,0,0,0,0,0,0,0,0,0,0,0
5766,5766,Pablo Ibáñez,3172,2010,West Bromwich Albion,4,3,1,286,0,0,6,5,1,494,1,0,10,8,2,780,1,0,0,1,1,0,1,1,0,0,0,0,0,0
5767,5767,Steven Reid,1140,2010,West Bromwich Albion,11,5,6,488,1,0,12,8,4,789,0,0,23,13,10,1277,1,0,0,0,0,1,0,1,0,0,0,0,0,0
5768,5768,Giles Barnes,1580,2010,West Bromwich Albion,9,1,8,243,0,0,5,0,5,61,0,0,14,1,13,304,0,0,0,0,0,0,0,0,0,0,0,0,0,0
5769,5769,Simon Cox,1741,2010,West Bromwich Albion,9,5,4,485,0,0,10,3,7,281,1,0,19,8,11,766,1,0,0,1,1,0,1,1,0,0,0,0,0,0
5770,5770,Salomon Kalou,1770,2011,Chelsea FC,6,3,3,216,0,0,6,4,2,358,1,0,12,7,5,574,1,0,0,0,0,0,0,0,0,0,0,0,0,0
5771,5771,Paulo Ferreira,1761,2011,Chelsea FC,4,2,2,220,0,0,2,1,1,147,0,0,6,3,3,367,0,0,0,0,0,0,0,0,0,0,0,0,0,0
5772,5772,Séamus Coleman,1467,2011,Everton FC,9,8,1,596,0,0,9,6,3,534,0,0,18,14,4,1130,0,0,0,0,0,0,0,0,0,0,0,0,0,0
5773,5773,Royston Drenthe,3173,2011,Everton FC,12,5,7,560,1,0,9,5,4,475,2,0,21,10,11,1035,3,0,0,0,0,0,2,2,0,0,0,0,0,0
5774,5774,Marouane Fellaini,2189,2011,Everton FC,18,17,1,1529,1,0,16,14,2,1325,2,0,34,31,3,2854,3,0,0,0,0,0,1,1,0,0,0,0,0,0
5775,5775,Jazz Richards,1703,2011,Swansea City,4,3,1,289,0,0,4,3,1,286,0,0,8,6,2,575,0,0,0,0,0,0,0,0,0,0,0,0,0,0
5776,5776,Kemy Agustien,3174,2011,Swansea City,7,4,3,378,0,0,6,3,3,332,0,0,13,7,6,710,0,0,0,0,0,0,0,0,0,0,0,0,0,0
5777,5777,Leroy Lita,2593,2011,Swansea City,10,2,8,253,1,0,6,2,4,205,1,0,16,4,12,458,2,0,0,0,0,0,1,1,0,0,0,0,0,0
5778,5778,Stephen Dobbie,3175,2011,Swansea City,4,1,3,128,0,0,4,1,3,130,0,0,8,2,6,258,0,0,0,0,0,0,0,0,0,0,0,0,0,0
5779,5779,Paul McShane,1607,2014,Hull City,10,10,0,841,0,0,10,9,1,854,1,0,20,19,1,1695,1,0,0,0,0,0,0,0,0,0,0,0,0,0
5780,5780,Michael Dawson,1267,2014,Hull City,14,14,0,1260,1,0,14,14,0,1174,0,0,28,28,0,2434,1,0,3,0,3,1,0,1,0,0,0,0,0,0
5781,5781,Tom Huddlestone,1270,2014,Hull City,15,15,0,1324,0,0,16,15,1,1269,0,0,31,30,1,2593,0,0,0,0,0,0,0,0,0,0,0,0,0,0
5782,5782,Dame N'Doye,3176,2014,Hull City,8,8,0,698,3,0,7,5,2,498,2,0,15,13,2,1196,5,0,3,0,3,2,1,3,0,0,0,0,0,0
5783,5783,Maynor Figueroa,2057,2014,Hull City,0,0,0,0,0,0,3,2,1,209,0,0,3,2,1,209,0,0,0,0,0,0,0,0,0,0,0,0,0,0
5784,5784,Stephen Quinn,3177,2014,Hull City,12,8,4,653,1,0,16,9,7,984,0,0,28,17,11,1637,1,0,0,0,0,0,0,0,0,0,0,0,0,0
5785,5785,Danny Graham,2317,2014,Sunderland AFC,6,3,3,272,0,0,8,4,4,354,1,0,14,7,7,626,1,0,0,0,0,0,1,1,0,0,0,0,0,0
5786,5786,Jermain Defoe,1127,2014,Sunderland AFC,8,8,0,687,2,0,9,9,0,770,2,0,17,17,0,1457,4,0,3,0,3,1,1,2,0,0,0,0,0,0
5787,5787,Patrick van Aanholt,2254,2014,Sunderland AFC,14,13,1,1172,0,0,14,13,1,1134,0,0,28,26,2,2306,0,0,0,0,0,0,0,0,0,0,0,0,0,0
5788,5788,Ricardo Álvarez,3178,2014,Sunderland AFC,9,4,5,357,0,0,4,1,3,138,0,0,13,5,8,495,0,0,0,0,0,0,0,0,0,0,0,0,0,0
5789,5789,Paul Telfer,2105,2001,Southampton FC,14,13,1,1158,1,0,13,13,0,1128,0,0,27,26,1,2286,1,0,0,0,0,0,0,0,0,0,0,0,0,0
5790,5790,Fabrice Fernandes,2695,2001,Southampton FC,7,3,4,343,1,0,4,3,1,194,0,0,11,6,5,537,1,0,0,0,0,0,0,0,0,0,0,0,0,0
5791,5791,Zat Knight,1755,2001,Fulham FC,3,2,1,170,0,0,7,6,1,455,0,0,10,8,2,625,0,0,0,0,0,0,0,0,0,0,0,0,0,0
5792,5792,Lee Clark,2017,2001,Fulham FC,5,3,2,228,0,0,4,2,2,190,0,0,9,5,4,418,0,0,0,0,0,0,0,0,0,0,0,0,0,0
5793,5793,Bjarne Goldbæk,3062,2001,Fulham FC,7,5,2,383,1,0,5,3,2,233,0,0,12,8,4,616,1,0,0,0,0,1,0,1,0,0,0,0,0,0
5794,5794,Ed de Goey,3051,2001,Chelsea FC,3,3,0,270,0,0,3,3,0,270,0,0,6,6,0,540,0,0,0,0,0,0,0,0,0,0,0,0,0,0
5795,5795,Celestine Babayaro,2015,2001,Chelsea FC,9,9,0,775,0,0,8,8,0,692,0,0,17,17,0,1467,0,0,0,0,0,0,0,0,0,0,0,0,0,0
5796,5796,Marcel Desailly,2614,2001,Chelsea FC,13,13,0,1170,0,0,10,10,0,900,1,0,23,23,0,2070,1,0,0,0,0,0,0,0,0,0,0,0,0,0
5797,5797,William Gallas,2040,2001,Chelsea FC,17,15,2,1414,1,0,12,11,1,1036,0,0,29,26,3,2450,1,0,0,0,0,1,0,1,0,0,0,0,0,0
5798,5798,Mario Melchiot,1512,2001,Chelsea FC,19,17,2,1570,1,0,16,16,0,1385,1,0,35,33,2,2955,2,0,0,0,0,1,1,2,0,0,0,0,0,0
5799,5799,John Terry,1534,2001,Chelsea FC,16,15,1,1256,1,0,16,16,0,1380,0,0,32,31,1,2636,1,0,0,0,0,1,0,1,0,0,0,0,0,0
5800,5800,Slaviša Jokanović,3057,2001,Chelsea FC,8,4,4,428,0,0,12,8,4,678,0,0,20,12,8,1106,0,0,0,0,0,0,0,0,0,0,0,0,0,0
5801,5801,Boudewijn Zenden,1336,2001,Chelsea FC,12,8,4,627,2,0,9,5,4,540,1,0,21,13,8,1167,3,0,0,0,0,1,0,1,0,0,0,0,0,0
5802,5802,Emmanuel Petit,2616,2001,Chelsea FC,13,12,1,1014,1,0,12,12,0,990,0,0,25,24,1,2004,1,0,3,0,3,1,0,1,0,0,0,0,0,0
5803,5803,Jimmy Floyd Hasselbaink,1337,2001,Chelsea FC,18,18,0,1570,14,0,15,15,0,1341,9,0,33,33,0,2911,23,0,1,4,5,8,7,15,2,1,3,0,0,0
5804,5804,Gianfranco Zola,2617,2001,Chelsea FC,18,10,8,936,2,0,15,8,7,738,1,0,33,18,15,1674,3,0,0,0,0,1,1,2,0,0,0,0,0,0
5805,5805,Albert Ferrer,3179,2001,Chelsea FC,1,0,1,8,0,0,2,1,1,73,0,0,3,1,2,81,0,0,0,0,0,0,0,0,0,0,0,0,0,0
5806,5806,Samuele Dalla Bona,3055,2001,Chelsea FC,11,7,4,755,4,0,13,9,4,805,0,0,24,16,8,1560,4,0,3,0,3,1,0,1,0,0,0,0,0,0
5807,5807,Eiður Guðjohnsen,2373,2001,Chelsea FC,17,14,3,1201,10,0,13,10,3,812,4,0,30,24,6,2013,14,0,0,3,3,4,3,7,1,0,1,0,0,0
5808,5808,Marvin Emnes,1709,2015,Swansea City,0,0,0,0,0,0,2,1,1,66,0,0,2,1,1,66,0,0,0,0,0,0,0,0,0,0,0,0,0,0
5809,5809,Gomes,1266,2015,Watford FC,19,19,0,1710,0,0,19,19,0,1687,0,0,38,38,0,3397,0,0,0,0,0,0,0,0,0,0,0,0,0,0
5810,5810,Allan Nyom,1654,2015,Watford FC,15,12,3,1060,0,0,17,17,0,1415,0,0,32,29,3,2475,0,0,0,0,0,0,0,0,0,0,0,0,0,0
5811,5811,Miguel Britos,1930,2015,Watford FC,12,12,0,1050,0,0,12,12,0,1026,0,0,24,24,0,2076,0,0,0,0,0,0,0,0,0,0,0,0,0,0
5812,5812,Craig Cathcart,1918,2015,Watford FC,18,18,0,1576,1,0,17,16,1,1458,0,0,35,34,1,3034,1,0,0,0,0,0,0,0,0,0,0,0,0,0
5813,5813,Nathan Aké,1037,2015,Watford FC,12,10,2,945,1,0,12,10,2,954,0,0,24,20,4,1899,1,0,0,0,0,1,0,1,0,0,0,0,0,0
5814,5814,Jurado,3180,2015,Watford FC,15,15,0,1107,0,0,12,12,0,920,0,0,27,27,0,2027,0,0,0,0,0,0,0,0,0,0,0,0,0,0
5815,5815,Valon Behrami,1284,2015,Watford FC,11,8,3,705,0,0,10,6,4,600,0,0,21,14,7,1305,0,0,0,0,0,0,0,0,0,0,0,0,0,0
5816,5816,Ben Watson,2025,2015,Watford FC,17,15,2,1370,0,0,18,16,2,1445,1,0,35,31,4,2815,1,0,0,3,3,0,1,1,0,0,0,0,0,0
5817,5817,Étienne Capoue,1924,2015,Watford FC,17,17,0,1484,0,0,16,16,0,1338,0,0,33,33,0,2822,0,0,0,0,0,0,0,0,0,0,0,0,0,0
5818,5818,Troy Deeney,1928,2015,Watford FC,19,19,0,1704,6,0,19,17,2,1588,7,0,38,36,2,3292,13,0,4,3,7,5,5,10,3,3,6,0,0,0
5819,5819,Odion Ighalo,2990,2015,Watford FC,19,19,0,1685,8,0,18,17,1,1468,8,0,37,36,1,3153,16,0,3,4,7,4,6,10,0,0,0,0,0,0
5820,5820,Juan Paredes,3181,2015,Watford FC,10,5,5,506,0,0,7,2,5,259,0,0,17,7,10,765,0,0,0,0,0,0,0,0,0,0,0,0,0,0
5821,5821,Obbi Oularé,3182,2015,Watford FC,1,0,1,2,0,0,1,0,1,3,0,0,2,0,2,5,0,0,0,0,0,0,0,0,0,0,0,0,0,0
5822,5822,Giedrius Arlauskis,3183,2015,Watford FC,0,0,0,0,0,0,1,0,1,23,0,0,1,0,1,23,0,0,0,0,0,0,0,0,0,0,0,0,0,0
5823,5823,Sebastian Prödl,2366,2015,Watford FC,9,8,1,750,1,0,12,11,1,1026,1,0,21,19,2,1776,2,0,0,0,0,1,0,1,0,0,0,0,0,0
5824,5824,Adlène Guédioura,3130,2015,Watford FC,7,1,6,186,0,0,11,2,9,234,0,0,18,3,15,420,0,0,0,0,0,0,0,0,0,0,0,0,0,0
5825,5825,Ikechi Anya,3184,2015,Watford FC,13,10,3,889,0,0,15,7,8,791,0,0,28,17,11,1680,0,0,0,0,0,0,0,0,0,0,0,0,0,0
5826,5826,Almen Abdi,3185,2015,Watford FC,16,10,6,862,1,0,16,15,1,1125,1,0,32,25,7,1987,2,0,0,0,0,1,0,1,0,0,0,0,0,0
5827,5827,Andy Todd,1672,2007,Derby County,9,6,3,639,1,0,10,8,2,736,0,0,19,14,5,1375,1,0,1,0,1,1,0,1,0,0,0,0,0,0
5828,5828,Robert Earnshaw,1325,2007,Derby County,13,3,10,500,1,0,9,4,5,431,0,0,22,7,15,931,1,0,0,0,0,0,0,0,0,0,0,0,0,0
5829,5829,Gary Teale,1817,2007,Derby County,8,5,3,382,0,0,10,4,6,534,0,0,18,9,9,916,0,0,0,0,0,0,0,0,0,0,0,0,0,0
5830,5830,David James,1385,2007,Portsmouth FC,16,16,0,1440,0,0,18,18,0,1620,0,0,34,34,0,3060,0,0,0,0,0,0,0,0,0,0,0,0,0,0
5831,5831,Lauren,1602,2007,Portsmouth FC,7,5,2,482,0,0,8,6,2,496,0,0,15,11,4,978,0,0,0,0,0,0,0,0,0,0,0,0,0,0
5832,5832,Hermann Hreiðarsson,1953,2007,Portsmouth FC,15,14,1,1206,2,0,16,15,1,1347,1,0,31,29,2,2553,3,0,0,0,0,2,0,2,0,0,0,0,0,0
5833,5833,Sylvain Distin,1015,2007,Portsmouth FC,17,17,0,1530,0,0,18,18,0,1576,0,0,35,35,0,3106,0,0,0,0,0,0,0,0,0,0,0,0,0,0
5834,5834,Sol Campbell,1388,2007,Portsmouth FC,13,13,0,1170,0,0,17,17,0,1530,1,0,30,30,0,2700,1,0,0,0,0,0,1,1,0,0,0,0,0,0
5835,5835,Sulley Ali Muntari,1688,2007,Portsmouth FC,14,12,2,1068,1,0,14,14,0,1231,3,0,28,26,2,2299,4,0,0,0,0,0,1,1,1,0,1,0,0,0
5836,5836,Sean Davis,1087,2007,Portsmouth FC,9,7,2,669,1,0,12,10,2,886,0,0,21,17,4,1555,1,0,0,0,0,0,0,0,0,0,0,0,0,0
5837,5837,Pedro Mendes,1390,2007,Portsmouth FC,8,8,0,614,0,0,10,6,4,607,0,0,18,14,4,1221,0,0,0,0,0,0,0,0,0,0,0,0,0,0
5838,5838,David Nugent,2519,2007,Portsmouth FC,8,2,6,317,0,0,6,3,3,293,0,0,14,5,9,610,0,0,0,0,0,0,0,0,0,0,0,0,0,0
5839,5839,John Utaka,2813,2007,Portsmouth FC,13,11,2,828,1,0,15,13,2,1106,4,0,28,24,4,1934,5,0,0,0,0,1,1,2,0,0,0,0,0,0
5840,5840,Benjani,1391,2007,Portsmouth FC,10,10,0,850,7,0,12,10,2,908,5,0,22,20,2,1758,12,0,1,0,1,4,3,7,0,0,0,0,0,0
5841,5841,Noé Pamarot,1387,2007,Portsmouth FC,7,7,0,587,0,0,11,7,4,580,1,0,18,14,4,1167,1,0,0,0,0,0,1,1,0,0,0,0,0,0
5842,5842,Matthew Taylor,1069,2007,Portsmouth FC,5,1,4,237,1,0,8,2,6,215,0,0,13,3,10,452,1,0,0,0,0,0,0,0,1,0,1,0,0,0
5843,5843,Nwankwo Kanu,1324,2007,Portsmouth FC,13,8,5,757,2,0,12,5,7,615,2,0,25,13,12,1372,4,0,0,3,3,1,1,2,0,0,0,0,0,0
5844,5844,Petr Čech,1531,2016,Arsenal FC,16,16,0,1440,0,0,18,18,0,1568,0,0,34,34,0,3008,0,0,0,0,0,0,0,0,0,0,0,0,0,0
5845,5845,Kieran Gibbs,1508,2016,Arsenal FC,7,5,2,416,0,0,4,3,1,286,0,0,11,8,3,702,0,0,0,0,0,0,0,0,0,0,0,0,0,0
5846,5846,Gabriel Paulista,1594,2016,Arsenal FC,10,8,2,801,0,0,9,7,2,714,0,0,19,15,4,1515,0,0,0,0,0,0,0,0,0,0,0,0,0,0
5847,5847,Laurent Koscielny,1497,2016,Arsenal FC,16,16,0,1396,1,0,17,17,0,1504,1,0,33,33,0,2900,2,0,0,3,3,1,1,2,0,0,0,0,0,0
5848,5848,Nacho Monreal,1498,2016,Arsenal FC,17,16,1,1459,0,0,18,18,0,1604,0,0,35,34,1,3063,0,0,0,0,0,0,0,0,0,0,0,0,0,0
5849,5849,Héctor Bellerín,1499,2016,Arsenal FC,16,13,3,1242,1,0,16,13,3,1167,0,0,32,26,6,2409,1,0,0,0,0,1,0,1,0,0,0,0,0,0
5850,5850,Mesut Özil,1500,2016,Arsenal FC,17,17,0,1522,4,0,16,15,1,1326,4,0,33,32,1,2848,8,0,0,3,3,2,2,4,0,0,0,0,0,0
5851,5851,Granit Xhaka,1475,2016,Arsenal FC,14,13,1,1186,1,0,17,15,2,1322,1,0,31,28,3,2508,2,0,0,0,0,1,0,1,0,0,0,0,0,0
5852,5852,Francis Coquelin,1503,2016,Arsenal FC,15,10,5,866,0,0,13,11,2,830,0,0,28,21,7,1696,0,0,0,0,0,0,0,0,0,0,0,0,0,0
5853,5853,Alexis Sánchez,1505,2016,Arsenal FC,18,17,1,1505,9,0,19,18,1,1628,15,0,37,35,2,3133,24,0,3,0,3,5,6,11,2,0,2,0,0,0
5854,5854,Theo Walcott,1237,2016,Arsenal FC,13,11,2,924,8,0,14,11,3,910,2,0,27,22,5,1834,10,0,0,0,0,5,1,6,0,0,0,0,0,0
5855,5855,Aaron Ramsey,1501,2016,Arsenal FC,11,5,6,457,1,0,11,7,4,711,0,0,22,12,10,1168,1,0,0,0,0,0,0,0,0,0,0,0,0,0
5856,5856,Olivier Giroud,1504,2016,Arsenal FC,14,5,9,542,3,0,15,6,9,653,9,0,29,11,18,1195,12,0,3,2,5,2,5,7,0,0,0,0,0,0
5857,5857,Danny Welbeck,1506,2016,Arsenal FC,8,4,4,379,1,0,8,4,4,367,1,0,16,8,8,746,2,0,0,0,0,0,0,0,0,0,0,0,0,0
5858,5858,Emiliano Martínez,1482,2016,Arsenal FC,1,1,0,90,0,0,1,1,0,90,0,0,2,2,0,180,0,0,0,0,0,0,0,0,0,0,0,0,0,0
5859,5859,Mohamed Elneny,1865,2016,Arsenal FC,5,4,1,338,0,0,8,3,5,289,0,0,13,7,6,627,0,0,0,0,0,0,0,0,0,0,0,0,0,0
5860,5860,Alex Oxlade-Chamberlain,1184,2016,Arsenal FC,11,5,6,507,1,0,17,11,6,1036,1,0,28,16,12,1543,2,0,0,0,0,0,0,0,0,0,0,0,0,0
5861,5861,Alex Iwobi,1462,2016,Arsenal FC,14,9,5,755,3,0,11,8,3,648,0,0,25,17,8,1403,3,0,0,0,0,0,0,0,0,0,0,0,0,0
5862,5862,Kasper Schmeichel,2435,2016,Leicester City,15,15,0,1317,0,0,15,15,0,1350,0,0,30,30,0,2667,0,0,0,0,0,0,0,0,0,0,0,0,0,0
5863,5863,Robert Huth,1884,2016,Leicester City,16,16,0,1407,0,0,17,17,0,1522,2,0,33,33,0,2929,2,0,0,0,0,0,1,1,0,0,0,0,0,0
5864,5864,Danny Simpson,2395,2016,Leicester City,19,18,1,1633,0,0,16,16,0,1357,0,0,35,34,1,2990,0,0,0,0,0,0,0,0,0,0,0,0,0,0
5865,5865,Christian Fuchs,2564,2016,Leicester City,18,17,1,1550,2,0,18,18,0,1554,0,0,36,35,1,3104,2,0,0,0,0,1,0,1,0,0,0,0,0,0
5866,5866,Yohan Benalouane,2569,2016,Leicester City,5,5,0,395,0,0,6,6,0,526,0,0,11,11,0,921,0,0,0,0,0,0,0,0,0,0,0,0,0,0
5867,5867,Danny Drinkwater,2522,2016,Leicester City,15,14,1,1270,1,0,14,13,1,1196,0,0,29,27,2,2466,1,0,0,0,0,0,0,0,0,0,0,0,0,0
5868,5868,Marc Albrighton,1448,2016,Leicester City,15,14,1,1216,1,0,18,15,3,1208,1,0,33,29,4,2424,2,0,0,0,0,0,1,1,0,0,0,0,0,0
5869,5869,Wilfred Ndidi,2442,2016,Leicester City,9,9,0,802,2,0,8,8,0,720,0,0,17,17,0,1522,2,0,0,0,0,2,0,2,0,0,0,0,0,0
5870,5870,Riyad Mahrez,1842,2016,Leicester City,18,17,1,1480,3,0,18,16,2,1357,3,0,36,33,3,2837,6,0,0,0,0,2,2,4,1,2,3,0,0,0
5871,5871,Jamie Vardy,2443,2016,Leicester City,17,15,2,1337,9,0,18,18,0,1533,4,0,35,33,2,2870,13,0,1,3,4,4,1,5,0,0,0,0,0,0
5872,5872,Leonardo Ulloa,2518,2016,Leicester City,6,0,6,80,0,0,10,3,7,355,1,0,16,3,13,435,1,0,0,0,0,0,0,0,0,0,0,0,0,0
5873,5873,Shinji Okazaki,2668,2016,Leicester City,17,13,4,910,1,0,13,8,5,666,2,0,30,21,9,1576,3,0,0,0,0,0,0,0,0,0,0,0,0,0
5874,5874,Demarai Gray,2568,2016,Leicester City,17,4,13,517,0,0,13,5,8,519,1,0,30,9,21,1036,1,0,0,0,0,0,0,0,0,0,0,0,0,0
5875,5875,Ron-Robert Zieler,3186,2016,Leicester City,5,4,1,393,0,0,4,4,0,360,0,0,9,8,1,753,0,0,0,0,0,0,0,0,0,0,0,0,0,0
5876,5876,Ben Chilwell,2436,2016,Leicester City,7,5,2,454,1,0,5,2,3,241,0,0,12,7,5,695,1,0,0,0,0,0,0,0,0,0,0,0,0,0
5877,5877,Daniel Amartey,2666,2016,Leicester City,12,8,4,792,0,0,12,9,3,874,1,0,24,17,7,1666,1,0,0,1,1,0,1,1,0,0,0,0,0,0
5878,5878,Andy King,2523,2016,Leicester City,11,6,5,634,1,0,12,9,3,809,0,0,23,15,8,1443,1,0,0,0,0,0,0,0,0,0,0,0,0,0
5879,5879,Ahmed Musa,2669,2016,Leicester City,8,4,4,317,1,0,13,3,10,436,1,0,21,7,14,753,2,0,0,1,1,1,1,2,0,0,0,0,0,0
5880,5880,Sung-yueng Ki,1698,2013,Sunderland AFC,15,14,1,1233,0,0,12,11,1,952,3,0,27,25,2,2185,3,0,0,3,3,0,1,1,0,1,1,0,0,0
5881,5881,Craig Gardner,1403,2013,Sunderland AFC,11,3,8,403,2,0,7,4,3,360,0,0,18,7,11,763,2,0,0,0,0,2,0,2,1,0,1,0,0,0
5882,5882,Steven Fletcher,1408,2013,Sunderland AFC,10,6,4,542,1,0,10,7,3,698,2,0,20,13,7,1240,3,0,0,0,0,1,1,2,0,0,0,0,0,0
5883,5883,Jordan Pickford,1046,2013,Sunderland AFC,0,0,0,0,0,0,0,0,0,0,0,0,0,0,0,0,0,0,0,0,0,0,0,0,0,0,0,0,0,0
5884,5884,Ondřej Čelůstka,3187,2013,Sunderland AFC,11,7,4,712,0,0,10,7,3,621,0,0,21,14,7,1333,0,0,0,0,0,0,0,0,0,0,0,0,0,0
5885,5885,Valentin Roberge,3188,2013,Sunderland AFC,5,4,1,348,0,0,4,3,1,322,0,0,9,7,2,670,0,0,0,0,0,0,0,0,0,0,0,0,0,0
5886,5886,Maya Yoshida,1145,2013,Southampton FC,3,3,0,270,0,0,5,4,1,362,1,0,8,7,1,632,1,0,0,0,0,0,1,1,0,0,0,0,0,0
5887,5887,Guly,2871,2013,Southampton FC,7,0,7,57,0,0,2,0,2,21,0,0,9,0,9,78,0,0,0,0,0,0,0,0,0,0,0,0,0,0
5888,5888,Łukasz Fabiański,1227,2017,Swansea City,19,19,0,1710,0,0,19,19,0,1710,0,0,38,38,0,3420,0,0,0,0,0,0,0,0,0,0,0,0,0,0
5889,5889,Alfie Mawson,3189,2017,Swansea City,19,19,0,1710,2,0,19,19,0,1710,0,0,38,38,0,3420,2,0,3,0,3,1,0,1,0,0,0,0,0,0
5890,5890,Martin Olsson,1372,2017,Swansea City,18,18,0,1552,0,0,18,18,0,1602,0,0,36,36,0,3154,0,0,0,0,0,0,0,0,0,0,0,0,0,0
5891,5891,Kyle Naughton,2273,2017,Swansea City,17,17,0,1505,0,0,17,17,0,1528,0,0,34,34,0,3033,0,0,0,0,0,0,0,0,0,0,0,0,0,0
5892,5892,Federico Fernández,1697,2017,Swansea City,14,14,0,1260,0,0,16,16,0,1417,1,0,30,30,0,2677,1,0,0,1,1,0,1,1,0,0,0,0,0,0
5893,5893,Leon Britton,1707,2017,Swansea City,3,2,1,162,0,0,2,2,0,143,0,0,5,4,1,305,0,0,0,0,0,0,0,0,0,0,0,0,0,0
5894,5894,Leroy Fer,1375,2017,Swansea City,9,7,2,648,0,0,11,8,3,748,1,0,20,15,5,1396,1,0,0,0,0,0,1,1,0,0,0,0,0,0
5895,5895,Tom Carroll,2816,2017,Swansea City,19,14,5,1232,0,0,18,14,4,1337,0,0,37,28,9,2569,0,0,0,0,0,0,0,0,0,0,0,0,0,0
5896,5896,Tammy Abraham,2959,2017,Swansea City,15,6,9,743,3,0,16,9,7,974,2,0,31,15,16,1717,5,0,0,1,1,2,2,4,0,0,0,0,0,0
5897,5897,Luciano Narsingh,3190,2017,Swansea City,11,4,7,404,0,0,7,1,6,212,1,0,18,5,13,616,1,0,0,3,3,0,1,1,0,0,0,0,0,0
5898,5898,Jordan Ayew,1869,2017,Swansea City,19,17,2,1558,4,0,17,16,1,1380,3,0,36,33,3,2938,7,0,2,0,2,3,2,5,1,0,1,0,0,0
5899,5899,Sung-yueng Ki,1698,2017,Swansea City,13,11,2,1026,2,0,12,10,2,843,0,0,25,21,4,1869,2,0,3,0,3,2,0,2,0,0,0,0,0,0
5900,5900,Sam Clucas,2734,2017,Swansea City,13,11,2,963,2,0,16,12,4,1082,1,0,29,23,6,2045,3,0,0,0,0,1,1,2,0,0,0,0,0,0
5901,5901,Nathan Dyer,1702,2017,Swansea City,14,9,5,805,0,0,10,7,3,507,0,0,24,16,8,1312,0,0,0,0,0,0,0,0,0,0,0,0,0,0
5902,5902,Kristoffer Nordfeldt,2275,2017,Swansea City,0,0,0,0,0,0,0,0,0,0,0,0,0,0,0,0,0,0,0,0,0,0,0,0,0,0,0,0,0,0
5903,5903,Mike van der Hoorn,3191,2017,Swansea City,11,11,0,946,1,0,13,13,0,1006,0,0,24,24,0,1952,1,0,0,0,0,0,0,0,0,0,0,0,0,0
5904,5904,Àngel Rangel,1696,2017,Swansea City,3,2,1,153,0,0,1,0,1,2,0,0,4,2,2,155,0,0,0,0,0,0,0,0,0,0,0,0,0,0
5905,5905,Wayne Routledge,1758,2017,Swansea City,8,2,6,181,0,0,7,2,5,242,0,0,15,4,11,423,0,0,0,0,0,0,0,0,0,0,0,0,0,0
5906,5906,Philip Billing,3192,2017,Huddersfield Town,8,3,5,339,0,0,8,5,3,421,0,0,16,8,8,760,0,0,0,0,0,0,0,0,0,0,0,0,0,0
5907,5907,Joel Coleman,3193,2017,Huddersfield Town,0,0,0,0,0,0,0,0,0,0,0,0,0,0,0,0,0,0,0,0,0,0,0,0,0,0,0,0,0,0
5908,5908,Abdelhamid Sabiri,3194,2017,Huddersfield Town,1,1,0,82,0,0,4,1,3,137,0,0,5,2,3,219,0,0,0,0,0,0,0,0,0,0,0,0,0,0
5909,5909,Łukasz Fabiański,1227,2016,Swansea City,18,18,0,1620,0,0,19,19,0,1710,0,0,37,37,0,3330,0,0,0,0,0,0,0,0,0,0,0,0,0,0
5910,5910,Jordi Amat,2934,2016,Swansea City,8,7,1,631,0,0,9,8,1,777,0,0,17,15,2,1408,0,0,0,0,0,0,0,0,0,0,0,0,0,0
5911,5911,Mike van der Hoorn,3191,2016,Swansea City,6,5,1,481,1,0,2,2,0,180,0,0,8,7,1,661,1,0,0,0,0,0,0,0,0,0,0,0,0,0
5912,5912,Àngel Rangel,1696,2016,Swansea City,9,5,4,476,0,0,9,3,6,346,1,0,18,8,10,822,1,0,0,3,3,0,1,1,0,0,0,0,0,0
5913,5913,Kyle Naughton,2273,2016,Swansea City,16,16,0,1417,0,0,15,15,0,1301,1,0,31,31,0,2718,1,0,0,0,0,0,0,0,0,0,0,0,0,0
5914,5914,Leon Britton,1707,2016,Swansea City,10,10,0,772,0,0,6,6,0,404,0,0,16,16,0,1176,0,0,0,0,0,0,0,0,0,0,0,0,0,0
5915,5915,Leroy Fer,1375,2016,Swansea City,16,13,3,1051,4,0,18,14,4,1353,2,0,34,27,7,2404,6,0,0,3,3,3,1,4,0,0,0,0,0,0
5916,5916,Gylfi Sigurðsson,1055,2016,Swansea City,19,19,0,1709,4,0,19,18,1,1619,5,0,38,37,1,3328,9,0,3,4,7,4,4,8,2,1,3,0,0,0
5917,5917,Jack Cork,1701,2016,Swansea City,14,12,2,1085,0,0,16,13,3,1148,0,0,30,25,5,2233,0,0,0,0,0,0,0,0,0,0,0,0,0,0
5918,5918,Borja Bastón,3195,2016,Swansea City,8,4,4,355,0,0,10,0,10,193,1,0,18,4,14,548,1,0,0,0,0,0,0,0,0,0,0,0,0,0
5919,5919,Wayne Routledge,1758,2016,Swansea City,12,11,1,873,1,0,15,13,2,1058,2,0,27,24,3,1931,3,0,0,0,0,1,1,2,0,0,0,0,0,0
5920,5920,Sung-yueng Ki,1698,2016,Swansea City,13,6,7,706,0,0,10,7,3,581,0,0,23,13,10,1287,0,0,0,0,0,0,0,0,0,0,0,0,0,0
5921,5921,Jay Fulton,3196,2016,Swansea City,4,3,1,244,0,0,7,6,1,450,0,0,11,9,2,694,0,0,0,0,0,0,0,0,0,0,0,0,0,0
5922,5922,Modou Barrow,1705,2016,Swansea City,9,4,5,522,0,0,9,8,1,626,0,0,18,12,6,1148,0,0,0,0,0,0,0,0,0,0,0,0,0,0
5923,5923,Kristoffer Nordfeldt,2275,2016,Swansea City,1,1,0,90,0,0,0,0,0,0,0,0,1,1,0,90,0,0,0,0,0,0,0,0,0,0,0,0,0,0
5924,5924,Neil Taylor,1695,2016,Swansea City,4,4,0,311,0,0,7,7,0,611,0,0,11,11,0,922,0,0,0,0,0,0,0,0,0,0,0,0,0,0
5925,5925,Alfie Mawson,3189,2016,Swansea City,14,14,0,1260,2,0,13,13,0,1170,2,0,27,27,0,2430,4,0,0,0,0,2,1,3,0,0,0,0,0,0
5926,5926,Oliver McBurnie,3197,2016,Swansea City,4,0,4,73,0,0,1,0,1,4,0,0,5,0,5,77,0,0,0,0,0,0,0,0,0,0,0,0,0,0
5927,5927,Andreas Pereira,2190,2019,Manchester United,12,10,2,787,1,0,13,8,5,703,0,0,25,18,7,1490,1,0,0,0,0,1,0,1,0,0,0,0,0,0
5928,5928,Peter Schmeichel,3198,2002,Manchester City,16,16,0,1440,0,0,11,11,0,990,0,0,27,27,0,2430,0,0,0,0,0,0,0,0,0,0,0,0,0,0
5929,5929,Jihai Sun,1808,2002,Manchester City,12,11,1,968,0,0,15,13,2,1167,2,0,27,24,3,2135,2,0,0,0,0,0,1,1,0,0,0,0,0,0
5930,5930,Danny Tiatto,3199,2002,Manchester City,7,5,2,444,0,0,5,4,1,379,0,0,12,9,3,823,0,0,0,0,0,0,0,0,0,0,0,0,0,0
5931,5931,Richard Dunne,1617,2002,Manchester City,13,13,0,1023,0,0,10,9,1,855,0,0,23,22,1,1878,0,0,0,0,0,0,0,0,0,0,0,0,0,0
5932,5932,Lucien Mettomo,3200,2002,Manchester City,2,2,0,180,0,0,2,1,1,140,0,0,4,3,1,320,0,0,0,0,0,0,0,0,0,0,0,0,0,0
5933,5933,Niclas Jensen,3201,2002,Manchester City,17,16,1,1470,1,0,15,15,0,1305,0,0,32,31,1,2775,1,0,0,0,0,0,0,0,0,0,0,0,0,0
5934,5934,Eyal Berkovic,3123,2002,Manchester City,13,13,0,1056,1,0,13,13,0,1016,0,0,26,26,0,2072,1,0,0,0,0,0,0,0,0,0,0,0,0,0
5935,5935,Marc-Vivien Foé,3202,2002,Manchester City,19,19,0,1667,5,0,15,15,0,1350,4,0,34,34,0,3017,9,0,0,1,1,2,3,5,0,0,0,0,0,0
5936,5936,Shaun Wright-Phillips,1683,2002,Manchester City,17,12,5,1186,1,0,13,10,3,933,0,0,30,22,8,2119,1,0,0,0,0,0,0,0,0,0,0,0,0,0
5937,5937,Shaun Goater,3203,2002,Manchester City,15,8,7,720,4,0,10,5,5,505,3,0,25,13,12,1225,7,0,1,4,5,3,2,5,0,0,0,0,0,0
5938,5938,Nicolas Anelka,1720,2002,Manchester City,19,19,0,1680,6,0,17,17,0,1521,8,0,36,36,0,3201,14,0,0,6,6,2,6,8,0,1,1,0,0,0
5939,5939,Ali Benarbia,3204,2002,Manchester City,17,10,7,992,3,0,15,10,5,981,0,0,32,20,12,1973,3,0,0,0,0,2,0,2,0,0,0,0,0,0
5940,5940,Kevin Horlock,3205,2002,Manchester City,13,8,5,807,0,0,15,12,3,1062,0,0,28,20,8,1869,0,0,0,0,0,0,0,0,0,0,0,0,0,0
5941,5941,Darren Huckerby,2389,2002,Manchester City,7,3,4,290,1,0,9,3,6,287,0,0,16,6,10,577,1,0,3,0,3,1,0,1,0,0,0,0,0,0
5942,5942,Dean Kiely,2334,2002,Charlton Athletic,18,18,0,1620,0,0,19,19,0,1710,0,0,37,37,0,3330,0,0,0,0,0,0,0,0,0,0,0,0,0,0
5943,5943,Radostin Kishishev,1668,2002,Charlton Athletic,17,12,5,979,2,0,16,14,2,1137,0,0,33,26,7,2116,2,0,0,0,0,1,0,1,0,0,0,0,0,0
5944,5944,Chris Powell,1669,2002,Charlton Athletic,18,17,1,1566,0,0,18,17,1,1522,0,0,36,34,2,3088,0,0,0,0,0,0,0,0,0,0,0,0,0,0
5945,5945,Richard Rufus,1670,2002,Charlton Athletic,15,14,1,1291,2,0,15,15,0,1350,0,0,30,29,1,2641,2,0,0,0,0,1,0,1,0,0,0,0,0,0
5946,5946,Mark Fish,1671,2002,Charlton Athletic,11,11,0,921,1,0,12,12,0,994,0,0,23,23,0,1915,1,0,0,0,0,1,0,1,0,0,0,0,0,0
5947,5947,Gary Rowett,1303,2002,Charlton Athletic,6,6,0,540,1,0,6,6,0,456,0,0,12,12,0,996,1,0,1,0,1,1,0,1,0,0,0,0,0,0
5948,5948,Luke Young,1952,2002,Charlton Athletic,15,13,2,1137,0,0,16,15,1,1347,0,0,31,28,3,2484,0,0,0,0,0,0,0,0,0,0,0,0,0,0
5949,5949,Scott Parker,1282,2002,Charlton Athletic,14,14,0,1210,3,0,13,13,0,1152,1,0,27,27,0,2362,4,0,0,3,3,2,1,3,0,0,0,0,0,0
5950,5950,Jason Euell,1886,2002,Charlton Athletic,18,18,0,1600,6,0,17,16,1,1426,4,0,35,34,1,3026,10,0,3,3,6,4,2,6,2,1,3,0,0,0
5951,5951,Shaun Bartlett,1675,2002,Charlton Athletic,13,13,0,1005,0,0,17,11,6,1054,4,0,30,24,6,2059,4,0,0,6,6,0,4,4,0,0,0,0,0,0
5952,5952,Jonatan Johansson,1676,2002,Charlton Athletic,14,6,8,547,2,0,17,4,13,491,1,0,31,10,21,1038,3,0,0,0,0,0,1,1,0,0,0,0,0,0
5953,5953,Paul Konchesky,1560,2002,Charlton Athletic,13,6,7,642,3,0,16,10,6,960,0,0,29,16,13,1602,3,0,0,0,0,2,0,2,0,0,0,0,0,0
5954,5954,Kevin Lisbie,2337,2002,Charlton Athletic,15,11,4,1019,3,0,16,12,4,1073,1,0,31,23,8,2092,4,0,6,0,6,2,1,3,0,0,0,0,0,0
5955,5955,Wayne Routledge,1758,2007,Aston Villa,1,0,1,4,0,0,0,0,0,0,0,0,1,0,1,4,0,0,0,0,0,0,0,0,0,0,0,0,0,0
5956,5956,Patrik Berger,2689,2007,Aston Villa,5,0,5,101,0,0,3,0,3,69,0,0,8,0,8,170,0,0,0,0,0,0,0,0,0,0,0,0,0,0
5957,5957,Ali Al Habsi,2877,2007,Bolton Wanderers,2,2,0,180,0,0,6,6,0,540,0,0,8,8,0,720,0,0,0,0,0,0,0,0,0,0,0,0,0,0
5958,5958,Grétar Steinsson,2410,2007,Bolton Wanderers,5,5,0,402,0,0,9,9,0,810,0,0,14,14,0,1212,0,0,0,0,0,0,0,0,0,0,0,0,0,0
5959,5959,Andy O'Brien,2160,2007,Bolton Wanderers,15,14,1,1304,0,0,14,14,0,1247,0,0,29,28,1,2551,0,0,0,0,0,0,0,0,0,0,0,0,0,0
5960,5960,Gary Cahill,1533,2007,Bolton Wanderers,4,4,0,360,0,0,7,7,0,609,0,0,11,11,0,969,0,0,0,0,0,0,0,0,0,0,0,0,0,0
5961,5961,Danny Guthrie,2397,2007,Bolton Wanderers,12,12,0,1019,0,0,12,9,3,848,0,0,24,21,3,1867,0,0,0,0,0,0,0,0,0,0,0,0,0,0
5962,5962,Gavin McCann,1096,2007,Bolton Wanderers,13,7,6,726,0,0,16,11,5,1058,1,0,29,18,11,1784,1,0,0,3,3,0,1,1,0,0,0,0,0,0
5963,5963,Joey O'Brien,2412,2007,Bolton Wanderers,8,7,1,625,0,0,12,9,3,788,0,0,20,16,4,1413,0,0,0,0,0,0,0,0,0,0,0,0,0,0
5964,5964,Heiðar Helguson,1759,2007,Bolton Wanderers,2,0,2,39,0,0,4,3,1,232,2,0,6,3,3,271,2,0,0,0,0,0,1,1,0,0,0,0,0,0
5965,5965,Kevin Davies,1718,2007,Bolton Wanderers,16,15,1,1253,2,0,14,14,0,1211,2,0,30,29,1,2464,4,0,3,1,4,1,2,3,0,0,0,0,0,0
5966,5966,El-Hadji Diouf,1719,2007,Bolton Wanderers,14,13,1,1122,2,0,18,15,3,1340,2,0,32,28,4,2462,4,0,0,0,0,2,1,3,0,0,0,0,0,0
5967,5967,Tamir Cohen,2671,2007,Bolton Wanderers,4,1,3,155,1,0,6,2,4,137,0,0,10,3,7,292,1,0,0,0,0,0,0,0,0,0,0,0,0,0
5968,5968,Antonio Valencia,1641,2015,Manchester United,9,6,3,561,0,0,5,2,3,292,0,0,14,8,6,853,0,0,0,0,0,0,0,0,0,0,0,0,0,0
5969,5969,Marcus Rashford,1648,2015,Manchester United,7,7,0,561,4,0,4,4,0,301,1,0,11,11,0,862,5,0,3,3,6,2,1,3,0,0,0,0,0,0
5970,5970,Ashley Young,1619,2015,Manchester United,8,5,3,473,1,0,10,6,4,588,0,0,18,11,7,1061,1,0,0,0,0,0,0,0,0,0,0,0,0,0
5971,5971,Phil Jones,1650,2015,Manchester United,6,3,3,279,0,0,4,3,1,250,0,0,10,6,4,529,0,0,0,0,0,0,0,0,0,0,0,0,0,0
5972,5972,Tommy Elphick,3206,2015,AFC Bournemouth,6,5,1,472,1,0,6,6,0,540,0,0,12,11,1,1012,1,0,0,0,0,0,0,0,0,0,0,0,0,0
5973,5973,Callum Wilson,1039,2015,AFC Bournemouth,6,3,3,326,2,0,7,6,1,446,3,0,13,9,4,772,5,0,0,0,0,2,1,3,0,1,1,0,0,0
5974,5974,Joshua King,1040,2015,AFC Bournemouth,14,11,3,868,3,0,17,13,4,1056,3,0,31,24,7,1924,6,0,3,0,3,2,1,3,0,0,0,0,0,0
5975,5975,Max Gradel,2771,2015,AFC Bournemouth,7,6,1,453,1,0,7,5,2,446,0,0,14,11,3,899,1,0,0,0,0,1,0,1,0,0,0,0,0,0
5976,5976,Benik Afobe,1043,2015,AFC Bournemouth,8,7,1,565,2,0,7,5,2,372,2,0,15,12,3,937,4,0,0,3,3,0,2,2,0,0,0,0,0,0
5977,5977,Lewis Grabban,3207,2015,AFC Bournemouth,8,3,5,363,0,0,7,1,6,205,0,0,15,4,11,568,0,0,0,0,0,0,0,0,0,0,0,0,0,0
5978,5978,Jordan Holmes,3208,2015,AFC Bournemouth,0,0,0,0,0,0,0,0,0,0,0,0,0,0,0,0,0,0,0,0,0,0,0,0,0,0,0,0,0,0
5979,5979,Corey Jordan,3209,2015,AFC Bournemouth,0,0,0,0,0,0,0,0,0,0,0,0,0,0,0,0,0,0,0,0,0,0,0,0,0,0,0,0,0,0
5980,5980,Elvijs Putniņš,3210,2011,Queens Park Rangers,0,0,0,0,0,0,0,0,0,0,0,0,0,0,0,0,0,0,0,0,0,0,0,0,0,0,0,0,0,0
5981,5981,Jason Puncheon,1026,2011,Queens Park Rangers,2,0,2,15,0,0,0,0,0,0,0,0,2,0,2,15,0,0,0,0,0,0,0,0,0,0,0,0,0,0
5982,5982,Henrikh Mkhitaryan,2572,2016,Manchester United,12,7,5,638,2,0,12,8,4,712,2,0,24,15,9,1350,4,0,3,0,3,1,1,2,0,0,0,0,0,0
5983,5983,Anthony Martial,1647,2016,Manchester United,13,9,4,816,3,0,12,9,3,743,1,0,25,18,7,1559,4,0,0,0,0,2,1,3,0,0,0,0,0,0
5984,5984,Timothy Fosu-Mensah,2255,2016,Manchester United,2,1,1,91,0,0,2,0,2,5,0,0,4,1,3,96,0,0,0,0,0,0,0,0,0,0,0,0,0,0
5985,5985,Axel Tuanzebe,3211,2016,Manchester United,1,1,0,90,0,0,3,3,0,215,0,0,4,4,0,305,0,0,0,0,0,0,0,0,0,0,0,0,0,0
5986,5986,Matty Willock,3212,2016,Manchester United,0,0,0,0,0,0,0,0,0,0,0,0,0,0,0,0,0,0,0,0,0,0,0,0,0,0,0,0,0,0
5987,5987,Ben Foster,1653,2016,West Bromwich Albion,19,19,0,1710,0,0,19,19,0,1710,0,0,38,38,0,3420,0,0,0,0,0,0,0,0,0,0,0,0,0,0
5988,5988,Allan Nyom,1654,2016,West Bromwich Albion,16,14,2,1293,0,0,16,15,1,1345,0,0,32,29,3,2638,0,0,0,0,0,0,0,0,0,0,0,0,0,0
5989,5989,Jonny Evans,1216,2016,West Bromwich Albion,15,15,0,1290,1,0,16,15,1,1348,1,0,31,30,1,2638,2,0,0,0,0,1,1,2,0,0,0,0,0,0
5990,5990,Gareth McAuley,1732,2016,West Bromwich Albion,19,19,0,1647,3,0,17,17,0,1496,3,0,36,36,0,3143,6,0,3,1,4,3,2,5,0,0,0,0,0,0
5991,5991,Craig Dawson,1655,2016,West Bromwich Albion,18,18,0,1568,3,0,19,19,0,1710,1,0,37,37,0,3278,4,0,0,0,0,2,1,3,0,0,0,0,0,0
5992,5992,Chris Brunt,1658,2016,West Bromwich Albion,16,14,2,1290,3,0,15,13,2,1187,0,0,31,27,4,2477,3,0,0,0,0,1,0,1,0,0,0,0,0,0
5993,5993,Darren Fletcher,1730,2016,West Bromwich Albion,19,18,1,1569,2,0,19,19,0,1666,0,0,38,37,1,3235,2,0,0,0,0,1,0,1,0,0,0,0,0,0
5994,5994,Hal Robson-Kanu,1984,2016,West Bromwich Albion,13,1,12,210,1,0,16,4,12,473,2,0,29,5,24,683,3,0,0,3,3,1,1,2,0,0,0,0,0,0
5995,5995,James McClean,1407,2016,West Bromwich Albion,18,6,12,736,1,0,16,7,9,728,0,0,34,13,21,1464,1,0,0,0,0,0,0,0,0,0,0,0,0,0
5996,5996,Nacer Chadli,1170,2016,West Bromwich Albion,16,14,2,1140,3,0,15,13,2,1009,2,0,31,27,4,2149,5,0,0,0,0,2,2,4,1,0,1,0,0,0
5997,5997,Claudio Yacob,1661,2016,West Bromwich Albion,15,12,3,1107,0,0,18,15,3,1311,0,0,33,27,6,2418,0,0,0,0,0,0,0,0,0,0,0,0,0,0
5998,5998,James Morrison,1735,2016,West Bromwich Albion,14,10,4,917,3,0,17,7,10,822,2,0,31,17,14,1739,5,0,3,0,3,1,2,3,0,0,0,0,0,0
5999,5999,Salomón Rondón,1659,2016,West Bromwich Albion,19,18,1,1583,5,0,19,14,5,1313,3,0,38,32,6,2896,8,0,0,4,4,1,3,4,0,0,0,0,0,0
6000,6000,Boaz Myhill,1663,2016,West Bromwich Albion,0,0,0,0,0,0,0,0,0,0,0,0,0,0,0,0,0,0,0,0,0,0,0,0,0,0,0,0,0,0
6001,6001,Marc Wilson,1546,2016,West Bromwich Albion,1,0,1,26,0,0,3,3,0,230,0,0,4,3,1,256,0,0,0,0,0,0,0,0,0,0,0,0,0,0
6002,6002,Rekeem Harper,3213,2016,West Bromwich Albion,0,0,0,0,0,0,0,0,0,0,0,0,0,0,0,0,0,0,0,0,0,0,0,0,0,0,0,0,0,0
6003,6003,Sam Field,1665,2016,West Bromwich Albion,5,2,3,131,0,0,3,2,1,145,0,0,8,4,4,276,0,0,0,0,0,0,0,0,0,0,0,0,0,0
6004,6004,Florian Lejeune,2577,2018,Newcastle United,6,6,0,515,0,0,6,6,0,540,0,0,12,12,0,1055,0,0,0,0,0,0,0,0,0,0,0,0,0,0
6005,6005,Isaac Hayden,2470,2018,Newcastle United,11,10,1,904,0,0,14,11,3,983,1,0,25,21,4,1887,1,0,0,0,0,0,1,1,0,0,0,0,0,0
6006,6006,Miguel Almirón,2471,2018,Newcastle United,5,5,0,405,0,0,5,4,1,358,0,0,10,9,1,763,0,0,0,0,0,0,0,0,0,0,0,0,0,0
6007,6007,Sean Longstaff,2475,2018,Newcastle United,4,4,0,355,1,0,5,4,1,333,0,0,9,8,1,688,1,0,0,0,0,0,0,0,0,0,0,0,0,0
6008,6008,Tom Heaton,1249,2018,Burnley FC,10,10,0,900,0,0,9,9,0,810,0,0,19,19,0,1710,0,0,0,0,0,0,0,0,0,0,0,0,0,0
6009,6009,Charlie Taylor,2347,2018,Burnley FC,19,18,1,1636,0,0,19,17,2,1604,0,0,38,35,3,3240,0,0,0,0,0,0,0,0,0,0,0,0,0,0
6010,6010,James Tarkowski,1264,2018,Burnley FC,18,18,0,1620,2,0,17,17,0,1467,1,0,35,35,0,3087,3,0,3,0,3,2,0,2,0,0,0,0,0,0
6011,6011,Ben Mee,1251,2018,Burnley FC,19,19,0,1710,0,0,19,19,0,1710,0,0,38,38,0,3420,0,0,0,0,0,0,0,0,0,0,0,0,0,0
6012,6012,Phil Bardsley,1409,2018,Burnley FC,10,10,0,900,0,0,9,9,0,772,0,0,19,19,0,1672,0,0,0,0,0,0,0,0,0,0,0,0,0,0
6013,6013,Jack Cork,1701,2018,Burnley FC,19,19,0,1693,1,0,18,18,0,1620,0,0,37,37,0,3313,1,0,0,0,0,1,0,1,0,0,0,0,0,0
6014,6014,Jeff Hendrick,1254,2018,Burnley FC,15,12,3,898,1,0,17,13,4,1173,2,0,32,25,7,2071,3,0,0,0,0,1,2,3,0,0,0,0,0,0
6015,6015,Jóhann Guðmundsson,1256,2018,Burnley FC,15,8,7,847,0,0,14,11,3,901,3,0,29,19,10,1748,3,0,0,0,0,0,2,2,0,0,0,0,0,0
6016,6016,Ashley Barnes,1491,2018,Burnley FC,19,14,5,1307,6,0,18,12,6,1080,6,0,37,26,11,2387,12,0,4,4,8,2,3,5,1,1,2,0,0,0
6017,6017,Chris Wood,2348,2018,Burnley FC,19,15,4,1330,4,0,19,14,5,1265,6,0,38,29,9,2595,10,0,0,0,0,3,4,7,0,0,0,0,0,0
6018,6018,Dwight McNeil,2349,2018,Burnley FC,12,11,1,941,3,0,9,8,1,658,0,0,21,19,2,1599,3,0,0,0,0,1,0,1,0,0,0,0,0,0
6019,6019,Robbie Brady,2230,2018,Burnley FC,9,4,5,390,0,0,7,2,5,325,0,0,16,6,10,715,0,0,0,0,0,0,0,0,0,0,0,0,0,0
6020,6020,Peter Crouch,1273,2018,Burnley FC,4,0,4,56,0,0,2,0,2,30,0,0,6,0,6,86,0,0,0,0,0,0,0,0,0,0,0,0,0,0
6021,6021,Matěj Vydra,2302,2018,Burnley FC,6,1,5,93,1,0,7,2,5,220,0,0,13,3,10,313,1,0,0,0,0,1,0,1,0,0,0,0,0,0
6022,6022,Joe Hart,1363,2018,Burnley FC,9,9,0,810,0,0,10,10,0,900,0,0,19,19,0,1710,0,0,0,0,0,0,0,0,0,0,0,0,0,0
6023,6023,Matthew Lowton,1250,2018,Burnley FC,9,9,0,810,0,0,12,10,2,938,0,0,21,19,2,1748,0,0,0,0,0,0,0,0,0,0,0,0,0,0
6024,6024,Ben Gibson,3004,2018,Burnley FC,1,1,0,63,1,0,0,0,0,0,0,0,1,1,0,63,1,0,0,0,0,0,0,0,0,0,0,0,0,0
6025,6025,Stephen Ward,1252,2018,Burnley FC,1,1,0,74,0,0,2,2,0,156,0,0,3,3,0,230,0,0,0,0,0,0,0,0,0,0,0,0,0,0
6026,6026,Robert Green,1277,2006,West Ham United,13,13,0,1170,0,0,12,12,0,1080,0,0,25,25,0,2250,0,0,0,0,0,0,0,0,0,0,0,0,0,0
6027,6027,Paul Konchesky,1560,2006,West Ham United,10,10,0,900,0,0,11,11,0,981,0,0,21,21,0,1881,0,0,0,0,0,0,0,0,0,0,0,0,0,0
6028,6028,Daniel Gabbidon,2464,2006,West Ham United,10,10,0,861,0,0,8,8,0,696,0,0,18,18,0,1557,0,0,0,0,0,0,0,0,0,0,0,0,0,0
6029,6029,Jonathan Spector,1288,2006,West Ham United,13,10,3,1027,0,0,11,6,5,665,0,0,24,16,8,1692,0,0,0,0,0,0,0,0,0,0,0,0,0,0
6030,6030,James Collins,1618,2006,West Ham United,7,7,0,551,0,0,9,9,0,810,0,0,16,16,0,1361,0,0,0,0,0,0,0,0,0,0,0,0,0,0
6031,6031,Matthew Etherington,1557,2006,West Ham United,14,13,1,1067,0,0,12,10,2,868,0,0,26,23,3,1935,0,0,0,0,0,0,0,0,0,0,0,0,0,0
6032,6032,Yossi Benayoun,1892,2006,West Ham United,16,14,2,1262,2,0,12,11,1,978,1,0,28,25,3,2240,3,0,0,0,0,2,0,2,0,0,0,0,0,0
6033,6033,Hayden Mullins,1941,2006,West Ham United,14,10,4,945,2,0,15,10,5,1032,0,0,29,20,9,1977,2,0,3,0,3,1,0,1,0,0,0,0,0,0
6034,6034,Nigel Reo-Coker,2494,2006,West Ham United,17,17,0,1483,1,0,17,17,0,1517,0,0,34,34,0,3000,1,0,3,0,3,1,0,1,0,0,0,0,0,0
6035,6035,Teddy Sheringham,1076,2006,West Ham United,9,2,7,331,2,0,7,2,5,252,0,0,16,4,12,583,2,0,0,0,0,1,0,1,0,0,0,0,0,0
6036,6036,Marlon Harewood,1942,2006,West Ham United,15,9,6,857,1,0,16,9,7,814,2,0,31,18,13,1671,3,0,3,0,3,1,0,1,0,0,0,0,0,0
6037,6037,Carlton Cole,2326,2006,West Ham United,8,3,5,302,1,0,9,2,7,232,1,0,17,5,12,534,2,0,0,0,0,0,1,1,0,0,0,0,0,0
6038,6038,Carlos Tévez,1417,2006,West Ham United,14,10,4,871,5,0,12,9,3,827,2,0,26,19,7,1698,7,0,0,3,3,2,2,4,0,1,1,0,0,0
6039,6039,Wayne Bridge,1768,2007,Chelsea FC,7,6,1,545,0,0,4,3,1,271,0,0,11,9,2,816,0,0,0,0,0,0,0,0,0,0,0,0,0,0
6040,6040,Alex,2269,2007,Chelsea FC,14,12,2,1125,1,0,14,10,4,941,1,0,28,22,6,2066,2,0,0,0,0,1,0,1,0,0,0,0,0,0
6041,6041,Shaun Wright-Phillips,1683,2007,Chelsea FC,12,9,3,762,1,0,15,11,4,893,1,0,27,20,7,1655,2,0,0,0,0,0,0,0,0,0,0,0,0,0
6042,6042,Adam Johnson,1405,2007,Middlesbrough FC,10,2,8,285,1,0,8,1,7,181,0,0,18,3,15,466,1,0,0,0,0,0,0,0,0,0,0,0,0,0
6043,6043,Afonso Alves,2219,2007,Middlesbrough FC,7,5,2,423,5,0,4,2,2,226,1,0,11,7,4,649,6,0,0,0,0,2,1,3,0,0,0,0,0,0
6044,6044,Martín Montoya,2418,2018,Brighton & Hove Albion,14,13,1,1176,0,0,11,11,0,990,0,0,25,24,1,2166,0,0,0,0,0,0,0,0,0,0,0,0,0,0
6045,6045,Jonas Lössl,2449,2018,Huddersfield Town,16,15,1,1427,0,0,15,15,0,1350,0,0,31,30,1,2777,0,0,0,0,0,0,0,0,0,0,0,0,0,0
6046,6046,Terence Kongolo,3214,2018,Huddersfield Town,17,17,0,1405,0,0,15,15,0,1317,1,0,32,32,0,2722,1,0,0,0,0,0,0,0,0,0,0,0,0,0
6047,6047,Christopher Schindler,3098,2018,Huddersfield Town,19,19,0,1691,0,0,18,18,0,1620,1,0,37,37,0,3311,1,0,0,1,1,0,1,1,0,0,0,0,0,0
6048,6048,Jon Stanković,3215,2018,Huddersfield Town,3,3,0,218,0,0,8,6,2,502,1,0,11,9,2,720,1,0,0,0,0,0,0,0,0,0,0,0,0,0
6049,6049,Erik Durm,3216,2018,Huddersfield Town,13,8,5,875,0,0,15,13,2,1183,0,0,28,21,7,2058,0,0,0,0,0,0,0,0,0,0,0,0,0,0
6050,6050,Jonathan Hogg,2598,2018,Huddersfield Town,16,16,0,1321,0,0,13,13,0,1083,0,0,29,29,0,2404,0,0,0,0,0,0,0,0,0,0,0,0,0,0
6051,6051,Juninho Bacuna,3217,2018,Huddersfield Town,11,8,3,723,0,0,10,8,2,692,1,0,21,16,5,1415,1,0,0,0,0,0,1,1,0,0,0,0,0,0
6052,6052,Philip Billing,3192,2018,Huddersfield Town,13,13,0,1106,1,0,14,12,2,1086,1,0,27,25,2,2192,2,0,0,0,0,0,1,1,0,0,0,0,0,0
6053,6053,Alex Pritchard,3028,2018,Huddersfield Town,14,13,1,992,1,0,16,13,3,1100,1,0,30,26,4,2092,2,0,0,1,1,1,1,2,0,0,0,0,0,0
6054,6054,Karlan Grant,3218,2018,Huddersfield Town,6,3,3,331,2,0,7,6,1,543,2,0,13,9,4,874,4,0,0,0,0,0,1,1,0,0,0,0,0,0
6055,6055,Steve Mounié,3108,2018,Huddersfield Town,16,12,4,1067,2,0,15,7,8,768,0,0,31,19,12,1835,2,0,3,0,3,2,0,2,0,0,0,0,0,0
6056,6056,Florent Hadergjonaj,3099,2018,Huddersfield Town,12,11,1,1011,0,0,12,8,4,829,0,0,24,19,5,1840,0,0,0,0,0,0,0,0,0,0,0,0,0,0
6057,6057,Aaron Mooy,2430,2018,Huddersfield Town,15,13,2,1190,1,0,14,12,2,1137,2,0,29,25,4,2327,3,0,0,0,0,0,1,1,1,0,1,0,0,0
6058,6058,Elias Kachunga,3101,2018,Huddersfield Town,9,7,2,611,0,0,11,6,5,570,0,0,20,13,7,1181,0,0,0,0,0,0,0,0,0,0,0,0,0,0
6059,6059,Ben Hamer,2520,2018,Huddersfield Town,4,4,0,283,0,0,3,3,0,270,0,0,7,7,0,553,0,0,0,0,0,0,0,0,0,0,0,0,0,0
6060,6060,Chris Löwe,3104,2018,Huddersfield Town,15,11,4,933,0,0,14,12,2,1124,0,0,29,23,6,2057,0,0,0,0,0,0,0,0,0,0,0,0,0,0
6061,6061,Zanka,3097,2018,Huddersfield Town,14,14,0,1248,1,0,10,10,0,900,2,0,24,24,0,2148,3,0,0,0,0,1,1,2,0,0,0,0,0,0
6062,6062,Matty Daly,3219,2018,Huddersfield Town,1,0,1,49,0,0,1,0,1,24,0,0,2,0,2,73,0,0,0,0,0,0,0,0,0,0,0,0,0,0
6063,6063,Bryan Hughes,1957,2004,Charlton Athletic,8,5,3,429,1,0,8,4,4,443,0,0,16,9,7,872,1,0,0,0,0,1,0,1,0,0,0,0,0,0
6064,6064,Jonatan Johansson,1676,2004,Charlton Athletic,12,7,5,742,4,0,13,7,6,628,0,0,25,14,11,1370,4,0,0,0,0,3,0,3,0,0,0,0,0,0
6065,6065,Kelvin Davis,1143,2005,Sunderland AFC,16,16,0,1440,0,0,17,17,0,1530,0,0,33,33,0,2970,0,0,0,0,0,0,0,0,0,0,0,0,0,0
6066,6066,Stephen Wright,3024,2005,Sunderland AFC,1,1,0,80,0,0,1,1,0,90,0,0,2,2,0,170,0,0,0,0,0,0,0,0,0,0,0,0,0,0
6067,6067,Gary Breen,2098,2005,Sunderland AFC,16,15,1,1376,1,0,19,18,1,1555,0,0,35,33,2,2931,1,0,0,0,0,1,0,1,0,0,0,0,0,0
6068,6068,Steven Caldwell,2375,2005,Sunderland AFC,13,13,0,1144,0,0,11,10,1,864,0,0,24,23,1,2008,0,0,0,0,0,0,0,0,0,0,0,0,0,0
6069,6069,Carl Robinson,3220,2005,Sunderland AFC,3,1,2,105,0,0,2,2,0,171,0,0,5,3,2,276,0,0,0,0,0,0,0,0,0,0,0,0,0,0
6070,6070,Dean Whitehead,1218,2005,Sunderland AFC,18,17,1,1538,2,0,19,19,0,1710,1,0,37,36,1,3248,3,0,0,0,0,1,1,2,2,0,2,0,0,0
6071,6071,Tommy Miller,3221,2005,Sunderland AFC,16,16,0,1322,1,0,13,11,2,994,2,0,29,27,2,2316,3,0,0,0,0,1,2,3,0,0,0,0,0,0
6072,6072,Andy Gray,3222,2005,Sunderland AFC,11,8,3,594,1,0,10,5,5,530,0,0,21,13,8,1124,1,0,0,0,0,1,0,1,0,0,0,0,0,0
6073,6073,Julio Arca,1341,2005,Sunderland AFC,11,10,1,871,0,0,13,12,1,1107,1,0,24,22,2,1978,1,0,0,0,0,0,0,0,0,0,0,0,0,0
6074,6074,Jon Stead,1139,2005,Sunderland AFC,17,12,5,1047,0,0,13,9,4,649,1,0,30,21,9,1696,1,0,0,0,0,0,1,1,0,0,0,0,0,0
6075,6075,Andy Welsh,3223,2005,Sunderland AFC,9,8,1,718,0,0,5,4,1,326,0,0,14,12,2,1044,0,0,0,0,0,0,0,0,0,0,0,0,0,0
6076,6076,Nayron Nosworthy,1214,2005,Sunderland AFC,13,11,2,983,0,0,17,13,4,1270,0,0,30,24,6,2253,0,0,0,0,0,0,0,0,0,0,0,0,0,0
6077,6077,Liam Lawrence,2536,2005,Sunderland AFC,16,9,7,960,1,0,13,10,3,837,2,0,29,19,10,1797,3,0,0,0,0,1,2,3,0,0,0,0,0,0
6078,6078,Stephen Elliott,3224,2005,Sunderland AFC,7,6,1,514,1,0,8,5,3,549,1,0,15,11,4,1063,2,0,0,0,0,0,1,1,0,0,0,0,0,0
6079,6079,Stephan Andersen,3225,2005,Charlton Athletic,7,7,0,630,0,0,8,8,0,720,0,0,15,15,0,1350,0,0,0,0,0,0,0,0,0,0,0,0,0,0
6080,6080,Chris Powell,1669,2005,Charlton Athletic,13,13,0,1150,0,0,14,12,2,1020,0,0,27,25,2,2170,0,0,0,0,0,0,0,0,0,0,0,0,0,0
6081,6081,Danny Murphy,1398,2005,Charlton Athletic,9,9,0,805,1,0,9,8,1,693,3,0,18,17,1,1498,4,0,1,0,1,1,2,3,0,1,1,0,0,0
6082,6082,Aleksey Smertin,1072,2005,Charlton Athletic,9,9,0,742,0,0,9,9,0,785,0,0,18,18,0,1527,0,0,0,0,0,0,0,0,0,0,0,0,0,0
6083,6083,Dennis Rommedahl,2747,2005,Charlton Athletic,10,8,2,673,0,0,11,11,0,738,2,0,21,19,2,1411,2,0,0,3,3,0,2,2,0,0,0,0,0,0
6084,6084,Jerome Thomas,1736,2005,Charlton Athletic,13,9,4,774,0,0,12,7,5,634,1,0,25,16,9,1408,1,0,0,0,0,0,0,0,0,0,0,0,0,0
6085,6085,Molla Wagué,3226,2017,Watford FC,3,3,0,244,1,0,3,2,1,195,0,0,6,5,1,439,1,0,0,0,0,1,0,1,0,0,0,0,0,0
6086,6086,Marvin Zeegelaar,3227,2017,Watford FC,7,7,0,630,0,0,5,5,0,416,0,0,12,12,0,1046,0,0,0,0,0,0,0,0,0,0,0,0,0,0
6087,6087,Renato Sanches,3228,2017,Swansea City,5,4,1,313,0,0,7,5,2,392,0,0,12,9,3,705,0,0,0,0,0,0,0,0,0,0,0,0,0,0
6088,6088,Roque Mesa,3229,2017,Swansea City,6,5,1,470,0,0,5,4,1,287,0,0,11,9,2,757,0,0,0,0,0,0,0,0,0,0,0,0,0,0
6089,6089,Oliver McBurnie,3197,2017,Swansea City,3,0,3,39,0,0,8,2,6,230,0,0,11,2,9,269,0,0,0,0,0,0,0,0,0,0,0,0,0,0
6090,6090,Pepe Reina,1775,2005,Liverpool FC,18,18,0,1620,0,0,15,15,0,1350,0,0,33,33,0,2970,0,0,0,0,0,0,0,0,0,0,0,0,0,0
6091,6091,Steve Finnan,2883,2005,Liverpool FC,17,17,0,1518,0,0,16,16,0,1413,0,0,33,33,0,2931,0,0,0,0,0,0,0,0,0,0,0,0,0,0
6092,6092,Sami Hyypiä,2361,2005,Liverpool FC,17,17,0,1466,0,0,19,18,1,1627,1,0,36,35,1,3093,1,0,0,3,3,0,1,1,0,0,0,0,0,0
6093,6093,John Arne Riise,2362,2005,Liverpool FC,17,13,4,1270,0,0,15,11,4,994,1,0,32,24,8,2264,1,0,0,3,3,0,1,1,0,0,0,0,0,0
6094,6094,Jamie Carragher,1778,2005,Liverpool FC,17,17,0,1530,0,0,19,19,0,1710,0,0,36,36,0,3240,0,0,0,0,0,0,0,0,0,0,0,0,0,0
6095,6095,Steven Gerrard,1424,2005,Liverpool FC,18,18,0,1560,5,0,14,14,0,1239,5,0,32,32,0,2799,10,0,0,0,0,4,2,6,0,2,2,0,0,0
6096,6096,Xabi Alonso,1891,2005,Liverpool FC,18,15,3,1306,2,0,17,14,3,1274,1,0,35,29,6,2580,3,0,3,0,3,2,0,2,0,0,0,0,0,0
6097,6097,Mohamed Sissoko,2745,2005,Liverpool FC,11,7,4,699,0,0,15,14,1,1281,0,0,26,21,5,1980,0,0,0,0,0,0,0,0,0,0,0,0,0,0
6098,6098,Djibril Cissé,1899,2005,Liverpool FC,16,8,8,715,2,0,17,11,6,1041,7,0,33,19,14,1756,9,0,3,4,7,1,3,4,0,2,2,0,0,0
6099,6099,Luis García,3230,2005,Liverpool FC,16,10,6,985,3,0,15,5,10,609,4,0,31,15,16,1594,7,0,3,1,4,1,4,5,0,0,0,0,0,0
6100,6100,Morientes,3231,2005,Liverpool FC,15,11,4,1074,5,0,13,9,4,751,0,0,28,20,8,1825,5,0,0,0,0,2,0,2,0,0,0,0,0,0
6101,6101,Boudewijn Zenden,1336,2005,Liverpool FC,4,3,1,260,2,0,3,2,1,191,0,0,7,5,2,451,2,0,0,0,0,1,0,1,0,0,0,0,0,0
6102,6102,Peter Crouch,1273,2005,Liverpool FC,17,15,2,1153,5,0,15,12,3,987,3,0,32,27,5,2140,8,0,3,0,3,2,2,4,0,0,0,0,0,0
6103,6103,Juan Iturbe,3232,2015,AFC Bournemouth,2,0,2,55,0,0,0,0,0,0,0,0,2,0,2,55,0,0,0,0,0,0,0,0,0,0,0,0,0,0
6104,6104,Carl Jenkinson,2752,2015,West Ham United,10,8,2,695,0,0,10,5,5,540,2,0,20,13,7,1235,2,0,0,0,0,0,1,1,0,0,0,0,0,0
6105,6105,Alex Song,1233,2015,West Ham United,4,4,0,290,0,0,8,4,4,369,0,0,12,8,4,659,0,0,0,0,0,0,0,0,0,0,0,0,0,0
6106,6106,Nikica Jelavić,2228,2015,West Ham United,5,0,5,30,0,0,8,1,7,308,1,0,13,1,12,338,1,0,0,0,0,0,0,0,0,0,0,0,0,0
6107,6107,Reece Oxford,2789,2015,West Ham United,2,1,1,70,0,0,5,2,3,141,0,0,7,3,4,211,0,0,0,0,0,0,0,0,0,0,0,0,0,0
6108,6108,Josh Cullen,2947,2015,West Ham United,0,0,0,0,0,0,1,0,1,1,0,0,1,0,1,1,0,0,0,0,0,0,0,0,0,0,0,0,0,0
6109,6109,José Enrique,2394,2013,Liverpool FC,5,3,2,332,0,0,3,3,0,270,0,0,8,6,2,602,0,0,0,0,0,0,0,0,0,0,0,0,0,0
6110,6110,Mamadou Sakho,2250,2013,Liverpool FC,7,7,0,607,1,0,11,10,1,874,0,0,18,17,1,1481,1,0,0,0,0,0,0,0,0,0,0,0,0,0
6111,6111,Daniel Agger,1776,2013,Liverpool FC,12,10,2,869,2,0,8,6,2,550,0,0,20,16,4,1419,2,0,0,0,0,2,0,2,0,0,0,0,0,0
6112,6112,Tiago Ilori,3233,2013,Liverpool FC,0,0,0,0,0,0,0,0,0,0,0,0,0,0,0,0,0,0,0,0,0,0,0,0,0,0,0,0,0,0
6113,6113,Andre Wisdom,2625,2013,Liverpool FC,1,0,1,12,0,0,1,1,0,69,0,0,2,1,1,81,0,0,0,0,0,0,0,0,0,0,0,0,0,0
6114,6114,Jordon Ibe,1042,2013,Liverpool FC,1,0,1,14,0,0,0,0,0,0,0,0,1,0,1,14,0,0,0,0,0,0,0,0,0,0,0,0,0,0
6115,6115,Joel Ward,1019,2013,Crystal Palace,18,18,0,1620,0,0,18,18,0,1620,0,0,36,36,0,3240,0,0,0,0,0,0,0,0,0,0,0,0,0,0
6116,6116,Florian Marange,3234,2013,Crystal Palace,0,0,0,0,0,0,1,1,0,90,0,0,1,1,0,90,0,0,0,0,0,0,0,0,0,0,0,0,0,0
6117,6117,Yannick Bolasie,1057,2013,Crystal Palace,14,11,3,975,0,0,15,12,3,1073,0,0,29,23,6,2048,0,0,0,0,0,0,0,0,0,0,0,0,0,0
6118,6118,Lewis Price,3235,2013,Crystal Palace,0,0,0,0,0,0,0,0,0,0,0,0,0,0,0,0,0,0,0,0,0,0,0,0,0,0,0,0,0,0
6119,6119,Ryan Inniss,3236,2013,Crystal Palace,0,0,0,0,0,0,0,0,0,0,0,0,0,0,0,0,0,0,0,0,0,0,0,0,0,0,0,0,0,0
6120,6120,Dean Kiely,2334,2005,Portsmouth FC,8,8,0,720,0,0,7,7,0,630,0,0,15,15,0,1350,0,0,0,0,0,0,0,0,0,0,0,0,0,0
6121,6121,Linvoy Primus,1065,2005,Portsmouth FC,11,11,0,916,0,0,9,9,0,810,0,0,20,20,0,1726,0,0,0,0,0,0,0,0,0,0,0,0,0,0
6122,6122,Andy Griffin,1578,2005,Portsmouth FC,10,8,2,802,0,0,12,12,0,969,0,0,22,20,2,1771,0,0,0,0,0,0,0,0,0,0,0,0,0,0
6123,6123,Andrés D'Alessandro,3237,2005,Portsmouth FC,8,8,0,651,0,0,5,5,0,426,1,0,13,13,0,1077,1,0,0,0,0,0,1,1,0,0,0,0,0,0
6124,6124,Matthew Taylor,1069,2005,Portsmouth FC,17,16,1,1458,2,0,17,16,1,1394,4,0,34,32,2,2852,6,0,3,3,6,1,3,4,1,1,2,0,0,0
6125,6125,Wayne Routledge,1758,2005,Portsmouth FC,8,1,7,272,0,0,5,2,3,165,0,0,13,3,10,437,0,0,0,0,0,0,0,0,0,0,0,0,0,0
6126,6126,Sean Davis,1087,2005,Portsmouth FC,9,9,0,671,0,0,8,7,1,568,1,0,17,16,1,1239,1,0,0,0,0,0,0,0,0,0,0,0,0,0
6127,6127,Pedro Mendes,1390,2005,Portsmouth FC,7,7,0,613,2,0,7,7,0,608,1,0,14,14,0,1221,3,0,3,0,3,2,0,2,0,0,0,0,0,0
6128,6128,Benjani,1391,2005,Portsmouth FC,9,9,0,705,0,0,7,7,0,576,1,0,16,16,0,1281,1,0,0,0,0,0,1,1,0,0,0,0,0,0
6129,6129,Noé Pamarot,1387,2005,Portsmouth FC,4,2,2,185,0,0,4,2,2,268,0,0,8,4,4,453,0,0,0,0,0,0,0,0,0,0,0,0,0,0
6130,6130,Salif Diao,1992,2005,Portsmouth FC,6,3,3,282,0,0,5,4,1,374,0,0,11,7,4,656,0,0,0,0,0,0,0,0,0,0,0,0,0,0
6131,6131,Henrikh Mkhitaryan,2572,2019,Arsenal FC,1,0,1,23,0,0,2,1,1,88,0,0,3,1,2,111,0,0,0,0,0,0,0,0,0,0,0,0,0,0
6132,6132,Jordon Mutch,1024,2010,Birmingham City,0,0,0,0,0,0,3,3,0,244,0,0,3,3,0,244,0,0,0,0,0,0,0,0,0,0,0,0,0,0
6133,6133,Nedum Onuoha,2533,2010,Sunderland AFC,16,16,0,1345,0,0,15,15,0,1324,1,0,31,31,0,2669,1,0,0,0,0,0,1,1,0,0,0,0,0,0
6134,6134,Ryan Noble,3238,2010,Sunderland AFC,1,0,1,20,0,0,2,0,2,42,0,0,3,0,3,62,0,0,0,0,0,0,0,0,0,0,0,0,0,0
6135,6135,Cristian Riveros,3239,2010,Sunderland AFC,3,2,1,181,0,0,9,3,6,320,1,0,12,5,7,501,1,0,0,0,0,0,0,0,0,0,0,0,0,0
6136,6136,David Meyler,2225,2010,Sunderland AFC,2,2,0,148,0,0,3,2,1,113,0,0,5,4,1,261,0,0,0,0,0,0,0,0,0,0,0,0,0,0
6137,6137,Michy Batshuayi,2732,2018,Crystal Palace,6,4,2,368,2,0,5,5,0,388,3,0,11,9,2,756,5,0,0,0,0,1,2,3,0,0,0,0,0,0
6138,6138,Christian Benteke,1443,2018,Crystal Palace,10,6,4,526,0,0,6,3,3,287,1,0,16,9,7,813,1,0,0,0,0,0,1,1,0,0,0,0,0,0
6139,6139,Martin Kelly,1034,2018,Crystal Palace,8,7,1,660,0,0,5,5,0,450,0,0,13,12,1,1110,0,0,0,0,0,0,0,0,0,0,0,0,0,0
6140,6140,Cheikhou Kouyaté,2311,2018,Crystal Palace,14,9,5,865,0,0,17,12,5,1032,0,0,31,21,10,1897,0,0,0,0,0,0,0,0,0,0,0,0,0,0
6141,6141,Tim Howard,1743,2007,Everton FC,18,18,0,1620,0,0,18,18,0,1620,0,0,36,36,0,3240,0,0,0,0,0,0,0,0,0,0,0,0,0,0
6142,6142,Joseph Yobo,1801,2007,Everton FC,16,15,1,1351,1,0,14,14,0,1260,0,0,30,29,1,2611,1,0,0,0,0,1,0,1,0,0,0,0,0,0
6143,6143,Joleon Lescott,1365,2007,Everton FC,19,18,1,1664,3,0,19,19,0,1710,5,0,38,37,1,3374,8,0,3,3,6,3,3,6,0,0,0,0,0,0
6144,6144,Alan Stubbs,2795,2007,Everton FC,5,5,0,338,0,0,3,2,1,224,1,0,8,7,1,562,1,0,0,0,0,0,0,0,0,0,0,0,0,0
6145,6145,Phil Neville,1114,2007,Everton FC,19,19,0,1702,2,0,18,18,0,1542,0,0,37,37,0,3244,2,0,0,0,0,2,0,2,0,0,0,0,0,0
6146,6146,Mikel Arteta,1802,2007,Everton FC,16,15,1,1374,0,0,12,12,0,1080,1,0,28,27,1,2454,1,0,0,0,0,0,1,1,0,0,0,0,0,0
6147,6147,Tim Cahill,1746,2007,Everton FC,9,9,0,706,5,0,9,9,0,798,2,0,18,18,0,1504,7,0,0,1,1,2,2,4,0,0,0,0,0,0
6148,6148,Steven Pienaar,2406,2007,Everton FC,12,10,2,902,2,0,16,15,1,1187,0,0,28,25,3,2089,2,0,0,0,0,0,0,0,0,0,0,0,0,0
6149,6149,Leon Osman,1747,2007,Everton FC,13,13,0,1125,3,0,15,13,2,1190,1,0,28,26,2,2315,4,0,3,0,3,2,1,3,0,0,0,0,0,0
6150,6150,Lee Carsley,1803,2007,Everton FC,17,16,1,1391,1,0,17,17,0,1477,0,0,34,33,1,2868,1,0,0,0,0,1,0,1,0,0,0,0,0,0
6151,6151,Yakubu Ayegbeni,1073,2007,Everton FC,14,14,0,1157,11,0,15,12,3,1004,4,0,29,26,3,2161,15,0,0,0,0,6,3,9,1,0,1,0,0,0
6152,6152,Phil Jagielka,1048,2007,Everton FC,18,13,5,1378,1,0,16,14,2,1272,0,0,34,27,7,2650,1,0,3,0,3,1,0,1,0,0,0,0,0,0
6153,6153,Thomas Gravesen,2796,2007,Everton FC,4,1,3,118,0,0,4,0,4,59,0,0,8,1,7,177,0,0,0,0,0,0,0,0,0,0,0,0,0,0
6154,6154,James Vaughan,3240,2007,Everton FC,5,0,5,104,1,0,3,0,3,35,0,0,8,0,8,139,1,0,0,0,0,0,0,0,0,0,0,0,0,0
6155,6155,Rafael Schmitz,3241,2007,Birmingham City,7,5,2,465,0,0,8,7,1,611,0,0,15,12,3,1076,0,0,0,0,0,0,0,0,0,0,0,0,0,0
6156,6156,Daniël de Ridder,3242,2007,Birmingham City,4,3,1,287,0,0,6,3,3,291,0,0,10,6,4,578,0,0,0,0,0,0,0,0,0,0,0,0,0,0
6157,6157,David Seaman,2354,2001,Arsenal FC,9,9,0,810,0,0,8,8,0,720,0,0,17,17,0,1530,0,0,0,0,0,0,0,0,0,0,0,0,0,0
6158,6158,Ashley Cole,1523,2001,Arsenal FC,14,14,0,1200,1,0,14,14,0,1199,1,0,28,28,0,2399,2,0,3,1,4,1,1,2,0,0,0,0,0,0
6159,6159,Tony Adams,3243,2001,Arsenal FC,7,7,0,630,0,0,3,3,0,257,0,0,10,10,0,887,0,0,0,0,0,0,0,0,0,0,0,0,0,0
6160,6160,Oleg Luzhniy,3244,2001,Arsenal FC,9,9,0,761,0,0,8,5,3,543,0,0,17,14,3,1304,0,0,0,0,0,0,0,0,0,0,0,0,0,0
6161,6161,Sol Campbell,1388,2001,Arsenal FC,13,13,0,1170,1,0,17,15,2,1364,1,0,30,28,2,2534,2,0,0,0,0,1,0,1,0,0,0,0,0,0
6162,6162,Patrick Vieira,1524,2001,Arsenal FC,19,18,1,1582,2,0,16,16,0,1440,0,0,35,34,1,3022,2,0,0,0,0,2,0,2,0,0,0,0,0,0
6163,6163,Freddie Ljungberg,1525,2001,Arsenal FC,12,12,0,937,7,0,12,11,1,910,5,0,24,23,1,1847,12,0,0,0,0,6,3,9,0,0,0,0,0,0
6164,6164,Edu,1529,2001,Arsenal FC,7,5,2,412,0,0,7,3,4,282,1,0,14,8,6,694,1,0,0,0,0,0,1,1,0,0,0,0,0,0
6165,6165,Dennis Bergkamp,1527,2001,Arsenal FC,18,12,6,1115,3,0,14,9,5,769,6,0,32,21,11,1884,9,0,0,3,3,2,3,5,0,0,0,0,0,0
6166,6166,Sylvain Wiltord,2356,2001,Arsenal FC,16,10,6,918,6,0,15,13,2,1102,4,0,31,23,8,2020,10,0,3,6,9,3,2,5,0,0,0,0,0,0
6167,6167,Thierry Henry,2357,2001,Arsenal FC,19,18,1,1626,12,0,13,12,1,1059,12,0,32,30,2,2685,24,0,3,0,3,7,6,13,1,3,4,0,0,0
6168,6168,Gilles Grimandi,3245,2001,Arsenal FC,13,5,8,534,0,0,13,6,7,628,0,0,26,11,15,1162,0,0,0,0,0,0,0,0,0,0,0,0,0,0
6169,6169,Francis Jeffers,2359,2001,Arsenal FC,4,0,4,72,2,0,2,2,0,122,0,0,6,2,4,194,2,0,0,0,0,1,0,1,0,0,0,0,0,0
6170,6170,Nwankwo Kanu,1324,2001,Arsenal FC,12,5,7,446,2,0,11,4,7,479,1,0,23,9,14,925,3,0,0,0,0,0,1,1,0,0,0,0,0,0
6171,6171,Patrick M'Boma,3246,2001,Sunderland AFC,4,2,2,236,0,0,5,3,2,236,1,0,9,5,4,472,1,0,0,0,0,0,1,1,0,0,0,0,0,0
6172,6172,Philippe Christanval,3247,2006,Fulham FC,11,11,0,976,0,0,8,7,1,631,1,0,19,18,1,1607,1,0,0,1,1,0,1,1,0,0,0,0,0,0
6173,6173,Simon Davies,1125,2006,Fulham FC,7,7,0,630,0,0,6,6,0,518,2,0,13,13,0,1148,2,0,0,0,0,0,2,2,0,0,0,0,0,0
6174,6174,Vincenzo Montella,3248,2006,Fulham FC,6,2,4,214,2,0,3,0,3,65,0,0,9,2,7,279,2,0,0,0,0,2,0,2,1,0,1,0,0,0
6175,6175,Clint Dempsey,1565,2006,Fulham FC,6,0,6,101,1,0,3,1,2,143,0,0,9,1,8,244,1,0,3,0,3,1,0,1,0,0,0,0,0,0
6176,6176,Chris Kirkland,2056,2006,Wigan Athletic,13,13,0,1170,0,0,13,13,0,1126,0,0,26,26,0,2296,0,0,0,0,0,0,0,0,0,0,0,0,0,0
6177,6177,Fitz Hall,2024,2006,Wigan Athletic,12,11,1,950,0,0,12,11,1,945,0,0,24,22,2,1895,0,0,0,0,0,0,0,0,0,0,0,0,0,0
6178,6178,Arjan de Zeeuw,1067,2006,Wigan Athletic,12,12,0,1014,0,0,9,9,0,751,0,0,21,21,0,1765,0,0,0,0,0,0,0,0,0,0,0,0,0,0
6179,6179,Emmerson Boyce,2023,2006,Wigan Athletic,17,17,0,1505,0,0,17,17,0,1517,0,0,34,34,0,3022,0,0,0,0,0,0,0,0,0,0,0,0,0,0
6180,6180,Paul Scharner,1734,2006,Wigan Athletic,12,10,2,956,0,0,13,12,1,1094,3,0,25,22,3,2050,3,0,0,1,1,0,3,3,0,0,0,0,0,0
6181,6181,Leighton Baines,1466,2006,Wigan Athletic,16,16,0,1407,2,0,19,19,0,1710,1,0,35,35,0,3117,3,0,0,0,0,2,0,2,0,1,1,0,0,0
6182,6182,Kevin Kilbane,1103,2006,Wigan Athletic,15,14,1,1201,1,0,16,12,4,1157,0,0,31,26,5,2358,1,0,0,0,0,1,0,1,0,0,0,0,0,0
6183,6183,Denny Landzaat,2342,2006,Wigan Athletic,17,15,2,1292,0,0,16,14,2,1235,2,0,33,29,4,2527,2,0,0,0,0,0,1,1,0,0,0,0,0,0
6184,6184,Gary Teale,1817,2006,Wigan Athletic,5,2,3,202,0,0,7,5,2,334,0,0,12,7,5,536,0,0,0,0,0,0,0,0,0,0,0,0,0,0
6185,6185,Henri Camara,1818,2006,Wigan Athletic,14,11,3,961,3,0,9,7,2,655,3,0,23,18,5,1616,6,0,0,3,3,1,3,4,0,1,1,0,0,0
6186,6186,Emile Heskey,1519,2006,Wigan Athletic,16,16,0,1326,6,0,18,17,1,1379,3,0,34,33,1,2705,9,0,3,0,3,5,3,8,0,0,0,0,0,0
6187,6187,Antonio Valencia,1641,2006,Wigan Athletic,11,9,2,750,1,0,11,8,3,707,0,0,22,17,5,1457,1,0,0,0,0,0,0,0,0,0,0,0,0,0
6188,6188,Lee McCulloch,1819,2006,Wigan Athletic,14,13,1,1150,2,0,15,12,3,1171,2,0,29,25,4,2321,4,0,3,3,6,2,2,4,0,0,0,0,0,0
6189,6189,Svetoslav Todorov,2967,2006,Wigan Athletic,3,1,2,109,0,0,2,1,1,116,0,0,5,2,3,225,0,0,0,0,0,0,0,0,0,0,0,0,0,0
6190,6190,Mario Balotelli,1681,2014,Liverpool FC,8,4,4,401,1,0,8,6,2,538,0,0,16,10,6,939,1,0,3,0,3,1,0,1,0,0,0,0,0,0
6191,6191,Lazar Marković,3249,2014,Liverpool FC,10,6,4,477,1,0,9,5,4,457,1,0,19,11,8,934,2,0,0,3,3,1,1,2,0,0,0,0,0,0
6192,6192,Brad Jones,1431,2014,Liverpool FC,1,1,0,90,0,0,2,2,0,106,0,0,3,3,0,196,0,0,0,0,0,0,0,0,0,0,0,0,0,0
6193,6193,Manquillo,2469,2014,Liverpool FC,6,6,0,514,0,0,4,4,0,248,0,0,10,10,0,762,0,0,0,0,0,0,0,0,0,0,0,0,0,0
6194,6194,Cameron Brannagan,3250,2014,Liverpool FC,0,0,0,0,0,0,0,0,0,0,0,0,0,0,0,0,0,0,0,0,0,0,0,0,0,0,0,0,0,0
6195,6195,Sofiane Boufal,1912,2016,Southampton FC,12,6,6,566,1,0,12,6,6,536,0,0,24,12,12,1102,1,0,3,0,3,1,0,1,0,0,0,0,0,0
6196,6196,Martín Cáceres,3251,2016,Southampton FC,0,0,0,0,0,0,1,1,0,90,0,0,1,1,0,90,0,0,0,0,0,0,0,0,0,0,0,0,0,0
6197,6197,Jérémy Pied,3252,2016,Southampton FC,3,0,3,36,0,0,1,1,0,90,0,0,4,1,3,126,0,0,0,0,0,0,0,0,0,0,0,0,0,0
6198,6198,Rob Holding,2510,2016,Arsenal FC,3,3,0,270,0,0,5,5,0,450,0,0,8,8,0,720,0,0,0,0,0,0,0,0,0,0,0,0,0,0
6199,6199,Shkodran Mustafi,1483,2016,Arsenal FC,13,13,0,1105,2,0,13,13,0,1170,0,0,26,26,0,2275,2,0,1,0,1,2,0,2,0,0,0,0,0,0
6200,6200,David Ospina,1495,2016,Arsenal FC,1,1,0,90,0,0,1,0,1,52,0,0,2,1,1,142,0,0,0,0,0,0,0,0,0,0,0,0,0,0
6201,6201,Márton Fülöp,1213,2009,Sunderland AFC,6,6,0,540,0,0,6,5,1,473,0,0,12,11,1,1013,0,0,0,0,0,0,0,0,0,0,0,0,0,0
6202,6202,George McCartney,1340,2009,Sunderland AFC,12,9,3,752,0,0,12,10,2,915,0,0,24,19,5,1667,0,0,0,0,0,0,0,0,0,0,0,0,0,0
6203,6203,John Mensah,1685,2009,Sunderland AFC,12,10,2,747,0,0,4,4,0,327,1,0,16,14,2,1074,1,0,0,0,0,0,0,0,0,0,0,0,0,0
6204,6204,Lorik Cana,3253,2009,Sunderland AFC,15,15,0,1350,0,0,15,13,2,1169,0,0,30,28,2,2519,0,0,0,0,0,0,0,0,0,0,0,0,0,0
6205,6205,Andy Reid,1220,2009,Sunderland AFC,11,10,1,870,2,0,10,8,2,774,0,0,21,18,3,1644,2,0,0,0,0,1,0,1,0,0,0,0,0,0
6206,6206,Nayron Nosworthy,1214,2009,Sunderland AFC,5,3,2,318,0,0,4,3,1,299,0,0,9,6,3,617,0,0,0,0,0,0,0,0,0,0,0,0,0,0
6207,6207,Tim Howard,1743,2009,Everton FC,19,19,0,1710,0,0,19,19,0,1710,0,0,38,38,0,3420,0,0,0,0,0,0,0,0,0,0,0,0,0,0
6208,6208,Tony Hibbert,1744,2009,Everton FC,11,10,1,838,0,0,9,7,2,641,0,0,20,17,3,1479,0,0,0,0,0,0,0,0,0,0,0,0,0,0
6209,6209,Leighton Baines,1466,2009,Everton FC,19,19,0,1710,1,0,18,18,0,1620,0,0,37,37,0,3330,1,0,3,0,3,1,0,1,1,0,1,0,0,0
6210,6210,John Heitinga,1745,2009,Everton FC,15,14,1,1266,0,0,16,15,1,1325,0,0,31,29,2,2591,0,0,0,0,0,0,0,0,0,0,0,0,0,0
6211,6211,Lucas Neill,1132,2009,Everton FC,5,4,1,364,0,0,7,6,1,554,0,0,12,10,2,918,0,0,0,0,0,0,0,0,0,0,0,0,0,0
6212,6212,Diniyar Bilyaletdinov,1753,2009,Everton FC,15,12,3,1045,6,0,8,4,4,392,0,0,23,16,7,1437,6,0,4,0,4,6,0,6,0,0,0,0,0,0
6213,6213,Tim Cahill,1746,2009,Everton FC,16,16,0,1362,2,0,17,17,0,1507,6,0,33,33,0,2869,8,0,1,6,7,2,6,8,0,0,0,0,0,0
6214,6214,Steven Pienaar,2406,2009,Everton FC,15,15,0,1342,3,0,15,15,0,1320,1,0,30,30,0,2662,4,0,0,0,0,1,1,2,0,0,0,0,0,0
6215,6215,Leon Osman,1747,2009,Everton FC,14,13,1,1044,1,0,12,12,0,948,1,0,26,25,1,1992,2,0,1,0,1,1,1,2,0,0,0,0,0,0
6216,6216,Marouane Fellaini,2189,2009,Everton FC,12,10,2,916,0,0,11,10,1,847,2,0,23,20,3,1763,2,0,0,1,1,0,2,2,0,0,0,0,0,0
6217,6217,Louis Saha,1727,2009,Everton FC,17,11,6,1085,8,0,16,15,1,1251,5,0,33,26,7,2336,13,0,3,4,7,4,3,7,1,1,2,0,0,0
6218,6218,James Vaughan,3240,2009,Everton FC,4,0,4,26,1,0,4,0,4,28,0,0,8,0,8,54,1,0,0,0,0,1,0,1,0,0,0,0,0,0
6219,6219,Yakubu Ayegbeni,1073,2009,Everton FC,12,5,7,605,1,0,13,4,9,479,4,0,25,9,16,1084,5,0,0,0,0,1,2,3,0,0,0,0,0,0
6220,6220,Matt Clarke,3254,2000,Bradford City,9,9,0,810,0,0,6,6,0,540,0,0,15,15,0,1350,0,0,0,0,0,0,0,0,0,0,0,0,0,0
6221,6221,David Wetherall,3255,2000,Bradford City,9,9,0,810,1,0,6,6,0,489,0,0,15,15,0,1299,1,0,0,0,0,1,0,1,0,0,0,0,0,0
6222,6222,David Hopkin,3256,2000,Bradford City,5,4,1,366,0,0,6,4,2,388,0,0,11,8,3,754,0,0,0,0,0,0,0,0,0,0,0,0,0,0
6223,6223,Ashley Ward,3257,2000,Bradford City,15,10,5,987,3,0,12,8,4,772,1,0,27,18,9,1759,4,0,0,0,0,2,0,2,0,0,0,0,0,0
6224,6224,David Seaman,2354,2000,Arsenal FC,13,13,0,1170,0,0,11,11,0,990,0,0,24,24,0,2160,0,0,0,0,0,0,0,0,0,0,0,0,0,0
6225,6225,Lee Dixon,3258,2000,Arsenal FC,16,13,3,1256,1,0,13,13,0,1126,0,0,29,26,3,2382,1,0,0,0,0,0,0,0,0,0,0,0,0,0
6226,6226,Ashley Cole,1523,2000,Arsenal FC,8,7,1,599,1,0,9,8,1,701,2,0,17,15,2,1300,3,0,0,1,1,1,2,3,0,0,0,0,0,0
6227,6227,Martin Keown,2355,2000,Arsenal FC,13,13,0,1170,0,0,14,14,0,1260,0,0,27,27,0,2430,0,0,0,0,0,0,0,0,0,0,0,0,0,0
6228,6228,Gilles Grimandi,3245,2000,Arsenal FC,16,15,1,1277,1,0,14,13,1,1115,0,0,30,28,2,2392,1,0,0,0,0,1,0,1,0,0,0,0,0,0
6229,6229,Oleg Luzhniy,3244,2000,Arsenal FC,9,6,3,540,0,0,9,9,0,765,0,0,18,15,3,1305,0,0,0,0,0,0,0,0,0,0,0,0,0,0
6230,6230,Robert Pirés,1603,2000,Arsenal FC,17,17,0,1384,2,0,15,11,4,1014,2,0,32,28,4,2398,4,0,0,3,3,2,2,4,0,0,0,0,0,0
6231,6231,Freddie Ljungberg,1525,2000,Arsenal FC,14,11,3,1045,3,0,16,14,2,1157,3,0,30,25,5,2202,6,0,0,0,0,2,2,4,0,0,0,0,0,0
6232,6232,Ray Parlour,1334,2000,Arsenal FC,14,11,3,989,4,0,18,16,2,1407,0,0,32,27,5,2396,4,0,0,0,0,1,0,1,0,0,0,0,0,0
6233,6233,Sylvain Wiltord,2356,2000,Arsenal FC,13,9,4,791,7,0,13,10,3,875,1,0,26,19,7,1666,8,0,0,0,0,2,0,2,0,0,0,0,0,0
6234,6234,Thierry Henry,2357,2000,Arsenal FC,19,15,4,1442,14,0,15,11,4,1057,3,0,34,26,8,2499,17,0,9,3,12,7,2,9,0,1,1,0,0,0
6235,6235,Nwankwo Kanu,1324,2000,Arsenal FC,13,6,7,566,1,0,13,7,6,749,2,0,26,13,13,1315,3,0,0,0,0,0,1,1,0,0,0,0,0,0
6236,6236,Asmir Begović,1036,2012,Stoke City,19,19,0,1710,0,0,19,19,0,1710,0,0,38,38,0,3420,0,0,0,0,0,0,0,0,0,0,0,0,0,0
6237,6237,Geoff Cameron,1548,2012,Stoke City,17,13,4,1207,0,0,18,16,2,1429,0,0,35,29,6,2636,0,0,0,0,0,0,0,0,0,0,0,0,0,0
6238,6238,Robert Huth,1884,2012,Stoke City,17,17,0,1530,1,0,18,18,0,1620,0,0,35,35,0,3150,1,0,0,0,0,1,0,1,0,0,0,0,0,0
6239,6239,Ryan Shawcross,1547,2012,Stoke City,18,18,0,1620,1,0,19,19,0,1710,0,0,37,37,0,3330,1,0,0,0,0,1,0,1,0,0,0,0,0,0
6240,6240,Andy Wilkinson,1553,2012,Stoke City,14,11,3,1028,0,0,10,8,2,701,0,0,24,19,5,1729,0,0,0,0,0,0,0,0,0,0,0,0,0,0
6241,6241,Glenn Whelan,1549,2012,Stoke City,16,16,0,1339,0,0,16,15,1,1253,0,0,32,31,1,2592,0,0,0,0,0,0,0,0,0,0,0,0,0,0
6242,6242,Steven N'Zonzi,1550,2012,Stoke City,18,18,0,1598,1,0,17,17,0,1530,0,0,35,35,0,3128,1,0,0,0,0,1,0,1,0,0,0,0,0,0
6243,6243,Matthew Etherington,1557,2012,Stoke City,16,12,4,968,0,0,15,9,6,759,0,0,31,21,10,1727,0,0,0,0,0,0,0,0,0,0,0,0,0,0
6244,6244,Kenwyne Jones,1222,2012,Stoke City,14,6,8,651,3,0,12,4,8,388,0,0,26,10,16,1039,3,0,1,0,1,3,0,3,0,0,0,0,0,0
6245,6245,Jon Walters,1555,2012,Stoke City,19,19,0,1661,3,0,19,19,0,1647,5,0,38,38,0,3308,8,0,0,0,0,2,4,6,0,3,3,0,0,0
6246,6246,Michael Kightly,1259,2012,Stoke City,14,8,6,729,1,0,8,6,2,467,2,0,22,14,8,1196,3,0,0,0,0,1,1,2,0,0,0,0,0,0
6247,6247,Peter Crouch,1273,2012,Stoke City,17,13,4,1036,4,0,17,15,2,1301,3,0,34,28,6,2337,7,0,0,1,1,2,3,5,0,0,0,0,0,0
6248,6248,Cameron Jerome,1783,2012,Stoke City,13,3,10,489,3,0,13,5,8,616,0,0,26,8,18,1105,3,0,4,0,4,2,0,2,0,0,0,0,0,0
6249,6249,Thomas Sørensen,1090,2012,Stoke City,0,0,0,0,0,0,0,0,0,0,0,0,0,0,0,0,0,0,0,0,0,0,0,0,0,0,0,0,0,0
6250,6250,Matthew Upson,1279,2012,Stoke City,1,1,0,90,1,0,0,0,0,0,0,0,1,1,0,90,1,0,0,0,0,0,0,0,0,0,0,0,0,0
6251,6251,Wilson Palacios,1271,2012,Stoke City,1,0,1,9,0,0,3,0,3,37,0,0,4,0,4,46,0,0,0,0,0,0,0,0,0,0,0,0,0,0
6252,6252,Dean Whitehead,1218,2012,Stoke City,12,4,8,510,0,0,14,8,6,881,1,0,26,12,14,1391,1,0,0,3,3,0,1,1,0,0,0,0,0,0
6253,6253,Apostolos Vellios,3259,2012,Everton FC,5,0,5,48,0,0,1,0,1,8,0,0,6,0,6,56,0,0,0,0,0,0,0,0,0,0,0,0,0,0
6254,6254,Jussi Jääskeläinen,1710,2004,Bolton Wanderers,17,17,0,1530,0,0,18,18,0,1620,0,0,35,35,0,3150,0,0,0,0,0,0,0,0,0,0,0,0,0,0
6255,6255,Bruno N'Gotty,3076,2004,Bolton Wanderers,19,19,0,1682,0,0,16,16,0,1440,0,0,35,35,0,3122,0,0,0,0,0,0,0,0,0,0,0,0,0,0
6256,6256,Radhi Jaïdi,2502,2004,Bolton Wanderers,13,10,3,880,2,0,14,11,3,1046,3,0,27,21,6,1926,5,0,0,1,1,2,3,5,0,0,0,0,0,0
6257,6257,Iván Campo,1713,2004,Bolton Wanderers,11,10,1,824,0,0,15,10,5,888,0,0,26,20,6,1712,0,0,0,0,0,0,0,0,0,0,0,0,0,0
6258,6258,Nicky Hunt,1711,2004,Bolton Wanderers,14,14,0,1255,0,0,15,15,0,1157,0,0,29,29,0,2412,0,0,0,0,0,0,0,0,0,0,0,0,0,0
6259,6259,Gary Speed,1716,2004,Bolton Wanderers,19,19,0,1689,0,0,18,18,0,1606,1,0,37,37,0,3295,1,0,0,1,1,0,1,1,0,0,0,0,0,0
6260,6260,Stylianos Giannakopoulos,1717,2004,Bolton Wanderers,16,14,2,1153,5,0,17,13,4,1122,2,0,33,27,6,2275,7,0,9,0,9,4,1,5,0,0,0,0,0,0
6261,6261,Jay Jay Okocha,2865,2004,Bolton Wanderers,14,14,0,1191,3,0,16,14,2,1187,3,0,30,28,2,2378,6,0,0,0,0,2,2,4,1,3,4,0,0,0
6262,6262,Ricardo Gardner,2411,2004,Bolton Wanderers,17,15,2,1326,0,0,15,14,1,1261,0,0,32,29,3,2587,0,0,0,0,0,0,0,0,0,0,0,0,0,0
6263,6263,Henrik Pedersen,1722,2004,Bolton Wanderers,13,7,6,701,2,0,14,6,8,655,4,0,27,13,14,1356,6,0,0,4,4,0,4,4,0,0,0,0,0,0
6264,6264,Kevin Davies,1718,2004,Bolton Wanderers,18,17,1,1465,5,0,16,15,1,1291,3,0,34,32,2,2756,8,0,9,0,9,4,2,6,0,0,0,0,0,0
6265,6265,Hierro,3260,2004,Bolton Wanderers,13,6,7,601,0,0,14,8,6,737,1,0,27,14,13,1338,1,0,0,0,0,0,1,1,0,0,0,0,0,0
6266,6266,Kevin Nolan,2396,2004,Bolton Wanderers,18,14,4,1285,2,0,17,12,5,1120,2,0,35,26,9,2405,4,0,0,6,6,1,2,3,0,0,0,0,0,0
6267,6267,Les Ferdinand,2083,2004,Bolton Wanderers,6,0,6,86,1,0,5,1,4,161,0,0,11,1,10,247,1,0,1,0,1,1,0,1,0,0,0,0,0,0
6268,6268,Jerzy Dudek,2899,2004,Liverpool FC,13,13,0,1170,0,0,11,11,0,990,0,0,24,24,0,2160,0,0,0,0,0,0,0,0,0,0,0,0,0,0
6269,6269,Sami Hyypiä,2361,2004,Liverpool FC,14,14,0,1260,2,0,18,18,0,1521,0,0,32,32,0,2781,2,0,1,0,1,2,0,2,0,0,0,0,0,0
6270,6270,John Arne Riise,2362,2004,Liverpool FC,18,16,2,1414,1,0,19,18,1,1569,5,0,37,34,3,2983,6,0,0,3,3,1,3,4,0,0,0,0,0,0
6271,6271,Josemi,3261,2004,Liverpool FC,6,5,1,411,0,0,9,8,1,725,0,0,15,13,2,1136,0,0,0,0,0,0,0,0,0,0,0,0,0,0
6272,6272,Jamie Carragher,1778,2004,Liverpool FC,19,19,0,1710,0,0,19,19,0,1710,0,0,38,38,0,3420,0,0,0,0,0,0,0,0,0,0,0,0,0,0
6273,6273,Steven Gerrard,1424,2004,Liverpool FC,14,14,0,1235,5,0,16,14,2,1238,2,0,30,28,2,2473,7,0,4,0,4,5,0,5,0,0,0,0,0,0
6274,6274,Xabi Alonso,1891,2004,Liverpool FC,13,12,1,1011,1,0,11,8,3,797,1,0,24,20,4,1808,2,0,0,0,0,1,1,2,0,0,0,0,0,0
6275,6275,Dietmar Hamann,2690,2004,Liverpool FC,16,12,4,1068,0,0,14,11,3,959,0,0,30,23,7,2027,0,0,0,0,0,0,0,0,0,0,0,0,0,0
6276,6276,Stephen Warnock,1616,2004,Liverpool FC,10,7,3,497,0,0,9,4,5,306,0,0,19,11,8,803,0,0,0,0,0,0,0,0,0,0,0,0,0,0
6277,6277,Milan Baroš,1961,2004,Liverpool FC,12,10,2,903,7,0,14,12,2,976,2,0,26,22,4,1879,9,0,3,1,4,4,2,6,3,0,3,0,0,0
6278,6278,Luis García,3230,2004,Liverpool FC,15,14,1,1268,5,0,14,12,2,1076,3,0,29,26,3,2344,8,0,0,3,3,1,2,3,0,0,0,0,0,0
6279,6279,Djimi Traoré,2364,2004,Liverpool FC,11,8,3,756,0,0,15,10,5,1014,0,0,26,18,8,1770,0,0,0,0,0,0,0,0,0,0,0,0,0,0
6280,6280,Djibril Cissé,1899,2004,Liverpool FC,7,5,2,461,3,0,9,5,4,470,1,0,16,10,6,931,4,0,0,0,0,1,1,2,1,0,1,0,0,0
6281,6281,Jonathan Fortune,2665,2005,Charlton Athletic,5,4,1,376,0,0,6,3,3,360,0,0,11,7,4,736,0,0,0,0,0,0,0,0,0,0,0,0,0,0
6282,6282,Shaun Bartlett,1675,2005,Charlton Athletic,9,4,5,374,1,0,7,2,5,319,0,0,16,6,10,693,1,0,0,0,0,1,0,1,0,0,0,0,0,0
6283,6283,Kevin Lisbie,2337,2005,Charlton Athletic,4,0,4,74,0,0,2,0,2,58,0,0,6,0,6,132,0,0,0,0,0,0,0,0,0,0,0,0,0,0
6284,6284,Mario Melchiot,1512,2005,Birmingham City,13,12,1,961,1,0,10,10,0,892,0,0,23,22,1,1853,1,0,0,0,0,0,0,0,0,0,0,0,0,0
6285,6285,Muzzy Izzet,2682,2005,Birmingham City,9,5,4,460,0,0,7,5,2,487,0,0,16,10,6,947,0,0,0,0,0,0,0,0,0,0,0,0,0,0
6286,6286,Chris Sutton,3114,2005,Birmingham City,4,4,0,315,0,0,6,6,0,515,1,0,10,10,0,830,1,0,0,0,0,0,1,1,0,0,0,0,0,0
6287,6287,David Dunn,1456,2005,Birmingham City,7,3,4,302,1,0,8,5,3,264,1,0,15,8,7,566,2,0,0,1,1,0,1,1,0,0,0,0,0,0
6288,6288,Danny Rose,1399,2014,Tottenham Hotspur,16,15,1,1308,3,0,12,12,0,1064,0,0,28,27,1,2372,3,0,0,0,0,1,0,1,0,0,0,0,0,0
6289,6289,Younès Kaboul,2408,2014,Tottenham Hotspur,6,6,0,540,0,0,5,5,0,450,0,0,11,11,0,990,0,0,0,0,0,0,0,0,0,0,0,0,0,0
6290,6290,Kyle Naughton,2273,2014,Tottenham Hotspur,2,2,0,122,0,0,3,3,0,270,0,0,5,5,0,392,0,0,0,0,0,0,0,0,0,0,0,0,0,0
6291,6291,Étienne Capoue,1924,2014,Tottenham Hotspur,6,6,0,477,0,0,6,5,1,423,0,0,12,11,1,900,0,0,0,0,0,0,0,0,0,0,0,0,0,0
6292,6292,Emmanuel Adebayor,1235,2014,Tottenham Hotspur,8,5,3,493,2,0,5,4,1,320,0,0,13,9,4,813,2,0,0,0,0,1,0,1,0,0,0,0,0,0
6293,6293,Fraser Forster,1240,2014,Southampton FC,16,16,0,1364,0,0,14,14,0,1260,0,0,30,30,0,2624,0,0,0,0,0,0,0,0,0,0,0,0,0,0
6294,6294,Emmanuel Mayuka,2872,2014,Southampton FC,3,0,3,29,0,0,2,0,2,20,0,0,5,0,5,49,0,0,0,0,0,0,0,0,0,0,0,0,0,0
6295,6295,Radostin Kishishev,1668,2001,Charlton Athletic,1,0,1,6,0,0,1,0,1,5,0,0,2,0,2,11,0,0,0,0,0,0,0,0,0,0,0,0,0,0
6296,6296,John Mikel Obi,1769,2012,Chelsea FC,10,8,2,676,0,0,12,11,1,951,0,0,22,19,3,1627,0,0,0,0,0,0,0,0,0,0,0,0,0,0
6297,6297,Oriol Romeu,1243,2012,Chelsea FC,3,1,2,108,0,0,3,3,0,128,0,0,6,4,2,236,0,0,0,0,0,0,0,0,0,0,0,0,0,0
6298,6298,Maicon,3262,2012,Manchester City,5,2,3,244,0,0,4,2,2,272,0,0,9,4,5,516,0,0,0,0,0,0,0,0,0,0,0,0,0,0
6299,6299,Vincent Candela,3263,2004,Bolton Wanderers,5,4,1,361,0,0,4,4,0,330,0,0,9,8,1,691,0,0,0,0,0,0,0,0,0,0,0,0,0,0
6300,6300,Tal Ben Haim,1715,2004,Bolton Wanderers,10,9,1,815,1,0,10,9,1,846,0,0,20,18,2,1661,1,0,0,0,0,1,0,1,0,0,0,0,0,0
6301,6301,Jason Shackell,1489,2004,Norwich City,6,6,0,540,0,0,5,5,0,450,0,0,11,11,0,990,0,0,0,0,0,0,0,0,0,0,0,0,0,0
6302,6302,Dean Ashton,2245,2004,Norwich City,8,8,0,714,5,0,8,8,0,707,2,0,16,16,0,1421,7,0,6,0,6,4,2,6,1,0,1,0,0,0
6303,6303,Gary Doherty,2792,2004,Norwich City,9,8,1,718,1,0,11,9,2,782,1,0,20,17,3,1500,2,0,0,1,1,1,1,2,0,0,0,0,0,0
6304,6304,Jonas Olsson,1771,2011,West Bromwich Albion,16,16,0,1440,0,0,17,17,0,1530,2,0,33,33,0,2970,2,0,0,0,0,0,2,2,0,0,0,0,0,0
6305,6305,Steven Reid,1140,2011,West Bromwich Albion,11,11,0,952,1,0,11,10,1,819,0,0,22,21,1,1771,1,0,0,0,0,1,0,1,0,0,0,0,0,0
6306,6306,Youssuf Mulumbu,1773,2011,West Bromwich Albion,18,18,0,1492,1,0,17,16,1,1318,0,0,35,34,1,2810,1,0,0,0,0,1,0,1,0,0,0,0,0,0
6307,6307,Zdeněk Grygera,3264,2011,Fulham FC,3,3,0,225,0,0,2,2,0,180,0,0,5,5,0,405,0,0,0,0,0,0,0,0,0,0,0,0,0,0
6308,6308,Steven Sidwell,1622,2011,Fulham FC,8,8,0,667,1,0,6,4,2,415,0,0,14,12,2,1082,1,0,0,0,0,1,0,1,0,0,0,0,0,0
6309,6309,Bryan Ruiz,3265,2011,Fulham FC,14,10,4,830,2,0,13,7,6,682,0,0,27,17,10,1512,2,0,0,0,0,1,0,1,0,0,0,0,0,0
6310,6310,Neil Etheridge,3142,2011,Fulham FC,0,0,0,0,0,0,0,0,0,0,0,0,0,0,0,0,0,0,0,0,0,0,0,0,0,0,0,0,0,0
6311,6311,Philippe Senderos,1228,2011,Fulham FC,11,11,0,990,1,0,10,10,0,839,0,0,21,21,0,1829,1,0,3,0,3,1,0,1,0,0,0,0,0,0
6312,6312,Marcel Gecov,3266,2011,Fulham FC,1,0,1,1,0,0,1,0,1,5,0,0,2,0,2,6,0,0,0,0,0,0,0,0,0,0,0,0,0,0
6313,6313,Mark Crossley,1932,2005,Fulham FC,7,7,0,603,0,0,5,5,0,431,0,0,12,12,0,1034,0,0,0,0,0,0,0,0,0,0,0,0,0,0
6314,6314,Moritz Volz,1078,2005,Fulham FC,11,11,0,990,0,0,11,11,0,970,0,0,22,22,0,1960,0,0,0,0,0,0,0,0,0,0,0,0,0,0
6315,6315,Carlos Bocanegra,1081,2005,Fulham FC,9,9,0,810,1,0,10,9,1,841,0,0,19,18,1,1651,1,0,3,0,3,1,0,1,0,0,0,0,0,0
6316,6316,Alain Goma,1080,2005,Fulham FC,6,6,0,540,0,0,6,6,0,540,0,0,12,12,0,1080,0,0,0,0,0,0,0,0,0,0,0,0,0,0
6317,6317,Niclas Jensen,3201,2005,Fulham FC,8,6,2,588,0,0,7,7,0,630,0,0,15,13,2,1218,0,0,0,0,0,0,0,0,0,0,0,0,0,0
6318,6318,Steed Malbranque,1086,2005,Fulham FC,16,14,2,1308,5,0,16,16,0,1412,1,0,32,30,2,2720,6,0,9,3,12,5,1,6,0,0,0,0,0,0
6319,6319,Claus Jensen,1674,2005,Fulham FC,4,4,0,339,1,0,6,6,0,532,1,0,10,10,0,871,2,0,0,0,0,1,1,2,0,0,0,0,0,0
6320,6320,Boa Morte,1085,2005,Fulham FC,17,17,0,1530,6,0,17,17,0,1458,0,0,34,34,0,2988,6,0,6,0,6,3,0,3,0,0,0,0,0,0
6321,6321,Papa Bouba Diop,1757,2005,Fulham FC,10,10,0,809,1,0,11,10,1,915,1,0,21,20,1,1724,2,0,0,0,0,1,1,2,0,0,0,0,0,0
6322,6322,Ahmad Elrich,3267,2005,Fulham FC,4,1,3,90,0,0,2,1,1,67,0,0,6,2,4,157,0,0,0,0,0,0,0,0,0,0,0,0,0,0
6323,6323,Collins John,1089,2005,Fulham FC,16,9,7,806,6,0,18,6,12,733,5,0,34,15,19,1539,11,0,3,0,3,4,4,8,0,1,1,0,0,0
6324,6324,Tony Warner,3268,2005,Fulham FC,6,5,1,477,0,0,11,10,1,919,0,0,17,15,2,1396,0,0,0,0,0,0,0,0,0,0,0,0,0,0
6325,6325,Liam Rosenior,1756,2005,Fulham FC,12,11,1,996,0,0,11,10,1,901,0,0,23,21,2,1897,0,0,0,0,0,0,0,0,0,0,0,0,0,0
6326,6326,Brian McBride,1088,2005,Fulham FC,18,17,1,1447,5,0,18,15,3,1251,4,0,36,32,4,2698,9,0,3,0,3,4,2,6,0,0,0,0,0,0
6327,6327,Josemi,3261,2005,Liverpool FC,4,1,3,82,0,0,2,2,0,180,0,0,6,3,3,262,0,0,0,0,0,0,0,0,0,0,0,0,0,0
6328,6328,Djimi Traoré,2364,2005,Liverpool FC,9,5,4,455,0,0,6,4,2,353,0,0,15,9,6,808,0,0,0,0,0,0,0,0,0,0,0,0,0,0
6329,6329,Harry Kewell,1296,2005,Liverpool FC,12,12,0,987,3,0,15,10,5,1024,0,0,27,22,5,2011,3,0,6,0,6,2,0,2,0,0,0,0,0,0
6330,6330,Alan Wright,2766,2003,Middlesbrough FC,1,1,0,90,0,0,1,1,0,90,0,0,2,2,0,180,0,0,0,0,0,0,0,0,0,0,0,0,0,0
6331,6331,Stewart Downing,1335,2003,Middlesbrough FC,11,1,10,257,0,0,8,5,3,423,0,0,19,6,13,680,0,0,0,0,0,0,0,0,0,0,0,0,0,0
6332,6332,Gilberto Silva,1234,2003,Arsenal FC,17,15,2,1283,1,0,15,14,1,1261,3,0,32,29,3,2544,4,0,0,0,0,1,1,2,0,0,0,0,0,0
6333,6333,Sylvain Wiltord,2356,2003,Arsenal FC,6,5,1,358,0,0,6,3,3,291,3,0,12,8,4,649,3,0,0,0,0,0,1,1,0,0,0,0,0,0
6334,6334,Edu,1529,2003,Arsenal FC,15,6,9,731,1,0,15,7,8,743,1,0,30,13,17,1474,2,0,0,3,3,1,1,2,0,0,0,0,0,0
6335,6335,Dennis Bergkamp,1527,2003,Arsenal FC,15,11,4,977,2,0,13,10,3,787,2,0,28,21,7,1764,4,0,3,0,3,1,1,2,0,0,0,0,0,0
6336,6336,Thomas Sørensen,1090,2003,Aston Villa,19,19,0,1626,0,0,17,17,0,1530,0,0,36,36,0,3156,0,0,0,0,0,0,0,0,0,0,0,0,0,0
6337,6337,Mark Delaney,3269,2003,Aston Villa,11,10,1,873,0,0,13,12,1,1079,0,0,24,22,2,1952,0,0,0,0,0,0,0,0,0,0,0,0,0,0
6338,6338,Jlloyd Samuel,1789,2003,Aston Villa,19,19,0,1710,1,0,17,17,0,1530,1,0,36,36,0,3240,2,0,0,3,3,0,1,1,0,0,0,0,0,0
6339,6339,Olof Mellberg,1790,2003,Aston Villa,18,18,0,1620,0,0,15,15,0,1296,1,0,33,33,0,2916,1,0,0,0,0,0,0,0,0,0,0,0,0,0
6340,6340,Gareth Barry,1418,2003,Aston Villa,18,18,0,1463,1,0,16,16,0,1376,2,0,34,34,0,2839,3,0,0,0,0,0,1,1,0,1,1,0,0,0
6341,6341,Gavin McCann,1096,2003,Aston Villa,14,14,0,1260,0,0,12,12,0,1030,0,0,26,26,0,2290,0,0,0,0,0,0,0,0,0,0,0,0,0,0
6342,6342,Thomas Hitzlsperger,1792,2003,Aston Villa,16,11,5,1119,2,0,14,9,5,927,1,0,30,20,10,2046,3,0,0,0,0,1,1,2,0,0,0,0,0,0
6343,6343,Dion Dublin,2768,2003,Aston Villa,12,5,7,490,1,0,9,6,3,588,2,0,21,11,10,1078,3,0,3,0,3,1,1,2,0,0,0,0,0,0
6344,6344,Darius Vassell,1798,2003,Aston Villa,16,14,2,1276,5,0,15,11,4,943,4,0,31,25,6,2219,9,0,3,3,6,3,3,6,1,0,1,0,0,0
6345,6345,Marcus Allbäck,3270,2003,Aston Villa,9,4,5,409,0,0,5,3,2,312,1,0,14,7,7,721,1,0,0,0,0,0,1,1,0,0,0,0,0,0
6346,6346,Juan Pablo Ángel,1795,2003,Aston Villa,17,17,0,1441,10,0,14,14,0,1177,6,0,31,31,0,2618,16,0,4,0,4,7,3,10,1,1,2,0,0,0
6347,6347,Stefan Postma,3271,2003,Aston Villa,2,0,2,84,0,0,0,0,0,0,0,0,2,0,2,84,0,0,0,0,0,0,0,0,0,0,0,0,0,0
6348,6348,Ulises De la Cruz,1794,2003,Aston Villa,15,10,5,957,0,0,11,8,3,743,0,0,26,18,8,1700,0,0,0,0,0,0,0,0,0,0,0,0,0,0
6349,6349,Oleg Luzhniy,3244,2003,Wolverhampton Wanderers,1,1,0,90,0,0,5,3,2,303,0,0,6,4,2,393,0,0,0,0,0,0,0,0,0,0,0,0,0,0
6350,6350,Silas,3272,2003,Wolverhampton Wanderers,3,1,2,74,0,0,6,1,5,168,0,0,9,2,7,242,0,0,0,0,0,0,0,0,0,0,0,0,0,0
6351,6351,Pablo Zabaleta,1355,2015,Manchester City,7,7,0,630,0,0,6,5,1,432,0,0,13,12,1,1062,0,0,0,0,0,0,0,0,0,0,0,0,0,0
6352,6352,Samir Nasri,1358,2015,Manchester City,4,1,3,187,1,0,8,3,5,348,1,0,12,4,8,535,2,0,3,0,3,1,0,1,0,0,0,0,0,0
6353,6353,Richard Wright,2977,2015,Manchester City,0,0,0,0,0,0,0,0,0,0,0,0,0,0,0,0,0,0,0,0,0,0,0,0,0,0,0,0,0,0
6354,6354,Ryan Giggs,1110,2013,Manchester United,6,2,4,227,0,0,6,4,2,276,0,0,12,6,6,503,0,0,0,0,0,0,0,0,0,0,0,0,0,0
6355,6355,Bryan Oviedo,2240,2013,Everton FC,4,4,0,330,1,0,5,4,1,389,1,0,9,8,1,719,2,0,0,3,3,0,1,1,0,0,0,0,0,0
6356,6356,Gareth Barry,1418,2013,Everton FC,16,16,0,1409,2,0,16,16,0,1440,0,0,32,32,0,2849,2,0,0,0,0,1,0,1,0,0,0,0,0,0
6357,6357,Steven Pienaar,2406,2013,Everton FC,11,8,3,778,1,0,12,11,1,853,0,0,23,19,4,1631,1,0,3,0,3,1,0,1,0,0,0,0,0,0
6358,6358,Kevin Mirallas,2238,2013,Everton FC,17,14,3,1180,7,0,15,14,1,1159,2,0,32,28,4,2339,9,0,3,0,3,3,2,5,0,0,0,0,0,0
6359,6359,John Heitinga,1745,2013,Everton FC,1,0,1,21,0,0,0,0,0,0,0,0,1,0,1,21,0,0,0,0,0,0,0,0,0,0,0,0,0,0
6360,6360,Nikica Jelavić,2228,2013,Everton FC,5,2,3,166,0,0,4,3,1,213,0,0,9,5,4,379,0,0,0,0,0,0,0,0,0,0,0,0,0,0
6361,6361,Edwin van der Sar,1077,2009,Manchester United,11,11,0,990,0,0,10,10,0,900,0,0,21,21,0,1890,0,0,0,0,0,0,0,0,0,0,0,0,0,0
6362,6362,Gary Neville,1105,2009,Manchester United,8,8,0,717,0,0,9,7,2,636,0,0,17,15,2,1353,0,0,0,0,0,0,0,0,0,0,0,0,0,0
6363,6363,Rio Ferdinand,1294,2009,Manchester United,6,6,0,540,0,0,6,5,1,452,0,0,12,11,1,992,0,0,0,0,0,0,0,0,0,0,0,0,0,0
6364,6364,Nemanja Vidić,1725,2009,Manchester United,12,12,0,1027,1,0,11,11,0,990,0,0,23,23,0,2017,1,0,0,0,0,0,0,0,0,0,0,0,0,0
6365,6365,Dimitar Berbatov,1397,2009,Manchester United,16,13,3,1090,6,0,16,10,6,926,6,0,32,23,9,2016,12,0,0,0,0,3,2,5,0,0,0,0,0,0
6366,6366,Nani,2258,2009,Manchester United,12,11,1,926,1,0,11,8,3,723,2,0,23,19,4,1649,3,0,0,3,3,1,1,2,0,0,0,0,0,0
6367,6367,Fábio,2320,2009,Manchester United,4,1,3,118,0,0,1,0,1,32,0,0,5,1,4,150,0,0,0,0,0,0,0,0,0,0,0,0,0,0
6368,6368,Stephen Kelly,1121,2009,Fulham FC,2,2,0,129,0,0,6,5,1,465,0,0,8,7,1,594,0,0,0,0,0,0,0,0,0,0,0,0,0,0
6369,6369,Nicky Shorey,1731,2009,Fulham FC,3,3,0,270,0,0,6,6,0,540,0,0,9,9,0,810,0,0,0,0,0,0,0,0,0,0,0,0,0,0
6370,6370,Danny Murphy,1398,2009,Fulham FC,12,12,0,1018,3,0,11,11,0,944,2,0,23,23,0,1962,5,0,0,0,0,2,1,3,1,2,3,0,0,0
6371,6371,Simon Davies,1125,2009,Fulham FC,10,7,3,542,0,0,6,4,2,371,0,0,16,11,5,913,0,0,0,0,0,0,0,0,0,0,0,0,0,0
6372,6372,Ledley King,1119,2006,Watford FC,1,1,0,90,0,0,0,0,0,0,0,0,1,1,0,90,0,0,0,0,0,0,0,0,0,0,0,0,0,0
6373,6373,Benoît Assou-Ekotto,1269,2006,Watford FC,1,1,0,90,0,0,0,0,0,0,0,0,1,1,0,90,0,0,0,0,0,0,0,0,0,0,0,0,0,0
6374,6374,Aaron Lennon,1052,2006,Watford FC,1,1,0,90,0,0,0,0,0,0,0,0,1,1,0,90,0,0,0,0,0,0,0,0,0,0,0,0,0,0
6375,6375,Robbie Keane,1126,2006,Watford FC,1,1,0,76,0,0,0,0,0,0,0,0,1,1,0,76,0,0,0,0,0,0,0,0,0,0,0,0,0,0
6376,6376,Wojciech Szczęsny,1507,2011,Arsenal FC,19,19,0,1710,0,0,18,18,0,1620,0,0,37,37,0,3330,0,0,0,0,0,0,0,0,0,0,0,0,0,0
6377,6377,Per Mertesacker,1496,2011,Arsenal FC,10,10,0,879,0,0,11,11,0,951,0,0,21,21,0,1830,0,0,0,0,0,0,0,0,0,0,0,0,0,0
6378,6378,Thomas Vermaelen,2749,2011,Arsenal FC,15,15,0,1307,4,0,14,13,1,1172,2,0,29,28,1,2479,6,0,4,3,7,2,1,3,0,0,0,0,0,0
6379,6379,Laurent Koscielny,1497,2011,Arsenal FC,16,16,0,1343,0,0,16,16,0,1440,2,0,32,32,0,2783,2,0,0,3,3,0,2,2,0,0,0,0,0,0
6380,6380,Johan Djourou,1229,2011,Arsenal FC,8,8,0,655,0,0,9,5,4,433,0,0,17,13,4,1088,0,0,0,0,0,0,0,0,0,0,0,0,0,0
6381,6381,Tomáš Rosický,1509,2011,Arsenal FC,15,11,4,994,1,0,12,7,5,675,0,0,27,18,9,1669,1,0,0,0,0,1,0,1,0,0,0,0,0,0
6382,6382,Aaron Ramsey,1501,2011,Arsenal FC,16,11,5,1065,0,0,17,15,2,1315,2,0,33,26,7,2380,2,0,0,0,0,0,2,2,0,0,0,0,0,0
6383,6383,Alex Song,1233,2011,Arsenal FC,17,17,0,1492,1,0,17,17,0,1506,0,0,34,34,0,2998,1,0,0,0,0,0,0,0,0,0,0,0,0,0
6384,6384,Robin van Persie,1528,2011,Arsenal FC,19,18,1,1629,17,0,18,18,0,1620,13,0,37,36,1,3249,30,0,9,7,16,14,10,24,0,2,2,0,0,0
6385,6385,Theo Walcott,1237,2011,Arsenal FC,17,17,0,1416,3,0,17,14,3,1244,5,0,34,31,3,2660,8,0,0,0,0,0,3,3,0,0,0,0,0,0
6386,6386,Alex Oxlade-Chamberlain,1184,2011,Arsenal FC,9,4,5,350,2,0,6,2,4,180,0,0,15,6,9,530,2,0,0,0,0,0,0,0,0,0,0,0,0,0
6387,6387,Ke Li,3273,2011,Arsenal FC,1,0,1,44,0,0,0,0,0,0,0,0,1,0,1,44,0,0,0,0,0,0,0,0,0,0,0,0,0,0
6388,6388,Chu-young Park,3274,2011,Arsenal FC,1,0,1,6,0,0,0,0,0,0,0,0,1,0,1,6,0,0,0,0,0,0,0,0,0,0,0,0,0,0
6389,6389,Andrey Arshavin,2750,2011,Arsenal FC,10,4,6,385,1,0,8,3,5,246,0,0,18,7,11,631,1,0,3,0,3,1,0,1,0,0,0,0,0,0
6390,6390,Manuel Almunia,2039,2011,Arsenal FC,0,0,0,0,0,0,0,0,0,0,0,0,0,0,0,0,0,0,0,0,0,0,0,0,0,0,0,0,0,0
6391,6391,Sébastien Squillaci,2867,2011,Arsenal FC,0,0,0,0,0,0,1,0,1,9,0,0,1,0,1,9,0,0,0,0,0,0,0,0,0,0,0,0,0,0
6392,6392,Ignasi Miquel,3275,2011,Arsenal FC,2,0,2,82,0,0,2,1,1,133,0,0,4,1,3,215,0,0,0,0,0,0,0,0,0,0,0,0,0,0
6393,6393,Yossi Benayoun,1892,2011,Arsenal FC,9,5,4,437,1,0,10,5,5,467,3,0,19,10,9,904,4,0,0,3,3,1,2,3,0,0,0,0,0,0
6394,6394,Joel Pereira,1649,2016,Manchester United,1,1,0,90,0,0,0,0,0,0,0,0,1,1,0,90,0,0,0,0,0,0,0,0,0,0,0,0,0,0
6395,6395,Demetri Mitchell,3276,2016,Manchester United,1,1,0,90,0,0,0,0,0,0,0,0,1,1,0,90,0,0,0,0,0,0,0,0,0,0,0,0,0,0
6396,6396,Scott McTominay,1652,2016,Manchester United,1,1,0,90,0,0,1,0,1,6,0,0,2,1,1,96,0,0,0,0,0,0,0,0,0,0,0,0,0,0
6397,6397,Josh Harrop,3277,2016,Manchester United,1,1,0,90,1,0,0,0,0,0,0,0,1,1,0,90,1,0,0,0,0,1,0,1,0,0,0,0,0,0
6398,6398,Angel Gomes,3278,2016,Manchester United,1,0,1,2,0,0,0,0,0,0,0,0,1,0,1,2,0,0,0,0,0,0,0,0,0,0,0,0,0,0
6399,6399,Kieran O'Hara,3279,2016,Manchester United,0,0,0,0,0,0,0,0,0,0,0,0,0,0,0,0,0,0,0,0,0,0,0,0,0,0,0,0,0,0
6400,6400,Zachary Dearnley,3280,2016,Manchester United,0,0,0,0,0,0,0,0,0,0,0,0,0,0,0,0,0,0,0,0,0,0,0,0,0,0,0,0,0,0
6401,6401,Patrick van Aanholt,2254,2016,Crystal Palace,5,3,2,303,2,0,6,5,1,411,0,0,11,8,3,714,2,0,3,0,3,1,0,1,0,0,0,0,0,0
6402,6402,Jeffrey Schlupp,2252,2016,Crystal Palace,7,6,1,520,0,0,8,5,3,477,0,0,15,11,4,997,0,0,0,0,0,0,0,0,0,0,0,0,0,0
6403,6403,Luka Milivojević,2251,2016,Crystal Palace,7,7,0,622,2,0,7,7,0,605,0,0,14,14,0,1227,2,0,0,0,0,0,0,0,2,0,2,0,0,0
6404,6404,Sullay Kaikai,2777,2016,Crystal Palace,0,0,0,0,0,0,1,0,1,23,0,0,1,0,1,23,0,0,0,0,0,0,0,0,0,0,0,0,0,0
6405,6405,Bakary Sako,2253,2016,Crystal Palace,4,0,4,54,0,0,3,0,3,81,0,0,7,0,7,135,0,0,0,0,0,0,0,0,0,0,0,0,0,0
6406,6406,John Terry,1534,2016,Chelsea FC,7,4,3,314,1,0,2,2,0,180,0,0,9,6,3,494,1,0,0,0,0,1,0,1,0,0,0,0,0,0
6407,6407,Oscar,1543,2016,Chelsea FC,5,3,2,285,0,0,4,2,2,171,0,0,9,5,4,456,0,0,0,0,0,0,0,0,0,0,0,0,0,0
6408,6408,Branislav Ivanović,1532,2016,Chelsea FC,6,3,3,298,0,0,7,3,4,286,0,0,13,6,7,584,0,0,0,0,0,0,0,0,0,0,0,0,0,0
6409,6409,Ola Aina,3281,2016,Chelsea FC,3,0,3,24,0,0,0,0,0,0,0,0,3,0,3,24,0,0,0,0,0,0,0,0,0,0,0,0,0,0
6410,6410,Maarten Stekelenburg,1465,2016,Everton FC,9,9,0,784,0,0,10,10,0,900,0,0,19,19,0,1684,0,0,0,0,0,0,0,0,0,0,0,0,0,0
6411,6411,Yannick Bolasie,1057,2016,Everton FC,6,6,0,509,0,0,7,6,1,519,1,0,13,12,1,1028,1,0,0,0,0,0,1,1,0,0,0,0,0,0
6412,6412,Gerard Deulofeu,1927,2016,Everton FC,4,1,3,135,0,0,7,3,4,321,0,0,11,4,7,456,0,0,0,0,0,0,0,0,0,0,0,0,0,0
6413,6413,Justin Hoyte,3282,2005,Sunderland AFC,15,15,0,1321,1,0,12,12,0,1054,0,0,27,27,0,2375,1,0,0,0,0,1,0,1,0,0,0,0,0,0
6414,6414,Christian Bassila,3283,2005,Sunderland AFC,7,7,0,518,0,0,6,5,1,464,0,0,13,12,1,982,0,0,0,0,0,0,0,0,0,0,0,0,0,0
6415,6415,Daryl Murphy,1900,2005,Sunderland AFC,10,2,8,215,1,0,8,3,5,333,0,0,18,5,13,548,1,0,1,0,1,1,0,1,0,0,0,0,0,0
6416,6416,Christian Dailly,1626,2005,West Ham United,11,4,7,487,0,0,10,1,9,329,0,0,21,5,16,816,0,0,0,0,0,0,0,0,0,0,0,0,0,0
6417,6417,Alex,2269,2010,Chelsea FC,6,5,1,447,2,0,9,7,2,662,0,0,15,12,3,1109,2,0,0,0,0,1,0,1,0,0,0,0,0,0
6418,6418,Jay Emmanuel-Thomas,3284,2010,Arsenal FC,0,0,0,0,0,0,1,0,1,9,0,0,1,0,1,9,0,0,0,0,0,0,0,0,0,0,0,0,0,0
6419,6419,Carlos Vela,3285,2010,Arsenal FC,3,0,3,58,1,0,1,0,1,3,0,0,4,0,4,61,1,0,0,0,0,0,0,0,0,0,0,0,0,0
6420,6420,Emmanuel Eboué,1231,2010,Arsenal FC,6,4,2,338,0,0,7,4,3,368,1,0,13,8,5,706,1,0,0,0,0,0,0,0,0,0,0,0,0,0
6421,6421,Denilson,1232,2010,Arsenal FC,7,3,4,271,0,0,9,3,6,349,0,0,16,6,10,620,0,0,0,0,0,0,0,0,0,0,0,0,0,0
6422,6422,Jürgen Locadia,2487,2017,Brighton & Hove Albion,2,1,1,83,1,0,4,2,2,141,0,0,6,3,3,224,1,0,0,0,0,0,0,0,0,0,0,0,0,0
6423,6423,Leonardo Ulloa,2518,2017,Brighton & Hove Albion,4,0,4,58,0,0,6,2,4,204,1,0,10,2,8,262,1,0,0,0,0,0,1,1,0,0,0,0,0,0
6424,6424,André Ayew,2274,2017,Swansea City,6,5,1,469,0,0,6,5,1,482,0,0,12,10,2,951,0,0,0,0,0,0,0,0,0,0,0,0,0,0
6425,6425,Kyle Bartley,2276,2017,Swansea City,1,1,0,67,0,0,4,1,3,166,0,0,5,2,3,233,0,0,0,0,0,0,0,0,0,0,0,0,0,0
6426,6426,Armand Traoré,1238,2012,Queens Park Rangers,13,13,0,1102,0,0,13,11,2,994,0,0,26,24,2,2096,0,0,0,0,0,0,0,0,0,0,0,0,0,0
6427,6427,Steven Sidwell,1622,2014,Stoke City,5,2,3,195,0,0,7,3,4,252,0,0,12,5,7,447,0,0,0,0,0,0,0,0,0,0,0,0,0,0
6428,6428,Victor Moses,1434,2014,Stoke City,9,9,0,741,2,0,10,10,0,714,1,0,19,19,0,1455,3,0,0,3,3,2,1,3,0,1,1,0,0,0
6429,6429,Jon Walters,1555,2014,Stoke City,16,13,3,1191,7,0,16,15,1,1234,1,0,32,28,4,2425,8,0,3,0,3,2,0,2,0,0,0,0,0,0
6430,6430,Thomas Sørensen,1090,2014,Stoke City,0,0,0,0,0,0,0,0,0,0,0,0,0,0,0,0,0,0,0,0,0,0,0,0,0,0,0,0,0,0
6431,6431,Jack Wilshere,1694,2019,West Ham United,4,1,3,110,0,0,4,1,3,101,0,0,8,2,6,211,0,0,0,0,0,0,0,0,0,0,0,0,0,0
6432,6432,Guaita,2701,2019,Crystal Palace,18,18,0,1620,0,0,17,17,0,1530,0,0,35,35,0,3150,0,0,0,0,0,0,0,0,0,0,0,0,0,0
6433,6433,Martin Kelly,1034,2019,Crystal Palace,9,8,1,701,0,0,10,9,1,849,0,0,19,17,2,1550,0,0,0,0,0,0,0,0,0,0,0,0,0,0
6434,6434,Jeffrey Schlupp,2252,2019,Crystal Palace,9,6,3,591,2,0,8,5,3,445,1,0,17,11,6,1036,3,0,4,0,4,2,0,2,0,0,0,0,0,0
6435,6435,Christian Benteke,1443,2019,Crystal Palace,11,6,5,584,1,0,13,7,6,674,1,0,24,13,11,1258,2,0,0,0,0,0,1,1,0,0,0,0,0,0
6436,6436,James Tomkins,1281,2019,Crystal Palace,9,9,0,803,0,0,9,9,0,781,1,0,18,18,0,1584,1,0,0,0,0,0,1,1,0,0,0,0,0,0
6437,6437,Victor Camarasa,3286,2019,Crystal Palace,0,0,0,0,0,0,1,0,1,5,0,0,1,0,1,5,0,0,0,0,0,0,0,0,0,0,0,0,0,0
6438,6438,Trent Alexander-Arnold,1192,2016,Liverpool FC,4,0,4,29,0,0,3,2,1,137,0,0,7,2,5,166,0,0,0,0,0,0,0,0,0,0,0,0,0,0
6439,6439,Ben Woodburn,3287,2016,Liverpool FC,2,0,2,31,0,0,3,1,2,53,0,0,5,1,4,84,0,0,0,0,0,0,0,0,0,0,0,0,0,0
6440,6440,Marc Pugh,1016,2016,AFC Bournemouth,10,8,2,678,2,0,11,8,3,655,0,0,21,16,5,1333,2,0,3,0,3,1,0,1,0,0,0,0,0,0
6441,6441,Ryan Allsop,3288,2016,AFC Bournemouth,0,0,0,0,0,0,1,1,0,90,0,0,1,1,0,90,0,0,0,0,0,0,0,0,0,0,0,0,0,0
6442,6442,Baily Cargill,3289,2016,AFC Bournemouth,0,0,0,0,0,0,1,0,1,12,0,0,1,0,1,12,0,0,0,0,0,0,0,0,0,0,0,0,0,0
6443,6443,Lewis Cook,1038,2016,AFC Bournemouth,4,3,1,307,0,0,2,1,1,124,0,0,6,4,2,431,0,0,0,0,0,0,0,0,0,0,0,0,0,0
6444,6444,Ali Al Habsi,2877,2010,Wigan Athletic,16,16,0,1440,0,0,18,18,0,1620,0,0,34,34,0,3060,0,0,0,0,0,0,0,0,0,0,0,0,0,0
6445,6445,Steve Gohouri,2881,2010,Wigan Athletic,13,13,0,1170,0,0,14,13,1,1191,1,0,27,26,1,2361,1,0,0,1,1,0,1,1,0,0,0,0,0,0
6446,6446,Steven Caldwell,2375,2010,Wigan Athletic,4,3,1,343,0,0,7,6,1,559,0,0,11,9,2,902,0,0,0,0,0,0,0,0,0,0,0,0,0,0
6447,6447,Emmerson Boyce,2023,2010,Wigan Athletic,12,11,1,865,0,0,10,9,1,807,0,0,22,20,2,1672,0,0,0,0,0,0,0,0,0,0,0,0,0,0
6448,6448,Maynor Figueroa,2057,2010,Wigan Athletic,17,16,1,1393,1,0,16,16,0,1421,0,0,33,32,1,2814,1,0,3,0,3,1,0,1,0,0,0,0,0,0
6449,6449,James McCarthy,1053,2010,Wigan Athletic,13,13,0,1044,3,0,11,11,0,940,0,0,24,24,0,1984,3,0,0,0,0,1,0,1,0,0,0,0,0,0
6450,6450,Hendry Thomas,2058,2010,Wigan Athletic,13,12,1,1005,0,0,11,10,1,880,0,0,24,22,2,1885,0,0,0,0,0,0,0,0,0,0,0,0,0,0
6451,6451,Charles N'Zogbia,2016,2010,Wigan Athletic,17,16,1,1429,3,0,17,16,1,1381,6,0,34,32,2,2810,9,0,3,0,3,2,3,5,0,0,0,0,0,0
6452,6452,James McArthur,1023,2010,Wigan Athletic,10,1,9,252,0,0,8,2,6,289,0,0,18,3,15,541,0,0,0,0,0,0,0,0,0,0,0,0,0,0
6453,6453,Franco Di Santo,2272,2010,Wigan Athletic,13,5,8,516,0,0,12,4,8,398,1,0,25,9,16,914,1,0,0,0,0,0,0,0,0,0,0,0,0,0
6454,6454,Hugo Rodallega,2061,2010,Wigan Athletic,18,17,1,1535,5,0,18,17,1,1523,4,0,36,34,2,3058,9,0,1,6,7,4,4,8,0,0,0,0,0,0
6455,6455,Ronnie Stam,2878,2010,Wigan Athletic,13,7,6,742,0,0,12,10,2,840,1,0,25,17,8,1582,1,0,0,1,1,0,1,1,0,0,0,0,0,0
6456,6456,Ben Watson,2025,2010,Wigan Athletic,15,11,4,1029,2,0,14,12,2,1093,1,0,29,23,6,2122,3,0,0,0,0,1,1,2,2,0,2,0,0,0
6457,6457,Callum McManaman,3001,2010,Wigan Athletic,2,0,2,11,0,0,1,0,1,1,0,0,3,0,3,12,0,0,0,0,0,0,0,0,0,0,0,0,0,0
6458,6458,Mike Pollitt,2880,2010,Wigan Athletic,0,0,0,0,0,0,1,0,1,28,0,0,1,0,1,28,0,0,0,0,0,0,0,0,0,0,0,0,0,0
6459,6459,Jordi Gómez,2059,2010,Wigan Athletic,6,5,1,347,1,0,7,4,3,375,0,0,13,9,4,722,1,0,0,0,0,1,0,1,0,0,0,0,0,0
6460,6460,Momo Diamé,2060,2010,Wigan Athletic,18,14,4,1219,0,0,18,16,2,1421,1,0,36,30,6,2640,1,0,0,0,0,0,1,1,0,0,0,0,0,0
6461,6461,Victor Moses,1434,2010,Wigan Athletic,10,5,5,485,1,0,11,3,8,329,0,0,21,8,13,814,1,0,3,0,3,1,0,1,0,0,0,0,0,0
6462,6462,Carlos Cuéllar,1401,2010,Aston Villa,7,5,2,504,0,0,5,5,0,387,0,0,12,10,2,891,0,0,0,0,0,0,0,0,0,0,0,0,0,0
6463,6463,Nathan Baker,1973,2010,Aston Villa,2,2,0,69,0,0,2,2,0,180,0,0,4,4,0,249,0,0,0,0,0,0,0,0,0,0,0,0,0,0
6464,6464,Jean Makoun,3290,2010,Aston Villa,3,3,0,247,0,0,4,4,0,327,0,0,7,7,0,574,0,0,0,0,0,0,0,0,0,0,0,0,0,0
6465,6465,Nigel Reo-Coker,2494,2010,Aston Villa,13,9,4,796,0,0,16,15,1,1254,0,0,29,24,5,2050,0,0,0,0,0,0,0,0,0,0,0,0,0,0
6466,6466,Darren Bent,1958,2010,Aston Villa,8,8,0,713,2,0,8,8,0,687,7,0,16,16,0,1400,9,0,4,0,4,2,5,7,0,0,0,0,0,0
6467,6467,Stilian Petrov,1620,2010,Aston Villa,13,11,2,1037,1,0,13,11,2,944,0,0,26,22,4,1981,1,0,0,0,0,0,0,0,0,0,0,0,0,0
6468,6468,Chris Herd,3040,2010,Aston Villa,4,1,3,96,0,0,2,0,2,11,0,0,6,1,5,107,0,0,0,0,0,0,0,0,0,0,0,0,0,0
6469,6469,Andy Marshall,3291,2010,Aston Villa,0,0,0,0,0,0,0,0,0,0,0,0,0,0,0,0,0,0,0,0,0,0,0,0,0,0,0,0,0,0
6470,6470,Robert Pirés,1603,2010,Aston Villa,5,2,3,171,0,0,4,0,4,78,0,0,9,2,7,249,0,0,0,0,0,0,0,0,0,0,0,0,0,0
6471,6471,Emile Heskey,1519,2010,Aston Villa,8,6,2,439,1,0,10,5,5,442,2,0,18,11,7,881,3,0,0,3,3,0,2,2,0,0,0,0,0,0
6472,6472,Sean Morrison,1978,2018,Cardiff City,18,18,0,1600,0,0,16,16,0,1440,1,0,34,34,0,3040,1,0,0,0,0,0,0,0,0,0,0,0,0,0
6473,6473,Harry Arter,1007,2018,Cardiff City,14,14,0,1186,0,0,11,10,1,823,0,0,25,24,1,2009,0,0,0,0,0,0,0,0,0,0,0,0,0,0
6474,6474,Victor Camarasa,3286,2018,Cardiff City,16,16,0,1267,4,0,16,15,1,1312,1,0,32,31,1,2579,5,0,0,3,3,2,1,3,1,0,1,0,0,0
6475,6475,Kadeem Harris,3292,2018,Cardiff City,5,1,4,133,1,0,8,2,6,233,0,0,13,3,10,366,1,0,0,0,0,0,0,0,0,0,0,0,0,0
6476,6476,Ryan Giles,3293,2018,Wolverhampton Wanderers,0,0,0,0,0,0,0,0,0,0,0,0,0,0,0,0,0,0,0,0,0,0,0,0,0,0,0,0,0,0
6477,6477,Bjørn Helge Riise,3294,2010,Fulham FC,1,0,1,8,0,0,2,0,2,18,0,0,3,0,3,26,0,0,0,0,0,0,0,0,0,0,0,0,0,0
6478,6478,Eddie Johnson,3295,2010,Fulham FC,7,0,7,123,0,0,4,1,3,92,0,0,11,1,10,215,0,0,0,0,0,0,0,0,0,0,0,0,0,0
6479,6479,Neil Etheridge,3142,2010,Fulham FC,0,0,0,0,0,0,0,0,0,0,0,0,0,0,0,0,0,0,0,0,0,0,0,0,0,0,0,0,0,0
6480,6480,Marek Čech,3296,2010,West Bromwich Albion,8,7,1,643,0,0,7,7,0,574,0,0,15,14,1,1217,0,0,0,0,0,0,0,0,0,0,0,0,0,0
6481,6481,James Hurst,3297,2010,West Bromwich Albion,0,0,0,0,0,0,1,1,0,90,0,0,1,1,0,90,0,0,0,0,0,0,0,0,0,0,0,0,0,0
6482,6482,Jerome Thomas,1736,2010,West Bromwich Albion,17,17,0,1390,2,0,16,15,1,1203,1,0,33,32,1,2593,3,0,0,0,0,1,0,1,0,0,0,0,0,0
6483,6483,Gianni Zuiverloon,2002,2010,West Bromwich Albion,1,0,1,26,0,0,1,1,0,90,0,0,2,1,1,116,0,0,0,0,0,0,0,0,0,0,0,0,0,0
6484,6484,Abdoulaye Méïté,1712,2010,West Bromwich Albion,4,4,0,360,0,0,6,6,0,496,0,0,10,10,0,856,0,0,0,0,0,0,0,0,0,0,0,0,0,0
6485,6485,Ishmael Miller,1813,2010,West Bromwich Albion,1,0,1,10,0,0,5,0,5,87,0,0,6,0,6,97,0,0,0,0,0,0,0,0,0,0,0,0,0,0
6486,6486,Joseph Yobo,1801,2009,Everton FC,7,7,0,551,1,0,10,7,3,633,0,0,17,14,3,1184,1,0,0,0,0,0,0,0,0,0,0,0,0,0
6487,6487,Sylvain Distin,1015,2009,Everton FC,15,15,0,1330,0,0,14,14,0,1260,0,0,29,29,0,2590,0,0,0,0,0,0,0,0,0,0,0,0,0,0
6488,6488,Jack Rodwell,1748,2009,Everton FC,12,7,5,670,2,0,14,10,4,950,0,0,26,17,9,1620,2,0,0,0,0,0,0,0,0,0,0,0,0,0
6489,6489,Jô,3298,2009,Everton FC,8,3,5,250,0,0,7,3,4,267,0,0,15,6,9,517,0,0,0,0,0,0,0,0,0,0,0,0,0,0
6490,6490,Stephen Jordan,2549,2005,Manchester City,9,9,0,810,0,0,8,8,0,680,0,0,17,17,0,1490,0,0,0,0,0,0,0,0,0,0,0,0,0,0
6491,6491,Andy Cole,1113,2005,Manchester City,12,12,0,1024,5,0,10,8,2,745,4,0,22,20,2,1769,9,0,3,3,6,2,2,4,0,0,0,0,0,0
6492,6492,Nigel Martyn,1290,2005,Everton FC,9,9,0,810,0,0,10,10,0,855,0,0,19,19,0,1665,0,0,0,0,0,0,0,0,0,0,0,0,0,0
6493,6493,Joseph Yobo,1801,2005,Everton FC,13,13,0,1170,1,0,15,15,0,1350,0,0,28,28,0,2520,1,0,3,0,3,1,0,1,0,0,0,0,0,0
6494,6494,David Weir,1800,2005,Everton FC,16,16,0,1440,1,0,16,15,1,1352,0,0,32,31,1,2792,1,0,3,0,3,1,0,1,0,0,0,0,0,0
6495,6495,Phil Neville,1114,2005,Everton FC,17,17,0,1530,0,0,16,16,0,1440,0,0,33,33,0,2970,0,0,0,0,0,0,0,0,0,0,0,0,0,0
6496,6496,Nuno Valente,2106,2005,Everton FC,12,12,0,1023,0,0,8,8,0,720,0,0,20,20,0,1743,0,0,0,0,0,0,0,0,0,0,0,0,0,0
6497,6497,Matteo Ferrari,3299,2005,Everton FC,4,2,2,197,0,0,4,4,0,335,0,0,8,6,2,532,0,0,0,0,0,0,0,0,0,0,0,0,0,0
6498,6498,Kevin Kilbane,1103,2005,Everton FC,17,9,8,898,0,0,16,11,5,1027,0,0,33,20,13,1925,0,0,0,0,0,0,0,0,0,0,0,0,0,0
6499,6499,Tim Cahill,1746,2005,Everton FC,17,17,0,1458,4,0,14,14,0,1197,2,0,31,31,0,2655,6,0,0,3,3,1,1,2,0,0,0,0,0,0
6500,6500,Leon Osman,1747,2005,Everton FC,16,13,3,1154,2,0,18,14,4,1302,1,0,34,27,7,2456,3,0,0,0,0,1,1,2,0,0,0,0,0,0
6501,6501,James McFadden,1413,2005,Everton FC,15,11,4,909,3,0,16,13,3,1126,3,0,31,24,7,2035,6,0,0,3,3,2,3,5,0,0,0,0,0,0
6502,6502,Simon Davies,1125,2005,Everton FC,15,12,3,920,0,0,14,9,5,839,1,0,29,21,8,1759,1,0,0,3,3,0,1,1,0,0,0,0,0,0
6503,6503,James Beattie,2050,2005,Everton FC,17,16,1,1368,9,0,15,13,2,1142,1,0,32,29,3,2510,10,0,9,1,10,7,1,8,2,0,2,0,0,0
6504,6504,Duncan Ferguson,1805,2005,Everton FC,12,5,7,545,1,0,14,2,12,411,0,0,26,7,19,956,1,0,1,0,1,1,0,1,0,0,0,0,0,0
6505,6505,Kolo Touré,1415,2011,Manchester City,7,5,2,545,0,0,7,3,4,303,0,0,14,8,6,848,0,0,0,0,0,0,0,0,0,0,0,0,0,0
6506,6506,Mario Balotelli,1681,2011,Manchester City,14,7,7,685,9,0,9,7,2,649,4,0,23,14,9,1334,13,0,3,0,3,6,2,8,3,0,3,0,0,0
6507,6507,Stefan Savić,3300,2011,Manchester City,6,2,4,246,0,0,5,3,2,296,1,0,11,5,6,542,1,0,0,0,0,0,0,0,0,0,0,0,0,0
6508,6508,Mikel Arteta,1802,2011,Arsenal FC,15,15,0,1261,4,0,14,14,0,1214,2,0,29,29,0,2475,6,0,3,0,3,1,2,3,0,0,0,0,0,0
6509,6509,Gervinho,3301,2011,Arsenal FC,14,8,6,758,2,0,14,11,3,937,2,0,28,19,9,1695,4,0,0,0,0,2,1,3,0,0,0,0,0,0
6510,6510,Marouane Chamakh,1031,2011,Arsenal FC,6,1,5,121,0,0,4,0,4,44,1,0,10,1,9,165,1,0,0,0,0,0,0,0,0,0,0,0,0,0
6511,6511,Emmanuel Frimpong,2753,2011,Arsenal FC,4,2,2,166,0,0,2,1,1,71,0,0,6,3,3,237,0,0,0,0,0,0,0,0,0,0,0,0,0,0
6512,6512,Luke Chadwick,3302,2000,Manchester United,7,3,4,306,0,0,8,3,5,316,2,0,15,6,9,622,2,0,0,0,0,0,1,1,0,0,0,0,0,0
6513,6513,Carlo Nash,3303,2000,Manchester City,3,3,0,270,0,0,3,3,0,270,0,0,6,6,0,540,0,0,0,0,0,0,0,0,0,0,0,0,0,0
6514,6514,Laurent Charvet,3304,2000,Manchester City,10,7,3,649,0,0,8,7,1,613,0,0,18,14,4,1262,0,0,0,0,0,0,0,0,0,0,0,0,0,0
6515,6515,Danny Granville,2021,2000,Manchester City,9,8,1,632,0,0,9,7,2,606,0,0,18,15,3,1238,0,0,0,0,0,0,0,0,0,0,0,0,0,0
6516,6516,Stephen Howey,3305,2000,Manchester City,16,16,0,1417,3,0,17,17,0,1460,3,0,33,33,0,2877,6,0,0,2,2,1,3,4,0,0,0,0,0,0
6517,6517,Richard Dunne,1617,2000,Manchester City,12,12,0,1035,0,0,11,11,0,990,0,0,23,23,0,2025,0,0,0,0,0,0,0,0,0,0,0,0,0,0
6518,6518,Gerard Wiekens,3306,2000,Manchester City,16,13,3,1118,0,0,15,13,2,1150,2,0,31,26,5,2268,2,0,0,0,0,0,1,1,0,0,0,0,0,0
6519,6519,Alf-Inge Håland,3307,2000,Manchester City,17,17,0,1450,2,0,16,16,0,1412,1,0,33,33,0,2862,3,0,0,0,0,0,1,1,0,0,0,0,0,0
6520,6520,Tony Grant,3308,2000,Manchester City,4,1,3,180,0,0,5,3,2,230,0,0,9,4,5,410,0,0,0,0,0,0,0,0,0,0,0,0,0,0
6521,6521,Jeff Whitley,3309,2000,Manchester City,14,13,1,1129,0,0,15,14,1,1221,1,0,29,27,2,2350,1,0,0,0,0,0,1,1,0,0,0,0,0,0
6522,6522,Paul Dickov,1878,2000,Manchester City,12,8,4,749,2,0,9,7,2,686,2,0,21,15,6,1435,4,0,0,0,0,1,1,2,0,0,0,0,0,0
6523,6523,Paulo Wanchope,3310,2000,Manchester City,12,10,2,935,6,0,13,13,0,1103,3,0,25,23,2,2038,9,0,1,3,4,4,3,7,0,0,0,0,0,0
6524,6524,Spencer Prior,3311,2000,Manchester City,8,8,0,720,0,0,11,8,3,773,1,0,19,16,3,1493,1,0,0,0,0,0,1,1,0,0,0,0,0,0
6525,6525,Andrey Kanchelskis,3312,2000,Manchester City,4,3,1,250,0,0,5,3,2,343,0,0,9,6,3,593,0,0,0,0,0,0,0,0,0,0,0,0,0,0
6526,6526,Shaun Goater,3203,2000,Manchester City,13,12,1,1010,2,0,12,7,5,665,4,0,25,19,6,1675,6,0,0,4,4,1,4,5,0,0,0,0,0,0
6527,6527,Tony Hibbert,1744,2007,Everton FC,10,9,1,743,0,0,14,13,1,1222,0,0,24,22,2,1965,0,0,0,0,0,0,0,0,0,0,0,0,0,0
6528,6528,Victor Anichebe,1751,2007,Everton FC,14,6,8,655,1,0,13,4,9,420,0,0,27,10,17,1075,1,0,0,0,0,0,0,0,0,0,0,0,0,0
6529,6529,Leighton Baines,1466,2007,Everton FC,11,7,4,576,0,0,11,6,5,561,0,0,22,13,9,1137,0,0,0,0,0,0,0,0,0,0,0,0,0,0
6530,6530,Ryan Babel,1897,2007,Liverpool FC,15,8,7,729,2,0,15,7,8,686,2,0,30,15,15,1415,4,0,0,0,0,0,0,0,0,0,0,0,0,0
6531,6531,Dwight Tiendalli,2936,2014,Swansea City,2,1,1,91,0,0,1,0,1,36,0,0,3,1,2,127,0,0,0,0,0,0,0,0,0,0,0,0,0,0
6532,6532,Kyle Bartley,2276,2014,Swansea City,4,4,0,360,0,0,3,3,0,270,0,0,7,7,0,630,0,0,0,0,0,0,0,0,0,0,0,0,0,0
6533,6533,Joe Hart,1363,2014,Manchester City,18,18,0,1620,0,0,18,18,0,1620,0,0,36,36,0,3240,0,0,0,0,0,0,0,0,0,0,0,0,0,0
6534,6534,Pablo Zabaleta,1355,2014,Manchester City,16,16,0,1440,0,0,13,13,0,1170,1,0,29,29,0,2610,1,0,0,0,0,0,0,0,0,0,0,0,0,0
6535,6535,Aleksandar Kolarov,1366,2014,Manchester City,11,10,1,893,2,0,10,6,4,593,0,0,21,16,5,1486,2,0,0,0,0,0,0,0,0,0,0,0,0,0
6536,6536,Eliaquim Mangala,1209,2014,Manchester City,12,12,0,1080,0,0,13,12,1,1124,0,0,25,24,1,2204,0,0,0,0,0,0,0,0,0,0,0,0,0,0
6537,6537,Martín Demichelis,1356,2014,Manchester City,16,16,0,1440,0,0,15,12,3,1118,1,0,31,28,3,2558,1,0,0,1,1,0,1,1,0,0,0,0,0,0
6538,6538,James Milner,1189,2014,Manchester City,15,9,6,792,3,0,17,9,8,956,2,0,32,18,14,1748,5,0,1,0,1,1,1,2,0,0,0,0,0,0
6539,6539,Frank Lampard,1536,2014,Manchester City,15,6,9,536,3,0,17,4,13,456,3,0,32,10,22,992,6,0,4,3,7,3,1,4,0,0,0,0,0,0
6540,6540,David Silva,1211,2014,Manchester City,16,16,0,1292,8,0,16,16,0,1369,4,0,32,32,0,2661,12,0,0,1,1,3,2,5,0,0,0,0,0,0
6541,6541,Fernandinho,1202,2014,Manchester City,16,10,6,1012,2,0,17,15,2,1259,1,0,33,25,8,2271,3,0,3,0,3,1,1,2,0,0,0,0,0,0
6542,6542,Yaya Touré,1359,2014,Manchester City,15,13,2,1130,4,0,14,14,0,1225,6,0,29,27,2,2355,10,0,6,0,6,3,4,7,1,1,2,0,0,0
6543,6543,Kun Agüero,1204,2014,Manchester City,16,15,1,1240,13,0,17,15,2,1299,13,0,33,30,3,2539,26,0,3,4,7,6,8,14,4,1,5,0,0,0
6544,6544,Vincent Kompany,1414,2014,Manchester City,11,10,1,911,0,0,14,13,1,1124,0,0,25,23,2,2035,0,0,0,0,0,0,0,0,0,0,0,0,0,0
6545,6545,Jesús Navas,1361,2014,Manchester City,19,12,7,1215,0,0,16,11,5,1028,0,0,35,23,12,2243,0,0,0,0,0,0,0,0,0,0,0,0,0,0
6546,6546,Wilfried Bony,1597,2014,Manchester City,6,2,4,237,1,0,4,0,4,58,1,0,10,2,8,295,2,0,0,0,0,1,0,1,0,0,0,0,0,0
6547,6547,Willy Caballero,1588,2014,Manchester City,1,1,0,90,0,0,1,1,0,90,0,0,2,2,0,180,0,0,0,0,0,0,0,0,0,0,0,0,0,0
6548,6548,Gaël Clichy,1230,2014,Manchester City,9,9,0,810,0,0,14,14,0,1248,1,0,23,23,0,2058,1,0,0,0,0,0,0,0,0,0,0,0,0,0
6549,6549,Edin Džeko,1362,2014,Manchester City,11,4,7,401,1,0,11,7,4,554,3,0,22,11,11,955,4,0,0,0,0,0,2,2,0,0,0,0,0,0
6550,6550,Stevan Jovetić,2299,2014,Manchester City,10,5,5,487,4,0,7,4,3,298,1,0,17,9,8,785,5,0,0,0,0,2,1,3,0,0,0,0,0,0
6551,6551,Edwin van der Sar,1077,2007,Manchester United,14,14,0,1260,0,0,15,15,0,1306,0,0,29,29,0,2566,0,0,0,0,0,0,0,0,0,0,0,0,0,0
6552,6552,Rio Ferdinand,1294,2007,Manchester United,17,17,0,1451,1,0,18,18,0,1600,1,0,35,35,0,3051,2,0,0,0,0,0,0,0,0,0,0,0,0,0
6553,6553,Wes Brown,1108,2007,Manchester United,17,15,2,1377,1,0,19,19,0,1658,0,0,36,34,2,3035,1,0,0,0,0,1,0,1,0,0,0,0,0,0
6554,6554,Nemanja Vidić,1725,2007,Manchester United,17,17,0,1429,0,0,15,15,0,1239,1,0,32,32,0,2668,1,0,0,3,3,0,1,1,0,0,0,0,0,0
6555,6555,John O'Shea,1729,2007,Manchester United,13,6,7,656,0,0,15,4,11,480,0,0,28,10,18,1136,0,0,0,0,0,0,0,0,0,0,0,0,0,0
6556,6556,Anderson,2018,2007,Manchester United,15,11,4,991,0,0,9,5,4,499,0,0,24,16,8,1490,0,0,0,0,0,0,0,0,0,0,0,0,0,0
6557,6557,Ryan Giggs,1110,2007,Manchester United,15,12,3,1061,1,0,16,14,2,1176,2,0,31,26,5,2237,3,0,0,0,0,1,0,1,0,0,0,0,0,0
6558,6558,Paul Scholes,1112,2007,Manchester United,12,11,1,929,0,0,12,11,1,911,1,0,24,22,2,1840,1,0,0,0,0,0,1,1,0,0,0,0,0,0
6559,6559,Cristiano Ronaldo,1726,2007,Manchester United,17,17,0,1487,21,0,17,14,3,1265,10,0,34,31,3,2752,31,0,3,6,9,10,6,16,3,1,4,0,0,0
6560,6560,Nani,2258,2007,Manchester United,13,8,5,799,3,0,13,8,5,829,0,0,26,16,10,1628,3,0,3,0,3,2,0,2,0,0,0,0,0,0
6561,6561,Carlos Tévez,1417,2007,Manchester United,18,15,3,1368,11,0,16,16,0,1317,3,0,34,31,3,2685,14,0,3,5,8,3,3,6,0,0,0,0,0,0
6562,6562,Owen Hargreaves,3313,2007,Manchester United,13,9,4,850,1,0,11,8,3,767,1,0,24,17,7,1617,2,0,3,0,3,1,1,2,0,0,0,0,0,0
6563,6563,Ji-Sung Park,1788,2007,Manchester United,5,4,1,306,0,0,7,4,3,327,1,0,12,8,4,633,1,0,0,0,0,0,0,0,0,0,0,0,0,0
6564,6564,Michael Carrick,1627,2007,Manchester United,14,11,3,955,2,0,16,12,4,1155,0,0,30,23,7,2110,2,0,0,0,0,0,0,0,0,0,0,0,0,0
6565,6565,Joe Hart,1363,2007,Manchester City,14,14,0,1260,0,0,12,12,0,1080,0,0,26,26,0,2340,0,0,0,0,0,0,0,0,0,0,0,0,0,0
6566,6566,Michael Ball,2823,2007,Manchester City,16,10,6,976,0,0,12,9,3,891,0,0,28,19,9,1867,0,0,0,0,0,0,0,0,0,0,0,0,0,0
6567,6567,Gelson Fernandes,3090,2007,Manchester City,13,10,3,919,1,0,13,11,2,1039,1,0,26,21,5,1958,2,0,0,0,0,0,0,0,0,0,0,0,0,0
6568,6568,Darius Vassell,1798,2007,Manchester City,13,9,4,835,4,0,14,12,2,939,2,0,27,21,6,1774,6,0,1,3,4,4,2,6,0,0,0,0,0,0
6569,6569,Jihai Sun,1808,2007,Manchester City,6,2,4,285,0,0,8,5,3,524,0,0,14,7,7,809,0,0,0,0,0,0,0,0,0,0,0,0,0,0
6570,6570,Felipe Caicedo,3089,2007,Manchester City,6,0,6,104,0,0,4,0,4,111,0,0,10,0,10,215,0,0,0,0,0,0,0,0,0,0,0,0,0,0
6571,6571,Jordan Pickford,1046,2016,Sunderland AFC,14,14,0,1260,0,0,15,15,0,1350,0,0,29,29,0,2610,0,0,0,0,0,0,0,0,0,0,0,0,0,0
6572,6572,Jack Rodwell,1748,2016,Sunderland AFC,10,8,2,734,0,0,10,9,1,759,0,0,20,17,3,1493,0,0,0,0,0,0,0,0,0,0,0,0,0,0
6573,6573,Duncan Watmore,2820,2016,Sunderland AFC,7,6,1,578,0,0,7,5,2,451,0,0,14,11,3,1029,0,0,0,0,0,0,0,0,0,0,0,0,0,0
6574,6574,Papy Djilobodji,3314,2016,Sunderland AFC,10,9,1,858,0,0,8,8,0,720,0,0,18,17,1,1578,0,0,0,0,0,0,0,0,0,0,0,0,0,0
6575,6575,Lynden Gooch,3315,2016,Sunderland AFC,4,2,2,154,0,0,7,2,5,210,0,0,11,4,7,364,0,0,0,0,0,0,0,0,0,0,0,0,0,0
6576,6576,Donald Love,3316,2016,Sunderland AFC,7,5,2,481,0,0,5,1,4,126,0,0,12,6,6,607,0,0,0,0,0,0,0,0,0,0,0,0,0,0
6577,6577,Victor Anichebe,1751,2016,Sunderland AFC,8,7,1,581,2,0,10,7,3,636,1,0,18,14,4,1217,3,0,0,0,0,0,1,1,0,0,0,0,0,0
6578,6578,Ainsley Maitland-Niles,1473,2016,Arsenal FC,0,0,0,0,0,0,1,0,1,1,0,0,1,0,1,1,0,0,0,0,0,0,0,0,0,0,0,0,0,0
6579,6579,Carl Jenkinson,2752,2016,Arsenal FC,0,0,0,0,0,0,1,1,0,83,0,0,1,1,0,83,0,0,0,0,0,0,0,0,0,0,0,0,0,0
6580,6580,Federico Fernández,1697,2016,Swansea City,12,12,0,1080,0,0,15,15,0,1350,0,0,27,27,0,2430,0,0,0,0,0,0,0,0,0,0,0,0,0,0
6581,6581,Stephen Kingsley,3317,2016,Swansea City,8,7,1,631,0,0,5,5,0,406,0,0,13,12,1,1037,0,0,0,0,0,0,0,0,0,0,0,0,0,0
6582,6582,Llorente,1860,2016,Swansea City,16,13,3,1105,11,0,17,15,2,1346,4,0,33,28,5,2451,15,0,12,0,12,8,3,11,0,0,0,0,0,0
6583,6583,Nathan Dyer,1702,2016,Swansea City,5,3,2,177,0,0,3,0,3,34,0,0,8,3,5,211,0,0,0,0,0,0,0,0,0,0,0,0,0,0
6584,6584,Lucas Pérez,3318,2016,Arsenal FC,6,2,4,207,0,0,5,0,5,58,1,0,11,2,9,265,1,0,0,0,0,0,0,0,0,0,0,0,0,0
6585,6585,Jeff Reine-Adélaïde,1595,2016,Arsenal FC,0,0,0,0,0,0,0,0,0,0,0,0,0,0,0,0,0,0,0,0,0,0,0,0,0,0,0,0,0,0
6586,6586,Nicky Shorey,1731,2008,Aston Villa,9,8,1,672,0,0,11,10,1,830,0,0,20,18,2,1502,0,0,0,0,0,0,0,0,0,0,0,0,0,0
6587,6587,Nathan Delfouneso,2175,2008,Aston Villa,3,0,3,66,0,0,1,0,1,14,0,0,4,0,4,80,0,0,0,0,0,0,0,0,0,0,0,0,0,0
6588,6588,Tony Hibbert,1744,2008,Everton FC,10,10,0,809,0,0,5,4,1,326,0,0,15,14,1,1135,0,0,0,0,0,0,0,0,0,0,0,0,0,0
6589,6589,Tim Cahill,1746,2008,Everton FC,15,14,1,1167,2,0,11,11,0,981,6,0,26,25,1,2148,8,0,0,10,10,2,4,6,0,0,0,0,0,0
6590,6590,Steven Pienaar,2406,2008,Everton FC,15,14,1,1239,0,0,9,9,0,806,3,0,24,23,1,2045,3,0,0,3,3,0,2,2,0,0,0,0,0,0
6591,6591,Marouane Fellaini,2189,2008,Everton FC,16,16,0,1300,5,0,11,9,2,827,3,0,27,25,2,2127,8,0,1,3,4,2,2,4,0,0,0,0,0,0
6592,6592,Jô,3298,2008,Everton FC,6,5,1,419,5,0,6,6,0,509,0,0,12,11,1,928,5,0,0,0,0,2,0,2,1,0,1,0,0,0
6593,6593,Lars Jacobsen,2657,2008,Everton FC,1,1,0,90,0,0,4,3,1,271,0,0,5,4,1,361,0,0,0,0,0,0,0,0,0,0,0,0,0,0
6594,6594,Louis Saha,1727,2008,Everton FC,11,5,6,560,4,0,12,4,8,520,2,0,23,9,14,1080,6,0,3,0,3,2,1,3,1,0,1,0,0,0
6595,6595,Ronny Johnsen,2031,2001,Manchester United,4,3,1,274,1,0,6,6,0,540,0,0,10,9,1,814,1,0,0,0,0,1,0,1,0,0,0,0,0,0
6596,6596,David May,3319,2001,Manchester United,2,2,0,168,0,0,0,0,0,0,0,0,2,2,0,168,0,0,0,0,0,0,0,0,0,0,0,0,0,0
6597,6597,Luke Chadwick,3302,2001,Manchester United,6,3,3,238,0,0,2,2,0,169,0,0,8,5,3,407,0,0,0,0,0,0,0,0,0,0,0,0,0,0
6598,6598,Quinton Fortune,2782,2001,Manchester United,9,4,5,420,1,0,5,4,1,276,0,0,14,8,6,696,1,0,0,0,0,0,0,0,0,0,0,0,0,0
6599,6599,Fabian Wilnis,3320,2001,Ipswich Town,7,1,6,220,0,0,7,5,2,486,0,0,14,6,8,706,0,0,0,0,0,0,0,0,0,0,0,0,0,0
6600,6600,Jamie Clapham,1513,2001,Ipswich Town,15,10,5,946,1,0,17,12,5,1155,1,0,32,22,10,2101,2,0,0,0,0,0,0,0,0,0,0,0,0,0
6601,6601,Nathaniel Clyne,1144,2017,Liverpool FC,1,0,1,25,0,0,2,2,0,149,0,0,3,2,1,174,0,0,0,0,0,0,0,0,0,0,0,0,0,0
6602,6602,Ben Woodburn,3287,2017,Liverpool FC,1,0,1,6,0,0,0,0,0,0,0,0,1,0,1,6,0,0,0,0,0,0,0,0,0,0,0,0,0,0
6603,6603,Moritz Bauer,3321,2017,Stoke City,6,6,0,519,0,0,8,8,0,700,0,0,14,14,0,1219,0,0,0,0,0,0,0,0,0,0,0,0,0,0
6604,6604,Bruno Martins Indi,3322,2017,Stoke City,7,5,2,444,0,0,9,8,1,710,0,0,16,13,3,1154,0,0,0,0,0,0,0,0,0,0,0,0,0,0
6605,6605,Badou N'Diaye,3323,2017,Stoke City,5,5,0,439,1,0,7,7,0,611,1,0,12,12,0,1050,2,0,0,0,0,1,1,2,0,0,0,0,0,0
6606,6606,Jakob Haugaard,1587,2017,Stoke City,0,0,0,0,0,0,0,0,0,0,0,0,0,0,0,0,0,0,0,0,0,0,0,0,0,0,0,0,0,0
6607,6607,Stephen Ireland,1809,2017,Stoke City,1,0,1,21,0,0,3,1,2,107,0,0,4,1,3,128,0,0,0,0,0,0,0,0,0,0,0,0,0,0
6608,6608,Tyrese Campbell,3324,2017,Stoke City,3,0,3,49,0,0,1,0,1,26,0,0,4,0,4,75,0,0,0,0,0,0,0,0,0,0,0,0,0,0
6609,6609,Shaka Hislop,1064,2004,Portsmouth FC,9,9,0,810,0,0,8,8,0,720,0,0,17,17,0,1530,0,0,0,0,0,0,0,0,0,0,0,0,0,0
6610,6610,Aliou Cissé,2622,2004,Portsmouth FC,9,5,4,515,0,0,11,7,4,641,0,0,20,12,8,1156,0,0,0,0,0,0,0,0,0,0,0,0,0,0
6611,6611,Yakubu Ayegbeni,1073,2004,Portsmouth FC,16,15,1,1327,11,0,14,14,0,1140,2,0,30,29,1,2467,13,0,8,0,8,7,2,9,4,0,4,0,0,0
6612,6612,Diomansy Kamara,1564,2004,Portsmouth FC,12,7,5,654,2,0,13,8,5,718,2,0,25,15,10,1372,4,0,0,0,0,2,2,4,0,0,0,0,0,0
6613,6613,Richard Hughes,2812,2004,Portsmouth FC,8,7,1,639,0,0,8,6,2,504,0,0,16,13,3,1143,0,0,0,0,0,0,0,0,0,0,0,0,0,0
6614,6614,Carl Hoefkens,3325,2008,West Bromwich Albion,6,4,2,422,0,0,4,2,2,237,0,0,10,6,4,659,0,0,0,0,0,0,0,0,0,0,0,0,0,0
6615,6615,Ryan Donk,3326,2008,West Bromwich Albion,9,7,2,624,0,0,7,7,0,630,0,0,16,14,2,1254,0,0,0,0,0,0,0,0,0,0,0,0,0,0
6616,6616,Pelé,3327,2008,West Bromwich Albion,2,1,1,141,0,0,1,0,1,2,0,0,3,1,2,143,0,0,0,0,0,0,0,0,0,0,0,0,0,0
6617,6617,Marek Čech,3296,2008,West Bromwich Albion,5,2,3,223,0,0,3,1,2,114,0,0,8,3,5,337,0,0,0,0,0,0,0,0,0,0,0,0,0,0
6618,6618,Wes Brown,1108,2008,Manchester United,2,1,1,124,0,0,6,5,1,470,1,0,8,6,2,594,1,0,0,0,0,0,1,1,0,0,0,0,0,0
6619,6619,Richard Eckersley,3328,2008,Manchester United,0,0,0,0,0,0,2,0,2,49,0,0,2,0,2,49,0,0,0,0,0,0,0,0,0,0,0,0,0,0
6620,6620,Zoran Tošić,3329,2008,Manchester United,0,0,0,0,0,0,2,0,2,16,0,0,2,0,2,16,0,0,0,0,0,0,0,0,0,0,0,0,0,0
6621,6621,Tony Adams,3243,2000,Arsenal FC,17,17,0,1530,1,0,8,8,0,720,0,0,25,25,0,2250,1,0,0,0,0,0,0,0,0,0,0,0,0,0
6622,6622,Lauren,1602,2000,Arsenal FC,8,7,1,553,2,0,9,7,2,599,0,0,17,14,3,1152,2,0,0,0,0,1,0,1,0,0,0,0,0,0
6623,6623,Igors Stepanovs,3330,2000,Arsenal FC,5,5,0,450,0,0,4,4,0,360,0,0,9,9,0,810,0,0,0,0,0,0,0,0,0,0,0,0,0,0
6624,6624,Patrick Vieira,1524,2000,Arsenal FC,15,15,0,1350,5,0,14,12,2,1128,1,0,29,27,2,2478,6,0,3,1,4,4,1,5,0,0,0,0,0,0
6625,6625,Dennis Bergkamp,1527,2000,Arsenal FC,12,10,2,895,1,0,13,9,4,801,2,0,25,19,6,1696,3,0,0,4,4,0,2,2,0,0,0,0,0,0
6626,6626,Leon Cort,1996,2009,Burnley FC,8,8,0,720,0,0,7,7,0,573,0,0,15,15,0,1293,0,0,0,0,0,0,0,0,0,0,0,0,0,0
6627,6627,Danny Fox,2870,2009,Burnley FC,8,7,1,608,1,0,6,6,0,540,0,0,14,13,1,1148,1,0,0,0,0,0,0,0,0,0,0,0,0,0
6628,6628,Martin Paterson,3331,2009,Burnley FC,12,9,3,756,2,0,11,8,3,679,2,0,23,17,6,1435,4,0,0,0,0,2,1,3,0,0,0,0,0,0
6629,6629,Jack Cork,1701,2009,Burnley FC,5,3,2,296,1,0,6,5,1,475,0,0,11,8,3,771,1,0,0,0,0,1,0,1,0,0,0,0,0,0
6630,6630,Steven Thompson,3332,2009,Burnley FC,10,1,9,170,2,0,10,0,10,212,2,0,20,1,19,382,4,0,0,0,0,0,0,0,0,0,0,0,0,0
6631,6631,David James,1385,2009,Portsmouth FC,12,12,0,1080,0,0,13,13,0,1154,0,0,25,25,0,2234,0,0,0,0,0,0,0,0,0,0,0,0,0,0
6632,6632,Ricardo Rocha,2954,2009,Portsmouth FC,4,4,0,310,0,0,6,6,0,496,0,0,10,10,0,806,0,0,0,0,0,0,0,0,0,0,0,0,0,0
6633,6633,Hermann Hreiðarsson,1953,2009,Portsmouth FC,9,9,0,810,1,0,8,8,0,604,0,0,17,17,0,1414,1,0,0,0,0,1,0,1,0,0,0,0,0,0
6634,6634,Steve Finnan,2883,2009,Portsmouth FC,11,11,0,935,0,0,10,9,1,873,0,0,21,20,1,1808,0,0,0,0,0,0,0,0,0,0,0,0,0,0
6635,6635,Marc Wilson,1546,2009,Portsmouth FC,13,13,0,1126,0,0,15,15,0,1285,0,0,28,28,0,2411,0,0,0,0,0,0,0,0,0,0,0,0,0,0
6636,6636,Nadir Belhadj,2811,2009,Portsmouth FC,11,8,3,793,2,0,8,8,0,676,1,0,19,16,3,1469,3,0,0,0,0,1,0,1,0,0,0,0,0,0
6637,6637,Jamie O'Hara,2505,2009,Portsmouth FC,12,12,0,1061,1,0,14,13,1,1195,1,0,26,25,1,2256,2,0,0,0,0,1,1,2,0,0,0,0,0,0
6638,6638,Hassan Yebda,3333,2009,Portsmouth FC,11,9,2,793,0,0,7,6,1,487,2,0,18,15,3,1280,2,0,0,6,6,0,2,2,0,1,1,0,0,0
6639,6639,Frédéric Piquionne,3334,2009,Portsmouth FC,16,14,2,1166,3,0,18,12,6,1112,2,0,34,26,8,2278,5,0,0,0,0,1,2,3,0,0,0,0,0,0
6640,6640,Danny Webber,3335,2009,Portsmouth FC,7,1,6,84,1,0,10,3,7,380,0,0,17,4,13,464,1,0,1,0,1,1,0,1,0,0,0,0,0,0
6641,6641,Quincy Owusu-Abeyie,3336,2009,Portsmouth FC,4,2,2,260,0,0,6,1,5,95,0,0,10,3,7,355,0,0,0,0,0,0,0,0,0,0,0,0,0,0
6642,6642,Papa Bouba Diop,1757,2009,Portsmouth FC,5,4,1,360,0,0,7,5,2,356,0,0,12,9,3,716,0,0,0,0,0,0,0,0,0,0,0,0,0,0
6643,6643,Michael Brown,1122,2009,Portsmouth FC,13,12,1,1048,2,0,11,10,1,882,0,0,24,22,2,1930,2,0,0,0,0,1,0,1,0,0,0,0,0,0
6644,6644,John Utaka,2813,2009,Portsmouth FC,9,5,4,488,1,0,9,5,4,560,0,0,18,10,8,1048,1,0,0,0,0,1,0,1,0,0,0,0,0,0
6645,6645,Scott Dann,1020,2010,Birmingham City,10,10,0,900,0,0,10,10,0,900,2,0,20,20,0,1800,2,0,0,3,3,0,1,1,0,0,0,0,0,0
6646,6646,David Murphy,2135,2010,Birmingham City,5,1,4,143,0,0,5,2,3,278,0,0,10,3,7,421,0,0,0,0,0,0,0,0,0,0,0,0,0,0
6647,6647,Nikola Žigić,3337,2010,Birmingham City,15,7,8,726,3,0,10,6,4,583,2,0,25,13,12,1309,5,0,3,3,6,2,2,4,0,0,0,0,0,0
6648,6648,Maik Taylor,2501,2010,Birmingham City,0,0,0,0,0,0,0,0,0,0,0,0,0,0,0,0,0,0,0,0,0,0,0,0,0,0,0,0,0,0
6649,6649,Míchel,3338,2010,Birmingham City,0,0,0,0,0,0,0,0,0,0,0,0,0,0,0,0,0,0,0,0,0,0,0,0,0,0,0,0,0,0
6650,6650,Aaron Ramsdale,3339,2019,AFC Bournemouth,18,18,0,1620,0,0,19,19,0,1710,0,0,37,37,0,3330,0,0,0,0,0,0,0,0,0,0,0,0,0,0
6651,6651,Steve Cook,1002,2019,AFC Bournemouth,14,13,1,1210,1,0,15,15,0,1279,0,0,29,28,1,2489,1,0,0,0,0,0,0,0,0,0,0,0,0,0
6652,6652,Nathan Aké,1037,2019,AFC Bournemouth,16,16,0,1335,1,0,13,13,0,1170,1,0,29,29,0,2505,2,0,0,0,0,0,1,1,0,0,0,0,0,0
6653,6653,Adam Smith,1004,2019,AFC Bournemouth,12,12,0,1031,0,0,12,12,0,1029,0,0,24,24,0,2060,0,0,0,0,0,0,0,0,0,0,0,0,0,0
6654,6654,Jack Stacey,3340,2019,AFC Bournemouth,9,8,1,746,0,0,10,9,1,804,0,0,19,17,2,1550,0,0,0,0,0,0,0,0,0,0,0,0,0,0
6655,6655,Jefferson Lerma,2741,2019,AFC Bournemouth,18,16,2,1443,1,0,15,15,0,1304,0,0,33,31,2,2747,1,0,0,0,0,1,0,1,0,0,0,0,0,0
6656,6656,Lewis Cook,1038,2019,AFC Bournemouth,15,7,8,693,0,0,12,7,5,652,0,0,27,14,13,1345,0,0,0,0,0,0,0,0,0,0,0,0,0,0
6657,6657,David Brooks,2740,2019,AFC Bournemouth,5,5,0,316,0,0,4,3,1,197,1,0,9,8,1,513,1,0,0,0,0,0,0,0,0,0,0,0,0,0
6658,6658,Joshua King,1040,2019,AFC Bournemouth,13,12,1,1000,3,0,13,12,1,1020,3,0,26,24,2,2020,6,0,3,0,3,3,2,5,0,3,3,0,0,0
6659,6659,Callum Wilson,1039,2019,AFC Bournemouth,18,17,1,1527,4,0,17,15,2,1383,4,0,35,32,3,2910,8,0,0,0,0,2,3,5,0,0,0,0,0,0
6660,6660,Harry Wilson,3341,2019,AFC Bournemouth,14,9,5,808,2,0,17,11,6,845,5,0,31,20,11,1653,7,0,0,0,0,1,1,2,0,0,0,0,0,0
6661,6661,Dominic Solanke,1194,2019,AFC Bournemouth,13,8,5,774,2,0,19,9,10,869,1,0,32,17,15,1643,3,0,0,0,0,1,1,2,0,0,0,0,0,0
6662,6662,Arnaut Danjuma,3342,2019,AFC Bournemouth,7,3,4,320,0,0,7,3,4,306,0,0,14,6,8,626,0,0,0,0,0,0,0,0,0,0,0,0,0,0
6663,6663,Junior Stanislas,1009,2019,AFC Bournemouth,6,2,4,283,1,0,9,5,4,427,2,0,15,7,8,710,3,0,0,0,0,1,1,2,1,0,1,0,0,0
6664,6664,Artur Boruc,1000,2019,AFC Bournemouth,0,0,0,0,0,0,0,0,0,0,0,0,0,0,0,0,0,0,0,0,0,0,0,0,0,0,0,0,0,0
6665,6665,Diego Rico,3155,2019,AFC Bournemouth,13,13,0,1170,0,0,14,14,0,1166,0,0,27,27,0,2336,0,0,0,0,0,0,0,0,0,0,0,0,0,0
6666,6666,Lloyd Kelly,3343,2019,AFC Bournemouth,4,4,0,360,0,0,4,3,1,278,0,0,8,7,1,638,0,0,0,0,0,0,0,0,0,0,0,0,0,0
6667,6667,Chris Mepham,3156,2019,AFC Bournemouth,7,5,2,461,1,0,5,5,0,450,0,0,12,10,2,911,1,0,0,0,0,1,0,1,0,0,0,0,0,0
6668,6668,Dan Gosling,1005,2019,AFC Bournemouth,12,6,6,517,2,0,12,8,4,744,1,0,24,14,10,1261,3,0,0,3,3,1,1,2,0,0,0,0,0,0
6669,6669,Andrew Surman,1006,2019,AFC Bournemouth,0,0,0,0,0,0,5,2,3,235,0,0,5,2,3,235,0,0,0,0,0,0,0,0,0,0,0,0,0,0
6670,6670,Mathieu Debuchy,2453,2014,Arsenal FC,5,5,0,364,0,0,5,5,0,444,1,0,10,10,0,808,1,0,0,0,0,0,1,1,0,0,0,0,0,0
6671,6671,Alex Oxlade-Chamberlain,1184,2014,Arsenal FC,11,8,3,691,1,0,12,9,3,803,0,0,23,17,6,1494,1,0,1,0,1,1,0,1,0,0,0,0,0,0
6672,6672,Joel Campbell,1593,2014,Arsenal FC,1,0,1,21,0,0,3,0,3,18,0,0,4,0,4,39,0,0,0,0,0,0,0,0,0,0,0,0,0,0
6673,6673,Philipp Wollscheid,1582,2014,Stoke City,6,6,0,467,0,0,6,6,0,540,0,0,12,12,0,1007,0,0,0,0,0,0,0,0,0,0,0,0,0,0
6674,6674,Glenn Whelan,1549,2014,Stoke City,13,12,1,1072,0,0,15,14,1,1236,0,0,28,26,2,2308,0,0,0,0,0,0,0,0,0,0,0,0,0,0
6675,6675,Paul Robinson,1262,2005,Tottenham Hotspur,19,19,0,1710,0,0,18,18,0,1620,0,0,37,37,0,3330,0,0,0,0,0,0,0,0,0,0,0,0,0,0
6676,6676,Young-Pyo Lee,1393,2005,Tottenham Hotspur,16,16,0,1440,0,0,14,14,0,1204,0,0,30,30,0,2644,0,0,0,0,0,0,0,0,0,0,0,0,0,0
6677,6677,Michael Dawson,1267,2005,Tottenham Hotspur,15,15,0,1350,0,0,16,15,1,1358,0,0,31,30,1,2708,0,0,0,0,0,0,0,0,0,0,0,0,0,0
6678,6678,Ledley King,1119,2005,Tottenham Hotspur,14,14,0,1237,2,0,11,11,0,990,1,0,25,25,0,2227,3,0,0,0,0,2,0,2,0,0,0,0,0,0
6679,6679,Edgar Davids,3344,2005,Tottenham Hotspur,16,15,1,1265,0,0,14,12,2,1077,1,0,30,27,3,2342,1,0,0,0,0,0,0,0,0,0,0,0,0,0
6680,6680,Teemu Tainio,1395,2005,Tottenham Hotspur,13,12,1,854,1,0,10,9,1,816,0,0,23,21,2,1670,1,0,0,0,0,1,0,1,0,0,0,0,0,0
6681,6681,Paul Stalteri,2955,2005,Tottenham Hotspur,17,17,0,1530,1,0,15,15,0,1350,0,0,32,32,0,2880,1,0,0,0,0,1,0,1,0,0,0,0,0,0
6682,6682,Michael Carrick,1627,2005,Tottenham Hotspur,18,18,0,1620,2,0,16,16,0,1413,0,0,34,34,0,3033,2,0,3,0,3,1,0,1,0,0,0,0,0,0
6683,6683,Robbie Keane,1126,2005,Tottenham Hotspur,18,12,6,1032,6,0,17,12,5,1178,10,0,35,24,11,2210,16,0,3,7,10,5,8,13,2,1,3,0,0,0
6684,6684,Mido,2636,2005,Tottenham Hotspur,14,13,1,1200,8,0,12,10,2,885,3,0,26,23,3,2085,11,0,3,1,4,6,3,9,1,0,1,0,0,0
6685,6685,Andy Reid,1220,2005,Tottenham Hotspur,7,2,5,253,0,0,6,5,1,356,0,0,13,7,6,609,0,0,0,0,0,0,0,0,0,0,0,0,0,0
6686,6686,Jermain Defoe,1127,2005,Tottenham Hotspur,18,12,6,1105,7,0,18,11,7,1103,2,0,36,23,13,2208,9,0,4,0,4,4,1,5,0,0,0,0,0,0
6687,6687,Jamie Ashdown,3122,2005,Portsmouth FC,8,8,0,720,0,0,9,9,0,810,0,0,17,17,0,1530,0,0,0,0,0,0,0,0,0,0,0,0,0,0
6688,6688,Steven Reid,1140,2014,Burnley FC,3,0,3,4,0,0,4,1,3,106,0,0,7,1,6,110,0,0,0,0,0,0,0,0,0,0,0,0,0,0
6689,6689,Tom Carroll,2816,2014,Swansea City,7,3,4,338,0,0,6,5,1,354,0,0,13,8,5,692,0,0,0,0,0,0,0,0,0,0,0,0,0,0
6690,6690,Wayne Routledge,1758,2014,Swansea City,15,14,1,1168,3,0,14,13,1,1153,0,0,29,27,2,2321,3,0,0,0,0,1,0,1,0,0,0,0,0,0
6691,6691,Jordi Amat,2934,2014,Swansea City,4,3,1,271,0,0,6,4,2,318,0,0,10,7,3,589,0,0,0,0,0,0,0,0,0,0,0,0,0,0
6692,6692,Nélson Oliveira,3345,2014,Swansea City,4,2,2,134,0,0,6,2,4,255,1,0,10,4,6,389,1,0,0,0,0,0,1,1,0,0,0,0,0,0
6693,6693,Willy Boly,2143,2019,Wolverhampton Wanderers,11,11,0,990,0,0,11,11,0,990,0,0,22,22,0,1980,0,0,0,0,0,0,0,0,0,0,0,0,0,0
6694,6694,Daniel Podence,3346,2019,Wolverhampton Wanderers,5,2,3,172,1,0,4,1,3,116,0,0,9,3,6,288,1,0,0,0,0,1,0,1,0,0,0,0,0,0
6695,6695,Oskar Buur,3347,2019,Wolverhampton Wanderers,0,0,0,0,0,0,0,0,0,0,0,0,0,0,0,0,0,0,0,0,0,0,0,0,0,0,0,0,0,0
6696,6696,Bruno Jordão,3348,2019,Wolverhampton Wanderers,0,0,0,0,0,0,1,0,1,6,0,0,1,0,1,6,0,0,0,0,0,0,0,0,0,0,0,0,0,0
6697,6697,Júlio César,2539,2004,Bolton Wanderers,2,2,0,180,0,0,3,2,1,181,0,0,5,4,1,361,0,0,0,0,0,0,0,0,0,0,0,0,0,0
6698,6698,Mark Fish,1671,2004,Charlton Athletic,5,4,1,329,0,0,2,2,0,180,0,0,7,6,1,509,0,0,0,0,0,0,0,0,0,0,0,0,0,0
6699,6699,David Stockdale,2558,2013,Fulham FC,12,11,1,1004,0,0,9,8,1,734,0,0,21,19,2,1738,0,0,0,0,0,0,0,0,0,0,0,0,0,0
6700,6700,John Arne Riise,2362,2013,Fulham FC,9,9,0,766,0,0,11,8,3,722,0,0,20,17,3,1488,0,0,0,0,0,0,0,0,0,0,0,0,0,0
6701,6701,Brede Hangeland,1033,2013,Fulham FC,11,11,0,871,0,0,12,12,0,1036,0,0,23,23,0,1907,0,0,0,0,0,0,0,0,0,0,0,0,0,0
6702,6702,Sascha Riether,2554,2013,Fulham FC,17,16,1,1449,0,0,14,14,0,1198,0,0,31,30,1,2647,0,0,0,0,0,0,0,0,0,0,0,0,0,0
6703,6703,Fernando Amorebieta,3349,2013,Fulham FC,12,10,2,976,1,0,11,10,1,906,0,0,23,20,3,1882,1,0,0,0,0,0,0,0,0,0,0,0,0,0
6704,6704,Steven Sidwell,1622,2013,Fulham FC,19,17,2,1537,4,0,19,19,0,1696,3,0,38,36,2,3233,7,0,0,0,0,3,3,6,0,0,0,0,0,0
6705,6705,Mahamadou Diarra,3350,2013,Fulham FC,2,2,0,174,0,0,2,2,0,163,0,0,4,4,0,337,0,0,0,0,0,0,0,0,0,0,0,0,0,0
6706,6706,Lewis Holtby,2815,2013,Fulham FC,7,6,1,493,0,0,6,5,1,429,1,0,13,11,2,922,1,0,0,0,0,0,1,1,0,0,0,0,0,0
6707,6707,Scott Parker,1282,2013,Fulham FC,15,14,1,1158,1,0,14,13,1,1161,1,0,29,27,2,2319,2,0,0,3,3,1,1,2,0,0,0,0,0,0
6708,6708,Hugo Rodallega,2061,2013,Fulham FC,4,3,1,283,1,0,9,3,6,339,1,0,13,6,7,622,2,0,3,3,6,1,1,2,0,0,0,0,0,0
6709,6709,Kieran Richardson,1898,2013,Fulham FC,15,13,2,1145,2,0,16,15,1,1233,2,0,31,28,3,2378,4,0,0,0,0,1,1,2,0,0,0,0,0,0
6710,6710,Ashkan Dejagah,3351,2013,Fulham FC,11,5,6,589,4,0,11,8,3,712,1,0,22,13,9,1301,5,0,3,0,3,4,1,5,0,0,0,0,0,0
6711,6711,Darren Bent,1958,2013,Fulham FC,12,5,7,584,2,0,12,6,6,656,1,0,24,11,13,1240,3,0,3,1,4,1,1,2,0,0,0,0,0,0
6712,6712,Maarten Stekelenburg,1465,2013,Fulham FC,8,8,0,706,0,0,11,11,0,976,0,0,19,19,0,1682,0,0,0,0,0,0,0,0,0,0,0,0,0,0
6713,6713,Pajtim Kasami,2557,2013,Fulham FC,16,11,5,998,0,0,13,9,4,808,3,0,29,20,9,1806,3,0,0,3,3,0,3,3,0,0,0,0,0,0
6714,6714,Patrick Roberts,3352,2013,Fulham FC,1,0,1,9,0,0,1,0,1,35,0,0,2,0,2,44,0,0,0,0,0,0,0,0,0,0,0,0,0,0
6715,6715,Cauley Woodrow,3353,2013,Fulham FC,3,2,1,206,1,0,3,3,0,205,0,0,6,5,1,411,1,0,0,0,0,1,0,1,0,0,0,0,0,0
6716,6716,Sone Aluko,2233,2013,Hull City,10,6,4,568,0,0,7,4,3,368,1,0,17,10,7,936,1,0,0,3,3,0,1,1,0,0,0,0,0,0
6717,6717,Eldin Jakupović,2563,2013,Hull City,0,0,0,0,0,0,1,1,0,90,0,0,1,1,0,90,0,0,0,0,0,0,0,0,0,0,0,0,0,0
6718,6718,Stephen Quinn,3177,2013,Hull City,6,2,4,222,0,0,9,2,7,282,0,0,15,4,11,504,0,0,0,0,0,0,0,0,0,0,0,0,0,0
6719,6719,Kevin Lisbie,2337,2001,Charlton Athletic,13,5,8,588,3,0,8,4,4,448,2,0,21,9,12,1036,5,0,1,6,7,1,2,3,0,0,0,0,0,0
6720,6720,Andy Oakes,3354,2001,Derby County,9,9,0,810,0,0,9,9,0,752,0,0,18,18,0,1562,0,0,0,0,0,0,0,0,0,0,0,0,0,0
6721,6721,Youl Mawéné,3355,2001,Derby County,7,7,0,616,1,0,8,8,0,676,0,0,15,15,0,1292,1,0,3,0,3,1,0,1,0,0,0,0,0,0
6722,6722,Danny Higginbotham,1990,2001,Derby County,18,18,0,1620,0,0,16,16,0,1440,1,0,34,34,0,3060,1,0,0,0,0,0,0,0,0,1,1,0,0,0
6723,6723,Chris Riggott,1330,2001,Derby County,18,18,0,1620,0,0,16,16,0,1411,0,0,34,34,0,3031,0,0,0,0,0,0,0,0,0,0,0,0,0,0
6724,6724,Pierre Ducrocq,3356,2001,Derby County,9,9,0,752,0,0,9,9,0,724,0,0,18,18,0,1476,0,0,0,0,0,0,0,0,0,0,0,0,0,0
6725,6725,Richard Jackson,3357,2001,Derby County,4,4,0,336,0,0,2,1,1,107,0,0,6,5,1,443,0,0,0,0,0,0,0,0,0,0,0,0,0,0
6726,6726,Paul Boertien,3358,2001,Derby County,15,10,5,999,0,0,15,11,4,1010,0,0,30,21,9,2009,0,0,0,0,0,0,0,0,0,0,0,0,0,0
6727,6727,Simo Valakari,3359,2001,Derby County,4,3,1,268,0,0,5,3,2,313,0,0,9,6,3,581,0,0,0,0,0,0,0,0,0,0,0,0,0,0
6728,6728,Darryl Powell,2621,2001,Derby County,11,11,0,954,0,0,10,10,0,822,1,0,21,21,0,1776,1,0,0,0,0,0,1,1,0,0,0,0,0,0
6729,6729,Malcolm Christie,2137,2001,Derby County,17,12,5,1077,7,0,15,12,3,1051,2,0,32,24,8,2128,9,0,4,3,7,4,2,6,0,0,0,0,0,0
6730,6730,Fabrizio Ravanelli,3360,2001,Derby County,17,16,1,1405,5,0,12,12,0,1045,4,0,29,28,1,2450,9,0,0,0,0,5,2,7,1,0,1,0,0,0
6731,6731,Giorgi Kinkladze,3361,2001,Derby County,11,7,4,709,0,0,11,5,6,589,1,0,22,12,10,1298,1,0,0,0,0,0,1,1,0,0,0,0,0,0
6732,6732,Elliot Embleton,3362,2016,Sunderland AFC,0,0,0,0,0,0,0,0,0,0,0,0,0,0,0,0,0,0,0,0,0,0,0,0,0,0,0,0,0,0
6733,6733,Joel Asoro,3363,2016,Sunderland AFC,1,0,1,9,0,0,0,0,0,0,0,0,1,0,1,9,0,0,0,0,0,0,0,0,0,0,0,0,0,0
6734,6734,Josh Maja,3364,2016,Sunderland AFC,0,0,0,0,0,0,0,0,0,0,0,0,0,0,0,0,0,0,0,0,0,0,0,0,0,0,0,0,0,0
6735,6735,Lee Grant,1908,2016,Stoke City,15,15,0,1350,0,0,13,13,0,1170,0,0,28,28,0,2520,0,0,0,0,0,0,0,0,0,0,0,0,0,0
6736,6736,Glen Johnson,1386,2016,Stoke City,13,11,2,1055,0,0,10,10,0,900,0,0,23,21,2,1955,0,0,0,0,0,0,0,0,0,0,0,0,0,0
6737,6737,Bruno Martins Indi,3322,2016,Stoke City,18,18,0,1617,0,0,17,17,0,1530,1,0,35,35,0,3147,1,0,0,0,0,0,1,1,0,0,0,0,0,0
6738,6738,Xherdan Shaqiri,1904,2016,Stoke City,11,11,0,843,1,0,10,10,0,866,3,0,21,21,0,1709,4,0,0,1,1,0,2,2,0,0,0,0,0,0
6739,6739,Ibrahim Afellay,1907,2016,Stoke City,5,1,4,153,0,0,7,2,5,224,0,0,12,3,9,377,0,0,0,0,0,0,0,0,0,0,0,0,0,0
6740,6740,Julien N'Goy,3365,2016,Stoke City,2,0,2,18,0,0,3,0,3,26,0,0,5,0,5,44,0,0,0,0,0,0,0,0,0,0,0,0,0,0
6741,6741,Joel Taylor,3366,2016,Stoke City,0,0,0,0,0,0,0,0,0,0,0,0,0,0,0,0,0,0,0,0,0,0,0,0,0,0,0,0,0,0
6742,6742,Robbie Elliott,1945,2001,Newcastle United,13,12,1,1010,0,0,13,13,0,1049,1,0,26,25,1,2059,1,0,0,0,0,0,0,0,0,0,0,0,0,0
6743,6743,Craig Bellamy,2012,2001,Newcastle United,12,12,0,1079,5,0,14,13,1,1165,4,0,26,25,1,2244,9,0,4,0,4,3,2,5,0,0,0,0,0,0
6744,6744,Mark Delaney,3269,2004,Aston Villa,13,13,0,1170,0,0,16,16,0,1284,0,0,29,29,0,2454,0,0,0,0,0,0,0,0,0,0,0,0,0,0
6745,6745,Martin Laursen,2124,2004,Aston Villa,5,5,0,450,1,0,7,7,0,585,0,0,12,12,0,1035,1,0,0,0,0,1,0,1,0,0,0,0,0,0
6746,6746,Gavin McCann,1096,2004,Aston Villa,9,9,0,789,0,0,10,10,0,886,1,0,19,19,0,1675,1,0,0,0,0,0,1,1,0,0,0,0,0,0
6747,6747,Carlton Cole,2326,2004,Aston Villa,12,8,4,643,2,0,14,9,5,780,1,0,26,17,9,1423,3,0,0,0,0,1,0,1,0,0,0,0,0,0
6748,6748,Peter Whittingham,2969,2004,Aston Villa,6,2,4,269,1,0,7,3,4,314,0,0,13,5,8,583,1,0,0,0,0,1,0,1,0,0,0,0,0,0
6749,6749,Antti Niemi,1559,2004,Southampton FC,12,12,0,1080,0,0,15,15,0,1266,0,0,27,27,0,2346,0,0,0,0,0,0,0,0,0,0,0,0,0,0
6750,6750,Jason Dodd,2046,2004,Southampton FC,2,1,1,142,0,0,2,2,0,144,0,0,4,3,1,286,0,0,0,0,0,0,0,0,0,0,0,0,0,0
6751,6751,Graeme Le Saux,2615,2004,Southampton FC,12,11,1,889,1,0,9,9,0,684,0,0,21,20,1,1573,1,0,0,0,0,1,0,1,0,0,0,0,0,0
6752,6752,Claus Lundekvam,2047,2004,Southampton FC,16,15,1,1394,0,0,14,14,0,1260,0,0,30,29,1,2654,0,0,0,0,0,0,0,0,0,0,0,0,0,0
6753,6753,Danny Higginbotham,1990,2004,Southampton FC,8,8,0,720,0,0,12,11,1,997,1,0,20,19,1,1717,1,0,0,1,1,0,1,1,0,0,0,0,0,0
6754,6754,Mikael Nilsson,3367,2004,Southampton FC,7,6,1,534,0,0,8,6,2,477,0,0,15,12,3,1011,0,0,0,0,0,0,0,0,0,0,0,0,0,0
6755,6755,David Prutton,2915,2004,Southampton FC,9,6,3,557,1,0,11,10,1,905,0,0,20,16,4,1462,1,0,0,0,0,1,0,1,0,0,0,0,0,0
6756,6756,Fabrice Fernandes,2695,2004,Southampton FC,8,8,0,596,0,0,6,4,2,334,0,0,14,12,2,930,0,0,0,0,0,0,0,0,0,0,0,0,0,0
6757,6757,Yoann Folly,3368,2004,Southampton FC,0,0,0,0,0,0,3,1,2,149,0,0,3,1,2,149,0,0,0,0,0,0,0,0,0,0,0,0,0,0
6758,6758,Kevin Phillips,1100,2004,Southampton FC,14,10,4,950,8,0,14,10,4,1015,2,0,28,20,8,1965,10,0,3,1,4,7,1,8,0,1,1,0,0,0
6759,6759,Brett Ormerod,2607,2004,Southampton FC,4,1,3,159,0,0,5,4,1,281,0,0,9,5,4,440,0,0,0,0,0,0,0,0,0,0,0,0,0,0
6760,6760,Anders Svensson,2053,2004,Southampton FC,14,11,3,1022,4,0,14,8,6,815,0,0,28,19,9,1837,4,0,1,0,1,4,0,4,0,0,0,0,0,0
6761,6761,Rory Delap,1993,2004,Southampton FC,17,16,1,1354,0,0,16,14,2,1314,2,0,33,30,3,2668,2,0,0,0,0,0,2,2,0,0,0,0,0,0
6762,6762,Peter Crouch,1273,2004,Southampton FC,13,9,4,903,7,0,11,7,4,725,5,0,24,16,8,1628,12,0,1,0,1,3,2,5,0,0,0,0,0,0
6763,6763,DeAndre Yedlin,1175,2019,Newcastle United,9,6,3,516,1,0,7,4,3,420,0,0,16,10,6,936,1,0,0,0,0,1,0,1,0,0,0,0,0,0
6764,6764,Joe Cole,1630,2008,Chelsea FC,8,8,0,590,2,0,6,6,0,384,0,0,14,14,0,974,2,0,0,0,0,2,0,2,0,0,0,0,0,0
6765,6765,Owen Hargreaves,3313,2008,Manchester United,0,0,0,0,0,0,2,1,1,114,0,0,2,1,1,114,0,0,0,0,0,0,0,0,0,0,0,0,0,0
6766,6766,Tomasz Kuszczak,1786,2008,Manchester United,2,2,0,180,0,0,2,1,1,148,0,0,4,3,1,328,0,0,0,0,0,0,0,0,0,0,0,0,0,0
6767,6767,Agustín Delgado,3369,2002,Southampton FC,3,1,2,104,1,0,3,1,2,81,0,0,6,2,4,185,1,0,0,0,0,0,0,0,0,0,0,0,0,0
6768,6768,Mart Poom,3370,2000,Derby County,15,15,0,1350,0,0,14,13,1,1250,0,0,29,28,1,2600,0,0,0,0,0,0,0,0,0,0,0,0,0,0
6769,6769,Taribo West,3371,2000,Derby County,11,11,0,990,0,0,5,5,0,450,0,0,16,16,0,1440,0,0,0,0,0,0,0,0,0,0,0,0,0,0
6770,6770,Horacio Carbonari,3372,2000,Derby County,14,14,0,1229,1,0,11,11,0,945,0,0,25,25,0,2174,1,0,0,0,0,1,0,1,0,0,0,0,0,0
6771,6771,Chris Riggott,1330,2000,Derby County,15,14,1,1184,0,0,13,13,0,1170,3,0,28,27,1,2354,3,0,0,0,0,0,1,1,0,0,0,0,0,0
6772,6772,Paul Boertien,3358,2000,Derby County,6,5,1,470,1,0,2,2,0,180,0,0,8,7,1,650,1,0,0,0,0,1,0,1,0,0,0,0,0,0
6773,6773,Giorgi Kinkladze,3361,2000,Derby County,13,7,6,759,1,0,8,4,4,439,0,0,21,11,10,1198,1,0,1,0,1,1,0,1,0,0,0,0,0,0
6774,6774,Darryl Powell,2621,2000,Derby County,14,14,0,1099,1,0,13,13,0,1137,0,0,27,27,0,2236,1,0,0,0,0,1,0,1,0,0,0,0,0,0
6775,6775,Seth Johnson,2292,2000,Derby County,16,16,0,1440,0,0,11,11,0,984,1,0,27,27,0,2424,1,0,0,0,0,0,0,0,0,0,0,0,0,0
6776,6776,Rory Delap,1993,2000,Derby County,18,18,0,1580,1,0,13,12,1,1124,2,0,31,30,1,2704,3,0,0,3,3,0,2,2,0,0,0,0,0,0
6777,6777,Stefano Eranio,3373,2000,Derby County,14,13,1,1045,2,0,11,9,2,641,0,0,25,22,3,1686,2,0,0,0,0,1,0,1,0,0,0,0,0,0
6778,6778,Deon Burton,3374,2000,Derby County,15,10,5,1025,4,0,14,12,2,1095,1,0,29,22,7,2120,5,0,7,0,7,3,1,4,1,0,1,0,0,0
6779,6779,Youl Mawéné,3355,2000,Derby County,3,2,1,181,0,0,4,4,0,307,0,0,7,6,1,488,0,0,0,0,0,0,0,0,0,0,0,0,0,0
6780,6780,Þórður Guðjónsson,3375,2000,Derby County,5,1,4,163,0,0,4,1,3,95,1,0,9,2,7,258,1,0,0,0,0,0,0,0,0,0,0,0,0,0
6781,6781,Malcolm Christie,2137,2000,Derby County,17,15,2,1293,6,0,14,12,2,985,2,0,31,27,4,2278,8,0,4,3,7,5,1,6,0,0,0,0,0,0
6782,6782,Roy Carroll,1939,2004,Manchester United,13,13,0,1170,0,0,12,12,0,1080,0,0,25,25,0,2250,0,0,0,0,0,0,0,0,0,0,0,0,0,0
6783,6783,Gary Neville,1105,2004,Manchester United,12,12,0,1019,0,0,9,9,0,800,0,0,21,21,0,1819,0,0,0,0,0,0,0,0,0,0,0,0,0,0
6784,6784,Phil Neville,1114,2004,Manchester United,9,5,4,463,0,0,10,7,3,606,0,0,19,12,7,1069,0,0,0,0,0,0,0,0,0,0,0,0,0,0
6785,6785,Gabriel Heinze,1728,2004,Manchester United,12,12,0,1027,0,0,13,13,0,1170,1,0,25,25,0,2197,1,0,0,0,0,0,1,1,0,0,0,0,0,0
6786,6786,Rio Ferdinand,1294,2004,Manchester United,16,16,0,1440,0,0,14,14,0,1260,0,0,30,30,0,2700,0,0,0,0,0,0,0,0,0,0,0,0,0,0
6787,6787,Mikaël Silvestre,1106,2004,Manchester United,18,17,1,1544,2,0,16,15,1,1335,0,0,34,32,2,2879,2,0,3,0,3,2,0,2,0,0,0,0,0,0
6788,6788,Ryan Giggs,1110,2004,Manchester United,17,13,4,1137,3,0,14,12,2,1094,3,0,31,25,6,2231,6,0,0,3,3,3,2,5,0,0,0,0,0,0
6789,6789,Paul Scholes,1112,2004,Manchester United,16,14,2,1244,6,0,16,14,2,1276,3,0,32,28,4,2520,9,0,0,0,0,2,2,4,0,0,0,0,0,0
6790,6790,Cristiano Ronaldo,1726,2004,Manchester United,17,15,2,1368,3,0,15,9,6,967,2,0,32,24,8,2335,5,0,3,0,3,2,2,4,0,0,0,0,0,0
6791,6791,Wayne Rooney,1058,2004,Manchester United,15,13,2,1168,6,0,13,10,3,927,5,0,28,23,5,2095,11,0,3,3,6,3,3,6,0,0,0,0,0,0
6792,6792,Ruud van Nistelrooy,1453,2004,Manchester United,8,8,0,660,2,0,9,8,1,709,4,0,17,16,1,1369,6,0,0,6,6,2,3,5,1,2,3,0,0,0
6793,6793,Louis Saha,1727,2004,Manchester United,7,4,3,380,1,0,7,3,4,290,0,0,14,7,7,670,1,0,0,0,0,1,0,1,0,0,0,0,0,0
6794,6794,Alan Smith,1300,2004,Manchester United,16,9,7,888,3,0,14,12,2,1060,3,0,30,21,9,1948,6,0,1,1,2,2,2,4,0,0,0,0,0,0
6795,6795,Thierry Henry,2357,2004,Arsenal FC,17,16,1,1475,21,0,15,15,0,1350,4,0,32,31,1,2825,25,0,0,0,0,10,2,12,0,0,0,0,0,0
6796,6796,Jussi Jääskeläinen,1710,2002,Bolton Wanderers,19,19,0,1710,0,0,19,19,0,1710,0,0,38,38,0,3420,0,0,0,0,0,0,0,0,0,0,0,0,0,0
6797,6797,Bernard Mendy,2612,2002,Bolton Wanderers,10,10,0,818,0,0,11,10,1,811,0,0,21,20,1,1629,0,0,0,0,0,0,0,0,0,0,0,0,0,0
6798,6798,Bruno N'Gotty,3076,2002,Bolton Wanderers,13,13,0,1136,1,0,10,10,0,825,0,0,23,23,0,1961,1,0,0,0,0,1,0,1,0,0,0,0,0,0
6799,6799,Iván Campo,1713,2002,Bolton Wanderers,16,15,1,1376,2,0,15,13,2,1234,0,0,31,28,3,2610,2,0,0,0,0,1,0,1,0,0,0,0,0,0
6800,6800,Anthony Barness,3068,2002,Bolton Wanderers,13,9,4,874,0,0,12,12,0,1049,0,0,25,21,4,1923,0,0,0,0,0,0,0,0,0,0,0,0,0,0
6801,6801,Per Frandsen,3070,2002,Bolton Wanderers,18,18,0,1570,2,0,16,16,0,1285,0,0,34,34,0,2855,2,0,1,0,1,2,0,2,0,0,0,0,0,0
6802,6802,Jay Jay Okocha,2865,2002,Bolton Wanderers,15,13,2,1179,5,0,16,13,3,1174,2,0,31,26,5,2353,7,0,6,0,6,4,2,6,1,0,1,0,0,0
6803,6803,Ricardo Gardner,2411,2002,Bolton Wanderers,16,15,1,1307,2,0,16,16,0,1440,0,0,32,31,1,2747,2,0,0,0,0,2,0,2,0,0,0,0,0,0
6804,6804,Youri Djorkaeff,3077,2002,Bolton Wanderers,19,19,0,1656,4,0,17,17,0,1405,3,0,36,36,0,3061,7,0,1,1,2,3,3,6,0,0,0,0,0,0
6805,6805,Gareth Farrelly,3071,2002,Bolton Wanderers,4,3,1,205,0,0,4,3,1,314,1,0,8,6,2,519,1,0,0,0,0,0,1,1,0,0,0,0,0,0
6806,6806,Dean Holdsworth,3072,2002,Bolton Wanderers,4,3,1,226,0,0,5,2,3,148,0,0,9,5,4,374,0,0,0,0,0,0,0,0,0,0,0,0,0,0
6807,6807,Kevin Nolan,2396,2002,Bolton Wanderers,15,4,11,575,0,0,18,11,7,992,1,0,33,15,18,1567,1,0,0,3,3,0,1,1,0,0,0,0,0,0
6808,6808,Simon Charlton,2388,2002,Bolton Wanderers,15,13,2,1120,0,0,16,14,2,1250,0,0,31,27,4,2370,0,0,0,0,0,0,0,0,0,0,0,0,0,0
6809,6809,Igor Bališ,3376,2002,West Bromwich Albion,14,13,1,1149,1,0,13,13,0,1084,1,0,27,26,1,2233,2,0,0,0,0,1,1,2,1,0,1,0,0,0
6810,6810,Adam Chambers,3377,2002,West Bromwich Albion,8,6,2,547,0,0,5,4,1,348,0,0,13,10,3,895,0,0,0,0,0,0,0,0,0,0,0,0,0,0
6811,6811,Andy Johnson,1322,2002,West Bromwich Albion,17,16,1,1436,1,0,14,13,1,1195,0,0,31,29,2,2631,1,0,1,0,1,1,0,1,0,0,0,0,0,0
6812,6812,Jason Roberts,1820,2002,West Bromwich Albion,16,16,0,1399,1,0,15,14,1,1243,2,0,31,30,1,2642,3,0,1,3,4,1,1,2,0,0,0,0,0,0
6813,6813,Sixto Peralta,3378,2001,Ipswich Town,11,8,3,779,1,0,11,8,3,696,2,0,22,16,6,1475,3,0,0,0,0,0,1,1,0,0,0,0,0,0
6814,6814,Christian Atsu,2244,2017,Newcastle United,15,10,5,952,1,0,13,9,4,830,1,0,28,19,9,1782,2,0,0,0,0,1,0,1,0,0,0,0,0,0
6815,6815,Jonatan Johansson,1676,2005,Charlton Athletic,3,1,2,94,0,0,1,0,1,7,0,0,4,1,3,101,0,0,0,0,0,0,0,0,0,0,0,0,0,0
6816,6816,Fabien Barthez,1104,2002,Manchester United,14,14,0,1154,0,0,12,12,0,1027,0,0,26,26,0,2181,0,0,0,0,0,0,0,0,0,0,0,0,0,0
6817,6817,Phil Neville,1114,2002,Manchester United,13,10,3,820,1,0,11,8,3,757,0,0,24,18,6,1577,1,0,0,0,0,1,0,1,0,0,0,0,0,0
6818,6818,Laurent Blanc,1451,2002,Manchester United,8,7,1,626,0,0,10,7,3,706,0,0,18,14,4,1332,0,0,0,0,0,0,0,0,0,0,0,0,0,0
6819,6819,Mikaël Silvestre,1106,2002,Manchester United,17,17,0,1465,1,0,14,14,0,1186,0,0,31,31,0,2651,1,0,3,0,3,1,0,1,0,0,0,0,0,0
6820,6820,Rio Ferdinand,1294,2002,Manchester United,13,13,0,1170,0,0,13,12,1,1087,0,0,26,25,1,2257,0,0,0,0,0,0,0,0,0,0,0,0,0,0
6821,6821,Juan Sebastián Verón,1452,2002,Manchester United,15,12,3,984,2,0,8,7,1,598,0,0,23,19,4,1582,2,0,0,0,0,1,0,1,0,0,0,0,0,0
6822,6822,David Beckham,1109,2002,Manchester United,16,14,2,1328,3,0,13,11,2,1007,3,0,29,25,4,2335,6,0,0,3,3,2,3,5,0,0,0,0,0,0
6823,6823,Nicky Butt,1115,2002,Manchester United,10,7,3,626,0,0,6,5,1,412,0,0,16,12,4,1038,0,0,0,0,0,0,0,0,0,0,0,0,0,0
6824,6824,Ryan Giggs,1110,2002,Manchester United,16,12,4,1156,1,0,16,16,0,1336,7,0,32,28,4,2492,8,0,0,2,2,0,4,4,0,0,0,0,0,0
6825,6825,Paul Scholes,1112,2002,Manchester United,15,14,1,1204,8,0,14,13,1,1177,6,0,29,27,2,2381,14,0,3,0,3,5,4,9,0,0,0,0,0,0
6826,6826,Ruud van Nistelrooy,1453,2002,Manchester United,14,14,0,1191,16,0,16,15,1,1352,9,0,30,29,1,2543,25,0,6,6,12,8,6,14,5,1,6,0,0,0
6827,6827,John O'Shea,1729,2002,Manchester United,12,9,3,794,0,0,16,13,3,1133,0,0,28,22,6,1927,0,0,0,0,0,0,0,0,0,0,0,0,0,0
6828,6828,Ole Gunnar Solskjær,1116,2002,Manchester United,16,10,6,922,4,0,17,15,2,1318,5,0,33,25,8,2240,9,0,3,2,5,2,4,6,0,0,0,0,0,0
6829,6829,Diego Forlán,2783,2002,Manchester United,13,4,9,467,4,0,12,3,9,366,2,0,25,7,18,833,6,0,7,0,7,4,1,5,0,0,0,0,0,0
6830,6830,Franck Queudrue,1329,2002,Middlesbrough FC,16,15,1,1395,1,0,13,12,1,1071,0,0,29,27,2,2466,1,0,3,0,3,1,0,1,0,0,0,0,0,0
6831,6831,Joseph-Désiré Job,2071,2002,Middlesbrough FC,13,10,3,823,3,0,13,12,1,1015,1,0,26,22,4,1838,4,0,3,0,3,2,0,2,0,0,0,0,0,0
6832,6832,Dion Henry,3379,2017,Crystal Palace,0,0,0,0,0,0,0,0,0,0,0,0,0,0,0,0,0,0,0,0,0,0,0,0,0,0,0,0,0,0
6833,6833,Thibaut Courtois,2730,2017,Chelsea FC,17,17,0,1530,0,0,18,18,0,1620,0,0,35,35,0,3150,0,0,0,0,0,0,0,0,0,0,0,0,0,0
6834,6834,Marcos Alonso,1846,2017,Chelsea FC,18,18,0,1591,3,0,15,15,0,1269,4,0,33,33,0,2860,7,0,4,3,7,2,3,5,0,0,0,0,0,0
6835,6835,Gary Cahill,1533,2017,Chelsea FC,16,14,2,1229,0,0,11,10,1,931,0,0,27,24,3,2160,0,0,0,0,0,0,0,0,0,0,0,0,0,0
6836,6836,Azpilicueta,1535,2017,Chelsea FC,18,18,0,1620,2,0,19,19,0,1710,0,0,37,37,0,3330,2,0,0,0,0,2,0,2,0,0,0,0,0,0
6837,6837,David Luiz,1471,2017,Chelsea FC,4,4,0,360,1,0,6,5,1,482,0,0,10,9,1,842,1,0,0,0,0,0,0,0,0,0,0,0,0,0
6838,6838,Cesc Fàbregas,1526,2017,Chelsea FC,18,16,2,1441,1,0,14,9,5,877,1,0,32,25,7,2318,2,0,0,3,3,1,1,2,0,0,0,0,0,0
6839,6839,Tiemoué Bakayoko,3380,2017,Chelsea FC,13,8,5,801,0,0,16,16,0,1383,2,0,29,24,5,2184,2,0,0,0,0,0,2,2,0,0,0,0,0,0
6840,6840,Victor Moses,1434,2017,Chelsea FC,12,11,1,941,1,0,16,14,2,1178,2,0,28,25,3,2119,3,0,0,3,3,0,1,1,0,0,0,0,0,0
6841,6841,Eden Hazard,1541,2017,Chelsea FC,16,13,3,1125,4,0,18,15,3,1308,8,0,34,28,6,2433,12,0,0,3,3,2,5,7,1,1,2,0,0,0
6842,6842,Willian,1538,2017,Chelsea FC,18,10,8,1026,2,0,18,10,8,856,4,0,36,20,16,1882,6,0,0,1,1,1,2,3,1,0,1,0,0,0
6843,6843,Michy Batshuayi,2732,2017,Chelsea FC,6,1,5,144,2,0,6,2,4,209,0,0,12,3,9,353,2,0,0,0,0,1,0,1,0,0,0,0,0,0
6844,6844,Davide Zappacosta,3381,2017,Chelsea FC,10,6,4,486,1,0,12,6,6,608,0,0,22,12,10,1094,1,0,0,0,0,0,0,0,0,0,0,0,0,0
6845,6845,Pedro,1851,2017,Chelsea FC,14,9,5,740,2,0,17,8,9,784,2,0,31,17,14,1524,4,0,0,0,0,1,0,1,0,0,0,0,0,0
6846,6846,Charly Musonda,3382,2017,Chelsea FC,1,0,1,1,0,0,2,0,2,34,0,0,3,0,3,35,0,0,0,0,0,0,0,0,0,0,0,0,0,0
6847,6847,Willy Caballero,1588,2017,Chelsea FC,2,2,0,180,0,0,1,1,0,90,0,0,3,3,0,270,0,0,0,0,0,0,0,0,0,0,0,0,0,0
6848,6848,Antonio Rüdiger,1845,2017,Chelsea FC,16,14,2,1346,2,0,11,11,0,990,0,0,27,25,2,2336,2,0,3,0,3,2,0,2,0,0,0,0,0,0
6849,6849,Andreas Christensen,1854,2017,Chelsea FC,14,10,4,943,0,0,13,13,0,1128,0,0,27,23,4,2071,0,0,0,0,0,0,0,0,0,0,0,0,0,0
6850,6850,Kyle Scott,3383,2017,Chelsea FC,0,0,0,0,0,0,0,0,0,0,0,0,0,0,0,0,0,0,0,0,0,0,0,0,0,0,0,0,0,0
6851,6851,Uwe Rösler,3021,2001,Southampton FC,2,1,1,86,0,0,2,2,0,174,0,0,4,3,1,260,0,0,0,0,0,0,0,0,0,0,0,0,0,0
6852,6852,Francis Benali,3384,2001,Southampton FC,1,0,1,24,0,0,2,0,2,29,0,0,3,0,3,53,0,0,0,0,0,0,0,0,0,0,0,0,0,0
6853,6853,Andrey Kanchelskis,3312,2002,Southampton FC,1,0,1,34,0,0,0,0,0,0,0,0,1,0,1,34,0,0,0,0,0,0,0,0,0,0,0,0,0,0
6854,6854,Paul Gerrard,2822,2002,Everton FC,1,1,0,90,0,0,1,1,0,90,0,0,2,2,0,180,0,0,0,0,0,0,0,0,0,0,0,0,0,0
6855,6855,David Weir,1800,2002,Everton FC,15,13,2,1217,0,0,15,13,2,1237,1,0,30,26,4,2454,1,0,0,0,0,0,1,1,0,0,0,0,0,0
6856,6856,David Unsworth,2582,2002,Everton FC,16,15,1,1322,4,0,16,16,0,1364,1,0,32,31,1,2686,5,0,4,0,4,4,0,4,3,0,3,0,0,0
6857,6857,Weifeng Li,3385,2002,Everton FC,0,0,0,0,0,0,1,1,0,90,0,0,1,1,0,90,0,0,0,0,0,0,0,0,0,0,0,0,0,0
6858,6858,Tony Hibbert,1744,2002,Everton FC,11,11,0,989,0,0,12,11,1,971,0,0,23,22,1,1960,0,0,0,0,0,0,0,0,0,0,0,0,0,0
6859,6859,Niclas Alexandersson,3386,2002,Everton FC,3,1,2,80,0,0,4,3,1,231,0,0,7,4,3,311,0,0,0,0,0,0,0,0,0,0,0,0,0,0
6860,6860,Mark Pembridge,1933,2002,Everton FC,7,6,1,546,1,0,13,12,1,1020,0,0,20,18,2,1566,1,0,0,0,0,1,0,1,0,0,0,0,0,0
6861,6861,Tie Li,3387,2002,Everton FC,14,13,1,1010,0,0,14,14,0,1107,0,0,28,27,1,2117,0,0,0,0,0,0,0,0,0,0,0,0,0,0
6862,6862,Thomas Gravesen,2796,2002,Everton FC,17,15,2,1363,1,0,15,14,1,1262,0,0,32,29,3,2625,1,0,0,0,0,1,0,1,0,0,0,0,0,0
6863,6863,Tomasz Radzinski,1935,2002,Everton FC,14,11,3,1004,8,0,15,15,0,1216,3,0,29,26,3,2220,11,0,11,1,12,7,2,9,0,0,0,0,0,0
6864,6864,Kevin Campbell,1601,2002,Everton FC,18,14,4,1228,5,0,17,16,1,1416,5,0,35,30,5,2644,10,0,3,9,12,4,5,9,0,0,0,0,0,0
6865,6865,Wayne Rooney,1058,2002,Everton FC,16,9,7,947,4,0,17,5,12,648,2,0,33,14,19,1595,6,0,9,3,12,4,2,6,0,0,0,0,0,0
6866,6866,Rodrigo Beckham,3388,2002,Everton FC,2,0,2,19,0,0,2,0,2,33,0,0,4,0,4,52,0,0,0,0,0,0,0,0,0,0,0,0,0,0
6867,6867,Gomes,1266,2008,Tottenham Hotspur,17,17,0,1530,0,0,16,16,0,1440,0,0,33,33,0,2970,0,0,0,0,0,0,0,0,0,0,0,0,0,0
6868,6868,Vedran Ćorluka,1268,2008,Tottenham Hotspur,17,17,0,1514,0,0,16,15,1,1361,0,0,33,32,1,2875,0,0,0,0,0,0,0,0,0,0,0,0,0,0
6869,6869,Ledley King,1119,2008,Tottenham Hotspur,11,11,0,944,0,0,12,12,0,1080,1,0,23,23,0,2024,1,0,0,0,0,0,1,1,0,0,0,0,0,0
6870,6870,Benoît Assou-Ekotto,1269,2008,Tottenham Hotspur,16,16,0,1340,0,0,13,13,0,1152,0,0,29,29,0,2492,0,0,0,0,0,0,0,0,0,0,0,0,0,0
6871,6871,Jonathan Woodgate,1882,2008,Tottenham Hotspur,17,17,0,1406,0,0,16,16,0,1439,1,0,33,33,0,2845,1,0,0,3,3,0,1,1,0,0,0,0,0,0
6872,6872,Aaron Lennon,1052,2008,Tottenham Hotspur,17,15,2,1331,3,0,16,11,5,1131,2,0,33,26,7,2462,5,0,0,1,1,1,2,3,0,0,0,0,0,0
6873,6873,Jermaine Jenas,1275,2008,Tottenham Hotspur,14,12,2,1088,2,0,17,16,1,1408,2,0,31,28,3,2496,4,0,3,0,3,2,1,3,0,0,0,0,0,0
6874,6874,Wilson Palacios,1271,2008,Tottenham Hotspur,5,5,0,450,0,0,6,6,0,522,0,0,11,11,0,972,0,0,0,0,0,0,0,0,0,0,0,0,0,0
6875,6875,Luka Modrić,1272,2008,Tottenham Hotspur,16,16,0,1345,1,0,17,17,0,1386,2,0,33,33,0,2731,3,0,3,0,3,1,1,2,0,0,0,0,0,0
6876,6876,Roman Pavlyuchenko,2528,2008,Tottenham Hotspur,16,13,3,926,5,0,11,5,6,477,0,0,27,18,9,1403,5,0,9,0,9,4,0,4,0,0,0,0,0,0
6877,6877,Jermain Defoe,1127,2008,Tottenham Hotspur,5,3,2,310,3,0,2,2,0,160,0,0,7,5,2,470,3,0,1,0,1,2,0,2,0,0,0,0,0,0
6878,6878,Shelton Martis,3389,2008,West Bromwich Albion,5,4,1,370,0,0,2,2,0,180,0,0,7,6,1,550,0,0,0,0,0,0,0,0,0,0,0,0,0,0
6879,6879,Juan Menseguez,3390,2008,West Bromwich Albion,4,2,2,221,1,0,3,1,2,125,0,0,7,3,4,346,1,0,0,0,0,0,0,0,0,0,0,0,0,0
6880,6880,Mike Pollitt,2880,2005,Wigan Athletic,12,11,1,1035,0,0,12,12,0,1080,0,0,24,23,1,2115,0,0,0,0,0,0,0,0,0,0,0,0,0,0
6881,6881,Stéphane Henchoz,2360,2005,Wigan Athletic,13,13,0,1166,0,0,13,13,0,1125,0,0,26,26,0,2291,0,0,0,0,0,0,0,0,0,0,0,0,0,0
6882,6882,David Thompson,2102,2005,Wigan Athletic,4,3,1,228,0,0,6,4,2,400,2,0,10,7,3,628,2,0,0,0,0,0,1,1,0,0,0,0,0,0
6883,6883,Neil Mellor,3391,2005,Wigan Athletic,1,1,0,90,0,0,2,2,0,155,1,0,3,3,0,245,1,0,0,3,3,0,1,1,0,0,0,0,0,0
6884,6884,Reto Ziegler,1938,2005,Wigan Athletic,6,2,4,279,0,0,4,3,1,275,0,0,10,5,5,554,0,0,0,0,0,0,0,0,0,0,0,0,0,0
6885,6885,Richard Wright,2977,2005,Everton FC,8,8,0,720,0,0,7,6,1,549,0,0,15,14,1,1269,0,0,0,0,0,0,0,0,0,0,0,0,0,0
6886,6886,Alan Stubbs,2795,2005,Everton FC,8,7,1,657,0,0,6,6,0,540,0,0,14,13,1,1197,0,0,0,0,0,0,0,0,0,0,0,0,0,0
6887,6887,Tony Hibbert,1744,2005,Everton FC,15,15,0,1308,0,0,13,13,0,1170,0,0,28,28,0,2478,0,0,0,0,0,0,0,0,0,0,0,0,0,0
6888,6888,Mikel Arteta,1802,2005,Everton FC,17,15,2,1358,0,0,11,11,0,928,1,0,28,26,2,2286,1,0,0,0,0,0,0,0,0,0,0,0,0,0
6889,6889,Emmerson Boyce,2023,2011,Wigan Athletic,12,12,0,1061,2,0,14,14,0,1209,1,0,26,26,0,2270,3,0,0,0,0,1,1,2,0,0,0,0,0,0
6890,6890,Shaun Maloney,2738,2011,Wigan Athletic,6,5,1,413,2,0,7,3,4,358,1,0,13,8,5,771,3,0,3,0,3,1,1,2,0,1,1,0,0,0
6891,6891,Jean Beausejour,2544,2011,Wigan Athletic,8,8,0,716,0,0,8,8,0,674,0,0,16,16,0,1390,0,0,0,0,0,0,0,0,0,0,0,0,0,0
6892,6892,Callum McManaman,3001,2011,Wigan Athletic,2,0,2,19,0,0,0,0,0,0,0,0,2,0,2,19,0,0,0,0,0,0,0,0,0,0,0,0,0,0
6893,6893,Chris Kirkland,2056,2011,Wigan Athletic,0,0,0,0,0,0,0,0,0,0,0,0,0,0,0,0,0,0,0,0,0,0,0,0,0,0,0,0,0,0
6894,6894,Liam Ridgewell,1772,2011,West Bromwich Albion,7,7,0,630,1,0,6,6,0,540,0,0,13,13,0,1170,1,0,0,0,0,0,0,0,0,0,0,0,0,0
6895,6895,Keith Andrews,2656,2011,West Bromwich Albion,7,4,3,385,1,0,7,4,3,403,1,0,14,8,6,788,2,0,0,0,0,0,0,0,0,0,0,0,0,0
6896,6896,Luke Daniels,2303,2011,West Bromwich Albion,0,0,0,0,0,0,0,0,0,0,0,0,0,0,0,0,0,0,0,0,0,0,0,0,0,0,0,0,0,0
6897,6897,Gabriel Tamaş,2729,2011,West Bromwich Albion,3,2,1,213,0,0,5,5,0,450,0,0,8,7,1,663,0,0,0,0,0,0,0,0,0,0,0,0,0,0
6898,6898,Phil Jones,1650,2018,Manchester United,9,8,1,652,0,0,9,7,2,612,0,0,18,15,3,1264,0,0,0,0,0,0,0,0,0,0,0,0,0,0
6899,6899,Jesse Lingard,1646,2018,Manchester United,15,11,4,1011,1,0,12,8,4,705,3,0,27,19,8,1716,4,0,1,0,1,1,1,2,0,1,1,0,0,0
6900,6900,Ander Herrera,1644,2018,Manchester United,10,8,2,617,0,0,12,8,4,787,2,0,22,16,6,1404,2,0,0,1,1,0,1,1,0,0,0,0,0,0
6901,6901,Marouane Fellaini,2189,2018,Manchester United,6,1,5,217,0,0,8,5,3,527,0,0,14,6,8,744,0,0,0,0,0,0,0,0,0,0,0,0,0,0
6902,6902,Mata,1643,2018,Manchester United,13,10,3,833,3,0,9,6,3,461,0,0,22,16,6,1294,3,0,0,0,0,1,0,1,0,0,0,0,0,0
6903,6903,Johnnie Jackson,3392,2003,Tottenham Hotspur,7,5,2,445,0,0,4,4,0,289,1,0,11,9,2,734,1,0,0,0,0,0,0,0,0,0,0,0,0,0
6904,6904,Jérôme Boateng,3393,2010,Manchester City,8,7,1,621,0,0,8,7,1,617,0,0,16,14,2,1238,0,0,0,0,0,0,0,0,0,0,0,0,0,0
6905,6905,Kolo Touré,1415,2010,Manchester City,11,11,0,893,1,0,11,10,1,954,0,0,22,21,1,1847,1,0,0,0,0,1,0,1,0,0,0,0,0,0
6906,6906,Jô,3298,2010,Manchester City,4,0,4,72,0,0,8,3,5,269,0,0,12,3,9,341,0,0,0,0,0,0,0,0,0,0,0,0,0,0
6907,6907,Oliver Skipp,2985,2018,Tottenham Hotspur,6,2,4,191,0,0,2,0,2,25,0,0,8,2,6,216,0,0,0,0,0,0,0,0,0,0,0,0,0,0
6908,6908,Brian Murphy,2168,2018,Cardiff City,0,0,0,0,0,0,0,0,0,0,0,0,0,0,0,0,0,0,0,0,0,0,0,0,0,0,0,0,0,0
6909,6909,Jazz Richards,1703,2018,Cardiff City,2,0,2,52,0,0,2,0,2,76,0,0,4,0,4,128,0,0,0,0,0,0,0,0,0,0,0,0,0,0
6910,6910,Ronny Johnsen,2031,2000,Manchester United,6,6,0,445,1,0,5,5,0,450,0,0,11,11,0,895,1,0,0,0,0,1,0,1,0,0,0,0,0,0
6911,6911,Ronnie Wallwork,1600,2000,Manchester United,8,2,6,337,0,0,4,2,2,229,0,0,12,4,8,566,0,0,0,0,0,0,0,0,0,0,0,0,0,0
6912,6912,Shay Given,1581,2000,Newcastle United,16,16,0,1440,0,0,17,17,0,1485,0,0,33,33,0,2925,0,0,0,0,0,0,0,0,0,0,0,0,0,0
6913,6913,Alain Goma,1080,2000,Newcastle United,9,8,1,765,0,0,10,10,0,802,1,0,19,18,1,1567,1,0,0,0,0,0,0,0,0,0,0,0,0,0
6914,6914,Warren Barton,3394,2000,Newcastle United,16,14,2,1140,0,0,11,11,0,990,0,0,27,25,2,2130,0,0,0,0,0,0,0,0,0,0,0,0,0,0
6915,6915,Marcelino,3395,2000,Newcastle United,1,1,0,90,0,0,4,3,1,271,0,0,5,4,1,361,0,0,0,0,0,0,0,0,0,0,0,0,0,0
6916,6916,Aaron Hughes,1561,2000,Newcastle United,16,15,1,1354,0,0,18,18,0,1550,0,0,34,33,1,2904,0,0,0,0,0,0,0,0,0,0,0,0,0,0
6917,6917,Nikolaos Dabizas,2161,2000,Newcastle United,6,6,0,495,0,0,2,2,0,180,0,0,8,8,0,675,0,0,0,0,0,0,0,0,0,0,0,0,0,0
6918,6918,Rob Lee,3396,2000,Newcastle United,8,7,1,641,0,0,14,14,0,1105,0,0,22,21,1,1746,0,0,0,0,0,0,0,0,0,0,0,0,0,0
6919,6919,Gary Speed,1716,2000,Newcastle United,17,17,0,1530,4,0,16,16,0,1440,1,0,33,33,0,2970,5,0,0,1,1,4,1,5,0,0,0,0,0,0
6920,6920,Daniel Cordone,3397,2000,Newcastle United,8,6,2,465,2,0,12,6,6,567,0,0,20,12,8,1032,2,0,0,0,0,1,0,1,0,0,0,0,0,0
6921,6921,Alan Shearer,1948,2000,Newcastle United,10,10,0,900,2,0,9,9,0,810,3,0,19,19,0,1710,5,0,3,3,6,2,3,5,1,1,2,0,0,0
6922,6922,Carl Cort,2162,2000,Newcastle United,8,8,0,662,5,0,4,4,0,346,1,0,12,12,0,1008,6,0,3,0,3,3,0,3,0,0,0,0,0,0
6923,6923,Nolberto Solano,1791,2000,Newcastle United,16,16,0,1349,3,0,15,13,2,1188,3,0,31,29,2,2537,6,0,0,1,1,2,3,5,1,1,2,0,0,0
6924,6924,Kieron Dyer,2033,2000,Newcastle United,12,12,0,1080,3,0,13,12,1,1084,2,0,25,24,1,2164,5,0,0,0,0,0,0,0,0,1,1,0,0,0
6925,6925,Laurent Depoitre,3102,2018,Huddersfield Town,12,3,9,446,0,0,11,7,4,614,0,0,23,10,13,1060,0,0,0,0,0,0,0,0,0,0,0,0,0,0
6926,6926,Isaac Mbenza,3398,2018,Huddersfield Town,13,5,8,589,1,0,9,5,4,393,0,0,22,10,12,982,1,0,1,0,1,1,0,1,0,0,0,0,0,0
6927,6927,Tom Smith,3106,2018,Huddersfield Town,6,4,2,431,0,0,9,9,0,780,0,0,15,13,2,1211,0,0,0,0,0,0,0,0,0,0,0,0,0,0
6928,6928,Rajiv van La Parra,3100,2018,Huddersfield Town,2,2,0,168,0,0,3,3,0,239,0,0,5,5,0,407,0,0,0,0,0,0,0,0,0,0,0,0,0,0
6929,6929,Alfie Whiteman,3399,2018,Tottenham Hotspur,0,0,0,0,0,0,0,0,0,0,0,0,0,0,0,0,0,0,0,0,0,0,0,0,0,0,0,0,0,0
6930,6930,Younès Kaboul,2408,2017,Watford FC,1,1,0,90,0,0,1,1,0,62,0,0,2,2,0,152,0,0,0,0,0,0,0,0,0,0,0,0,0,0
6931,6931,Divock Origi,2086,2017,Liverpool FC,0,0,0,0,0,0,1,0,1,9,0,0,1,0,1,9,0,0,0,0,0,0,0,0,0,0,0,0,0,0
6932,6932,Marko Grujić,2754,2017,Liverpool FC,1,0,1,6,0,0,2,0,2,8,0,0,3,0,3,14,0,0,0,0,0,0,0,0,0,0,0,0,0,0
6933,6933,Julio Arca,1341,2007,Middlesbrough FC,14,13,1,1055,2,0,10,10,0,813,0,0,24,23,1,1868,2,0,1,0,1,2,0,2,0,0,0,0,0,0
6934,6934,Fábio Rochemback,1885,2007,Middlesbrough FC,14,12,2,1103,1,0,12,9,3,878,0,0,26,21,5,1981,1,0,0,0,0,0,0,0,0,0,0,0,0,0
6935,6935,Dong-gook Lee,3400,2007,Middlesbrough FC,6,2,4,215,0,0,8,3,5,334,0,0,14,5,9,549,0,0,0,0,0,0,0,0,0,0,0,0,0,0
6936,6936,Stefano Okaka,2333,2009,Fulham FC,6,1,5,191,2,0,5,2,3,252,0,0,11,3,8,443,2,0,0,0,0,1,0,1,0,0,0,0,0,0
6937,6937,Kagisho Dikgacoi,3401,2009,Fulham FC,5,1,4,148,0,0,7,6,1,488,0,0,12,7,5,636,0,0,0,0,0,0,0,0,0,0,0,0,0,0
6938,6938,David Elm,3402,2009,Fulham FC,5,2,3,179,1,0,5,1,4,149,0,0,10,3,7,328,1,0,0,0,0,0,0,0,0,0,0,0,0,0
6939,6939,Tal Ben Haim,1715,2009,Portsmouth FC,10,10,0,900,0,0,12,11,1,1014,0,0,22,21,1,1914,0,0,0,0,0,0,0,0,0,0,0,0,0,0
6940,6940,Kevin-Prince Boateng,3159,2009,Portsmouth FC,11,11,0,961,3,0,11,9,2,883,0,0,22,20,2,1844,3,0,0,0,0,2,0,2,1,0,1,0,0,0
6941,6941,Angelos Basinas,3403,2009,Portsmouth FC,6,3,3,364,0,0,6,4,2,406,0,0,12,7,5,770,0,0,0,0,0,0,0,0,0,0,0,0,0,0
6942,6942,Aruna Dindane,3404,2009,Portsmouth FC,9,9,0,757,6,0,10,9,1,719,2,0,19,18,1,1476,8,0,1,1,2,3,1,4,1,0,1,0,0,0
6943,6943,Ciaran Clark,1437,2015,Aston Villa,9,7,2,632,0,0,9,9,0,810,1,0,18,16,2,1442,1,0,0,0,0,0,1,1,0,0,0,0,0,0
6944,6944,Jordan Amavi,3405,2015,Aston Villa,5,5,0,450,0,0,5,4,1,386,0,0,10,9,1,836,0,0,0,0,0,0,0,0,0,0,0,0,0,0
6945,6945,Jordan Veretout,3406,2015,Aston Villa,13,11,2,970,0,0,12,10,2,854,0,0,25,21,4,1824,0,0,0,0,0,0,0,0,0,0,0,0,0,0
6946,6946,Gabriel Agbonlahor,1442,2015,Aston Villa,6,6,0,479,1,0,9,7,2,558,0,0,15,13,2,1037,1,0,0,0,0,0,0,0,0,0,0,0,0,0
6947,6947,Nathan Baker,1973,2015,Aston Villa,0,0,0,0,0,0,0,0,0,0,0,0,0,0,0,0,0,0,0,0,0,0,0,0,0,0,0,0,0,0
6948,6948,Alan Hutton,2172,2015,Aston Villa,14,13,1,1175,0,0,14,13,1,1160,0,0,28,26,2,2335,0,0,0,0,0,0,0,0,0,0,0,0,0,0
6949,6949,Kieran Richardson,1898,2015,Aston Villa,3,3,0,264,0,0,8,5,3,459,0,0,11,8,3,723,0,0,0,0,0,0,0,0,0,0,0,0,0,0
6950,6950,Libor Kozák,3407,2015,Aston Villa,2,2,0,180,0,0,2,1,1,78,0,0,4,3,1,258,0,0,0,0,0,0,0,0,0,0,0,0,0,0
6951,6951,Luke Shaw,2576,2015,Manchester United,3,3,0,270,0,0,2,2,0,180,0,0,5,5,0,450,0,0,0,0,0,0,0,0,0,0,0,0,0,0
6952,6952,Adnan Januzaj,2259,2015,Manchester United,3,1,2,81,0,0,2,1,1,63,1,0,5,2,3,144,1,0,0,3,3,0,1,1,0,0,0,0,0,0
6953,6953,Bastian Schweinsteiger,2803,2015,Manchester United,9,7,2,619,0,0,9,6,3,583,1,0,18,13,5,1202,1,0,0,1,1,0,1,1,0,0,0,0,0,0
6954,6954,Sam Johnstone,3408,2015,Manchester United,0,0,0,0,0,0,0,0,0,0,0,0,0,0,0,0,0,0,0,0,0,0,0,0,0,0,0,0,0,0
6955,6955,Javier Hernández,2257,2015,Manchester United,1,0,1,23,0,0,0,0,0,0,0,0,1,0,1,23,0,0,0,0,0,0,0,0,0,0,0,0,0,0
6956,6956,Scott Dann,1020,2013,Crystal Palace,7,7,0,630,0,0,7,7,0,630,1,0,14,14,0,1260,1,0,0,0,0,0,0,0,0,0,0,0,0,0
6957,6957,Kagisho Dikgacoi,3401,2013,Crystal Palace,12,12,0,891,0,0,14,13,1,1111,0,0,26,25,1,2002,0,0,0,0,0,0,0,0,0,0,0,0,0,0
6958,6958,Joe Ledley,1025,2013,Crystal Palace,7,7,0,630,1,0,7,7,0,621,1,0,14,14,0,1251,2,0,0,0,0,0,0,0,0,0,0,0,0,0
6959,6959,Jonathan Parr,3409,2013,Crystal Palace,7,2,5,290,0,0,8,5,3,462,0,0,15,7,8,752,0,0,0,0,0,0,0,0,0,0,0,0,0,0
6960,6960,Glenn Murray,1010,2013,Crystal Palace,7,2,5,231,0,0,7,1,6,163,1,0,14,3,11,394,1,0,0,1,1,0,1,1,0,1,1,0,0,0
6961,6961,Wayne Hennessey,1018,2013,Crystal Palace,0,0,0,0,0,0,1,1,0,90,0,0,1,1,0,90,0,0,0,0,0,0,0,0,0,0,0,0,0,0
6962,6962,Paddy McCarthy,3410,2013,Crystal Palace,1,0,1,26,0,0,0,0,0,0,0,0,1,0,1,26,0,0,0,0,0,0,0,0,0,0,0,0,0,0
6963,6963,Tom Ince,2232,2013,Crystal Palace,5,2,3,222,1,0,3,3,0,191,0,0,8,5,3,413,1,0,0,0,0,1,0,1,0,0,0,0,0,0
6964,6964,Hilário,2709,2013,Chelsea FC,0,0,0,0,0,0,0,0,0,0,0,0,0,0,0,0,0,0,0,0,0,0,0,0,0,0,0,0,0,0
6965,6965,Mart Poom,3370,2001,Derby County,7,7,0,630,0,0,7,7,0,630,0,0,14,14,0,1260,0,0,0,0,0,0,0,0,0,0,0,0,0,0
6966,6966,Luciano Zavagno,3411,2001,Derby County,12,12,0,984,0,0,13,13,0,1083,0,0,25,25,0,2067,0,0,0,0,0,0,0,0,0,0,0,0,0,0
6967,6967,Craig Burley,3412,2001,Derby County,6,6,0,540,0,0,5,5,0,450,0,0,11,11,0,990,0,0,0,0,0,0,0,0,0,0,0,0,0,0
6968,6968,Deon Burton,3374,2001,Derby County,10,4,6,427,1,0,6,4,2,403,0,0,16,8,8,830,1,0,0,0,0,1,0,1,0,0,0,0,0,0
6969,6969,Mark Bosnich,3413,2001,Chelsea FC,1,1,0,90,0,0,4,4,0,350,0,0,5,5,0,440,0,0,0,0,0,0,0,0,0,0,0,0,0,0
6970,6970,Graeme Le Saux,2615,2001,Chelsea FC,14,13,1,1124,1,0,12,12,0,1066,0,0,26,25,1,2190,1,0,0,0,0,1,0,1,0,0,0,0,0,0
6971,6971,Frank Lampard,1536,2001,Chelsea FC,19,18,1,1616,2,0,16,14,2,1319,3,0,35,32,3,2935,5,0,0,1,1,0,3,3,0,0,0,0,0,0
6972,6972,Mario Stanić,3414,2001,Chelsea FC,12,8,4,682,0,0,13,8,5,751,1,0,25,16,9,1433,1,0,0,0,0,0,0,0,0,0,0,0,0,0
6973,6973,Mikael Forssell,1965,2001,Chelsea FC,10,1,9,177,3,0,11,1,10,258,1,0,21,2,19,435,4,0,3,0,3,1,1,2,0,0,0,0,0,0
6974,6974,Brede Hangeland,1033,2014,Crystal Palace,8,7,1,678,0,0,6,5,1,494,2,0,14,12,2,1172,2,0,0,0,0,0,2,2,0,0,0,0,0,0
6975,6975,Stuart O'Keefe,3133,2014,Crystal Palace,1,1,0,83,0,0,1,0,1,1,0,0,2,1,1,84,0,0,0,0,0,0,0,0,0,0,0,0,0,0
6976,6976,Barry Bannan,1975,2014,Crystal Palace,4,2,2,125,0,0,3,0,3,11,0,0,7,2,5,136,0,0,0,0,0,0,0,0,0,0,0,0,0,0
6977,6977,Jonathan Williams,3415,2014,Crystal Palace,2,0,2,35,0,0,0,0,0,0,0,0,2,0,2,35,0,0,0,0,0,0,0,0,0,0,0,0,0,0
6978,6978,Dwight Gayle,2477,2014,Crystal Palace,15,6,9,669,2,0,10,5,5,422,3,0,25,11,14,1091,5,0,0,3,3,2,2,4,1,0,1,0,0,0
6979,6979,Adrian Mariappa,1917,2014,Crystal Palace,4,2,2,244,0,0,8,6,2,595,0,0,12,8,4,839,0,0,0,0,0,0,0,0,0,0,0,0,0,0
6980,6980,Paddy McCarthy,3410,2014,Crystal Palace,0,0,0,0,0,0,0,0,0,0,0,0,0,0,0,0,0,0,0,0,0,0,0,0,0,0,0,0,0,0
6981,6981,Adlène Guédioura,3130,2014,Crystal Palace,3,0,3,66,0,0,4,0,4,56,0,0,7,0,7,122,0,0,0,0,0,0,0,0,0,0,0,0,0,0
6982,6982,Adrián,2309,2014,West Ham United,19,19,0,1710,0,0,19,19,0,1710,0,0,38,38,0,3420,0,0,0,0,0,0,0,0,0,0,0,0,0,0
6983,6983,Winston Reid,2638,2014,West Ham United,15,14,1,1219,1,0,15,15,0,1284,0,0,30,29,1,2503,1,0,0,0,0,1,0,1,0,0,0,0,0,0
6984,6984,Aaron Cresswell,2199,2014,West Ham United,19,19,0,1710,2,0,19,19,0,1710,0,0,38,38,0,3420,2,0,3,0,3,2,0,2,0,0,0,0,0,0
6985,6985,James Tomkins,1281,2014,West Ham United,11,11,0,955,0,0,11,9,2,897,1,0,22,20,2,1852,1,0,0,3,3,0,1,1,0,0,0,0,0,0
6986,6986,Joey O'Brien,2412,2014,West Ham United,6,3,3,256,0,0,3,3,0,270,0,0,9,6,3,526,0,0,0,0,0,0,0,0,0,0,0,0,0,0
6987,6987,Cheikhou Kouyaté,2311,2014,West Ham United,17,16,1,1415,2,0,14,14,0,1247,2,0,31,30,1,2662,4,0,0,0,0,1,2,3,0,0,0,0,0,0
6988,6988,Stewart Downing,1335,2014,West Ham United,19,19,0,1710,3,0,18,18,0,1604,3,0,37,37,0,3314,6,0,0,2,2,1,2,3,0,0,0,0,0,0
6989,6989,Mark Noble,2204,2014,West Ham United,14,14,0,1236,2,0,14,13,1,1072,0,0,28,27,1,2308,2,0,3,0,3,2,0,2,1,0,1,0,0,0
6990,6990,Mauro Zárate,2504,2014,West Ham United,3,2,1,153,0,0,4,3,1,261,2,0,7,5,2,414,2,0,0,0,0,0,2,2,0,0,0,0,0,0
6991,6991,Ricardo Vaz Tê,3416,2014,West Ham United,2,2,0,126,0,0,2,1,1,98,0,0,4,3,1,224,0,0,0,0,0,0,0,0,0,0,0,0,0,0
6992,6992,Carlton Cole,2326,2014,West Ham United,9,3,6,348,0,0,14,5,9,560,2,0,23,8,15,908,2,0,0,0,0,0,0,0,0,0,0,0,0,0
6993,6993,Momo Diamé,2060,2014,West Ham United,2,0,2,54,0,0,1,0,1,1,0,0,3,0,3,55,0,0,0,0,0,0,0,0,0,0,0,0,0,0
6994,6994,Diego Poyet,3417,2014,West Ham United,0,0,0,0,0,0,3,1,2,91,0,0,3,1,2,91,0,0,0,0,0,0,0,0,0,0,0,0,0,0
6995,6995,Diafra Sakho,3418,2014,West Ham United,13,12,1,1035,6,0,10,8,2,726,4,0,23,20,3,1761,10,0,3,1,4,2,2,4,0,0,0,0,0,0
6996,6996,Jussi Jääskeläinen,1710,2014,West Ham United,0,0,0,0,0,0,1,0,1,27,0,0,1,0,1,27,0,0,0,0,0,0,0,0,0,0,0,0,0,0
6997,6997,Guy Demel,3093,2014,West Ham United,3,1,2,101,0,0,3,2,1,156,0,0,6,3,3,257,0,0,0,0,0,0,0,0,0,0,0,0,0,0
6998,6998,Ravel Morrison,3419,2014,West Ham United,1,0,1,33,0,0,0,0,0,0,0,0,1,0,1,33,0,0,0,0,0,0,0,0,0,0,0,0,0,0
6999,6999,Enner Valencia,2715,2014,West Ham United,17,12,5,1039,1,0,15,13,2,1067,3,0,32,25,7,2106,4,0,0,0,0,0,1,1,0,0,0,0,0,0
7000,7000,Thibaut Courtois,2730,2014,Chelsea FC,15,15,0,1284,0,0,17,17,0,1530,0,0,32,32,0,2814,0,0,0,0,0,0,0,0,0,0,0,0,0,0
7001,7001,Branislav Ivanović,1532,2014,Chelsea FC,19,19,0,1710,1,0,19,19,0,1710,3,0,38,38,0,3420,4,0,0,3,3,1,1,2,0,0,0,0,0,0
7002,7002,Gary Cahill,1533,2014,Chelsea FC,17,14,3,1275,0,0,19,19,0,1710,1,0,36,33,3,2985,1,0,0,0,0,0,1,1,0,0,0,0,0,0
7003,7003,John Terry,1534,2014,Chelsea FC,19,19,0,1710,2,0,19,19,0,1710,3,0,38,38,0,3420,5,0,0,0,0,2,2,4,0,0,0,0,0,0
7004,7004,Azpilicueta,1535,2014,Chelsea FC,15,15,0,1297,0,0,14,14,0,1237,0,0,29,29,0,2534,0,0,0,0,0,0,0,0,0,0,0,0,0,0
7005,7005,Cesc Fàbregas,1526,2014,Chelsea FC,16,15,1,1348,0,0,18,18,0,1603,3,0,34,33,1,2951,3,0,0,3,3,0,1,1,0,0,0,0,0,0
7006,7006,Oscar,1543,2014,Chelsea FC,15,15,0,1179,3,0,13,11,2,857,3,0,28,26,2,2036,6,0,0,0,0,3,2,5,0,0,0,0,0,0
7007,7007,Nemanja Matić,1537,2014,Chelsea FC,19,18,1,1613,0,0,17,17,0,1530,1,0,36,35,1,3143,1,0,0,0,0,0,0,0,0,0,0,0,0,0
7008,7008,Willian,1538,2014,Chelsea FC,18,14,4,1245,2,0,18,14,4,1171,0,0,36,28,8,2416,2,0,3,0,3,1,0,1,0,0,0,0,0,0
7009,7009,Eden Hazard,1541,2014,Chelsea FC,19,19,0,1688,9,0,19,19,0,1690,5,0,38,38,0,3378,14,0,9,4,13,7,4,11,3,0,3,0,0,0
7010,7010,Diego Costa,2731,2014,Chelsea FC,13,11,2,1026,12,0,13,13,0,1090,8,0,26,24,2,2116,20,0,0,3,3,6,4,10,1,0,1,0,0,0
7011,7011,Ramires,2460,2014,Chelsea FC,12,2,10,356,0,0,11,9,2,743,2,0,23,11,12,1099,2,0,0,0,0,0,0,0,0,0,0,0,0,0
7012,7012,Juan Cuadrado,3420,2014,Chelsea FC,7,4,3,263,0,0,5,0,5,49,0,0,12,4,8,312,0,0,0,0,0,0,0,0,0,0,0,0,0,0
7013,7013,Loïc Rémy,2455,2014,Chelsea FC,11,4,7,425,6,0,8,2,6,241,1,0,19,6,13,666,7,0,3,3,6,3,1,4,0,0,0,0,0,0
7014,7014,Petr Čech,1531,2014,Chelsea FC,5,4,1,426,0,0,2,2,0,180,0,0,7,6,1,606,0,0,0,0,0,0,0,0,0,0,0,0,0,0
7015,7015,Filipe Luís,3421,2014,Chelsea FC,6,4,2,410,0,0,9,5,4,530,0,0,15,9,6,940,0,0,0,0,0,0,0,0,0,0,0,0,0,0
7016,7016,Kurt Zouma,1903,2014,Chelsea FC,8,6,2,534,0,0,7,1,6,110,0,0,15,7,8,644,0,0,0,0,0,0,0,0,0,0,0,0,0,0
7017,7017,Didier Drogba,1766,2014,Chelsea FC,13,4,9,405,1,0,15,4,11,450,3,0,28,8,20,855,4,0,0,0,0,0,2,2,0,0,0,0,0,0
7018,7018,Andy Johnson,1322,2011,Fulham FC,10,7,3,674,3,0,10,6,4,570,0,0,20,13,7,1244,3,0,0,0,0,1,0,1,0,0,0,0,0,0
7019,7019,Paul Robinson,1262,2011,Blackburn Rovers,18,18,0,1620,0,0,16,16,0,1440,0,0,34,34,0,3060,0,0,0,0,0,0,0,0,0,0,0,0,0,0
7020,7020,Míchel Salgado,2655,2011,Blackburn Rovers,3,3,0,198,0,0,6,6,0,457,0,0,9,9,0,655,0,0,0,0,0,0,0,0,0,0,0,0,0,0
7021,7021,Christopher Samba,2109,2011,Blackburn Rovers,9,9,0,765,0,0,7,7,0,586,2,0,16,16,0,1351,2,0,0,1,1,0,1,1,0,0,0,0,0,0
7022,7022,Gaël Givet,2654,2011,Blackburn Rovers,11,10,1,874,0,0,11,11,0,922,0,0,22,21,1,1796,0,0,0,0,0,0,0,0,0,0,0,0,0,0
7023,7023,Scott Dann,1020,2011,Blackburn Rovers,12,12,0,1080,1,0,15,15,0,1323,0,0,27,27,0,2403,1,0,0,0,0,1,0,1,0,0,0,0,0,0
7024,7024,David Dunn,1456,2011,Blackburn Rovers,13,11,2,815,2,0,13,10,3,836,0,0,26,21,5,1651,2,0,1,0,1,1,0,1,0,0,0,0,0,0
7025,7025,Mauro Fórmica,3422,2011,Blackburn Rovers,17,13,4,1126,4,0,17,12,5,1043,0,0,34,25,9,2169,4,0,0,0,0,3,0,3,0,0,0,0,0,0
7026,7026,Steven N'Zonzi,1550,2011,Blackburn Rovers,16,16,0,1440,1,0,16,15,1,1370,1,0,32,31,1,2810,2,0,0,0,0,0,0,0,0,0,0,0,0,0
7027,7027,Junior Hoilett,2535,2011,Blackburn Rovers,17,17,0,1483,2,0,17,17,0,1471,5,0,34,34,0,2954,7,0,0,0,0,1,3,4,0,0,0,0,0,0
7028,7028,Rubén Rochina,3423,2011,Blackburn Rovers,10,4,6,383,0,0,8,5,3,435,2,0,18,9,9,818,2,0,0,0,0,0,1,1,0,0,0,0,0,0
7029,7029,David Goodwillie,3424,2011,Blackburn Rovers,10,1,9,243,1,0,10,3,7,355,1,0,20,4,16,598,2,0,0,1,1,0,1,1,0,0,0,0,0,0
7030,7030,Martin Olsson,1372,2011,Blackburn Rovers,14,12,2,1142,0,0,13,11,2,1102,0,0,27,23,4,2244,0,0,0,0,0,0,0,0,0,0,0,0,0,0
7031,7031,Radosav Petrović,3425,2011,Blackburn Rovers,10,5,5,484,0,0,9,5,4,498,0,0,19,10,9,982,0,0,0,0,0,0,0,0,0,0,0,0,0,0
7032,7032,Jason Lowe,3426,2011,Blackburn Rovers,16,15,1,1365,0,0,16,15,1,1305,0,0,32,30,2,2670,0,0,0,0,0,0,0,0,0,0,0,0,0,0
7033,7033,Mark Bunn,1380,2011,Blackburn Rovers,1,1,0,90,0,0,2,2,0,180,0,0,3,3,0,270,0,0,0,0,0,0,0,0,0,0,0,0,0,0
7034,7034,Simon Vukčević,3427,2011,Blackburn Rovers,5,3,2,272,0,0,2,1,1,105,1,0,7,4,3,377,1,0,0,0,0,0,1,1,0,0,0,0,0,0
7035,7035,Yakubu Ayegbeni,1073,2011,Blackburn Rovers,16,15,1,1353,11,0,14,14,0,1166,6,0,30,29,1,2519,17,0,0,1,1,6,4,10,2,2,4,0,0,0
7036,7036,Jason Roberts,1820,2011,Blackburn Rovers,5,3,2,275,0,0,5,2,3,191,0,0,10,5,5,466,0,0,0,0,0,0,0,0,0,0,0,0,0,0
7037,7037,Tony Vidmar,3428,2002,Middlesbrough FC,6,6,0,495,0,0,5,3,2,386,0,0,11,9,2,881,0,0,0,0,0,0,0,0,0,0,0,0,0,0
7038,7038,Luke Wilkshire,3429,2002,Middlesbrough FC,7,2,5,234,0,0,5,3,2,199,0,0,12,5,7,433,0,0,0,0,0,0,0,0,0,0,0,0,0,0
7039,7039,Jerzy Dudek,2899,2002,Liverpool FC,16,16,0,1440,0,0,14,14,0,1260,0,0,30,30,0,2700,0,0,0,0,0,0,0,0,0,0,0,0,0,0
7040,7040,Dietmar Hamann,2690,2002,Liverpool FC,15,15,0,1326,1,0,15,14,1,1221,1,0,30,29,1,2547,2,0,0,0,0,1,0,1,0,0,0,0,0,0
7041,7041,Emile Heskey,1519,2002,Liverpool FC,17,11,6,1028,2,0,14,10,4,935,4,0,31,21,10,1963,6,0,1,6,7,2,3,5,0,0,0,0,0,0
7042,7042,Vladimír Šmicer,2692,2002,Liverpool FC,14,8,6,681,0,0,7,2,5,263,0,0,21,10,11,944,0,0,0,0,0,0,0,0,0,0,0,0,0,0
7043,7043,Kevin Nolan,2396,2006,Bolton Wanderers,15,15,0,1291,1,0,16,16,0,1403,2,0,31,31,0,2694,3,0,0,3,3,0,1,1,0,0,0,0,0,0
7044,7044,Ricardo Vaz Tê,3416,2006,Bolton Wanderers,12,1,11,318,0,0,12,1,11,279,0,0,24,2,22,597,0,0,0,0,0,0,0,0,0,0,0,0,0,0
7045,7045,Wes Brown,1108,2005,Manchester United,10,10,0,856,0,0,9,7,2,620,0,0,19,17,2,1476,0,0,0,0,0,0,0,0,0,0,0,0,0,0
7046,7046,Phil Bardsley,1409,2005,Manchester United,4,1,3,148,0,0,4,2,2,155,0,0,8,3,5,303,0,0,0,0,0,0,0,0,0,0,0,0,0,0
7047,7047,Carlton Cole,2326,2003,Charlton Athletic,12,4,8,526,3,0,9,4,5,452,1,0,21,8,13,978,4,0,0,3,3,2,1,3,0,0,0,0,0,0
7048,7048,Ronny Johnsen,2031,2003,Aston Villa,10,9,1,798,1,0,11,10,1,897,0,0,21,19,2,1695,1,0,0,0,0,0,0,0,0,0,0,0,0,0
7049,7049,Lee Hendrie,1797,2003,Aston Villa,16,16,0,1282,1,0,15,15,0,1230,1,0,31,31,0,2512,2,0,0,0,0,0,1,1,0,0,0,0,0,0
7050,7050,Liam Ridgewell,1772,2003,Aston Villa,7,3,4,308,0,0,3,1,2,96,0,0,10,4,6,404,0,0,0,0,0,0,0,0,0,0,0,0,0,0
7051,7051,Stefan Moore,3065,2003,Aston Villa,7,0,7,120,0,0,7,2,5,238,1,0,14,2,12,358,1,0,0,0,0,0,1,1,0,0,0,0,0,0
7052,7052,Wayne Hennessey,1018,2010,Wolverhampton Wanderers,12,12,0,1080,0,0,12,12,0,1080,0,0,24,24,0,2160,0,0,0,0,0,0,0,0,0,0,0,0,0,0
7053,7053,George Elokobi,2884,2010,Wolverhampton Wanderers,14,11,3,1066,1,0,13,12,1,1057,1,0,27,23,4,2123,2,0,0,0,0,1,0,1,0,0,0,0,0,0
7054,7054,Richard Stearman,3430,2010,Wolverhampton Wanderers,16,13,3,1282,0,0,15,14,1,1217,0,0,31,27,4,2499,0,0,0,0,0,0,0,0,0,0,0,0,0,0
7055,7055,Christophe Berra,2885,2010,Wolverhampton Wanderers,16,15,1,1351,0,0,16,16,0,1440,0,0,32,31,1,2791,0,0,0,0,0,0,0,0,0,0,0,0,0,0
7056,7056,Ronald Zubar,2887,2010,Wolverhampton Wanderers,8,7,1,629,0,0,7,7,0,630,1,0,15,14,1,1259,1,0,0,0,0,0,0,0,0,0,0,0,0,0
7057,7057,Dave Edwards,2889,2010,Wolverhampton Wanderers,8,8,0,561,1,0,7,4,3,359,0,0,15,12,3,920,1,0,3,0,3,1,0,1,0,0,0,0,0,0
7058,7058,Karl Henry,2921,2010,Wolverhampton Wanderers,14,14,0,1255,0,0,15,14,1,1251,0,0,29,28,1,2506,0,0,0,0,0,0,0,0,0,0,0,0,0,0
7059,7059,David Jones,1490,2010,Wolverhampton Wanderers,5,5,0,404,1,0,7,6,1,549,0,0,12,11,1,953,1,0,0,0,0,1,0,1,0,0,0,0,0,0
7060,7060,Matthew Jarvis,2627,2010,Wolverhampton Wanderers,18,16,2,1488,3,0,19,18,1,1569,1,0,37,34,3,3057,4,0,0,3,3,3,1,4,0,0,0,0,0,0
7061,7061,Adam Hammill,3431,2010,Wolverhampton Wanderers,5,3,2,202,0,0,5,4,1,340,0,0,10,7,3,542,0,0,0,0,0,0,0,0,0,0,0,0,0,0
7062,7062,Kevin Doyle,2594,2010,Wolverhampton Wanderers,12,12,0,1042,3,0,14,13,1,1146,2,0,26,25,1,2188,5,0,3,0,3,3,0,3,1,1,2,0,0,0
7063,7063,Stephen Ward,1252,2010,Wolverhampton Wanderers,17,14,3,1245,0,0,17,13,4,1148,1,0,34,27,7,2393,1,0,0,3,3,0,1,1,0,0,0,0,0,0
7064,7064,Jamie O'Hara,2505,2010,Wolverhampton Wanderers,6,6,0,499,2,0,8,7,1,618,1,0,14,13,1,1117,3,0,0,0,0,0,1,1,0,0,0,0,0,0
7065,7065,Sylvain Ebanks-Blake,3432,2010,Wolverhampton Wanderers,16,6,10,669,4,0,14,5,9,645,3,0,30,11,19,1314,7,0,3,1,4,2,2,4,0,0,0,0,0,0
7066,7066,Marcus Hahnemann,2588,2010,Wolverhampton Wanderers,7,7,0,630,0,0,7,7,0,630,0,0,14,14,0,1260,0,0,0,0,0,0,0,0,0,0,0,0,0,0
7067,7067,Jody Craddock,1093,2010,Wolverhampton Wanderers,7,7,0,545,0,0,8,7,1,631,1,0,15,14,1,1176,1,0,0,0,0,0,1,1,0,0,0,0,0,0
7068,7068,Nenad Milijaš,2890,2010,Wolverhampton Wanderers,12,10,2,882,1,0,11,10,1,832,1,0,23,20,3,1714,2,0,0,0,0,1,1,2,0,0,0,0,0,0
7069,7069,Steven Fletcher,1408,2010,Wolverhampton Wanderers,15,9,6,785,7,0,14,6,8,609,3,0,29,15,14,1394,10,0,1,0,1,3,3,6,0,1,1,0,0,0
7070,7070,Boudewijn Zenden,1336,2002,Chelsea FC,12,8,4,661,1,0,9,3,6,327,0,0,21,11,10,988,1,0,0,0,0,1,0,1,0,0,0,0,0,0
7071,7071,De Lucas,3433,2002,Chelsea FC,10,8,2,703,0,0,15,9,6,847,0,0,25,17,8,1550,0,0,0,0,0,0,0,0,0,0,0,0,0,0
7072,7072,Jimmy Floyd Hasselbaink,1337,2002,Chelsea FC,17,13,4,1163,7,0,19,14,5,1218,4,0,36,27,9,2381,11,0,0,1,1,5,1,6,2,1,3,0,0,0
7073,7073,Mario Stanić,3414,2002,Chelsea FC,8,5,3,440,1,0,10,8,2,579,3,0,18,13,5,1019,4,0,0,0,0,0,2,2,0,0,0,0,0,0
7074,7074,Aaron Hughes,1561,2013,Fulham FC,5,5,0,450,0,0,8,6,2,614,0,0,13,11,2,1064,0,0,0,0,0,0,0,0,0,0,0,0,0,0
7075,7075,Damien Duff,1348,2013,Fulham FC,8,5,3,380,0,0,7,4,3,315,0,0,15,9,6,695,0,0,0,0,0,0,0,0,0,0,0,0,0,0
7076,7076,Adel Taarabt,2165,2013,Fulham FC,7,4,3,309,0,0,5,3,2,286,0,0,12,7,5,595,0,0,0,0,0,0,0,0,0,0,0,0,0,0
7077,7077,Dimitar Berbatov,1397,2013,Fulham FC,10,10,0,863,2,0,8,8,0,706,2,0,18,18,0,1569,4,0,3,0,3,1,1,2,1,1,2,0,0,0
7078,7078,Alexander Kačaniklić,2555,2013,Fulham FC,11,6,5,529,1,0,11,9,2,742,0,0,22,15,7,1271,1,0,0,0,0,0,0,0,0,0,0,0,0,0
7079,7079,Giorgios Karagounis,2560,2013,Fulham FC,7,4,3,384,0,0,7,2,5,270,0,0,14,6,8,654,0,0,0,0,0,0,0,0,0,0,0,0,0,0
7080,7080,Neil Etheridge,3142,2013,Fulham FC,0,0,0,0,0,0,0,0,0,0,0,0,0,0,0,0,0,0,0,0,0,0,0,0,0,0,0,0,0,0
7081,7081,Matthew Briggs,2559,2013,Fulham FC,0,0,0,0,0,0,2,0,2,87,0,0,2,0,2,87,0,0,0,0,0,0,0,0,0,0,0,0,0,0
7082,7082,Derek Boateng,3434,2013,Fulham FC,2,1,1,90,0,0,1,1,0,65,0,0,3,2,1,155,0,0,0,0,0,0,0,0,0,0,0,0,0,0
7083,7083,Bryan Ruiz,3265,2013,Fulham FC,6,4,2,383,1,0,6,4,2,420,0,0,12,8,4,803,1,0,0,0,0,1,0,1,0,0,0,0,0,0
7084,7084,Tomáš Rosický,1509,2013,Arsenal FC,17,10,7,940,1,0,10,7,3,637,1,0,27,17,10,1577,2,0,0,3,3,0,1,1,0,0,0,0,0,0
7085,7085,Yaya Sanogo,3435,2013,Arsenal FC,3,0,3,13,0,0,5,0,5,59,0,0,8,0,8,72,0,0,0,0,0,0,0,0,0,0,0,0,0,0
7086,7086,Emmanuel Frimpong,2753,2013,Arsenal FC,0,0,0,0,0,0,0,0,0,0,0,0,0,0,0,0,0,0,0,0,0,0,0,0,0,0,0,0,0,0
7087,7087,Gedion Zelalem,3436,2013,Arsenal FC,0,0,0,0,0,0,0,0,0,0,0,0,0,0,0,0,0,0,0,0,0,0,0,0,0,0,0,0,0,0
7088,7088,Petr Čech,1531,2007,Chelsea FC,12,12,0,1080,0,0,14,14,0,1234,0,0,26,26,0,2314,0,0,0,0,0,0,0,0,0,0,0,0,0,0
7089,7089,Florent Malouda,2270,2007,Chelsea FC,9,6,3,543,1,0,12,10,2,854,1,0,21,16,5,1397,2,0,0,0,0,1,0,1,0,0,0,0,0,0
7090,7090,Steven Sidwell,1622,2007,Chelsea FC,8,3,5,231,0,0,7,4,3,286,0,0,15,7,8,517,0,0,0,0,0,0,0,0,0,0,0,0,0,0
7091,7091,Claudio Pizarro,3437,2007,Chelsea FC,10,4,6,381,1,0,11,0,11,299,1,0,21,4,17,680,2,0,0,3,3,1,1,2,0,0,0,0,0,0
7092,7092,Harry Lewis,3025,2016,Southampton FC,0,0,0,0,0,0,0,0,0,0,0,0,0,0,0,0,0,0,0,0,0,0,0,0,0,0,0,0,0,0
7093,7093,Harrison Reed,1153,2016,Southampton FC,1,0,1,12,0,0,2,1,1,51,0,0,3,1,2,63,0,0,0,0,0,0,0,0,0,0,0,0,0,0
7094,7094,Gonzalo Sorondo,3438,2004,Crystal Palace,10,8,2,705,0,0,10,8,2,759,0,0,20,16,4,1464,0,0,0,0,0,0,0,0,0,0,0,0,0,0
7095,7095,Mikele Leigertwood,1980,2004,Crystal Palace,10,8,2,759,1,0,10,8,2,804,0,0,20,16,4,1563,1,0,0,0,0,1,0,1,0,0,0,0,0,0
7096,7096,Pascal Cygan,3439,2004,Arsenal FC,9,9,0,744,0,0,6,6,0,540,0,0,15,15,0,1284,0,0,0,0,0,0,0,0,0,0,0,0,0,0
7097,7097,Yannick Bolasie,1057,2015,Crystal Palace,13,13,0,1092,3,0,13,10,3,984,2,0,26,23,3,2076,5,0,0,1,1,2,2,4,0,0,0,0,0,0
7098,7098,Emmanuel Adebayor,1235,2015,Crystal Palace,5,3,2,274,1,0,7,4,3,345,0,0,12,7,5,619,1,0,0,0,0,1,0,1,0,0,0,0,0,0
7099,7099,Bakary Sako,2253,2015,Crystal Palace,9,3,6,377,1,0,11,8,3,712,1,0,20,11,9,1089,2,0,3,0,3,1,1,2,0,0,0,0,0,0
7100,7100,Dwight Gayle,2477,2015,Crystal Palace,10,6,4,555,2,0,6,2,4,259,1,0,16,8,8,814,3,0,3,1,4,2,1,3,0,0,0,0,0,0
7101,7101,Julian Speroni,2249,2015,Crystal Palace,0,0,0,0,0,0,2,2,0,180,0,0,2,2,0,180,0,0,0,0,0,0,0,0,0,0,0,0,0,0
7102,7102,Gökhan Inler,3440,2015,Leicester City,4,2,2,149,0,0,1,1,0,46,0,0,5,3,2,195,0,0,0,0,0,0,0,0,0,0,0,0,0,0
7103,7103,Harry Kewell,1296,2007,Liverpool FC,5,5,0,356,0,0,5,3,2,250,0,0,10,8,2,606,0,0,0,0,0,0,0,0,0,0,0,0,0,0
7104,7104,Jack Hobbs,3441,2007,Liverpool FC,1,0,1,39,0,0,1,1,0,90,0,0,2,1,1,129,0,0,0,0,0,0,0,0,0,0,0,0,0,0
7105,7105,Jussi Jääskeläinen,1710,2007,Bolton Wanderers,15,15,0,1350,0,0,13,13,0,1170,0,0,28,28,0,2520,0,0,0,0,0,0,0,0,0,0,0,0,0,0
7106,7106,Jlloyd Samuel,1789,2007,Bolton Wanderers,6,4,2,382,0,0,12,8,4,747,0,0,18,12,6,1129,0,0,0,0,0,0,0,0,0,0,0,0,0,0
7107,7107,Abdoulaye Méïté,1712,2007,Bolton Wanderers,10,10,0,900,0,0,11,11,0,902,0,0,21,21,0,1802,0,0,0,0,0,0,0,0,0,0,0,0,0,0
7108,7108,Iván Campo,1713,2007,Bolton Wanderers,13,13,0,1054,1,0,13,11,2,920,0,0,26,24,2,1974,1,0,1,0,1,1,0,1,0,0,0,0,0,0
7109,7109,Ľubomir Michalík,3442,2007,Bolton Wanderers,2,2,0,180,0,0,5,3,2,315,0,0,7,5,2,495,0,0,0,0,0,0,0,0,0,0,0,0,0,0
7110,7110,Gary Speed,1716,2007,Bolton Wanderers,8,5,3,470,1,0,6,6,0,500,0,0,14,11,3,970,1,0,0,0,0,1,0,1,0,0,0,0,0,0
7111,7111,Ricardo Gardner,2411,2007,Bolton Wanderers,13,13,0,1126,0,0,13,12,1,1097,0,0,26,25,1,2223,0,0,0,0,0,0,0,0,0,0,0,0,0,0
7112,7112,Stylianos Giannakopoulos,1717,2007,Bolton Wanderers,8,1,7,158,1,0,7,0,7,133,1,0,15,1,14,291,2,0,3,0,3,1,1,2,0,0,0,0,0,0
7113,7113,Jens Lehmann,1522,2006,Arsenal FC,18,18,0,1620,0,0,18,18,0,1620,0,0,36,36,0,3240,0,0,0,0,0,0,0,0,0,0,0,0,0,0
7114,7114,Kolo Touré,1415,2006,Arsenal FC,18,18,0,1620,1,0,16,16,0,1440,2,0,34,34,0,3060,3,0,0,0,0,0,2,2,0,0,0,0,0,0
7115,7115,Johan Djourou,1229,2006,Arsenal FC,10,10,0,838,0,0,10,7,3,613,0,0,20,17,3,1451,0,0,0,0,0,0,0,0,0,0,0,0,0,0
7116,7116,Gaël Clichy,1230,2006,Arsenal FC,15,14,1,1269,0,0,11,11,0,990,0,0,26,25,1,2259,0,0,0,0,0,0,0,0,0,0,0,0,0,0
7117,7117,Justin Hoyte,3282,2006,Arsenal FC,8,6,2,468,1,0,13,11,2,948,0,0,21,17,4,1416,1,0,0,0,0,0,0,0,0,0,0,0,0,0
7118,7118,Cesc Fàbregas,1526,2006,Arsenal FC,19,19,0,1697,2,0,18,14,4,1397,0,0,37,33,4,3094,2,0,3,0,3,2,0,2,0,0,0,0,0,0
7119,7119,Tomáš Rosický,1509,2006,Arsenal FC,12,11,1,909,3,0,14,11,3,926,0,0,26,22,4,1835,3,0,3,0,3,3,0,3,0,0,0,0,0,0
7120,7120,Gilberto Silva,1234,2006,Arsenal FC,17,17,0,1484,8,0,17,17,0,1530,2,0,34,34,0,3014,10,0,2,0,2,5,1,6,5,0,5,0,0,0
7121,7121,Júlio Baptista,3443,2006,Arsenal FC,13,5,8,544,3,0,10,5,5,496,0,0,23,10,13,1040,3,0,0,0,0,1,0,1,0,0,0,0,0,0
7122,7122,Thierry Henry,2357,2006,Arsenal FC,10,9,1,854,6,0,7,7,0,620,4,0,17,16,1,1474,10,0,5,1,6,4,2,6,2,1,3,0,0,0
7123,7123,Theo Walcott,1237,2006,Arsenal FC,9,3,6,357,0,0,7,2,5,283,0,0,16,5,11,640,0,0,0,0,0,0,0,0,0,0,0,0,0,0
7124,7124,Mathieu Flamini,1510,2006,Arsenal FC,9,3,6,394,2,0,11,6,5,563,1,0,20,9,11,957,3,0,0,0,0,1,1,2,0,0,0,0,0,0
7125,7125,Emmanuel Adebayor,1235,2006,Arsenal FC,16,12,4,1132,5,0,13,9,4,855,3,0,29,21,8,1987,8,0,0,6,6,2,3,5,1,0,1,0,0,0
7126,7126,Jérémie Aliadiére,1530,2006,Arsenal FC,6,1,5,146,0,0,5,3,2,278,0,0,11,4,7,424,0,0,0,0,0,0,0,0,0,0,0,0,0,0
7127,7127,Matt Jackson,3444,2006,Wigan Athletic,9,8,1,674,1,0,11,9,2,856,0,0,20,17,3,1530,1,0,0,0,0,0,0,0,0,0,0,0,0,0
7128,7128,Ryan Taylor,2341,2006,Wigan Athletic,7,5,2,525,1,0,9,7,2,585,0,0,16,12,4,1110,1,0,3,0,3,1,0,1,0,0,0,0,0,0
7129,7129,Josip Skoko,2743,2006,Wigan Athletic,15,14,1,1145,0,0,13,10,3,998,0,0,28,24,4,2143,0,0,0,0,0,0,0,0,0,0,0,0,0,0
7130,7130,Julius Aghahowa,2345,2006,Wigan Athletic,3,2,1,189,0,0,3,1,2,122,0,0,6,3,3,311,0,0,0,0,0,0,0,0,0,0,0,0,0,0
7131,7131,Kristofer Hæstad,3445,2006,Wigan Athletic,0,0,0,0,0,0,2,1,1,74,0,0,2,1,1,74,0,0,0,0,0,0,0,0,0,0,0,0,0,0
7132,7132,Sandro,2409,2014,Queens Park Rangers,8,8,0,584,1,0,9,9,0,637,0,0,17,17,0,1221,1,0,0,0,0,0,0,0,0,0,0,0,0,0
7133,7133,Bobby Zamora,1943,2014,Queens Park Rangers,16,13,3,1079,0,0,15,6,9,698,3,0,31,19,12,1777,3,0,0,0,0,0,0,0,0,0,0,0,0,0
7134,7134,Mauricio Isla,3446,2014,Queens Park Rangers,15,13,2,1184,0,0,11,11,0,947,0,0,26,24,2,2131,0,0,0,0,0,0,0,0,0,0,0,0,0,0
7135,7135,Niko Kranjčar,1276,2014,Queens Park Rangers,8,2,6,268,1,0,14,9,5,846,1,0,22,11,11,1114,2,0,1,0,1,1,0,1,0,0,0,0,0,0
7136,7136,Adel Taarabt,2165,2014,Queens Park Rangers,4,1,3,93,0,0,3,2,1,203,0,0,7,3,4,296,0,0,0,0,0,0,0,0,0,0,0,0,0,0
7137,7137,Carl Jenkinson,2752,2014,West Ham United,16,15,1,1368,0,0,16,14,2,1300,0,0,32,29,3,2668,0,0,0,0,0,0,0,0,0,0,0,0,0,0
7138,7138,James Collins,1618,2014,West Ham United,14,10,4,904,0,0,13,11,2,1002,0,0,27,21,6,1906,0,0,0,0,0,0,0,0,0,0,0,0,0,0
7139,7139,Reece Burke,3447,2014,West Ham United,2,1,1,166,0,0,3,3,0,249,0,0,5,4,1,415,0,0,0,0,0,0,0,0,0,0,0,0,0,0
7140,7140,Kevin Nolan,2396,2014,West Ham United,14,8,6,774,0,0,15,11,4,972,1,0,29,19,10,1746,1,0,0,0,0,0,1,1,0,0,0,0,0,0
7141,7141,Matthew Jarvis,2627,2014,West Ham United,5,2,3,162,0,0,6,2,4,251,0,0,11,4,7,413,0,0,0,0,0,0,0,0,0,0,0,0,0,0
7142,7142,Reece Oxford,2789,2014,West Ham United,0,0,0,0,0,0,0,0,0,0,0,0,0,0,0,0,0,0,0,0,0,0,0,0,0,0,0,0,0,0
7143,7143,Nenê,3448,2014,West Ham United,5,0,5,73,0,0,3,0,3,54,0,0,8,0,8,127,0,0,0,0,0,0,0,0,0,0,0,0,0,0
7144,7144,Morgan Amalfitano,2301,2014,West Ham United,10,6,4,542,3,0,14,8,6,640,0,0,24,14,10,1182,3,0,0,0,0,1,0,1,0,0,0,0,0,0
7145,7145,Steven Pienaar,2406,2011,Everton FC,6,6,0,519,3,0,8,8,0,720,1,0,14,14,0,1239,4,0,0,1,1,2,1,3,0,0,0,0,0,0
7146,7146,Nikica Jelavić,2228,2011,Everton FC,5,5,0,428,4,0,8,5,3,527,5,0,13,10,3,955,9,0,3,0,3,2,3,5,1,0,1,0,0,0
7147,7147,Chris Riggott,1330,2007,Middlesbrough FC,5,5,0,450,1,0,5,4,1,379,0,0,10,9,1,829,1,0,0,0,0,1,0,1,0,0,0,0,0,0
7148,7148,Jamie Ashdown,3122,2007,Portsmouth FC,2,2,0,180,0,0,1,1,0,90,0,0,3,3,0,270,0,0,0,0,0,0,0,0,0,0,0,0,0,0
7149,7149,Glen Johnson,1386,2007,Portsmouth FC,14,14,0,1260,0,0,14,14,0,1216,1,0,28,28,0,2476,1,0,0,0,0,0,0,0,0,0,0,0,0,0
7150,7150,Lassana Diarra,2975,2007,Portsmouth FC,7,6,1,552,0,0,5,5,0,450,1,0,12,11,1,1002,1,0,0,3,3,0,1,1,0,0,0,0,0,0
7151,7151,Papa Bouba Diop,1757,2007,Portsmouth FC,11,11,0,962,0,0,13,13,0,1105,0,0,24,24,0,2067,0,0,0,0,0,0,0,0,0,0,0,0,0,0
7152,7152,Arnold Mvuemba,3449,2007,Portsmouth FC,3,0,3,25,0,0,5,3,2,289,0,0,8,3,5,314,0,0,0,0,0,0,0,0,0,0,0,0,0,0
7153,7153,Niko Kranjčar,1276,2007,Portsmouth FC,16,14,2,1312,1,0,17,16,1,1453,3,0,33,30,3,2765,4,0,0,3,3,0,1,1,0,0,0,0,0,0
7154,7154,Milan Baroš,1961,2007,Portsmouth FC,7,5,2,405,0,0,5,3,2,214,0,0,12,8,4,619,0,0,0,0,0,0,0,0,0,0,0,0,0,0
7155,7155,Lucas Radebe,2131,2000,Leeds United,9,9,0,742,0,0,9,8,1,742,0,0,18,17,1,1484,0,0,0,0,0,0,0,0,0,0,0,0,0,0
7156,7156,Andy Oakes,3354,2000,Derby County,3,3,0,270,0,0,3,3,0,190,0,0,6,6,0,460,0,0,0,0,0,0,0,0,0,0,0,0,0,0
7157,7157,Brian O'Neil,3450,2000,Derby County,2,1,1,78,0,0,2,2,0,101,0,0,4,3,1,179,0,0,0,0,0,0,0,0,0,0,0,0,0,0
7158,7158,Craig Burley,3412,2000,Derby County,11,11,0,917,1,0,12,12,0,1064,1,0,23,23,0,1981,2,0,3,0,3,1,1,2,0,0,0,0,0,0
7159,7159,Branko Strupar,3451,2000,Derby County,5,4,1,349,4,0,4,3,1,304,2,0,9,7,2,653,6,0,0,1,1,1,2,3,1,0,1,0,0,0
7160,7160,Bjørn Otto Bragstad,3452,2000,Derby County,5,5,0,433,0,0,6,4,2,457,0,0,11,9,2,890,0,0,0,0,0,0,0,0,0,0,0,0,0,0
7161,7161,Danny Higginbotham,1990,2000,Derby County,9,9,0,807,0,0,14,11,3,1002,0,0,23,20,3,1809,0,0,0,0,0,0,0,0,0,0,0,0,0,0
7162,7162,Lee Morris,3453,2000,Derby County,9,2,7,260,0,0,9,2,7,301,0,0,18,4,14,561,0,0,0,0,0,0,0,0,0,0,0,0,0,0
7163,7163,Lee Marshall,1308,2002,West Bromwich Albion,4,2,2,204,1,0,5,2,3,192,0,0,9,4,5,396,1,0,0,0,0,0,0,0,0,0,0,0,0,0
7164,7164,Steve Vickers,2066,2002,Birmingham City,3,3,0,270,0,0,2,2,0,124,0,0,5,5,0,394,0,0,0,0,0,0,0,0,0,0,0,0,0,0
7165,7165,Darren Carter,1515,2002,Birmingham City,5,2,3,200,0,0,7,1,6,182,0,0,12,3,9,382,0,0,0,0,0,0,0,0,0,0,0,0,0,0
7166,7166,Curtis Woodhouse,3454,2002,Birmingham City,0,0,0,0,0,0,3,0,3,43,0,0,3,0,3,43,0,0,0,0,0,0,0,0,0,0,0,0,0,0
7167,7167,Philippe Senderos,1228,2013,Fulham FC,8,8,0,667,0,0,4,4,0,360,1,0,12,12,0,1027,1,0,0,0,0,0,0,0,0,0,0,0,0,0
7168,7168,Elsad Zverotić,3455,2013,Fulham FC,2,2,0,140,0,0,4,3,1,266,0,0,6,5,1,406,0,0,0,0,0,0,0,0,0,0,0,0,0,0
7169,7169,David Marshall,2737,2013,Cardiff City,19,19,0,1710,0,0,18,18,0,1620,0,0,37,37,0,3330,0,0,0,0,0,0,0,0,0,0,0,0,0,0
7170,7170,Andrew Taylor,2574,2013,Cardiff City,11,11,0,943,0,0,7,7,0,630,0,0,18,18,0,1573,0,0,0,0,0,0,0,0,0,0,0,0,0,0
7171,7171,Steven Caulker,2806,2013,Cardiff City,19,19,0,1710,3,0,19,19,0,1710,2,0,38,38,0,3420,5,0,3,0,3,3,2,5,0,0,0,0,0,0
7172,7172,Ben Turner,3456,2013,Cardiff City,15,15,0,1350,0,0,16,15,1,1371,0,0,31,30,1,2721,0,0,0,0,0,0,0,0,0,0,0,0,0,0
7173,7173,Kévin Théophile-Catherine,3457,2013,Cardiff City,15,13,2,1186,0,0,13,13,0,1170,0,0,28,26,2,2356,0,0,0,0,0,0,0,0,0,0,0,0,0,0
7174,7174,Peter Whittingham,2969,2013,Cardiff City,14,14,0,1209,2,0,18,16,2,1455,1,0,32,30,2,2664,3,0,4,1,5,2,1,3,1,0,1,0,0,0
7175,7175,Gary Medel,3458,2013,Cardiff City,16,16,0,1398,0,0,18,18,0,1472,0,0,34,34,0,2870,0,0,0,0,0,0,0,0,0,0,0,0,0,0
7176,7176,Bo-kyung Kim,3459,2013,Cardiff City,14,10,4,792,1,0,14,11,3,885,0,0,28,21,7,1677,1,0,1,0,1,1,0,1,0,0,0,0,0,0
7177,7177,Aron Gunnarsson,3147,2013,Cardiff City,10,6,4,605,1,0,13,11,2,936,0,0,23,17,6,1541,1,0,0,0,0,1,0,1,0,0,0,0,0,0
7178,7178,Fraizer Campbell,1027,2013,Cardiff City,18,17,1,1418,5,0,19,15,4,1355,1,0,37,32,5,2773,6,0,0,0,0,3,0,3,0,0,0,0,0,0
7179,7179,Jordon Mutch,1024,2013,Cardiff City,16,13,3,1086,3,0,19,13,6,1177,4,0,35,26,9,2263,7,0,0,3,3,2,2,4,0,0,0,0,0,0
7180,7180,Nicky Maynard,3460,2013,Cardiff City,3,0,3,25,0,0,5,0,5,95,0,0,8,0,8,120,0,0,0,0,0,0,0,0,0,0,0,0,0,0
7181,7181,Craig Bellamy,2012,2013,Cardiff City,10,7,3,650,2,0,12,6,6,603,0,0,22,13,9,1253,2,0,0,0,0,2,0,2,0,0,0,0,0,0
7182,7182,Joe Lewis,3461,2013,Cardiff City,0,0,0,0,0,0,1,1,0,90,0,0,1,1,0,90,0,0,0,0,0,0,0,0,0,0,0,0,0,0
7183,7183,Mark Hudson,2970,2013,Cardiff City,1,1,0,78,0,0,1,1,0,69,0,0,2,2,0,147,0,0,0,0,0,0,0,0,0,0,0,0,0,0
7184,7184,Craig Noone,3462,2013,Cardiff City,11,8,3,769,0,0,6,5,1,454,1,0,17,13,4,1223,1,0,0,0,0,0,1,1,0,0,0,0,0,0
7185,7185,Don Cowie,3463,2013,Cardiff City,10,4,6,445,0,0,8,6,2,519,0,0,18,10,8,964,0,0,0,0,0,0,0,0,0,0,0,0,0,0
7186,7186,Dean Henderson,3464,2019,Sheffield United,18,18,0,1620,0,0,18,18,0,1620,0,0,36,36,0,3240,0,0,0,0,0,0,0,0,0,0,0,0,0,0
7187,7187,George Baldock,3465,2019,Sheffield United,19,19,0,1710,0,0,19,19,0,1710,2,0,38,38,0,3420,2,0,0,4,4,0,2,2,0,0,0,0,0,0
7188,7188,Enda Stevens,1972,2019,Sheffield United,19,19,0,1637,1,0,19,19,0,1710,1,0,38,38,0,3347,2,0,0,0,0,1,1,2,0,0,0,0,0,0
7189,7189,Jack O'Connell,3466,2019,Sheffield United,18,18,0,1620,0,0,15,14,1,1295,0,0,33,32,1,2915,0,0,0,0,0,0,0,0,0,0,0,0,0,0
7190,7190,Chris Basham,2601,2019,Sheffield United,19,19,0,1629,0,0,19,19,0,1626,0,0,38,38,0,3255,0,0,0,0,0,0,0,0,0,0,0,0,0,0
7191,7191,John Egan,3467,2019,Sheffield United,18,18,0,1609,1,0,18,18,0,1620,1,0,36,36,0,3229,2,0,3,1,4,1,1,2,0,0,0,0,0,0
7192,7192,John Fleck,3468,2019,Sheffield United,15,14,1,1229,4,0,15,14,1,1287,1,0,30,28,2,2516,5,0,0,1,1,2,1,3,0,0,0,0,0,0
7193,7193,Oliver Norwood,3469,2019,Sheffield United,19,19,0,1649,1,0,19,18,1,1452,0,0,38,37,1,3101,1,0,1,0,1,1,0,1,1,0,1,0,0,0
7194,7194,Muhamed Bešić,2236,2019,Sheffield United,3,1,2,102,0,0,6,1,5,143,0,0,9,2,7,245,0,0,0,0,0,0,0,0,0,0,0,0,0,0
7195,7195,Oliver McBurnie,3197,2019,Sheffield United,19,13,6,1155,5,0,17,11,6,963,1,0,36,24,12,2118,6,0,4,3,7,3,1,4,0,0,0,0,0,0
7196,7196,Billy Sharp,3470,2019,Sheffield United,13,6,7,580,2,0,12,4,8,472,1,0,25,10,15,1052,3,0,3,1,4,2,1,3,0,0,0,0,0,0
7197,7197,John Lundstram,3471,2019,Sheffield United,17,12,5,1140,4,0,17,14,3,1315,1,0,34,26,8,2455,5,0,6,0,6,3,1,4,0,0,0,0,0,0
7198,7198,Callum Robinson,3472,2019,Sheffield United,6,3,3,195,0,0,10,6,4,481,1,0,16,9,7,676,1,0,0,0,0,0,0,0,0,0,0,0,0,0
7199,7199,Lys Mousset,1044,2019,Sheffield United,14,4,10,524,3,0,16,7,9,708,3,0,30,11,19,1232,6,0,3,1,4,1,2,3,0,0,0,0,0,0
7200,7200,Michael Verrips,3473,2019,Sheffield United,0,0,0,0,0,0,0,0,0,0,0,0,0,0,0,0,0,0,0,0,0,0,0,0,0,0,0,0,0,0
7201,7201,Phil Jagielka,1048,2019,Sheffield United,4,1,3,124,0,0,2,1,1,116,0,0,6,2,4,240,0,0,0,0,0,0,0,0,0,0,0,0,0,0
7202,7202,Kieron Freeman,3474,2019,Sheffield United,1,0,1,1,0,0,1,0,1,5,0,0,2,0,2,6,0,0,0,0,0,0,0,0,0,0,0,0,0,0
7203,7203,Ben Osborn,3475,2019,Sheffield United,7,4,3,404,0,0,6,2,4,187,0,0,13,6,7,591,0,0,0,0,0,0,0,0,0,0,0,0,0,0
7204,7204,Eric García,3476,2019,Manchester City,7,5,2,477,0,0,6,3,3,313,0,0,13,8,5,790,0,0,0,0,0,0,0,0,0,0,0,0,0,0
7205,7205,William Gallas,2040,2012,Tottenham Hotspur,9,8,1,721,1,0,10,8,2,805,0,0,19,16,3,1526,1,0,0,0,0,1,0,1,0,0,0,0,0,0
7206,7206,Mousa Dembélé,1172,2012,Tottenham Hotspur,16,13,3,1130,1,0,14,13,1,1080,0,0,30,26,4,2210,1,0,0,0,0,1,0,1,0,0,0,0,0,0
7207,7207,Sandro,2409,2012,Tottenham Hotspur,11,11,0,858,0,0,11,11,0,921,1,0,22,22,0,1779,1,0,0,0,0,0,1,1,0,0,0,0,0,0
7208,7208,Iago Falqué,3477,2012,Tottenham Hotspur,0,0,0,0,0,0,1,0,1,5,0,0,1,0,1,5,0,0,0,0,0,0,0,0,0,0,0,0,0,0
7209,7209,Ryan Mason,1166,2012,Tottenham Hotspur,0,0,0,0,0,0,0,0,0,0,0,0,0,0,0,0,0,0,0,0,0,0,0,0,0,0,0,0,0,0
7210,7210,Max Ehmer,3478,2012,Queens Park Rangers,0,0,0,0,0,0,0,0,0,0,0,0,0,0,0,0,0,0,0,0,0,0,0,0,0,0,0,0,0,0
7211,7211,Mbulelo Mabizela,3479,2003,Tottenham Hotspur,2,0,2,6,0,0,4,0,4,95,1,0,6,0,6,101,1,0,0,0,0,0,1,1,0,0,0,0,0,0
7212,7212,Jonathan Blondel,3480,2003,Tottenham Hotspur,1,0,1,27,0,0,0,0,0,0,0,0,1,0,1,27,0,0,0,0,0,0,0,0,0,0,0,0,0,0
7213,7213,Simon Charlton,2388,2003,Bolton Wanderers,15,14,1,1178,0,0,16,14,2,1290,0,0,31,28,3,2468,0,0,0,0,0,0,0,0,0,0,0,0,0,0
7214,7214,Ricardo Gardner,2411,2003,Bolton Wanderers,11,10,1,873,0,0,11,10,1,905,0,0,22,20,2,1778,0,0,0,0,0,0,0,0,0,0,0,0,0,0
7215,7215,Thomas Sørensen,1090,2002,Sunderland AFC,12,12,0,1080,0,0,9,9,0,733,0,0,21,21,0,1813,0,0,0,0,0,0,0,0,0,0,0,0,0,0
7216,7216,Stephen Wright,3024,2002,Sunderland AFC,13,13,0,1067,0,0,13,12,1,1115,0,0,26,25,1,2182,0,0,0,0,0,0,0,0,0,0,0,0,0,0
7217,7217,Michael Gray,1092,2002,Sunderland AFC,17,17,0,1478,0,0,15,15,0,1313,1,0,32,32,0,2791,1,0,0,0,0,0,1,1,0,0,0,0,0,0
7218,7218,Phil Babb,3481,2002,Sunderland AFC,13,13,0,1144,0,0,13,13,0,1170,0,0,26,26,0,2314,0,0,0,0,0,0,0,0,0,0,0,0,0,0
7219,7219,Jody Craddock,1093,2002,Sunderland AFC,12,12,0,1080,0,0,13,13,0,1170,1,0,25,25,0,2250,1,0,0,0,0,0,0,0,0,0,0,0,0,0
7220,7220,Gavin McCann,1096,2002,Sunderland AFC,15,14,1,1223,1,0,15,15,0,1244,0,0,30,29,1,2467,1,0,0,0,0,1,0,1,0,0,0,0,0,0
7221,7221,Kevin Kilbane,1103,2002,Sunderland AFC,14,14,0,1223,0,0,16,16,0,1420,1,0,30,30,0,2643,1,0,0,0,0,0,1,1,0,0,0,0,0,0
7222,7222,Julio Arca,1341,2002,Sunderland AFC,8,4,4,517,0,0,5,3,2,266,0,0,13,7,6,783,0,0,0,0,0,0,0,0,0,0,0,0,0,0
7223,7223,Tore André Flo,3482,2002,Sunderland AFC,13,12,1,999,2,0,16,11,5,996,2,0,29,23,6,1995,4,0,1,0,1,1,2,3,0,0,0,0,0,0
7224,7224,Kevin Phillips,1100,2002,Sunderland AFC,16,16,0,1414,3,0,16,16,0,1334,3,0,32,32,0,2748,6,0,0,1,1,1,2,3,1,0,1,0,0,0
7225,7225,Michael Proctor,3483,2002,Sunderland AFC,12,9,3,724,2,0,9,2,7,293,0,0,21,11,10,1017,2,0,3,0,3,2,0,2,0,0,0,0,0,0
7226,7226,George McCartney,1340,2002,Sunderland AFC,12,7,5,720,0,0,12,9,3,833,0,0,24,16,8,1553,0,0,0,0,0,0,0,0,0,0,0,0,0,0
7227,7227,Marcus Stewart,2722,2002,Sunderland AFC,12,5,7,500,1,0,7,4,3,344,0,0,19,9,10,844,1,0,0,0,0,0,0,0,0,0,0,0,0,0
7228,7228,Jonathan Fortune,2665,2002,Charlton Athletic,11,10,1,874,0,0,14,11,3,1086,1,0,25,21,4,1960,1,0,0,0,0,0,0,0,0,0,0,0,0,0
7229,7229,Claus Jensen,1674,2002,Charlton Athletic,17,15,2,1399,3,0,17,16,1,1413,3,0,34,31,3,2812,6,0,0,0,0,2,3,5,0,0,0,0,0,0
7230,7230,Chris Bart-Williams,2685,2002,Charlton Athletic,6,3,3,238,0,0,7,4,3,373,1,0,13,7,6,611,1,0,0,0,0,0,1,1,0,1,1,0,0,0
7231,7231,Aly Cissokho,1422,2014,Aston Villa,13,12,1,1110,0,0,12,12,0,1023,0,0,25,24,1,2133,0,0,0,0,0,0,0,0,0,0,0,0,0,0
7232,7232,Kieran Richardson,1898,2014,Aston Villa,11,8,3,687,0,0,11,8,3,725,0,0,22,16,6,1412,0,0,0,0,0,0,0,0,0,0,0,0,0,0
7233,7233,Darren Bent,1958,2014,Aston Villa,4,0,4,36,0,0,3,0,3,43,0,0,7,0,7,79,0,0,0,0,0,0,0,0,0,0,0,0,0,0
7234,7234,Nathan Baker,1973,2014,Aston Villa,5,4,1,368,0,0,6,4,2,395,0,0,11,8,3,763,0,0,0,0,0,0,0,0,0,0,0,0,0,0
7235,7235,Joe Cole,1630,2014,Aston Villa,4,0,4,38,0,0,8,3,5,241,1,0,12,3,9,279,1,0,0,0,0,0,1,1,0,0,0,0,0,0
7236,7236,Hassan Kachloul,3484,2000,Southampton FC,13,12,1,1019,2,0,16,12,4,1108,2,0,29,24,5,2127,4,0,0,0,0,2,1,3,0,0,0,0,0,0
7237,7237,Matt Oakley,1573,2000,Southampton FC,16,16,0,1367,1,0,16,16,0,1328,0,0,32,32,0,2695,1,0,0,0,0,1,0,1,0,0,0,0,0,0
7238,7238,Francis Benali,3384,2000,Southampton FC,2,0,2,15,0,0,2,0,2,46,0,0,4,0,4,61,0,0,0,0,0,0,0,0,0,0,0,0,0,0
7239,7239,Matt Phillips,1660,2016,West Bromwich Albion,13,13,0,1069,2,0,14,13,1,1124,2,0,27,26,1,2193,4,0,0,3,3,1,2,3,0,0,0,0,0,0
7240,7240,Daniel Bachmann,3485,2017,Watford FC,0,0,0,0,0,0,0,0,0,0,0,0,0,0,0,0,0,0,0,0,0,0,0,0,0,0,0,0,0,0
7241,7241,Jerome Thomas,1736,2012,West Bromwich Albion,5,1,4,143,0,0,5,3,2,258,0,0,10,4,6,401,0,0,0,0,0,0,0,0,0,0,0,0,0,0
7242,7242,Kemar Roofe,3486,2012,West Bromwich Albion,0,0,0,0,0,0,0,0,0,0,0,0,0,0,0,0,0,0,0,0,0,0,0,0,0,0,0,0,0,0
7243,7243,Rob Elliot,2456,2012,Newcastle United,4,3,1,303,0,0,6,6,0,540,0,0,10,9,1,843,0,0,0,0,0,0,0,0,0,0,0,0,0,0
7244,7244,Mapou Yanga-Mbiwa,2452,2012,Newcastle United,7,5,2,487,0,0,7,6,1,551,0,0,14,11,3,1038,0,0,0,0,0,0,0,0,0,0,0,0,0,0
7245,7245,James Perch,2400,2012,Newcastle United,11,9,2,801,0,0,16,10,6,1019,1,0,27,19,8,1820,1,0,0,0,0,0,1,1,0,0,0,0,0,0
7246,7246,Massadio Haïdara,2280,2012,Newcastle United,2,1,1,106,0,0,2,1,1,156,0,0,4,2,2,262,0,0,0,0,0,0,0,0,0,0,0,0,0,0
7247,7247,Mathieu Debuchy,2453,2012,Newcastle United,7,7,0,630,0,0,7,7,0,553,0,0,14,14,0,1183,0,0,0,0,0,0,0,0,0,0,0,0,0,0
7248,7248,Steven Taylor,2014,2012,Newcastle United,12,12,0,1080,0,0,13,12,1,1058,0,0,25,24,1,2138,0,0,0,0,0,0,0,0,0,0,0,0,0,0
7249,7249,Yohan Cabaye,1029,2012,Newcastle United,14,14,0,1151,3,0,12,11,1,971,3,0,26,25,1,2122,6,0,0,0,0,3,2,5,1,0,1,0,0,0
7250,7250,Moussa Sissoko,1858,2012,Newcastle United,6,6,0,540,3,0,6,6,0,529,0,0,12,12,0,1069,3,0,3,0,3,3,0,3,0,0,0,0,0,0
7251,7251,Jonás Gutiérrez,2398,2012,Newcastle United,17,17,0,1372,1,0,17,17,0,1526,0,0,34,34,0,2898,1,0,0,0,0,1,0,1,0,0,0,0,0,0
7252,7252,Papiss Demba Cissé,2282,2012,Newcastle United,18,17,1,1426,5,0,18,18,0,1575,3,0,36,35,1,3001,8,0,9,0,9,5,3,8,0,0,0,0,0,0
7253,7253,Yoan Gouffran,2454,2012,Newcastle United,7,6,1,481,0,0,8,8,0,576,3,0,15,14,1,1057,3,0,0,3,3,0,3,3,0,0,0,0,0,0
7254,7254,Hatem Ben Arfa,2457,2012,Newcastle United,10,8,2,786,2,0,9,8,1,671,2,0,19,16,3,1457,4,0,4,0,4,2,2,4,1,1,2,0,0,0
7255,7255,Dan Gosling,1005,2012,Newcastle United,0,0,0,0,0,0,3,0,3,41,0,0,3,0,3,41,0,0,0,0,0,0,0,0,0,0,0,0,0,0
7256,7256,Shola Ameobi,1950,2012,Newcastle United,11,3,8,468,1,0,10,1,9,169,0,0,21,4,17,637,1,0,3,0,3,1,0,1,0,0,0,0,0,0
7257,7257,Steve Harper,2231,2012,Newcastle United,3,3,0,270,0,0,3,2,1,188,0,0,6,5,1,458,0,0,0,0,0,0,0,0,0,0,0,0,0,0
7258,7258,Mike Williamson,2287,2012,Newcastle United,10,10,0,900,0,0,9,9,0,810,0,0,19,19,0,1710,0,0,0,0,0,0,0,0,0,0,0,0,0,0
7259,7259,Vurnon Anita,2281,2012,Newcastle United,15,8,7,941,0,0,10,9,1,790,0,0,25,17,8,1731,0,0,0,0,0,0,0,0,0,0,0,0,0,0
7260,7260,Adam Campbell,3487,2012,Newcastle United,3,0,3,22,0,0,0,0,0,0,0,0,3,0,3,22,0,0,0,0,0,0,0,0,0,0,0,0,0,0
7261,7261,Asmir Begović,1036,2009,Stoke City,1,1,0,90,0,0,3,2,1,234,0,0,4,3,1,324,0,0,0,0,0,0,0,0,0,0,0,0,0,0
7262,7262,Ryan Shawcross,1547,2009,Stoke City,15,15,0,1350,2,0,13,12,1,1123,0,0,28,27,1,2473,2,0,1,0,1,2,0,2,0,0,0,0,0,0
7263,7263,Andy Wilkinson,1553,2009,Stoke City,10,9,1,874,0,0,15,12,3,1178,0,0,25,21,4,2052,0,0,0,0,0,0,0,0,0,0,0,0,0,0
7264,7264,Salif Diao,1992,2009,Stoke City,6,4,2,318,0,0,10,7,3,626,1,0,16,11,5,944,1,0,0,3,3,0,1,1,0,0,0,0,0,0
7265,7265,Patrice Evra,1724,2007,Manchester United,16,16,0,1337,0,0,17,17,0,1486,0,0,33,33,0,2823,0,0,0,0,0,0,0,0,0,0,0,0,0,0
7266,7266,Chris Eagles,2491,2007,Manchester United,2,1,1,99,0,0,2,0,2,33,0,0,4,1,3,132,0,0,0,0,0,0,0,0,0,0,0,0,0,0
7267,7267,Darren Fletcher,1730,2007,Manchester United,9,1,8,238,0,0,7,4,3,402,0,0,16,5,11,640,0,0,0,0,0,0,0,0,0,0,0,0,0,0
7268,7268,Louis Saha,1727,2007,Manchester United,8,2,6,274,2,0,9,4,5,457,3,0,17,6,11,731,5,0,3,0,3,1,0,1,1,1,2,0,0,0
7269,7269,Danny Higginbotham,1990,2007,Sunderland AFC,9,9,0,810,3,0,11,11,0,990,0,0,20,20,0,1800,3,0,0,0,0,3,0,3,0,0,0,0,0,0
7270,7270,Anthony Stokes,3488,2007,Sunderland AFC,10,5,5,480,1,0,10,3,7,262,0,0,20,8,12,742,1,0,3,0,3,1,0,1,0,0,0,0,0,0
7271,7271,Daryl Murphy,1900,2007,Sunderland AFC,14,9,5,837,3,0,13,11,2,942,0,0,27,20,7,1779,3,0,0,0,0,1,0,1,0,0,0,0,0,0
7272,7272,Steve Gohouri,2881,2009,Wigan Athletic,3,3,0,270,1,0,2,1,1,98,0,0,5,4,1,368,1,0,1,0,1,1,0,1,0,0,0,0,0,0
7273,7273,Ben Watson,2025,2009,Wigan Athletic,2,2,0,180,1,0,3,2,1,155,0,0,5,4,1,335,1,0,0,0,0,0,0,0,0,0,0,0,0,0
7274,7274,Marcelo Moreno,3489,2009,Wigan Athletic,8,6,2,507,0,0,4,3,1,221,0,0,12,9,3,728,0,0,0,0,0,0,0,0,0,0,0,0,0,0
7275,7275,Łukasz Fabiański,1227,2009,Arsenal FC,2,2,0,180,0,0,2,2,0,180,0,0,4,4,0,360,0,0,0,0,0,0,0,0,0,0,0,0,0,0
7276,7276,Bacary Sagna,1596,2009,Arsenal FC,16,12,4,1115,0,0,19,19,0,1643,0,0,35,31,4,2758,0,0,0,0,0,0,0,0,0,0,0,0,0,0
7277,7277,Mikaël Silvestre,1106,2009,Arsenal FC,7,6,1,514,0,0,5,3,2,343,1,0,12,9,3,857,1,0,0,0,0,0,0,0,0,0,0,0,0,0
7278,7278,Gaël Clichy,1230,2009,Arsenal FC,11,11,0,990,0,0,13,12,1,1096,0,0,24,23,1,2086,0,0,0,0,0,0,0,0,0,0,0,0,0,0
7279,7279,Sol Campbell,1388,2009,Arsenal FC,4,4,0,360,0,0,7,6,1,596,0,0,11,10,1,956,0,0,0,0,0,0,0,0,0,0,0,0,0,0
7280,7280,Abou Diaby,2434,2009,Arsenal FC,14,12,2,1126,6,0,15,14,1,1196,0,0,29,26,3,2322,6,0,3,0,3,2,0,2,0,0,0,0,0,0
7281,7281,Tomáš Rosický,1509,2009,Arsenal FC,13,8,5,707,2,0,12,6,6,597,1,0,25,14,11,1304,3,0,1,0,1,1,0,1,0,0,0,0,0,0
7282,7282,Samir Nasri,1358,2009,Arsenal FC,13,12,1,963,0,0,13,10,3,922,2,0,26,22,4,1885,2,0,0,0,0,0,1,1,0,0,0,0,0,0
7283,7283,Craig Eastmond,3490,2009,Arsenal FC,1,0,1,13,0,0,3,2,1,158,0,0,4,2,2,171,0,0,0,0,0,0,0,0,0,0,0,0,0,0
7284,7284,Theo Walcott,1237,2009,Arsenal FC,13,6,7,595,2,0,10,6,4,533,1,0,23,12,11,1128,3,0,0,0,0,1,1,2,0,0,0,0,0,0
7285,7285,Nicklas Bendtner,1236,2009,Arsenal FC,11,5,6,455,3,0,12,8,4,773,3,0,23,13,10,1228,6,0,3,3,6,2,2,4,0,0,0,0,0,0
7286,7286,Emmanuel Eboué,1231,2009,Arsenal FC,14,11,3,962,0,0,11,6,5,534,0,0,25,17,8,1496,0,0,0,0,0,0,0,0,0,0,0,0,0,0
7287,7287,Fran Mérida,3491,2009,Arsenal FC,2,0,2,25,0,0,2,0,2,36,1,0,4,0,4,61,1,0,0,0,0,0,0,0,0,0,0,0,0,0
7288,7288,Robin van Persie,1528,2009,Arsenal FC,7,7,0,626,5,0,9,7,2,629,4,0,16,14,2,1255,9,0,0,3,3,3,4,7,0,0,0,0,0,0
7289,7289,Fraser Forster,1240,2015,Southampton FC,9,9,0,810,0,0,9,9,0,810,0,0,18,18,0,1620,0,0,0,0,0,0,0,0,0,0,0,0,0,0
7290,7290,Cédric Soares,1910,2015,Southampton FC,12,12,0,1013,0,0,12,11,1,958,0,0,24,23,1,1971,0,0,0,0,0,0,0,0,0,0,0,0,0,0
7291,7291,Maya Yoshida,1145,2015,Southampton FC,8,4,4,449,1,0,12,6,6,564,0,0,20,10,10,1013,1,0,3,0,3,1,0,1,0,0,0,0,0,0
7292,7292,José Fonte,1146,2015,Southampton FC,19,19,0,1666,2,0,18,18,0,1514,0,0,37,37,0,3180,2,0,0,0,0,1,0,1,0,0,0,0,0,0
7293,7293,Virgil van Dijk,1241,2015,Southampton FC,17,17,0,1530,3,0,17,17,0,1530,0,0,34,34,0,3060,3,0,1,0,1,2,0,2,0,0,0,0,0,0
7294,7294,Ryan Bertrand,1148,2015,Southampton FC,16,16,0,1440,1,0,16,16,0,1440,0,0,32,32,0,2880,1,0,0,0,0,0,0,0,1,0,1,0,0,0
7295,7295,Oriol Romeu,1243,2015,Southampton FC,16,7,9,766,1,0,13,10,3,842,0,0,29,17,12,1608,1,0,1,0,1,1,0,1,0,0,0,0,0,0
7296,7296,James Ward-Prowse,1150,2015,Southampton FC,18,7,11,761,2,0,15,7,8,771,0,0,33,14,19,1532,2,0,0,0,0,1,0,1,1,0,1,0,0,0
7297,7297,Shane Long,1154,2015,Southampton FC,14,11,3,961,6,0,14,12,2,1150,4,0,28,23,5,2111,10,0,0,4,4,4,3,7,0,0,0,0,0,0
7298,7298,Sadio Mané,1151,2015,Southampton FC,19,16,3,1405,7,0,18,14,4,1201,4,0,37,30,7,2606,11,0,3,2,5,2,3,5,0,0,0,0,0,0
7299,7299,Charlie Austin,1245,2015,Southampton FC,3,1,2,104,0,0,4,1,3,104,1,0,7,2,5,208,1,0,0,3,3,0,1,1,0,0,0,0,0,0
7300,7300,Steven Davis,1149,2015,Southampton FC,17,16,1,1250,2,0,17,15,2,1363,3,0,34,31,3,2613,5,0,0,3,3,1,3,4,0,0,0,0,0,0
7301,7301,Dušan Tadić,1159,2015,Southampton FC,17,14,3,1116,5,0,17,13,4,1175,3,0,34,27,7,2291,8,0,0,3,3,0,1,1,0,1,1,0,0,0
7302,7302,Graziano Pellè,1152,2015,Southampton FC,16,13,3,1226,7,0,14,10,4,946,4,0,30,23,7,2172,11,0,0,0,0,3,2,5,0,0,0,0,0,0
7303,7303,Maarten Stekelenburg,1465,2015,Southampton FC,8,8,0,720,0,0,9,9,0,810,0,0,17,17,0,1530,0,0,0,0,0,0,0,0,0,0,0,0,0,0
7304,7304,Cuco Martina,1049,2015,Southampton FC,9,6,3,608,1,0,6,5,1,474,0,0,15,11,4,1082,1,0,0,0,0,1,0,1,0,0,0,0,0,0
7305,7305,Matt Targett,1158,2015,Southampton FC,6,6,0,495,0,0,8,7,1,576,0,0,14,13,1,1071,0,0,0,0,0,0,0,0,0,0,0,0,0,0
7306,7306,Jordy Clasie,1242,2015,Southampton FC,12,11,1,827,0,0,10,9,1,724,0,0,22,20,2,1551,0,0,0,0,0,0,0,0,0,0,0,0,0,0
7307,7307,Pablo Hernández,3492,2013,Swansea City,14,9,5,651,1,0,13,8,5,776,1,0,27,17,10,1427,2,0,0,0,0,0,0,0,0,0,0,0,0,0
7308,7308,Winston Reid,2638,2013,West Ham United,10,8,2,748,0,0,12,10,2,926,1,0,22,18,4,1674,1,0,0,0,0,0,1,1,0,0,0,0,0,0
7309,7309,Ravel Morrison,3419,2013,West Ham United,8,5,3,533,1,0,8,7,1,620,2,0,16,12,4,1153,3,0,0,0,0,1,1,2,0,0,0,0,0,0
7310,7310,Stewart Downing,1335,2013,West Ham United,15,14,1,1241,1,0,17,15,2,1271,0,0,32,29,3,2512,1,0,0,0,0,0,0,0,0,0,0,0,0,0
7311,7311,Ricardo Vaz Tê,3416,2013,West Ham United,3,1,2,84,1,0,5,2,3,173,1,0,8,3,5,257,2,0,0,0,0,0,0,0,0,0,0,0,0,0
7312,7312,Joe Hart,1363,2008,Manchester City,12,12,0,1080,0,0,9,9,0,739,0,0,21,21,0,1819,0,0,0,0,0,0,0,0,0,0,0,0,0,0
7313,7313,Micah Richards,1364,2008,Manchester City,17,17,0,1429,1,0,16,15,1,1192,0,0,33,32,1,2621,1,0,3,0,3,1,0,1,0,0,0,0,0,0
7314,7314,Javi Garrido,1381,2008,Manchester City,9,7,2,645,1,0,3,3,0,263,0,0,12,10,2,908,1,0,0,0,0,0,0,0,0,0,0,0,0,0
7315,7315,Shaun Wright-Phillips,1683,2008,Manchester City,15,15,0,1350,3,0,11,11,0,983,2,0,26,26,0,2333,5,0,0,0,0,1,0,1,0,0,0,0,0,0
7316,7316,Darius Vassell,1798,2008,Manchester City,4,3,1,158,0,0,3,2,1,199,0,0,7,5,2,357,0,0,0,0,0,0,0,0,0,0,0,0,0,0
7317,7317,Benjani,1391,2008,Manchester City,4,4,0,314,0,0,3,2,1,161,1,0,7,6,1,475,1,0,0,0,0,0,1,1,0,0,0,0,0,0
7318,7318,Dietmar Hamann,2690,2008,Manchester City,5,2,3,211,0,0,3,2,1,176,0,0,8,4,4,387,0,0,0,0,0,0,0,0,0,0,0,0,0,0
7319,7319,Mikaël Silvestre,1106,2008,Arsenal FC,8,7,1,587,1,0,5,4,1,415,1,0,13,11,2,1002,2,0,0,0,0,1,1,2,0,0,0,0,0,0
7320,7320,Gavin Hoyte,3493,2008,Arsenal FC,0,0,0,0,0,0,1,1,0,60,0,0,1,1,0,60,0,0,0,0,0,0,0,0,0,0,0,0,0,0
7321,7321,Aaron Ramsey,1501,2008,Arsenal FC,3,0,3,28,0,0,5,1,4,148,0,0,8,1,7,176,0,0,0,0,0,0,0,0,0,0,0,0,0,0
7322,7322,Carlos Vela,3285,2008,Arsenal FC,10,1,9,288,0,0,4,1,3,132,1,0,14,2,12,420,1,0,0,0,0,0,0,0,0,0,0,0,0,0
7323,7323,Alpay Özalan,2765,2002,Aston Villa,3,3,0,270,0,0,2,2,0,180,0,0,5,5,0,450,0,0,0,0,0,0,0,0,0,0,0,0,0,0
7324,7324,Steve Staunton,3494,2002,Aston Villa,11,9,2,873,0,0,14,12,2,1143,0,0,25,21,4,2016,0,0,0,0,0,0,0,0,0,0,0,0,0,0
7325,7325,Mark Kinsella,1677,2002,Aston Villa,10,7,3,636,0,0,9,8,1,745,0,0,19,15,4,1381,0,0,0,0,0,0,0,0,0,0,0,0,0,0
7326,7326,Juan Pablo Ángel,1795,2002,Aston Villa,8,5,3,452,1,0,7,3,4,330,0,0,15,8,7,782,1,0,0,0,0,1,0,1,0,0,0,0,0,0
7327,7327,Marcus Allbäck,3270,2002,Aston Villa,9,3,6,367,4,0,11,6,5,608,1,0,20,9,11,975,5,0,3,0,3,3,1,4,0,0,0,0,0,0
7328,7328,John Robinson,1678,2002,Charlton Athletic,6,4,2,429,0,0,7,6,1,495,0,0,13,10,3,924,0,0,0,0,0,0,0,0,0,0,0,0,0,0
7329,7329,Mathias Svensson,2335,2002,Charlton Athletic,9,1,8,154,0,0,6,3,3,265,0,0,15,4,11,419,0,0,0,0,0,0,0,0,0,0,0,0,0,0
7330,7330,Steve Brown,2686,2002,Charlton Athletic,1,0,1,19,0,0,2,0,2,105,0,0,3,0,3,124,0,0,0,0,0,0,0,0,0,0,0,0,0,0
7331,7331,Leon Osman,1747,2003,Everton FC,2,1,1,99,0,0,2,2,0,180,1,0,4,3,1,279,1,0,0,0,0,0,1,1,0,0,0,0,0,0
7332,7332,Francis Jeffers,2359,2003,Everton FC,11,4,7,400,0,0,6,1,5,183,0,0,17,5,12,583,0,0,0,0,0,0,0,0,0,0,0,0,0,0
7333,7333,Steffen Iversen,2080,2003,Wolverhampton Wanderers,9,7,2,563,3,0,7,4,3,315,1,0,16,11,5,878,4,0,1,0,1,2,0,2,0,0,0,0,0,0
7334,7334,Jóhannes Guðjónsson,3064,2003,Wolverhampton Wanderers,5,3,2,208,0,0,6,2,4,246,0,0,11,5,6,454,0,0,0,0,0,0,0,0,0,0,0,0,0,0
7335,7335,John Lukic,3495,2000,Arsenal FC,2,2,0,180,0,0,1,1,0,90,0,0,3,3,0,270,0,0,0,0,0,0,0,0,0,0,0,0,0,0
7336,7336,Sylvinho,3496,2000,Arsenal FC,12,11,1,959,1,0,11,11,0,964,1,0,23,22,1,1923,2,0,0,1,1,0,1,1,0,0,0,0,0,0
7337,7337,Lilian Martin,3497,2000,Derby County,5,4,1,323,0,0,4,3,1,224,0,0,9,7,2,547,0,0,0,0,0,0,0,0,0,0,0,0,0,0
7338,7338,Simo Valakari,3359,2000,Derby County,6,5,1,470,1,0,4,3,1,291,0,0,10,8,2,761,1,0,0,0,0,0,0,0,0,0,0,0,0,0
7339,7339,Scott Carson,1999,2006,Charlton Athletic,18,18,0,1620,0,0,18,18,0,1620,0,0,36,36,0,3240,0,0,0,0,0,0,0,0,0,0,0,0,0,0
7340,7340,Hermann Hreiðarsson,1953,2006,Charlton Athletic,17,16,1,1393,0,0,14,14,0,1260,0,0,31,30,1,2653,0,0,0,0,0,0,0,0,0,0,0,0,0,0
7341,7341,Radostin Kishishev,1668,2006,Charlton Athletic,6,4,2,402,0,0,8,2,6,249,0,0,14,6,8,651,0,0,0,0,0,0,0,0,0,0,0,0,0,0
7342,7342,Talal El-Karkouri,1959,2006,Charlton Athletic,19,19,0,1710,2,0,17,17,0,1530,1,0,36,36,0,3240,3,0,3,1,4,2,1,3,0,0,0,0,0,0
7343,7343,Djimi Traoré,2364,2006,Charlton Athletic,6,6,0,476,0,0,5,5,0,385,0,0,11,11,0,861,0,0,0,0,0,0,0,0,0,0,0,0,0,0
7344,7344,Osei Sankofa,3498,2006,Charlton Athletic,3,3,0,270,0,0,6,6,0,540,0,0,9,9,0,810,0,0,0,0,0,0,0,0,0,0,0,0,0,0
7345,7345,Matt Holland,1955,2006,Charlton Athletic,17,13,4,1235,0,0,16,14,2,1209,1,0,33,27,6,2444,1,0,0,0,0,0,1,1,0,0,0,0,0,0
7346,7346,Darren Ambrose,1956,2006,Charlton Athletic,14,11,3,966,2,0,12,10,2,786,1,0,26,21,5,1752,3,0,0,1,1,2,1,3,0,0,0,0,0,0
7347,7347,Jerome Thomas,1736,2006,Charlton Athletic,11,9,2,747,3,0,9,7,2,615,0,0,20,16,4,1362,3,0,0,0,0,0,0,0,1,0,1,0,0,0
7348,7348,Marcus Bent,1349,2006,Charlton Athletic,14,9,5,665,0,0,16,8,8,816,1,0,30,17,13,1481,1,0,0,0,0,0,0,0,0,0,0,0,0,0
7349,7349,Darren Bent,1958,2006,Charlton Athletic,17,17,0,1515,8,0,15,15,0,1350,6,0,32,32,0,2865,14,0,6,0,6,6,4,10,2,1,3,0,0,0
7350,7350,Bryan Hughes,1957,2006,Charlton Athletic,11,5,6,599,1,0,13,10,3,877,0,0,24,15,9,1476,1,0,3,0,3,1,0,1,0,0,0,0,0,0
7351,7351,Jimmy Floyd Hasselbaink,1337,2006,Charlton Athletic,14,6,8,683,1,0,11,5,6,426,1,0,25,11,14,1109,2,0,0,0,0,1,1,2,0,0,0,0,0,0
7352,7352,Dennis Rommedahl,2747,2006,Charlton Athletic,13,10,3,851,0,0,15,9,6,900,0,0,28,19,9,1751,0,0,0,0,0,0,0,0,0,0,0,0,0,0
7353,7353,Tim Howard,1743,2004,Manchester United,6,6,0,540,0,0,6,6,0,540,0,0,12,12,0,1080,0,0,0,0,0,0,0,0,0,0,0,0,0,0
7354,7354,Wes Brown,1108,2004,Manchester United,8,8,0,720,1,0,13,10,3,944,0,0,21,18,3,1664,1,0,3,0,3,1,0,1,0,0,0,0,0,0
7355,7355,Roy Keane,1111,2004,Manchester United,15,14,1,1320,1,0,15,13,2,1200,0,0,30,27,3,2520,1,0,0,0,0,1,0,1,0,0,0,0,0,0
7356,7356,Quinton Fortune,2782,2004,Manchester United,9,6,3,554,0,0,8,6,2,488,0,0,17,12,5,1042,0,0,0,0,0,0,0,0,0,0,0,0,0,0
7357,7357,Darren Fletcher,1730,2004,Manchester United,8,8,0,582,0,0,10,10,0,798,3,0,18,18,0,1380,3,0,0,0,0,0,2,2,0,0,0,0,0,0
7358,7358,Kléberson,3499,2004,Manchester United,3,2,1,160,0,0,5,4,1,255,0,0,8,6,2,415,0,0,0,0,0,0,0,0,0,0,0,0,0,0
7359,7359,Jean-Alain Boumsong,1946,2004,Newcastle United,7,7,0,630,0,0,6,6,0,518,0,0,13,13,0,1148,0,0,0,0,0,0,0,0,0,0,0,0,0,0
7360,7360,Peter Ramage,1947,2004,Newcastle United,2,1,1,134,0,0,2,1,1,127,0,0,4,2,2,261,0,0,0,0,0,0,0,0,0,0,0,0,0,0
7361,7361,Guðni Bergsson,3500,2002,Bolton Wanderers,15,15,0,1350,0,0,16,16,0,1440,0,0,31,31,0,2790,0,0,0,0,0,0,0,0,0,0,0,0,0,0
7362,7362,Mike Whitlow,3066,2002,Bolton Wanderers,8,7,1,597,0,0,9,7,2,707,0,0,17,14,3,1304,0,0,0,0,0,0,0,0,0,0,0,0,0,0
7363,7363,Henrik Pedersen,1722,2002,Bolton Wanderers,17,16,1,1305,3,0,16,15,1,1219,4,0,33,31,2,2524,7,0,0,0,0,3,2,5,0,0,0,0,0,0
7364,7364,Pierre-Yves André,3501,2002,Bolton Wanderers,4,0,4,61,0,0,5,0,5,119,0,0,9,0,9,180,0,0,0,0,0,0,0,0,0,0,0,0,0,0
7365,7365,Kevin Poole,3502,2002,Bolton Wanderers,0,0,0,0,0,0,0,0,0,0,0,0,0,0,0,0,0,0,0,0,0,0,0,0,0,0,0,0,0,0
7366,7366,Salva Ballesta,3503,2002,Bolton Wanderers,2,0,2,40,0,0,4,1,3,101,0,0,6,1,5,141,0,0,0,0,0,0,0,0,0,0,0,0,0,0
7367,7367,Chris Riggott,1330,2002,Middlesbrough FC,2,1,1,124,0,0,3,3,0,270,2,0,5,4,1,394,2,0,0,0,0,0,1,1,0,0,0,0,0,0
7368,7368,Stewart Downing,1335,2002,Middlesbrough FC,1,0,1,12,0,0,1,0,1,45,0,0,2,0,2,57,0,0,0,0,0,0,0,0,0,0,0,0,0,0
7369,7369,Doriva,1338,2002,Middlesbrough FC,2,2,0,160,0,0,3,1,2,180,0,0,5,3,2,340,0,0,0,0,0,0,0,0,0,0,0,0,0,0
7370,7370,Mark Crossley,1932,2002,Middlesbrough FC,0,0,0,0,0,0,0,0,0,0,0,0,0,0,0,0,0,0,0,0,0,0,0,0,0,0,0,0,0,0
7371,7371,Andrew Davies,2295,2002,Middlesbrough FC,1,1,0,90,0,0,0,0,0,0,0,0,1,1,0,90,0,0,0,0,0,0,0,0,0,0,0,0,0,0
7372,7372,Thibaut Courtois,2730,2015,Chelsea FC,13,13,0,1170,0,0,10,10,0,900,0,0,23,23,0,2070,0,0,0,0,0,0,0,0,0,0,0,0,0,0
7373,7373,Branislav Ivanović,1532,2015,Chelsea FC,17,17,0,1500,1,0,16,16,0,1418,1,0,33,33,0,2918,2,0,0,3,3,1,1,2,0,0,0,0,0,0
7374,7374,Abdul Rahman Baba,3504,2015,Chelsea FC,6,5,1,495,0,0,9,6,3,522,0,0,15,11,4,1017,0,0,0,0,0,0,0,0,0,0,0,0,0,0
7375,7375,Gary Cahill,1533,2015,Chelsea FC,14,13,1,1201,1,0,9,8,1,754,1,0,23,21,2,1955,2,0,0,0,0,0,1,1,0,0,0,0,0,0
7376,7376,Azpilicueta,1535,2015,Chelsea FC,18,17,1,1495,1,0,19,19,0,1707,1,0,37,36,1,3202,2,0,0,0,0,1,0,1,0,0,0,0,0,0
7377,7377,Cesc Fàbregas,1526,2015,Chelsea FC,19,17,2,1462,4,0,18,16,2,1437,1,0,37,33,4,2899,5,0,1,0,1,4,1,5,2,0,2,0,0,0
7378,7378,Nemanja Matić,1537,2015,Chelsea FC,16,13,3,1175,0,0,17,15,2,1307,2,0,33,28,5,2482,2,0,0,0,0,0,1,1,0,0,0,0,0,0
7379,7379,Willian,1538,2015,Chelsea FC,18,18,0,1531,2,0,17,14,3,1219,3,0,35,32,3,2750,5,0,0,1,1,1,1,2,0,0,0,0,0,0
7380,7380,Eden Hazard,1541,2015,Chelsea FC,14,10,4,944,1,0,17,15,2,1247,3,0,31,25,6,2191,4,0,1,0,1,1,1,2,0,0,0,0,0,0
7381,7381,Bertrand Traoré,3505,2015,Chelsea FC,6,2,4,206,2,0,4,2,2,167,0,0,10,4,6,373,2,0,0,0,0,1,0,1,0,0,0,0,0,0
7382,7382,Pedro,1851,2015,Chelsea FC,16,13,3,1065,3,0,13,11,2,978,4,0,29,24,5,2043,7,0,0,0,0,0,2,2,0,0,0,0,0,0
7383,7383,Fikayo Tomori,3506,2015,Chelsea FC,1,0,1,30,0,0,0,0,0,0,0,0,1,0,1,30,0,0,0,0,0,0,0,0,0,0,0,0,0,0
7384,7384,Ruben Loftus-Cheek,1852,2015,Chelsea FC,7,2,5,232,0,0,6,2,4,176,1,0,13,4,9,408,1,0,0,0,0,0,1,1,0,0,0,0,0,0
7385,7385,Tammy Abraham,2959,2015,Chelsea FC,1,0,1,37,0,0,1,0,1,16,0,0,2,0,2,53,0,0,0,0,0,0,0,0,0,0,0,0,0,0
7386,7386,Asmir Begović,1036,2015,Chelsea FC,8,6,2,587,0,0,9,9,0,810,0,0,17,15,2,1397,0,0,0,0,0,0,0,0,0,0,0,0,0,0
7387,7387,Oscar,1543,2015,Chelsea FC,14,11,3,894,2,0,13,9,4,880,1,0,27,20,7,1774,3,0,0,0,0,1,1,2,1,0,1,0,0,0
7388,7388,Alexandre Pato,3507,2015,Chelsea FC,0,0,0,0,0,0,2,1,1,131,1,0,2,1,1,131,1,0,0,0,0,0,0,0,0,1,1,0,0,0
7389,7389,Kenedy,2932,2015,Chelsea FC,7,2,5,277,0,0,7,2,5,272,1,0,14,4,10,549,1,0,0,0,0,0,1,1,0,0,0,0,0,0
7390,7390,Ben Chilwell,2436,2015,Leicester City,0,0,0,0,0,0,0,0,0,0,0,0,0,0,0,0,0,0,0,0,0,0,0,0,0,0,0,0,0,0
7391,7391,Lucas Neill,1132,2006,Blackburn Rovers,10,10,0,900,0,0,10,10,0,895,0,0,20,20,0,1795,0,0,0,0,0,0,0,0,0,0,0,0,0,0
7392,7392,Stéphane Henchoz,2360,2006,Blackburn Rovers,6,5,1,451,0,0,6,5,1,427,0,0,12,10,2,878,0,0,0,0,0,0,0,0,0,0,0,0,0,0
7393,7393,André Ooijer,2108,2006,Blackburn Rovers,11,11,0,959,0,0,9,9,0,755,0,0,20,20,0,1714,0,0,0,0,0,0,0,0,0,0,0,0,0,0
7394,7394,Michael Gray,1092,2006,Blackburn Rovers,4,4,0,360,0,0,7,6,1,505,0,0,11,10,1,865,0,0,0,0,0,0,0,0,0,0,0,0,0,0
7395,7395,Robbie Savage,1309,2006,Blackburn Rovers,11,11,0,974,0,0,10,10,0,867,0,0,21,21,0,1841,0,0,0,0,0,0,0,0,0,0,0,0,0,0
7396,7396,David Bentley,2011,2006,Blackburn Rovers,18,18,0,1530,2,0,17,17,0,1460,2,0,35,35,0,2990,4,0,0,3,3,2,1,3,0,0,0,0,0,0
7397,7397,Shabani Nonda,3508,2006,Blackburn Rovers,14,9,5,797,4,0,12,8,4,779,3,0,26,17,9,1576,7,0,0,3,3,3,2,5,0,1,1,0,0,0
7398,7398,Andy Todd,1672,2006,Blackburn Rovers,4,3,1,314,0,0,5,3,2,294,0,0,9,6,3,608,0,0,0,0,0,0,0,0,0,0,0,0,0,0
7399,7399,Shay Given,1581,2006,Newcastle United,11,11,0,899,0,0,9,9,0,806,0,0,20,20,0,1705,0,0,0,0,0,0,0,0,0,0,0,0,0,0
7400,7400,Celestine Babayaro,2015,2006,Newcastle United,7,7,0,630,0,0,4,4,0,360,0,0,11,11,0,990,0,0,0,0,0,0,0,0,0,0,0,0,0,0
7401,7401,Nolberto Solano,1791,2006,Newcastle United,15,14,1,1255,2,0,11,9,2,725,0,0,26,23,3,1980,2,0,4,0,4,2,0,2,2,0,2,0,0,0
7402,7402,Emre Belözoğlu,2712,2006,Newcastle United,12,11,1,977,1,0,11,9,2,792,1,0,23,20,3,1769,2,0,3,0,3,1,0,1,0,1,1,0,0,0
7403,7403,Paul Huntington,3509,2006,Newcastle United,5,5,0,450,0,0,5,4,1,361,1,0,10,9,1,811,1,0,0,0,0,0,1,1,0,0,0,0,0,0
7404,7404,Matty Pattison,3510,2006,Newcastle United,1,0,1,3,0,0,5,1,4,205,0,0,6,1,5,208,0,0,0,0,0,0,0,0,0,0,0,0,0,0
7405,7405,Giuseppe Rossi,3511,2006,Newcastle United,7,2,5,227,0,0,4,1,3,152,0,0,11,3,8,379,0,0,0,0,0,0,0,0,0,0,0,0,0,0
7406,7406,Grant Hanley,1837,2011,Blackburn Rovers,11,9,2,883,0,0,12,10,2,941,1,0,23,19,4,1824,1,0,0,3,3,0,1,1,0,0,0,0,0,0
7407,7407,Marcus Olsson,3512,2011,Blackburn Rovers,6,4,2,450,0,0,6,6,0,540,0,0,12,10,2,990,0,0,0,0,0,0,0,0,0,0,0,0,0,0
7408,7408,Jake Kean,3513,2011,Blackburn Rovers,0,0,0,0,0,0,1,1,0,90,0,0,1,1,0,90,0,0,0,0,0,0,0,0,0,0,0,0,0,0
7409,7409,Morten Gamst Pedersen,2009,2011,Blackburn Rovers,17,17,0,1457,1,0,16,16,0,1379,2,0,33,33,0,2836,3,0,0,0,0,1,1,2,0,0,0,0,0,0
7410,7410,Robbie Blake,2551,2010,Bolton Wanderers,6,0,6,31,1,0,2,0,2,11,0,0,8,0,8,42,1,0,1,0,1,1,0,1,0,0,0,0,0,0
7411,7411,Harald Wapenaar,3514,2003,Portsmouth FC,2,2,0,180,0,0,2,2,0,180,0,0,4,4,0,360,0,0,0,0,0,0,0,0,0,0,0,0,0,0
7412,7412,Boris Živković,3515,2003,Portsmouth FC,8,8,0,720,0,0,9,8,1,724,0,0,17,16,1,1444,0,0,0,0,0,0,0,0,0,0,0,0,0,0
7413,7413,Tim Sherwood,2077,2003,Portsmouth FC,6,4,2,379,0,0,7,3,4,290,0,0,13,7,6,669,0,0,0,0,0,0,0,0,0,0,0,0,0,0
7414,7414,Patrik Berger,2689,2003,Portsmouth FC,10,10,0,860,5,0,9,9,0,744,0,0,19,19,0,1604,5,0,3,0,3,2,0,2,0,0,0,0,0,0
7415,7415,Richard Hughes,2812,2003,Portsmouth FC,4,2,2,201,0,0,6,5,1,408,0,0,10,7,3,609,0,0,0,0,0,0,0,0,0,0,0,0,0,0
7416,7416,Jason Roberts,1820,2003,Portsmouth FC,4,1,3,146,1,0,5,2,3,244,0,0,9,3,6,390,1,0,0,0,0,1,0,1,0,0,0,0,0,0
7417,7417,Ángel Crespo,3516,2015,Aston Villa,1,1,0,90,0,0,0,0,0,0,0,0,1,1,0,90,0,0,0,0,0,0,0,0,0,0,0,0,0,0
7418,7418,Shay Given,1581,2015,Stoke City,2,2,0,180,0,0,1,1,0,46,0,0,3,3,0,226,0,0,0,0,0,0,0,0,0,0,0,0,0,0
7419,7419,Marc Wilson,1546,2012,Stoke City,8,8,0,645,0,0,11,11,0,848,0,0,19,19,0,1493,0,0,0,0,0,0,0,0,0,0,0,0,0,0
7420,7420,Michael Owen,1949,2012,Stoke City,3,0,3,26,0,0,5,0,5,69,1,0,8,0,8,95,1,0,0,0,0,0,0,0,0,0,0,0,0,0
7421,7421,Ryan Shotton,3517,2012,Stoke City,12,10,2,889,0,0,11,10,1,932,0,0,23,20,3,1821,0,0,0,0,0,0,0,0,0,0,0,0,0,0
7422,7422,Łukasz Fabiański,1227,2018,West Ham United,19,19,0,1710,0,0,19,19,0,1710,0,0,38,38,0,3420,0,0,0,0,0,0,0,0,0,0,0,0,0,0
7423,7423,Aaron Cresswell,2199,2018,West Ham United,11,10,1,888,0,0,9,8,1,701,0,0,20,18,2,1589,0,0,0,0,0,0,0,0,0,0,0,0,0,0
7424,7424,Pablo Zabaleta,1355,2018,West Ham United,14,14,0,1216,0,0,12,9,3,876,0,0,26,23,3,2092,0,0,0,0,0,0,0,0,0,0,0,0,0,0
7425,7425,Angelo Ogbonna,2201,2018,West Ham United,12,10,2,957,1,0,12,10,2,914,0,0,24,20,4,1871,1,0,0,0,0,0,0,0,0,0,0,0,0,0
7426,7426,Issa Diop,2213,2018,West Ham United,17,17,0,1530,1,0,16,16,0,1440,0,0,33,33,0,2970,1,0,0,0,0,1,0,1,0,0,0,0,0,0
7427,7427,Manuel Lanzini,2351,2018,West Ham United,5,4,1,367,0,0,5,4,1,321,1,0,10,8,2,688,1,0,0,0,0,0,0,0,0,0,0,0,0,0
7428,7428,Pedro Obiang,2639,2018,West Ham United,13,7,6,610,0,0,11,5,6,512,0,0,24,12,12,1122,0,0,0,0,0,0,0,0,0,0,0,0,0,0
7429,7429,Declan Rice,2206,2018,West Ham United,16,16,0,1440,2,0,18,18,0,1565,0,0,34,34,0,3005,2,0,3,0,3,2,0,2,0,0,0,0,0,0
7430,7430,Marko Arnautović,1552,2018,West Ham United,15,13,2,1083,7,0,13,11,2,917,3,0,28,24,4,2000,10,0,1,0,1,4,1,5,1,0,1,0,0,0
7431,7431,Robert Snodgrass,2207,2018,West Ham United,16,13,3,1108,1,0,17,12,5,1114,1,0,33,25,8,2222,2,0,0,0,0,1,1,2,0,0,0,0,0,0
7432,7432,Lucas Pérez,3318,2018,West Ham United,10,2,8,287,3,0,5,2,3,181,0,0,15,4,11,468,3,0,0,0,0,2,0,2,0,0,0,0,0,0
7433,7433,Grady Diangana,3518,2018,West Ham United,9,3,6,327,0,0,8,3,5,278,0,0,17,6,11,605,0,0,0,0,0,0,0,0,0,0,0,0,0,0
7434,7434,Javier Hernández,2257,2018,West Ham United,13,7,6,694,5,0,12,7,5,641,2,0,25,14,11,1335,7,0,3,0,3,4,1,5,0,0,0,0,0,0
7435,7435,Michail Antonio,2208,2018,West Ham United,16,11,5,998,4,0,17,11,6,1101,2,0,33,22,11,2099,6,0,1,3,4,2,1,3,0,0,0,0,0,0
7436,7436,Adrián,2309,2018,West Ham United,0,0,0,0,0,0,0,0,0,0,0,0,0,0,0,0,0,0,0,0,0,0,0,0,0,0,0,0,0,0
7437,7437,Fabián Balbuena,2200,2018,West Ham United,11,11,0,934,0,0,12,12,0,1080,1,0,23,23,0,2014,1,0,0,0,0,0,1,1,0,0,0,0,0,0
7438,7438,Arthur Masuaku,2209,2018,West Ham United,11,9,2,823,0,0,12,10,2,935,0,0,23,19,4,1758,0,0,0,0,0,0,0,0,0,0,0,0,0,0
7439,7439,Mark Noble,2204,2018,West Ham United,15,14,1,1146,2,0,16,15,1,1213,3,0,31,29,2,2359,5,0,0,0,0,1,2,3,2,2,4,0,0,0
7440,7440,Phil Jagielka,1048,2018,Everton FC,3,1,2,96,1,0,4,3,1,284,0,0,7,4,3,380,1,0,3,0,3,1,0,1,0,0,0,0,0,0
7441,7441,Brett Ormerod,2607,2001,Southampton FC,11,4,7,499,0,0,7,4,3,370,1,0,18,8,10,869,1,0,0,0,0,0,0,0,0,0,0,0,0,0
7442,7442,Jon Harley,3053,2001,Fulham FC,5,2,3,207,0,0,5,3,2,303,0,0,10,5,5,510,0,0,0,0,0,0,0,0,0,0,0,0,0,0
7443,7443,Fernando,1592,2014,Manchester City,15,13,2,1071,1,0,10,9,1,811,1,0,25,22,3,1882,2,0,0,0,0,0,1,1,0,0,0,0,0,0
7444,7444,Bacary Sagna,1596,2014,Manchester City,4,3,1,290,0,0,5,5,0,450,0,0,9,8,1,740,0,0,0,0,0,0,0,0,0,0,0,0,0,0
7445,7445,Scott Parker,1282,2011,Tottenham Hotspur,12,12,0,1071,0,0,17,16,1,1406,0,0,29,28,1,2477,0,0,0,0,0,0,0,0,0,0,0,0,0,0
7446,7446,Stephen Ward,1252,2009,Wolverhampton Wanderers,11,9,2,819,0,0,11,9,2,794,0,0,22,18,4,1613,0,0,0,0,0,0,0,0,0,0,0,0,0,0
7447,7447,Karl Henry,2921,2009,Wolverhampton Wanderers,17,17,0,1530,0,0,17,17,0,1530,0,0,34,34,0,3060,0,0,0,0,0,0,0,0,0,0,0,0,0,0
7448,7448,Adlène Guédioura,3130,2009,Wolverhampton Wanderers,6,4,2,358,1,0,7,3,4,213,0,0,13,7,6,571,1,0,3,0,3,1,0,1,0,0,0,0,0,0
7449,7449,Sylvain Ebanks-Blake,3432,2009,Wolverhampton Wanderers,14,8,6,788,2,0,9,4,5,379,0,0,23,12,11,1167,2,0,2,0,2,2,0,2,1,0,1,0,0,0
7450,7450,Andy Keogh,3519,2009,Wolverhampton Wanderers,5,4,1,321,0,0,8,4,4,423,1,0,13,8,5,744,1,0,0,3,3,0,1,1,0,0,0,0,0,0
7451,7451,Andy van der Meyde,3520,2005,Everton FC,5,3,2,243,0,0,5,4,1,270,0,0,10,7,3,513,0,0,0,0,0,0,0,0,0,0,0,0,0,0
7452,7452,Ugo Ehiogu,2134,2005,Middlesbrough FC,9,8,1,730,0,0,9,8,1,715,0,0,18,16,2,1445,0,0,0,0,0,0,0,0,0,0,0,0,0,0
7453,7453,Emanuel Pogatetz,1883,2005,Middlesbrough FC,14,12,2,1100,0,0,10,9,1,855,1,0,24,21,3,1955,1,0,0,0,0,0,1,1,0,0,0,0,0,0
7454,7454,Stuart Parnaby,1881,2005,Middlesbrough FC,11,11,0,909,1,0,9,8,1,741,1,0,20,19,1,1650,2,0,3,0,3,1,0,1,0,0,0,0,0,0
7455,7455,George Boateng,1333,2005,Middlesbrough FC,13,12,1,1131,1,0,13,13,0,1170,1,0,26,25,1,2301,2,0,0,0,0,0,1,1,0,0,0,0,0,0
7456,7456,Fábio Rochemback,1885,2005,Middlesbrough FC,11,11,0,893,1,0,11,11,0,956,1,0,22,22,0,1849,2,0,0,0,0,1,1,2,0,0,0,0,0,0
7457,7457,Mendieta,2296,2005,Middlesbrough FC,9,7,2,636,2,0,8,8,0,620,0,0,17,15,2,1256,2,0,0,0,0,1,0,1,0,0,0,0,0,0
7458,7458,Yakubu Ayegbeni,1073,2005,Middlesbrough FC,18,16,2,1449,9,0,16,13,3,1138,4,0,34,29,5,2587,13,0,2,0,2,7,3,10,2,1,3,0,0,0
7459,7459,James Morrison,1735,2005,Middlesbrough FC,11,10,1,741,1,0,13,11,2,946,0,0,24,21,3,1687,1,0,0,0,0,1,0,1,0,0,0,0,0,0
7460,7460,Simon Mignolet,1191,2015,Liverpool FC,19,19,0,1710,0,0,15,15,0,1350,0,0,34,34,0,3060,0,0,0,0,0,0,0,0,0,0,0,0,0,0
7461,7461,Nathaniel Clyne,1144,2015,Liverpool FC,17,17,0,1530,0,0,16,16,0,1440,1,0,33,33,0,2970,1,0,0,0,0,0,0,0,0,0,0,0,0,0
7462,7462,Dejan Lovren,1179,2015,Liverpool FC,12,11,1,951,0,0,12,11,1,947,0,0,24,22,2,1898,0,0,0,0,0,0,0,0,0,0,0,0,0,0
7463,7463,Joe Gomez,1180,2015,Liverpool FC,2,2,0,168,0,0,3,3,0,270,0,0,5,5,0,438,0,0,0,0,0,0,0,0,0,0,0,0,0,0
7464,7464,Martin Škrtel,1423,2015,Liverpool FC,10,10,0,900,0,0,12,11,1,985,1,0,22,21,1,1885,1,0,0,0,0,0,0,0,0,0,0,0,0,0
7465,7465,James Milner,1189,2015,Liverpool FC,16,16,0,1390,3,0,12,12,0,1054,2,0,28,28,0,2444,5,0,3,0,3,2,1,3,1,0,1,0,0,0
7466,7466,Coutinho,1425,2015,Liverpool FC,13,12,1,1036,3,0,13,12,1,1007,5,0,26,24,2,2043,8,0,0,3,3,2,4,6,0,0,0,0,0,0
7467,7467,Lucas Leiva,1429,2015,Liverpool FC,12,8,4,737,0,0,15,13,2,1216,0,0,27,21,6,1953,0,0,0,0,0,0,0,0,0,0,0,0,0,0
7468,7468,Emre Can,1185,2015,Liverpool FC,15,14,1,1221,0,0,15,14,1,1272,1,0,30,28,2,2493,1,0,0,0,0,0,0,0,0,0,0,0,0,0
7469,7469,Christian Benteke,1443,2015,Liverpool FC,13,7,6,732,4,0,16,7,9,785,5,0,29,14,15,1517,9,0,7,6,13,4,2,6,0,1,1,0,0,0
7470,7470,Roberto Firmino,1186,2015,Liverpool FC,17,11,6,988,5,0,14,13,1,994,5,0,31,24,7,1982,10,0,0,0,0,3,4,7,0,0,0,0,0,0
7471,7471,Alberto Moreno,2128,2015,Liverpool FC,18,16,2,1491,1,0,14,12,2,1055,0,0,32,28,4,2546,1,0,0,0,0,1,0,1,0,0,0,0,0,0
7472,7472,Danny Ings,1193,2015,Liverpool FC,3,1,2,163,1,0,3,2,1,176,1,0,6,3,3,339,2,0,0,0,0,1,1,2,0,0,0,0,0,0
7473,7473,Jordon Ibe,1042,2015,Liverpool FC,13,5,8,535,0,0,14,7,7,638,1,0,27,12,15,1173,1,0,0,1,1,0,1,1,0,0,0,0,0,0
7474,7474,Ádám Bogdán,2488,2015,Liverpool FC,0,0,0,0,0,0,2,2,0,180,0,0,2,2,0,180,0,0,0,0,0,0,0,0,0,0,0,0,0,0
7475,7475,Mamadou Sakho,2250,2015,Liverpool FC,10,10,0,850,1,0,12,11,1,1005,0,0,22,21,1,1855,1,0,0,0,0,0,0,0,0,0,0,0,0,0
7476,7476,Jordan Rossiter,3521,2015,Liverpool FC,0,0,0,0,0,0,1,0,1,14,0,0,1,0,1,14,0,0,0,0,0,0,0,0,0,0,0,0,0,0
7477,7477,Divock Origi,2086,2015,Liverpool FC,8,4,4,283,4,0,8,3,5,383,1,0,16,7,9,666,5,0,1,0,1,2,0,2,0,0,0,0,0,0
7478,7478,Diafra Sakho,3418,2015,West Ham United,11,9,2,776,2,0,10,9,1,750,3,0,21,18,3,1526,5,0,0,0,0,2,1,3,0,0,0,0,0,0
7479,7479,Raphael Spiegel,2761,2015,West Ham United,0,0,0,0,0,0,0,0,0,0,0,0,0,0,0,0,0,0,0,0,0,0,0,0,0,0,0,0,0,0
7480,7480,Kyle Knoyle,3522,2015,West Ham United,0,0,0,0,0,0,0,0,0,0,0,0,0,0,0,0,0,0,0,0,0,0,0,0,0,0,0,0,0,0
7481,7481,Martin Samuelsen,3523,2015,West Ham United,0,0,0,0,0,0,0,0,0,0,0,0,0,0,0,0,0,0,0,0,0,0,0,0,0,0,0,0,0,0
7482,7482,Elliot Lee,3524,2015,West Ham United,0,0,0,0,0,0,0,0,0,0,0,0,0,0,0,0,0,0,0,0,0,0,0,0,0,0,0,0,0,0
7483,7483,Tim Howard,1743,2005,Manchester United,0,0,0,0,0,0,1,0,1,45,0,0,1,0,1,45,0,0,0,0,0,0,0,0,0,0,0,0,0,0
7484,7484,James Morrison,1735,2017,West Bromwich Albion,2,2,0,160,0,0,2,0,2,46,1,0,4,2,2,206,1,0,0,0,0,0,0,0,0,0,0,0,0,0
7485,7485,Kane Wilson,3525,2017,West Bromwich Albion,0,0,0,0,0,0,0,0,0,0,0,0,0,0,0,0,0,0,0,0,0,0,0,0,0,0,0,0,0,0
7486,7486,Jesé,3526,2017,Stoke City,7,4,3,342,1,0,5,3,2,212,0,0,12,7,5,554,1,0,3,0,3,1,0,1,0,0,0,0,0,0
7487,7487,Bojan,1585,2017,Stoke City,0,0,0,0,0,0,1,1,0,72,0,0,1,1,0,72,0,0,0,0,0,0,0,0,0,0,0,0,0,0
7488,7488,Jens Lehmann,1522,2010,Arsenal FC,0,0,0,0,0,0,1,1,0,90,0,0,1,1,0,90,0,0,0,0,0,0,0,0,0,0,0,0,0,0
7489,7489,Kieran Gibbs,1508,2010,Arsenal FC,2,2,0,180,0,0,5,2,3,165,0,0,7,4,3,345,0,0,0,0,0,0,0,0,0,0,0,0,0,0
7490,7490,Fábio Aurélio,2054,2010,Liverpool FC,9,5,4,414,0,0,5,2,3,152,0,0,14,7,7,566,0,0,0,0,0,0,0,0,0,0,0,0,0,0
7491,7491,Jon Flanagan,1263,2010,Liverpool FC,4,4,0,351,0,0,3,3,0,270,0,0,7,7,0,621,0,0,0,0,0,0,0,0,0,0,0,0,0,0
7492,7492,Raúl Meireles,2992,2010,Liverpool FC,16,16,0,1264,3,0,17,16,1,1280,2,0,33,32,1,2544,5,0,0,3,3,3,1,4,0,0,0,0,0,0
7493,7493,Luis Suárez,1427,2010,Liverpool FC,7,6,1,563,2,0,6,6,0,539,2,0,13,12,1,1102,4,0,0,0,0,0,0,0,0,0,0,0,0,0
7494,7494,Andy Carroll,1779,2010,Liverpool FC,4,2,2,214,2,0,3,3,0,233,0,0,7,5,2,447,2,0,0,0,0,1,0,1,0,0,0,0,0,0
7495,7495,Jack Robinson,3118,2010,Liverpool FC,1,1,0,79,0,0,1,0,1,68,0,0,2,1,1,147,0,0,0,0,0,0,0,0,0,0,0,0,0,0
7496,7496,Jonjo Shelvey,1699,2010,Liverpool FC,9,0,9,108,0,0,6,0,6,213,0,0,15,0,15,321,0,0,0,0,0,0,0,0,0,0,0,0,0,0
7497,7497,Péter Gulácsi,3527,2010,Liverpool FC,0,0,0,0,0,0,0,0,0,0,0,0,0,0,0,0,0,0,0,0,0,0,0,0,0,0,0,0,0,0
7498,7498,Joe Cole,1630,2010,Liverpool FC,11,4,7,394,2,0,9,5,4,447,0,0,20,9,11,841,2,0,3,0,3,1,0,1,0,0,0,0,0,0
7499,7499,David N'Gog,1895,2010,Liverpool FC,13,5,8,557,2,0,12,4,8,500,0,0,25,9,16,1057,2,0,0,0,0,2,0,2,0,0,0,0,0,0
7500,7500,Andy Webster,3528,2006,Wigan Athletic,2,1,1,119,0,0,2,2,0,155,0,0,4,3,1,274,0,0,0,0,0,0,0,0,0,0,0,0,0,0
7501,7501,Andreas Johansson,1821,2006,Wigan Athletic,4,2,2,190,0,0,8,2,6,256,0,0,12,4,8,446,0,0,0,0,0,0,0,0,0,0,0,0,0,0
7502,7502,David Cotterill,3529,2006,Wigan Athletic,9,2,7,321,0,0,7,3,4,322,1,0,16,5,11,643,1,0,0,0,0,0,1,1,0,0,0,0,0,0
7503,7503,Thimothée Atouba,3530,2004,Tottenham Hotspur,7,5,2,507,0,0,11,10,1,892,1,0,18,15,3,1399,1,0,0,3,3,0,1,1,0,0,0,0,0,0
7504,7504,Anthony Gardner,1120,2004,Tottenham Hotspur,8,4,4,399,0,0,9,4,5,431,0,0,17,8,9,830,0,0,0,0,0,0,0,0,0,0,0,0,0,0
7505,7505,Rohan Ricketts,1124,2004,Tottenham Hotspur,4,3,1,204,0,0,2,2,0,171,0,0,6,5,1,375,0,0,0,0,0,0,0,0,0,0,0,0,0,0
7506,7506,Darren Kenton,3531,2004,Southampton FC,4,4,0,360,0,0,4,4,0,344,0,0,8,8,0,704,0,0,0,0,0,0,0,0,0,0,0,0,0,0
7507,7507,Paul Telfer,2105,2004,Southampton FC,14,11,3,1080,0,0,14,13,1,1196,0,0,28,24,4,2276,0,0,0,0,0,0,0,0,0,0,0,0,0,0
7508,7508,Andreas Jakobsson,3532,2004,Southampton FC,14,12,2,906,1,0,12,11,1,1035,1,0,26,23,3,1941,2,0,1,0,1,1,1,2,0,0,0,0,0,0
7509,7509,Jake Hesketh,2790,2014,Southampton FC,1,0,1,20,0,0,1,1,0,32,0,0,2,1,1,52,0,0,0,0,0,0,0,0,0,0,0,0,0,0
7510,7510,Lloyd Isgrove,3533,2014,Southampton FC,0,0,0,0,0,0,1,0,1,8,0,0,1,0,1,8,0,0,0,0,0,0,0,0,0,0,0,0,0,0
7511,7511,Jonny Evans,1216,2014,Manchester United,5,5,0,450,0,0,9,7,2,642,0,0,14,12,2,1092,0,0,0,0,0,0,0,0,0,0,0,0,0,0
7512,7512,Andy Carroll,1779,2013,West Ham United,7,6,1,562,0,0,8,6,2,562,2,0,15,12,3,1124,2,0,0,0,0,0,2,2,0,0,0,0,0,0
7513,7513,Pablo Armero,3534,2013,West Ham United,2,2,0,180,0,0,3,1,2,141,0,0,5,3,2,321,0,0,0,0,0,0,0,0,0,0,0,0,0,0
7514,7514,Antonio Nocerino,3535,2013,West Ham United,5,0,5,51,0,0,5,2,3,205,0,0,10,2,8,256,0,0,0,0,0,0,0,0,0,0,0,0,0,0
7515,7515,Hugo Lloris,1160,2013,Tottenham Hotspur,18,18,0,1620,0,0,19,19,0,1710,0,0,37,37,0,3330,0,0,0,0,0,0,0,0,0,0,0,0,0,0
7516,7516,Danny Rose,1399,2013,Tottenham Hotspur,11,11,0,990,0,0,11,11,0,952,1,0,22,22,0,1942,1,0,0,3,3,0,1,1,0,0,0,0,0,0
7517,7517,Younès Kaboul,2408,2013,Tottenham Hotspur,5,4,1,404,1,0,8,7,1,634,0,0,13,11,2,1038,1,0,0,0,0,0,0,0,0,0,0,0,0,0
7518,7518,Kyle Naughton,2273,2013,Tottenham Hotspur,12,10,2,924,0,0,10,9,1,821,0,0,22,19,3,1745,0,0,0,0,0,0,0,0,0,0,0,0,0,0
7519,7519,Michael Dawson,1267,2013,Tottenham Hotspur,15,15,0,1350,0,0,17,16,1,1488,0,0,32,31,1,2838,0,0,0,0,0,0,0,0,0,0,0,0,0,0
7520,7520,Aaron Lennon,1052,2013,Tottenham Hotspur,11,11,0,902,1,0,16,15,1,1284,0,0,27,26,1,2186,1,0,0,0,0,0,0,0,0,0,0,0,0,0
7521,7521,Paulinho,3536,2013,Tottenham Hotspur,15,14,1,1197,2,0,15,14,1,1210,4,0,30,28,2,2407,6,0,0,4,4,2,3,5,0,0,0,0,0,0
7522,7522,Gylfi Sigurðsson,1055,2013,Tottenham Hotspur,12,7,5,634,5,0,13,7,6,643,0,0,25,14,11,1277,5,0,3,0,3,3,0,3,0,0,0,0,0,0
7523,7523,Christian Eriksen,1165,2013,Tottenham Hotspur,15,14,1,1169,5,0,10,9,1,813,2,0,25,23,2,1982,7,0,0,1,1,3,1,4,0,0,0,0,0,0
7524,7524,Emmanuel Adebayor,1235,2013,Tottenham Hotspur,10,10,0,890,4,0,11,10,1,918,7,0,21,20,1,1808,11,0,3,3,6,2,5,7,1,0,1,0,0,0
7525,7525,Harry Kane,1169,2013,Tottenham Hotspur,4,3,1,266,2,0,6,3,3,232,1,0,10,6,4,498,3,0,0,0,0,2,0,2,0,0,0,0,0,0
7526,7526,Vlad Chiricheş,1171,2013,Tottenham Hotspur,9,9,0,766,0,0,8,7,1,648,1,0,17,16,1,1414,1,0,0,0,0,0,1,1,0,0,0,0,0,0
7527,7527,Sandro,2409,2013,Tottenham Hotspur,9,5,4,371,1,0,8,5,3,457,0,0,17,10,7,828,1,0,0,0,0,1,0,1,0,0,0,0,0,0
7528,7528,Soldado,1173,2013,Tottenham Hotspur,15,12,3,1035,4,0,13,10,3,896,2,0,28,22,6,1931,6,0,9,3,12,4,1,5,3,1,4,0,0,0
7529,7529,Brad Friedel,1343,2013,Tottenham Hotspur,1,1,0,90,0,0,0,0,0,0,0,0,1,1,0,90,0,0,0,0,0,0,0,0,0,0,0,0,0,0
7530,7530,Ezekiel Fryers,2127,2013,Tottenham Hotspur,4,3,1,314,0,0,3,0,3,83,0,0,7,3,4,397,0,0,0,0,0,0,0,0,0,0,0,0,0,0
7531,7531,Nabil Bentaleb,1167,2013,Tottenham Hotspur,7,5,2,493,0,0,8,6,2,576,0,0,15,11,4,1069,0,0,0,0,0,0,0,0,0,0,0,0,0,0
7532,7532,Alex Pritchard,3028,2013,Tottenham Hotspur,1,0,1,7,0,0,0,0,0,0,0,0,1,0,1,7,0,0,0,0,0,0,0,0,0,0,0,0,0,0
7533,7533,Matthew Lowton,1250,2017,Burnley FC,14,13,1,1214,0,0,12,12,0,1080,0,0,26,25,1,2294,0,0,0,0,0,0,0,0,0,0,0,0,0,0
7534,7534,Ben Mee,1251,2017,Burnley FC,13,13,0,1170,0,0,16,16,0,1440,0,0,29,29,0,2610,0,0,0,0,0,0,0,0,0,0,0,0,0,0
7535,7535,Robbie Brady,2230,2017,Burnley FC,7,7,0,618,0,0,8,8,0,661,1,0,15,15,0,1279,1,0,0,0,0,0,0,0,0,0,0,0,0,0
7536,7536,Luke Young,1952,2006,Charlton Athletic,15,15,0,1328,0,0,13,13,0,1170,1,0,28,28,0,2498,1,0,0,0,0,0,0,0,0,0,0,0,0,0
7537,7537,Alex Song,1233,2006,Charlton Athletic,6,6,0,445,0,0,6,6,0,540,0,0,12,12,0,985,0,0,0,0,0,0,0,0,0,0,0,0,0,0
7538,7538,Madjid Bougherra,3537,2006,Charlton Athletic,1,0,1,14,0,0,4,2,2,204,0,0,5,2,3,218,0,0,0,0,0,0,0,0,0,0,0,0,0,0
7539,7539,Zhi Zheng,3538,2006,Charlton Athletic,6,5,1,452,1,0,6,3,3,386,0,0,12,8,4,838,1,0,0,0,0,1,0,1,0,0,0,0,0,0
7540,7540,Craig Gardner,1403,2009,Birmingham City,6,4,2,357,1,0,7,6,1,541,0,0,13,10,3,898,1,0,1,0,1,1,0,1,0,0,0,0,0,0
7541,7541,Kevin Phillips,1100,2009,Birmingham City,11,1,10,210,4,0,8,1,7,208,0,0,19,2,17,418,4,0,4,0,4,4,0,4,0,0,0,0,0,0
7542,7542,Andrew Surman,1006,2009,Wolverhampton Wanderers,2,1,1,98,0,0,5,2,3,218,0,0,7,3,4,316,0,0,0,0,0,0,0,0,0,0,0,0,0,0
7543,7543,Andreas Cornelius,3539,2013,Cardiff City,6,0,6,75,0,0,2,0,2,32,0,0,8,0,8,107,0,0,0,0,0,0,0,0,0,0,0,0,0,0
7544,7544,Billy Jones,1733,2013,West Bromwich Albion,11,11,0,841,0,0,10,10,0,900,0,0,21,21,0,1741,0,0,0,0,0,0,0,0,0,0,0,0,0,0
7545,7545,Youssuf Mulumbu,1773,2013,West Bromwich Albion,18,16,2,1496,0,0,19,17,2,1582,2,0,37,33,4,3078,2,0,0,3,3,0,2,2,0,0,0,0,0,0
7546,7546,Scott Sinclair,1420,2013,West Bromwich Albion,3,3,0,190,0,0,5,1,4,111,0,0,8,4,4,301,0,0,0,0,0,0,0,0,0,0,0,0,0,0
7547,7547,Simon Mignolet,1191,2011,Sunderland AFC,14,14,0,1222,0,0,15,15,0,1350,0,0,29,29,0,2572,0,0,0,0,0,0,0,0,0,0,0,0,0,0
7548,7548,Phil Bardsley,1409,2011,Sunderland AFC,15,14,1,1179,0,0,16,15,1,1300,1,0,31,29,2,2479,1,0,0,0,0,0,1,1,0,0,0,0,0,0
7549,7549,Michael Turner,1371,2011,Sunderland AFC,12,12,0,1080,0,0,12,11,1,1035,0,0,24,23,1,2115,0,0,0,0,0,0,0,0,0,0,0,0,0,0
7550,7550,John O'Shea,1729,2011,Sunderland AFC,15,15,0,1181,0,0,14,14,0,1260,0,0,29,29,0,2441,0,0,0,0,0,0,0,0,0,0,0,0,0,0
7551,7551,Lee Cattermole,1687,2011,Sunderland AFC,10,10,0,817,0,0,13,13,0,1125,0,0,23,23,0,1942,0,0,0,0,0,0,0,0,0,0,0,0,0,0
7552,7552,Sebastian Larsson,1402,2011,Sunderland AFC,15,15,0,1314,3,0,17,17,0,1393,4,0,32,32,0,2707,7,0,3,1,4,2,3,5,0,0,0,0,0,0
7553,7553,Craig Gardner,1403,2011,Sunderland AFC,15,11,4,1077,2,0,15,11,4,1037,1,0,30,22,8,2114,3,0,0,0,0,0,1,1,0,0,0,0,0,0
7554,7554,Kieran Richardson,1898,2011,Sunderland AFC,14,13,1,1154,0,0,15,13,2,1130,2,0,29,26,3,2284,2,0,0,0,0,0,1,1,0,0,0,0,0,0
7555,7555,Jack Colback,1404,2011,Sunderland AFC,18,15,3,1435,1,0,17,14,3,1236,0,0,35,29,6,2671,1,0,0,0,0,1,0,1,0,0,0,0,0,0
7556,7556,Stéphane Sessègnon,1406,2011,Sunderland AFC,18,18,0,1595,4,0,18,18,0,1570,3,0,36,36,0,3165,7,0,1,0,1,2,1,3,0,0,0,0,0,0
7557,7557,James McClean,1407,2011,Sunderland AFC,12,10,2,923,3,0,11,10,1,920,2,0,23,20,3,1843,5,0,0,3,3,2,1,3,0,0,0,0,0,0
7558,7558,Wayne Bridge,1768,2011,Sunderland AFC,5,2,3,204,0,0,3,1,2,113,0,0,8,3,5,317,0,0,0,0,0,0,0,0,0,0,0,0,0,0
7559,7559,Fraizer Campbell,1027,2011,Sunderland AFC,7,5,2,472,1,0,5,1,4,163,0,0,12,6,6,635,1,0,0,0,0,1,0,1,0,0,0,0,0,0
7560,7560,Nicklas Bendtner,1236,2011,Sunderland AFC,14,14,0,1151,4,0,14,11,3,1080,4,0,28,25,3,2231,8,0,3,0,3,3,3,6,0,1,1,0,0,0
7561,7561,Keiren Westwood,1410,2011,Sunderland AFC,5,4,1,398,0,0,4,4,0,360,0,0,9,8,1,758,0,0,0,0,0,0,0,0,0,0,0,0,0,0
7562,7562,Matt Kilgallon,1400,2011,Sunderland AFC,4,3,1,326,0,0,6,6,0,467,0,0,10,9,1,793,0,0,0,0,0,0,0,0,0,0,0,0,0,0
7563,7563,Sotirios Kyrgiakos,3170,2011,Sunderland AFC,1,1,0,90,0,0,2,1,1,99,0,0,3,2,1,189,0,0,0,0,0,0,0,0,0,0,0,0,0,0
7564,7564,David Meyler,2225,2011,Sunderland AFC,4,0,4,37,0,0,3,1,2,122,0,0,7,1,6,159,0,0,0,0,0,0,0,0,0,0,0,0,0,0
7565,7565,Phil Neville,1114,2012,Everton FC,8,8,0,682,0,0,10,10,0,869,0,0,18,18,0,1551,0,0,0,0,0,0,0,0,0,0,0,0,0,0
7566,7566,Magaye Gueye,1750,2012,Everton FC,1,0,1,44,0,0,1,0,1,4,0,0,2,0,2,48,0,0,0,0,0,0,0,0,0,0,0,0,0,0
7567,7567,Maya Yoshida,1145,2012,Southampton FC,16,16,0,1440,0,0,16,15,1,1412,0,0,32,31,1,2852,0,0,0,0,0,0,0,0,0,0,0,0,0,0
7568,7568,Gastón Ramírez,2226,2012,Southampton FC,12,10,2,889,4,0,14,10,4,822,1,0,26,20,6,1711,5,0,0,0,0,3,1,4,0,0,0,0,0,0
7569,7569,Ben Reeves,3540,2012,Southampton FC,2,0,2,16,0,0,1,0,1,9,0,0,3,0,3,25,0,0,0,0,0,0,0,0,0,0,0,0,0,0
7570,7570,Richard Chaplow,3541,2012,Southampton FC,1,0,1,28,0,0,2,0,2,24,0,0,3,0,3,52,0,0,0,0,0,0,0,0,0,0,0,0,0,0
7571,7571,Steve Harper,2231,2007,Newcastle United,10,9,1,854,0,0,11,10,1,936,0,0,21,19,2,1790,0,0,0,0,0,0,0,0,0,0,0,0,0,0
7572,7572,Stephen Carr,1780,2007,Newcastle United,4,3,1,282,0,0,6,5,1,431,0,0,10,8,2,713,0,0,0,0,0,0,0,0,0,0,0,0,0,0
7573,7573,David Rozehnal,3542,2007,Newcastle United,11,8,3,774,0,0,10,8,2,715,0,0,21,16,5,1489,0,0,0,0,0,0,0,0,0,0,0,0,0,0
7574,7574,Steven Taylor,2014,2007,Newcastle United,15,13,2,1214,1,0,16,16,0,1419,0,0,31,29,2,2633,1,0,1,0,1,1,0,1,0,0,0,0,0,0
7575,7575,Charles N'Zogbia,2016,2007,Newcastle United,17,14,3,1225,1,0,15,13,2,1213,2,0,32,27,5,2438,3,0,0,0,0,0,2,2,0,0,0,0,0,0
7576,7576,James Milner,1189,2007,Newcastle United,15,12,3,1137,1,0,14,13,1,1094,1,0,29,25,4,2231,2,0,0,1,1,0,1,1,0,0,0,0,0,0
7577,7577,Geremi,1764,2007,Newcastle United,13,12,1,1033,0,0,14,12,2,1030,2,0,27,24,3,2063,2,0,0,1,1,0,2,2,0,0,0,0,0,0
7578,7578,Nicky Butt,1115,2007,Newcastle United,18,18,0,1505,1,0,17,17,0,1497,2,0,35,35,0,3002,3,0,0,0,0,1,2,3,0,0,0,0,0,0
7579,7579,Obafemi Martins,3121,2007,Newcastle United,16,12,4,1076,3,0,15,11,4,976,6,0,31,23,8,2052,9,0,0,0,0,3,2,5,1,0,1,0,0,0
7580,7580,Alan Smith,1300,2007,Newcastle United,15,12,3,1094,0,0,18,14,4,1301,0,0,33,26,7,2395,0,0,0,0,0,0,0,0,0,0,0,0,0,0
7581,7581,Mark Viduka,1299,2007,Newcastle United,13,10,3,841,6,0,13,9,4,819,1,0,26,19,7,1660,7,0,1,0,1,5,1,6,0,0,0,0,0,0
7582,7582,Caçapa,3543,2007,Newcastle United,10,9,1,727,1,0,9,7,2,706,0,0,19,16,3,1433,1,0,0,0,0,0,0,0,0,0,0,0,0,0
7583,7583,Michael Owen,1949,2007,Newcastle United,15,12,3,1117,7,0,14,12,2,1060,4,0,29,24,5,2177,11,0,3,1,4,3,3,6,1,1,2,0,0,0
7584,7584,Shola Ameobi,1950,2007,Newcastle United,3,1,2,147,0,0,3,1,2,125,0,0,6,2,4,272,0,0,0,0,0,0,0,0,0,0,0,0,0,0
7585,7585,Daniel Sturridge,1428,2007,Manchester City,1,1,0,55,0,0,2,1,1,104,1,0,3,2,1,159,1,0,0,1,1,0,1,1,0,0,0,0,0,0
7586,7586,Jens Lehmann,1522,2007,Arsenal FC,3,2,1,201,0,0,3,3,0,270,0,0,6,5,1,471,0,0,0,0,0,0,0,0,0,0,0,0,0,0
7587,7587,Eduardo,3544,2007,Arsenal FC,9,5,4,434,1,0,6,6,0,354,3,0,15,11,4,788,4,0,0,0,0,1,2,3,0,0,0,0,0,0
7588,7588,Justin Hoyte,3282,2007,Arsenal FC,2,2,0,148,0,0,3,0,3,7,0,0,5,2,3,155,0,0,0,0,0,0,0,0,0,0,0,0,0,0
7589,7589,Luke Shaw,2576,2012,Southampton FC,11,10,1,912,0,0,14,12,2,1040,0,0,25,22,3,1952,0,0,0,0,0,0,0,0,0,0,0,0,0,0
7590,7590,Nick Pope,2346,2016,Burnley FC,0,0,0,0,0,0,0,0,0,0,0,0,0,0,0,0,0,0,0,0,0,0,0,0,0,0,0,0,0,0
7591,7591,Yaya Touré,1359,2016,Manchester City,13,12,1,1030,1,0,12,10,2,916,4,0,25,22,3,1946,5,0,0,3,3,0,3,3,0,2,2,0,0,0
7592,7592,Stephen Kelly,1121,2008,Stoke City,3,0,3,85,0,0,3,2,1,174,0,0,6,2,4,259,0,0,0,0,0,0,0,0,0,0,0,0,0,0
7593,7593,Gaël Givet,2654,2008,Blackburn Rovers,6,6,0,514,0,0,7,7,0,553,0,0,13,13,0,1067,0,0,0,0,0,0,0,0,0,0,0,0,0,0
7594,7594,El-Hadji Diouf,1719,2008,Blackburn Rovers,7,6,1,582,0,0,6,6,0,526,1,0,13,12,1,1108,1,0,0,0,0,0,1,1,0,0,0,0,0,0
7595,7595,Carlos Villanueva,3545,2008,Blackburn Rovers,5,2,3,242,0,0,7,3,4,313,0,0,12,5,7,555,0,0,0,0,0,0,0,0,0,0,0,0,0,0
7596,7596,Dennis Wise,3054,2001,Leicester City,8,7,1,637,1,0,9,8,1,730,0,0,17,15,2,1367,1,0,0,0,0,0,0,0,0,0,0,0,0,0
7597,7597,Gary Rowett,1303,2001,Leicester City,5,3,2,351,0,0,6,6,0,471,0,0,11,9,2,822,0,0,0,0,0,0,0,0,0,0,0,0,0,0
7598,7598,Kit Symons,3546,2001,Fulham FC,2,1,1,165,0,0,2,1,1,116,0,0,4,2,2,281,0,0,0,0,0,0,0,0,0,0,0,0,0,0
7599,7599,Ciaran Clark,1437,2014,Aston Villa,11,10,1,946,1,0,14,12,2,1047,0,0,25,22,3,1993,1,0,0,0,0,1,0,1,0,0,0,0,0,0
7600,7600,Carles Gil,1872,2014,Aston Villa,3,2,1,179,0,0,2,2,0,180,0,0,5,4,1,359,0,0,0,0,0,0,0,0,0,0,0,0,0,0
7601,7601,Ben Foster,1653,2014,West Bromwich Albion,14,14,0,1226,0,0,14,14,0,1260,0,0,28,28,0,2486,0,0,0,0,0,0,0,0,0,0,0,0,0,0
7602,7602,James Morrison,1735,2014,West Bromwich Albion,16,16,0,1399,0,0,17,13,4,1159,2,0,33,29,4,2558,2,0,0,3,3,0,2,2,0,0,0,0,0,0
7603,7603,Sébastien Pocognoli,3547,2014,West Bromwich Albion,9,9,0,709,0,0,6,6,0,510,0,0,15,15,0,1219,0,0,0,0,0,0,0,0,0,0,0,0,0,0
7604,7604,Jon Flanagan,1263,2013,Liverpool FC,11,11,0,873,0,0,12,12,0,1024,1,0,23,23,0,1897,1,0,0,0,0,0,0,0,0,0,0,0,0,0
7605,7605,Carl Tiler,3548,2000,Charlton Athletic,2,2,0,180,0,0,5,5,0,443,0,0,7,7,0,623,0,0,0,0,0,0,0,0,0,0,0,0,0,0
7606,7606,Steve Brown,2686,2000,Charlton Athletic,10,6,4,628,0,0,15,9,6,929,0,0,25,15,10,1557,0,0,0,0,0,0,0,0,0,0,0,0,0,0
7607,7607,Charlie MacDonald,3549,2000,Charlton Athletic,1,1,0,66,0,0,2,0,2,22,0,0,3,1,2,88,0,0,0,0,0,0,0,0,0,0,0,0,0,0
7608,7608,Mark Crossley,1932,2000,Middlesbrough FC,2,2,0,180,0,0,3,2,1,187,0,0,5,4,1,367,0,0,0,0,0,0,0,0,0,0,0,0,0,0
7609,7609,Dean Gordon,3550,2000,Middlesbrough FC,10,5,5,609,1,0,9,7,2,660,1,0,19,12,7,1269,2,0,3,0,3,1,0,1,0,0,0,0,0,0
7610,7610,Ugo Ehiogu,2134,2000,Middlesbrough FC,10,10,0,900,2,0,10,10,0,817,1,0,20,20,0,1717,3,0,0,1,1,0,1,1,0,0,0,0,0,0
7611,7611,Colin Cooper,2138,2000,Middlesbrough FC,11,11,0,940,1,0,15,14,1,1171,1,0,26,25,1,2111,2,0,1,0,1,1,1,2,0,0,0,0,0,0
7612,7612,Paul Ince,2905,2000,Middlesbrough FC,15,15,0,1335,1,0,14,14,0,1260,1,0,29,29,0,2595,2,0,1,0,1,1,0,1,0,0,0,0,0,0
7613,7613,Gianluca Festa,3551,2000,Middlesbrough FC,13,11,2,949,0,0,12,10,2,948,2,0,25,21,4,1897,2,0,0,0,0,0,1,1,0,0,0,0,0,0
7614,7614,Carlos Marinelli,2698,2000,Middlesbrough FC,8,2,6,252,0,0,5,0,5,75,0,0,13,2,11,327,0,0,0,0,0,0,0,0,0,0,0,0,0,0
7615,7615,Ben Gibson,3004,2019,Burnley FC,0,0,0,0,0,0,0,0,0,0,0,0,0,0,0,0,0,0,0,0,0,0,0,0,0,0,0,0,0,0
7616,7616,Danny Drinkwater,2522,2019,Burnley FC,1,1,0,59,0,0,0,0,0,0,0,0,1,1,0,59,0,0,0,0,0,0,0,0,0,0,0,0,0,0
7617,7617,Rob Elliot,2456,2019,Newcastle United,0,0,0,0,0,0,0,0,0,0,0,0,0,0,0,0,0,0,0,0,0,0,0,0,0,0,0,0,0,0
7618,7618,Paddy McNair,2194,2016,Sunderland AFC,4,3,1,210,0,0,5,2,3,145,0,0,9,5,4,355,0,0,0,0,0,0,0,0,0,0,0,0,0,0
7619,7619,Jan Kirchhoff,3552,2016,Sunderland AFC,5,4,1,323,0,0,2,1,1,112,0,0,7,5,2,435,0,0,0,0,0,0,0,0,0,0,0,0,0,0
7620,7620,Craig Gardner,1403,2016,West Bromwich Albion,5,1,4,100,0,0,4,1,3,113,0,0,9,2,7,213,0,0,0,0,0,0,0,0,0,0,0,0,0,0
7621,7621,Jonas Olsson,1771,2016,West Bromwich Albion,4,4,0,321,0,0,3,3,0,270,0,0,7,7,0,591,0,0,0,0,0,0,0,0,0,0,0,0,0,0
7622,7622,Saido Berahino,1905,2016,West Bromwich Albion,2,1,1,96,0,0,2,2,0,149,0,0,4,3,1,245,0,0,0,0,0,0,0,0,0,0,0,0,0,0
7623,7623,Jonathan Leko,3553,2016,West Bromwich Albion,6,0,6,118,0,0,3,0,3,11,0,0,9,0,9,129,0,0,0,0,0,0,0,0,0,0,0,0,0,0
7624,7624,Matt Jackson,3444,2005,Wigan Athletic,6,5,1,454,0,0,10,6,4,617,0,0,16,11,5,1071,0,0,0,0,0,0,0,0,0,0,0,0,0,0
7625,7625,Alan Mahon,1347,2005,Wigan Athletic,3,2,1,172,0,0,3,3,0,210,1,0,6,5,1,382,1,0,0,0,0,0,0,0,0,0,0,0,0,0
7626,7626,Josip Skoko,2743,2005,Wigan Athletic,0,0,0,0,0,0,5,3,2,194,0,0,5,3,2,194,0,0,0,0,0,0,0,0,0,0,0,0,0,0
7627,7627,David Connolly,1970,2005,Wigan Athletic,8,1,7,154,0,0,9,3,6,338,1,0,17,4,13,492,1,0,0,0,0,0,1,1,0,0,0,0,0,0
7628,7628,Peter Crouch,1273,2006,Liverpool FC,18,13,5,990,6,0,14,6,8,521,3,0,32,19,13,1511,9,0,3,0,3,3,1,4,0,0,0,0,0,0
7629,7629,Mark González,3554,2006,Liverpool FC,13,6,7,561,2,0,12,8,4,656,0,0,25,14,11,1217,2,0,0,0,0,1,0,1,0,0,0,0,0,0
7630,7630,Ben Foster,1653,2019,Watford FC,19,19,0,1710,0,0,19,19,0,1710,0,0,38,38,0,3420,0,0,0,0,0,0,0,0,0,0,0,0,0,0
7631,7631,Adam Masina,2089,2019,Watford FC,14,10,4,935,1,0,12,10,2,884,0,0,26,20,6,1819,1,0,0,0,0,1,0,1,0,0,0,0,0,0
7632,7632,Craig Cathcart,1918,2019,Watford FC,14,14,0,1185,0,0,15,14,1,1304,0,0,29,28,1,2489,0,0,0,0,0,0,0,0,0,0,0,0,0,0
7633,7633,Kiko Femenía,1919,2019,Watford FC,15,14,1,1221,0,0,13,12,1,1020,0,0,28,26,2,2241,0,0,0,0,0,0,0,0,0,0,0,0,0,0
7634,7634,Christian Kabasele,1921,2019,Watford FC,14,14,0,1260,0,0,13,12,1,1037,0,0,27,26,1,2297,0,0,0,0,0,0,0,0,0,0,0,0,0,0
7635,7635,Abdoulaye Doucouré,1922,2019,Watford FC,19,19,0,1655,1,0,18,17,1,1511,3,0,37,36,1,3166,4,0,0,0,0,0,3,3,0,0,0,0,0,0
7636,7636,Will Hughes,1923,2019,Watford FC,14,12,2,1025,0,0,16,15,1,1238,1,0,30,27,3,2263,1,0,0,0,0,0,1,1,0,0,0,0,0,0
7637,7637,Étienne Capoue,1924,2019,Watford FC,15,15,0,1321,0,0,15,15,0,1311,0,0,30,30,0,2632,0,0,0,0,0,0,0,0,0,0,0,0,0,0
7638,7638,Gerard Deulofeu,1927,2019,Watford FC,14,13,1,1063,2,0,14,12,2,1046,2,0,28,25,3,2109,4,0,0,0,0,1,2,3,1,0,1,0,0,0
7639,7639,Troy Deeney,1928,2019,Watford FC,14,13,1,1176,6,0,13,13,0,1058,4,0,27,26,1,2234,10,0,3,0,3,3,1,4,4,1,5,0,0,0
7640,7640,Ismaïla Sarr,3555,2019,Watford FC,15,11,4,1066,4,0,13,11,2,964,1,0,28,22,6,2030,5,0,0,0,0,2,1,3,0,0,0,0,0,0
7641,7641,Nathaniel Chalobah,2330,2019,Watford FC,12,5,7,452,0,0,10,5,5,503,0,0,22,10,12,955,0,0,0,0,0,0,0,0,0,0,0,0,0,0
7642,7642,Roberto Pereyra,2090,2019,Watford FC,14,8,6,801,2,0,14,9,5,849,1,0,28,17,11,1650,3,0,1,0,1,1,0,1,1,0,1,0,0,0
7643,7643,Ignacio Pussetto,3556,2019,Watford FC,4,0,4,28,0,0,3,0,3,39,0,0,7,0,7,67,0,0,0,0,0,0,0,0,0,0,0,0,0,0
7644,7644,Gomes,1266,2019,Watford FC,0,0,0,0,0,0,0,0,0,0,0,0,0,0,0,0,0,0,0,0,0,0,0,0,0,0,0,0,0,0
7645,7645,Craig Dawson,1655,2019,Watford FC,15,13,2,1188,2,0,14,13,1,1171,0,0,29,26,3,2359,2,0,1,0,1,2,0,2,0,0,0,0,0,0
7646,7646,Danny Welbeck,1506,2019,Watford FC,8,3,5,367,1,0,10,5,5,449,1,0,18,8,10,816,2,0,3,0,3,1,0,1,0,0,0,0,0,0
7647,7647,Andre Gray,1925,2019,Watford FC,9,6,3,471,1,0,14,1,13,275,1,0,23,7,16,746,2,0,0,0,0,1,0,1,0,0,0,0,0,0
7648,7648,Adam Lallana,1190,2019,Liverpool FC,9,2,7,199,0,0,6,1,5,175,1,0,15,3,12,374,1,0,0,1,1,0,1,1,0,0,0,0,0,0
7649,7649,Joel Matip,1182,2019,Liverpool FC,3,2,1,181,1,0,6,6,0,523,0,0,9,8,1,704,1,0,0,0,0,1,0,1,0,0,0,0,0,0
7650,7650,Ki-Jana Hoever,3557,2019,Liverpool FC,0,0,0,0,0,0,0,0,0,0,0,0,0,0,0,0,0,0,0,0,0,0,0,0,0,0,0,0,0,0
7651,7651,Jerzy Dudek,2899,2005,Liverpool FC,1,1,0,90,0,0,5,4,1,367,0,0,6,5,1,457,0,0,0,0,0,0,0,0,0,0,0,0,0,0
7652,7652,Jan Kromkamp,3558,2005,Liverpool FC,4,3,1,271,0,0,9,3,6,332,0,0,13,6,7,603,0,0,0,0,0,0,0,0,0,0,0,0,0,0
7653,7653,Robbie Fowler,2691,2005,Liverpool FC,6,4,2,369,2,0,8,5,3,405,3,0,14,9,5,774,5,0,3,3,6,2,3,5,0,0,0,0,0,0
7654,7654,Scott Carson,1999,2004,Liverpool FC,2,2,0,180,0,0,2,2,0,180,0,0,4,4,0,360,0,0,0,0,0,0,0,0,0,0,0,0,0,0
7655,7655,Mauricio Pellegrino,3559,2004,Liverpool FC,7,7,0,586,0,0,5,4,1,327,0,0,12,11,1,913,0,0,0,0,0,0,0,0,0,0,0,0,0,0
7656,7656,Harry Kewell,1296,2004,Liverpool FC,10,9,1,778,0,0,8,6,2,619,1,0,18,15,3,1397,1,0,0,0,0,0,1,1,0,0,0,0,0,0
7657,7657,Núñez,3560,2004,Liverpool FC,12,5,7,623,0,0,6,3,3,278,0,0,18,8,10,901,0,0,0,0,0,0,0,0,0,0,0,0,0,0
7658,7658,Igor Bišćan,2365,2004,Liverpool FC,10,3,7,319,1,0,9,5,4,410,1,0,19,8,11,729,2,0,3,0,3,1,0,1,0,0,0,0,0,0
7659,7659,Steve Finnan,2883,2004,Liverpool FC,18,15,3,1340,1,0,15,14,1,1206,0,0,33,29,4,2546,1,0,0,0,0,0,0,0,0,0,0,0,0,0
7660,7660,Steven Davis,1149,2004,Aston Villa,13,9,4,843,0,0,14,9,5,958,1,0,27,18,9,1801,1,0,0,3,3,0,1,1,0,0,0,0,0,0
7661,7661,Samir Nasri,1358,2014,Manchester City,11,9,2,766,1,0,13,9,4,826,1,0,24,18,6,1592,2,0,0,0,0,0,0,0,0,0,0,0,0,0
7662,7662,Mike Williamson,2287,2014,Newcastle United,15,12,3,1127,1,0,16,15,1,1318,0,0,31,27,4,2445,1,0,0,0,0,1,0,1,0,0,0,0,0,0
7663,7663,Massadio Haïdara,2280,2014,Newcastle United,7,5,2,458,0,0,8,7,1,641,0,0,15,12,3,1099,0,0,0,0,0,0,0,0,0,0,0,0,0,0
7664,7664,Gabriel Obertan,2283,2014,Newcastle United,7,4,3,377,1,0,6,4,2,275,0,0,13,8,5,652,1,0,3,0,3,1,0,1,0,0,0,0,0,0
7665,7665,Adam Armstrong,3561,2014,Newcastle United,6,0,6,97,0,0,5,1,4,106,0,0,11,1,10,203,0,0,0,0,0,0,0,0,0,0,0,0,0,0
7666,7666,Stephen Warnock,1616,2005,Liverpool FC,9,5,4,456,1,0,11,10,1,820,0,0,20,15,5,1276,1,0,0,0,0,0,0,0,0,0,0,0,0,0
7667,7667,Dietmar Hamann,2690,2005,Liverpool FC,9,5,4,525,0,0,8,8,0,621,0,0,17,13,4,1146,0,0,0,0,0,0,0,0,0,0,0,0,0,0
7668,7668,Damien Francis,2117,2005,Wigan Athletic,11,9,2,816,0,0,9,7,2,633,1,0,20,16,4,1449,1,0,0,3,3,0,1,1,0,0,0,0,0,0
7669,7669,Andy O'Brien,2160,2010,Bolton Wanderers,0,0,0,0,0,0,2,1,1,42,0,0,2,1,1,42,0,0,0,0,0,0,0,0,0,0,0,0,0,0
7670,7670,Pascal Zuberbühler,3562,2010,Fulham FC,0,0,0,0,0,0,0,0,0,0,0,0,0,0,0,0,0,0,0,0,0,0,0,0,0,0,0,0,0,0
7671,7671,Fredrik Stoor,3563,2010,Fulham FC,0,0,0,0,0,0,0,0,0,0,0,0,0,0,0,0,0,0,0,0,0,0,0,0,0,0,0,0,0,0
7672,7672,David Elm,3402,2010,Fulham FC,0,0,0,0,0,0,0,0,0,0,0,0,0,0,0,0,0,0,0,0,0,0,0,0,0,0,0,0,0,0
7673,7673,Warren Barton,3394,2001,Derby County,7,7,0,630,0,0,6,6,0,540,0,0,13,13,0,1170,0,0,0,0,0,0,0,0,0,0,0,0,0,0
7674,7674,Lee Morris,3453,2001,Derby County,9,6,3,498,3,0,5,2,3,205,1,0,14,8,6,703,4,0,3,0,3,1,0,1,0,0,0,0,0,0
7675,7675,Brian O'Neil,3450,2001,Derby County,5,4,1,367,0,0,4,3,1,305,0,0,9,7,2,672,0,0,0,0,0,0,0,0,0,0,0,0,0,0
7676,7676,Øyvind Leonhardsen,2078,2001,Tottenham Hotspur,4,1,3,91,0,0,3,1,2,136,0,0,7,2,5,227,0,0,0,0,0,0,0,0,0,0,0,0,0,0
7677,7677,Tim Sherwood,2077,2001,Tottenham Hotspur,8,7,1,635,0,0,11,8,3,753,0,0,19,15,4,1388,0,0,0,0,0,0,0,0,0,0,0,0,0,0
7678,7678,Steffen Iversen,2080,2001,Tottenham Hotspur,7,3,4,473,2,0,10,8,2,744,2,0,17,11,6,1217,4,0,0,0,0,2,2,4,0,0,0,0,0,0
7679,7679,Matthew Etherington,1557,2001,Tottenham Hotspur,5,2,3,224,0,0,6,1,5,170,0,0,11,3,8,394,0,0,0,0,0,0,0,0,0,0,0,0,0,0
7680,7680,Pascal Cygan,3439,2005,Arsenal FC,5,5,0,394,2,0,6,5,1,451,0,0,11,10,1,845,2,0,0,0,0,1,0,1,0,0,0,0,0,0
7681,7681,Aliou Cissé,2622,2005,Portsmouth FC,1,0,1,1,0,0,2,2,0,166,0,0,3,2,1,167,0,0,0,0,0,0,0,0,0,0,0,0,0,0
7682,7682,Zvonimir Vukić,3564,2005,Portsmouth FC,4,3,1,271,0,0,5,3,2,247,1,0,9,6,3,518,1,0,0,0,0,0,1,1,0,0,0,0,0,0
7683,7683,Giannis Skopelitis,3565,2005,Portsmouth FC,0,0,0,0,0,0,5,0,5,73,0,0,5,0,5,73,0,0,0,0,0,0,0,0,0,0,0,0,0,0
7684,7684,Ivica Mornar,3566,2005,Portsmouth FC,1,1,0,45,0,0,1,0,1,7,0,0,2,1,1,52,0,0,0,0,0,0,0,0,0,0,0,0,0,0
7685,7685,Manuel Almunia,2039,2010,Arsenal FC,4,4,0,360,0,0,4,4,0,360,0,0,8,8,0,720,0,0,0,0,0,0,0,0,0,0,0,0,0,0
7686,7686,Dean Whitehead,1218,2010,Stoke City,18,14,4,1351,1,0,19,17,2,1547,1,0,37,31,6,2898,2,0,3,0,3,1,1,2,0,0,0,0,0,0
7687,7687,John Carew,1621,2010,Stoke City,3,2,1,167,1,0,7,5,2,449,0,0,10,7,3,616,1,0,0,0,0,1,0,1,0,0,0,0,0,0
7688,7688,Ricardo Fuller,2500,2010,Stoke City,13,6,7,626,4,0,15,3,12,493,0,0,28,9,19,1119,4,0,0,0,0,2,0,2,0,0,0,0,0,0
7689,7689,Salif Diao,1992,2010,Stoke City,2,0,2,16,0,0,6,3,3,218,0,0,8,3,5,234,0,0,0,0,0,0,0,0,0,0,0,0,0,0
7690,7690,Tal Ben Haim,1715,2007,Chelsea FC,6,4,2,424,0,0,7,6,1,591,0,0,13,10,3,1015,0,0,0,0,0,0,0,0,0,0,0,0,0,0
7691,7691,Ricardo Gardner,2411,2005,Bolton Wanderers,14,13,1,1144,0,0,15,13,2,1209,0,0,29,26,3,2353,0,0,0,0,0,0,0,0,0,0,0,0,0,0
7692,7692,Ricardo Vaz Tê,3416,2005,Bolton Wanderers,12,5,7,553,3,0,10,1,9,282,0,0,22,6,16,835,3,0,4,0,4,3,0,3,0,0,0,0,0,0
7693,7693,Alessandro Pistone,1799,2005,Everton FC,1,1,0,90,0,0,1,1,0,33,0,0,2,2,0,123,0,0,0,0,0,0,0,0,0,0,0,0,0,0
7694,7694,Kieran Richardson,1898,2006,Manchester United,10,5,5,537,1,0,5,3,2,243,0,0,15,8,7,780,1,0,0,0,0,1,0,1,0,0,0,0,0,0
7695,7695,Dong-gook Lee,3400,2006,Middlesbrough FC,6,2,4,154,0,0,3,1,2,124,0,0,9,3,6,278,0,0,0,0,0,0,0,0,0,0,0,0,0,0
7696,7696,Davide Zappacosta,3381,2018,Chelsea FC,3,0,3,35,0,0,1,1,0,90,0,0,4,1,3,125,0,0,0,0,0,0,0,0,0,0,0,0,0,0
7697,7697,Yoan Gouffran,2454,2015,Newcastle United,3,0,3,32,0,0,5,2,3,192,0,0,8,2,6,224,0,0,0,0,0,0,0,0,0,0,0,0,0,0
7698,7698,Ritchie De Laet,2514,2015,Leicester City,7,4,3,372,1,0,5,3,2,284,0,0,12,7,5,656,1,0,0,0,0,0,0,0,0,0,0,0,0,0
7699,7699,Gabriel Jesus,1841,2016,Manchester City,6,4,2,366,4,0,4,4,0,285,3,0,10,8,2,651,7,0,3,1,4,3,1,4,1,0,1,0,0,0
7700,7700,Martin Olsson,1372,2016,Swansea City,7,7,0,616,2,0,8,7,1,637,0,0,15,14,1,1253,2,0,0,0,0,1,0,1,0,0,0,0,0,0
7701,7701,Tom Carroll,2816,2016,Swansea City,8,8,0,720,1,0,9,8,1,670,0,0,17,16,1,1390,1,0,0,0,0,0,0,0,0,0,0,0,0,0
7702,7702,Luciano Narsingh,3190,2016,Swansea City,6,2,4,219,0,0,7,1,6,190,0,0,13,3,10,409,0,0,0,0,0,0,0,0,0,0,0,0,0,0
7703,7703,Jason Davidson,3567,2014,West Bromwich Albion,0,0,0,0,0,0,2,1,1,102,0,0,2,1,1,102,0,0,0,0,0,0,0,0,0,0,0,0,0,0
7704,7704,Graham Dorrans,1737,2014,West Bromwich Albion,10,9,1,765,1,0,11,10,1,829,0,0,21,19,2,1594,1,0,0,0,0,0,0,0,0,0,0,0,0,0
7705,7705,Cristian Gamboa,3568,2014,West Bromwich Albion,5,0,5,101,0,0,5,1,4,132,0,0,10,1,9,233,0,0,0,0,0,0,0,0,0,0,0,0,0,0
7706,7706,Ibrahim Ba,3569,2003,Bolton Wanderers,5,0,5,125,0,0,4,0,4,141,0,0,9,0,9,266,0,0,0,0,0,0,0,0,0,0,0,0,0,0
7707,7707,Marco Ambrosio,3570,2003,Chelsea FC,4,4,0,360,0,0,4,4,0,360,0,0,8,8,0,720,0,0,0,0,0,0,0,0,0,0,0,0,0,0
7708,7708,Tomasz Kuszczak,1786,2006,Manchester United,5,5,0,450,0,0,1,1,0,90,0,0,6,6,0,540,0,0,0,0,0,0,0,0,0,0,0,0,0,0
7709,7709,William Gallas,2040,2006,Arsenal FC,12,12,0,1071,2,0,9,9,0,810,1,0,21,21,0,1881,3,0,0,0,0,1,0,1,0,0,0,0,0,0
7710,7710,Emmanuel Eboué,1231,2006,Arsenal FC,13,13,0,1158,0,0,10,9,1,815,0,0,23,22,1,1973,0,0,0,0,0,0,0,0,0,0,0,0,0,0
7711,7711,Freddie Ljungberg,1525,2006,Arsenal FC,8,8,0,521,0,0,10,8,2,684,0,0,18,16,2,1205,0,0,0,0,0,0,0,0,0,0,0,0,0,0
7712,7712,Aliaksandr Hleb,2433,2006,Arsenal FC,18,14,4,1297,1,0,14,12,2,972,1,0,32,26,6,2269,2,0,0,0,0,1,0,1,0,0,0,0,0,0
7713,7713,Daniel Agger,1776,2005,Liverpool FC,3,3,0,270,0,0,1,1,0,90,0,0,4,4,0,360,0,0,0,0,0,0,0,0,0,0,0,0,0,0
7714,7714,Martin Latka,3571,2005,Birmingham City,3,3,0,270,0,0,3,3,0,251,0,0,6,6,0,521,0,0,0,0,0,0,0,0,0,0,0,0,0,0
7715,7715,Alex Bruce,2222,2005,Birmingham City,1,0,1,2,0,0,5,3,2,274,0,0,6,3,3,276,0,0,0,0,0,0,0,0,0,0,0,0,0,0
7716,7716,Victor Wanyama,1864,2015,Southampton FC,15,14,1,1277,1,0,15,15,0,1288,0,0,30,29,1,2565,1,0,0,0,0,0,0,0,0,0,0,0,0,0
7717,7717,Juanmi,3572,2015,Southampton FC,7,0,7,105,0,0,5,0,5,56,0,0,12,0,12,161,0,0,0,0,0,0,0,0,0,0,0,0,0,0
7718,7718,Kelvin Davis,1143,2015,Southampton FC,1,1,0,90,0,0,0,0,0,0,0,0,1,1,0,90,0,0,0,0,0,0,0,0,0,0,0,0,0,0
7719,7719,Steven Caulker,2806,2015,Southampton FC,0,0,0,0,0,0,3,1,2,145,0,0,3,1,2,145,0,0,0,0,0,0,0,0,0,0,0,0,0,0
7720,7720,Shane Long,1154,2018,Southampton FC,15,6,9,646,3,0,11,6,5,640,2,0,26,12,14,1286,5,0,0,0,0,2,1,3,0,0,0,0,0,0
7721,7721,Rigobert Song,2340,2001,West Ham United,1,1,0,90,0,0,4,4,0,315,0,0,5,5,0,405,0,0,0,0,0,0,0,0,0,0,0,0,0,0
7722,7722,Svetoslav Todorov,2967,2001,West Ham United,1,1,0,70,0,0,5,1,4,150,0,0,6,2,4,220,0,0,0,0,0,0,0,0,0,0,0,0,0,0
7723,7723,Felipe Anderson,2203,2018,West Ham United,17,17,0,1439,4,0,19,19,0,1615,5,0,36,36,0,3054,9,0,0,4,4,3,4,7,0,0,0,0,0,0
7724,7724,Ryan Fredericks,2202,2018,West Ham United,5,4,1,404,1,0,10,8,2,681,0,0,15,12,3,1085,1,0,0,0,0,0,0,0,0,0,0,0,0,0
7725,7725,Calum Davenport,1394,2004,Tottenham Hotspur,0,0,0,0,0,0,1,0,1,7,0,0,1,0,1,7,0,0,0,0,0,0,0,0,0,0,0,0,0,0
7726,7726,Tim Howard,1743,2006,Everton FC,18,18,0,1620,0,0,16,16,0,1440,0,0,34,34,0,3060,0,0,0,0,0,0,0,0,0,0,0,0,0,0
7727,7727,Joseph Yobo,1801,2006,Everton FC,19,19,0,1710,2,0,17,17,0,1530,0,0,36,36,0,3240,2,0,0,0,0,1,0,1,0,0,0,0,0,0
7728,7728,Joleon Lescott,1365,2006,Everton FC,19,18,1,1661,1,0,17,16,1,1476,1,0,36,34,2,3137,2,0,0,0,0,1,1,2,0,0,0,0,0,0
7729,7729,Phil Neville,1114,2006,Everton FC,17,17,0,1518,1,0,16,16,0,1415,0,0,33,33,0,2933,1,0,0,0,0,0,0,0,0,0,0,0,0,0
7730,7730,Nuno Valente,2106,2006,Everton FC,8,5,3,447,0,0,6,5,1,451,0,0,14,10,4,898,0,0,0,0,0,0,0,0,0,0,0,0,0,0
7731,7731,Mikel Arteta,1802,2006,Everton FC,17,17,0,1518,6,0,16,16,0,1440,3,0,33,33,0,2958,9,0,3,1,4,5,2,7,3,2,5,0,0,0
7732,7732,Tim Cahill,1746,2006,Everton FC,8,8,0,618,1,0,9,8,1,699,4,0,17,16,1,1317,5,0,0,2,2,1,3,4,0,0,0,0,0,0
7733,7733,Leon Osman,1747,2006,Everton FC,17,16,1,1418,1,0,15,13,2,1211,2,0,32,29,3,2629,3,0,0,0,0,1,0,1,0,0,0,0,0,0
7734,7734,Lee Carsley,1803,2006,Everton FC,19,19,0,1673,1,0,17,17,0,1525,0,0,36,36,0,3198,1,0,0,0,0,1,0,1,0,0,0,0,0,0
7735,7735,Andy Johnson,1322,2006,Everton FC,16,16,0,1412,8,0,14,14,0,1124,3,0,30,30,0,2536,11,0,7,0,7,6,1,7,0,1,1,0,0,0
7736,7736,James Beattie,2050,2006,Everton FC,18,7,11,748,2,0,15,8,7,715,0,0,33,15,18,1463,2,0,0,0,0,1,0,1,2,0,2,0,0,0
7737,7737,David Weir,1800,2006,Everton FC,3,1,2,100,0,0,2,1,1,52,0,0,5,2,3,152,0,0,0,0,0,0,0,0,0,0,0,0,0,0
7738,7738,Victor Anichebe,1751,2006,Everton FC,13,5,8,491,3,0,6,0,6,126,0,0,19,5,14,617,3,0,0,0,0,1,0,1,0,0,0,0,0,0
7739,7739,Stephen Jordan,2549,2006,Manchester City,6,6,0,495,0,0,7,6,1,545,0,0,13,12,1,1040,0,0,0,0,0,0,0,0,0,0,0,0,0,0
7740,7740,Stephen Ireland,1809,2006,Manchester City,12,8,4,796,0,0,12,6,6,538,1,0,24,14,10,1334,1,0,0,3,3,0,1,1,0,0,0,0,0,0
7741,7741,Dietmar Hamann,2690,2006,Manchester City,7,5,2,394,0,0,9,7,2,593,0,0,16,12,4,987,0,0,0,0,0,0,0,0,0,0,0,0,0,0
7742,7742,Ishmael Miller,1813,2006,Manchester City,9,2,7,309,0,0,7,1,6,153,0,0,16,3,13,462,0,0,0,0,0,0,0,0,0,0,0,0,0,0
7743,7743,David Weir,1800,2003,Everton FC,4,4,0,302,0,0,6,5,1,508,0,0,10,9,1,810,0,0,0,0,0,0,0,0,0,0,0,0,0,0
7744,7744,Mario Melchiot,1512,2003,Chelsea FC,11,9,2,884,1,0,11,10,1,864,1,0,22,19,3,1748,2,0,0,3,3,1,1,2,0,0,0,0,0,0
7745,7745,Don Hutchison,1095,2002,West Ham United,6,0,6,70,0,0,4,0,4,50,0,0,10,0,10,120,0,0,0,0,0,0,0,0,0,0,0,0,0,0
7746,7746,Andy Griffin,1578,2002,Newcastle United,12,10,2,918,1,0,13,10,3,942,0,0,25,20,5,1860,1,0,0,0,0,1,0,1,0,0,0,0,0,0
7747,7747,Steven Caldwell,2375,2002,Newcastle United,8,8,0,711,1,0,5,3,2,366,0,0,13,11,2,1077,1,0,0,0,0,0,0,0,0,0,0,0,0,0
7748,7748,Clarence Acuña,3573,2002,Newcastle United,2,1,1,76,0,0,2,1,1,74,0,0,4,2,2,150,0,0,0,0,0,0,0,0,0,0,0,0,0,0
7749,7749,Carl Cort,2162,2002,Newcastle United,0,0,0,0,0,0,1,0,1,4,0,0,1,0,1,4,0,0,0,0,0,0,0,0,0,0,0,0,0,0
7750,7750,Lomana LuaLua,1074,2002,Newcastle United,5,1,4,175,2,0,6,4,2,338,0,0,11,5,6,513,2,0,0,0,0,1,0,1,0,0,0,0,0,0
7751,7751,Mauro Zárate,2504,2015,West Ham United,7,5,2,396,2,0,8,4,4,393,1,0,15,9,6,789,3,0,0,0,0,2,0,2,0,0,0,0,0,0
7752,7752,Modibo Maïga,2763,2015,West Ham United,2,0,2,24,1,0,1,0,1,1,0,0,3,0,3,25,1,0,0,0,0,0,0,0,0,0,0,0,0,0
7753,7753,Kevin Nolan,2396,2015,West Ham United,1,1,0,46,0,0,1,0,1,11,0,0,2,1,1,57,0,0,0,0,0,0,0,0,0,0,0,0,0,0
7754,7754,Yohan Benalouane,2569,2015,Leicester City,1,0,1,15,0,0,3,0,3,50,0,0,4,0,4,65,0,0,0,0,0,0,0,0,0,0,0,0,0,0
7755,7755,Jonny Maddison,3574,2015,Leicester City,0,0,0,0,0,0,0,0,0,0,0,0,0,0,0,0,0,0,0,0,0,0,0,0,0,0,0,0,0,0
7756,7756,Dean Hammond,3575,2015,Leicester City,0,0,0,0,0,0,0,0,0,0,0,0,0,0,0,0,0,0,0,0,0,0,0,0,0,0,0,0,0,0
7757,7757,Andrej Kramarić,2531,2015,Leicester City,1,0,1,12,0,0,1,0,1,10,0,0,2,0,2,22,0,0,0,0,0,0,0,0,0,0,0,0,0,0
7758,7758,Dong-won Ji,3576,2011,Sunderland AFC,10,0,10,111,2,0,9,2,7,325,0,0,19,2,17,436,2,0,3,0,3,1,0,1,0,0,0,0,0,0
7759,7759,Ahmed Elmohamady,1690,2011,Sunderland AFC,10,4,6,440,1,0,8,3,5,336,0,0,18,7,11,776,1,0,1,0,1,1,0,1,0,0,0,0,0,0
7760,7760,Connor Wickham,1035,2011,Sunderland AFC,8,2,6,304,1,0,8,3,5,219,0,0,16,5,11,523,1,0,0,0,0,1,0,1,0,0,0,0,0,0
7761,7761,Craig Lynch,1693,2011,Sunderland AFC,0,0,0,0,0,0,0,0,0,0,0,0,0,0,0,0,0,0,0,0,0,0,0,0,0,0,0,0,0,0
7762,7762,Zak Whitbread,3577,2011,Norwich City,8,8,0,663,0,0,10,10,0,777,0,0,18,18,0,1440,0,0,0,0,0,0,0,0,0,0,0,0,0,0
7763,7763,Daniel Ayala,3003,2011,Norwich City,4,3,1,227,0,0,3,3,0,270,0,0,7,6,1,497,0,0,0,0,0,0,0,0,0,0,0,0,0,0
7764,7764,Jed Steer,1447,2011,Norwich City,0,0,0,0,0,0,0,0,0,0,0,0,0,0,0,0,0,0,0,0,0,0,0,0,0,0,0,0,0,0
7765,7765,Elliott Ward,3578,2011,Norwich City,6,6,0,540,0,0,6,6,0,540,0,0,12,12,0,1080,0,0,0,0,0,0,0,0,0,0,0,0,0,0
7766,7766,Jonjoe Kenny,1050,2018,Everton FC,5,4,1,413,0,0,5,4,1,377,0,0,10,8,2,790,0,0,0,0,0,0,0,0,0,0,0,0,0,0
7767,7767,Morgan Schneiderlin,1051,2018,Everton FC,9,6,3,474,0,0,5,4,1,361,0,0,14,10,4,835,0,0,0,0,0,0,0,0,0,0,0,0,0,0
7768,7768,Andrey Yarmolenko,2352,2018,West Ham United,5,3,2,269,0,0,4,2,2,190,2,0,9,5,4,459,2,0,0,0,0,0,1,1,0,0,0,0,0,0
7769,7769,Carlos Sánchez,1867,2018,West Ham United,4,1,3,120,0,0,3,1,2,120,0,0,7,2,5,240,0,0,0,0,0,0,0,0,0,0,0,0,0,0
7770,7770,Petr Čech,1531,2004,Chelsea FC,18,18,0,1620,0,0,17,17,0,1530,0,0,35,35,0,3150,0,0,0,0,0,0,0,0,0,0,0,0,0,0
7771,7771,Ricardo Carvalho,1760,2004,Chelsea FC,12,11,1,991,0,0,13,11,2,978,1,0,25,22,3,1969,1,0,0,0,0,0,0,0,0,0,0,0,0,0
7772,7772,Wayne Bridge,1768,2004,Chelsea FC,9,8,1,743,0,0,6,4,2,405,0,0,15,12,3,1148,0,0,0,0,0,0,0,0,0,0,0,0,0,0
7773,7773,Paulo Ferreira,1761,2004,Chelsea FC,14,14,0,1260,0,0,15,15,0,1350,0,0,29,29,0,2610,0,0,0,0,0,0,0,0,0,0,0,0,0,0
7774,7774,John Terry,1534,2004,Chelsea FC,19,19,0,1710,0,0,17,17,0,1530,3,0,36,36,0,3240,3,0,0,0,0,0,1,1,0,0,0,0,0,0
7775,7775,Claude Makélélé,1762,2004,Chelsea FC,17,17,0,1530,1,0,19,19,0,1710,0,0,36,36,0,3240,1,0,3,0,3,1,0,1,0,0,0,0,0,0
7776,7776,Frank Lampard,1536,2004,Chelsea FC,19,19,0,1710,5,0,19,19,0,1703,8,0,38,38,0,3413,13,0,3,1,4,4,5,9,1,2,3,0,0,0
7777,7777,Joe Cole,1630,2004,Chelsea FC,13,11,2,898,3,0,15,8,7,746,5,0,28,19,9,1644,8,0,3,6,9,3,3,6,0,0,0,0,0,0
7778,7778,Tiago,3579,2004,Chelsea FC,17,9,8,858,1,0,17,12,5,1108,3,0,34,21,13,1966,4,0,0,0,0,0,1,1,0,0,0,0,0,0
7779,7779,Didier Drogba,1766,2004,Chelsea FC,14,10,4,892,8,0,12,8,4,739,2,0,26,18,8,1631,10,0,4,3,7,4,2,6,0,0,0,0,0,0
7780,7780,Eiður Guðjohnsen,2373,2004,Chelsea FC,19,16,3,1346,5,0,19,14,5,1201,7,0,38,30,8,2547,12,0,3,4,7,2,3,5,1,0,1,0,0,0
7781,7781,Aleksey Smertin,1072,2004,Chelsea FC,8,5,3,351,0,0,8,6,2,431,0,0,16,11,5,782,0,0,0,0,0,0,0,0,0,0,0,0,0,0
7782,7782,Damien Duff,1348,2004,Chelsea FC,17,15,2,1325,4,0,13,13,0,1084,2,0,30,28,2,2409,6,0,3,0,3,3,1,4,0,0,0,0,0,0
7783,7783,Mateja Kežman,3580,2004,Chelsea FC,15,2,13,330,3,0,10,4,6,408,1,0,25,6,19,738,4,0,0,0,0,0,1,1,1,0,1,0,0,0
7784,7784,Jamie Redknapp,1123,2004,Tottenham Hotspur,7,5,2,406,0,0,7,4,3,356,0,0,14,9,5,762,0,0,0,0,0,0,0,0,0,0,0,0,0,0
7785,7785,Danny Ward,2444,2017,Liverpool FC,0,0,0,0,0,0,0,0,0,0,0,0,0,0,0,0,0,0,0,0,0,0,0,0,0,0,0,0,0,0
7786,7786,Laurent Koscielny,1497,2017,Arsenal FC,12,12,0,1080,2,0,13,13,0,1147,0,0,25,25,0,2227,2,0,0,0,0,0,0,0,0,0,0,0,0,0
7787,7787,Nacho Monreal,1498,2017,Arsenal FC,14,14,0,1116,3,0,14,12,2,1128,2,0,28,26,2,2244,5,0,0,0,0,3,2,5,0,0,0,0,0,0
7788,7788,Héctor Bellerín,1499,2017,Arsenal FC,18,18,0,1604,1,0,17,16,1,1447,1,0,35,34,1,3051,2,0,1,0,1,1,1,2,0,0,0,0,0,0
7789,7789,Mesut Özil,1500,2017,Arsenal FC,15,14,1,1243,3,0,11,10,1,921,1,0,26,24,2,2164,4,0,3,0,3,2,1,3,0,0,0,0,0,0
7790,7790,Francis Coquelin,1503,2017,Arsenal FC,3,0,3,41,0,0,4,1,3,123,0,0,7,1,6,164,0,0,0,0,0,0,0,0,0,0,0,0,0,0
7791,7791,Alexandre Lacazette,1481,2017,Arsenal FC,16,14,2,1152,11,0,16,12,4,1060,3,0,32,26,6,2212,14,0,0,0,0,3,1,4,2,0,2,0,0,0
7792,7792,Olivier Giroud,1504,2017,Arsenal FC,8,0,8,148,3,0,8,1,7,225,1,0,16,1,15,373,4,0,3,1,4,1,1,2,0,0,0,0,0,0
7793,7793,Theo Walcott,1237,2017,Arsenal FC,4,0,4,37,0,0,2,0,2,26,0,0,6,0,6,63,0,0,0,0,0,0,0,0,0,0,0,0,0,0
7794,7794,Sander Berge,3581,2019,Sheffield United,7,6,1,476,1,0,7,6,1,473,0,0,14,12,2,949,1,0,0,0,0,1,0,1,0,0,0,0,0,0
7795,7795,David McGoldrick,3582,2019,Sheffield United,15,12,3,1000,2,0,13,10,3,825,0,0,28,22,6,1825,2,0,0,0,0,1,0,1,0,0,0,0,0,0
7796,7796,Panagiotis Retsos,3583,2019,Sheffield United,0,0,0,0,0,0,0,0,0,0,0,0,0,0,0,0,0,0,0,0,0,0,0,0,0,0,0,0,0,0
7797,7797,Ondrej Duda,3584,2019,Norwich City,6,5,1,403,0,0,4,4,0,326,0,0,10,9,1,729,0,0,0,0,0,0,0,0,0,0,0,0,0,0
7798,7798,Lukas Rupp,3585,2019,Norwich City,6,2,4,211,0,0,6,6,0,488,0,0,12,8,4,699,0,0,0,0,0,0,0,0,0,0,0,0,0,0
7799,7799,Sotirios Kyrgiakos,3170,2009,Liverpool FC,7,6,1,619,0,0,7,7,0,630,1,0,14,13,1,1249,1,0,0,0,0,0,1,1,0,0,0,0,0,0
7800,7800,Nedum Onuoha,2533,2009,Manchester City,6,3,3,345,1,0,4,2,2,225,0,0,10,5,5,570,1,0,0,0,0,0,0,0,0,0,0,0,0,0
7801,7801,Gary Cahill,1533,2009,Bolton Wanderers,16,16,0,1440,3,0,13,13,0,1170,2,0,29,29,0,2610,5,0,0,3,3,1,2,3,0,0,0,0,0,0
7802,7802,Ricardo Gardner,2411,2009,Bolton Wanderers,9,3,6,350,1,0,12,8,4,753,0,0,21,11,10,1103,1,0,0,0,0,1,0,1,0,0,0,0,0,0
7803,7803,Gavin McCann,1096,2009,Bolton Wanderers,6,3,3,286,0,0,5,2,3,246,0,0,11,5,6,532,0,0,0,0,0,0,0,0,0,0,0,0,0,0
7804,7804,Manuel Almunia,2039,2009,Arsenal FC,14,14,0,1260,0,0,15,15,0,1350,0,0,29,29,0,2610,0,0,0,0,0,0,0,0,0,0,0,0,0,0
7805,7805,Thomas Vermaelen,2749,2009,Arsenal FC,17,17,0,1530,5,0,16,16,0,1314,2,0,33,33,0,2844,7,0,0,0,0,3,0,3,0,0,0,0,0,0
7806,7806,William Gallas,2040,2009,Arsenal FC,13,13,0,1170,1,0,13,13,0,1170,2,0,26,26,0,2340,3,0,0,0,0,0,0,0,0,0,0,0,0,0
7807,7807,Armand Traoré,1238,2009,Arsenal FC,4,4,0,358,0,0,5,5,0,447,0,0,9,9,0,805,0,0,0,0,0,0,0,0,0,0,0,0,0,0
7808,7808,Cesc Fàbregas,1526,2009,Arsenal FC,14,13,1,1094,9,0,13,13,0,1106,6,0,27,26,1,2200,15,0,0,0,0,3,3,6,2,1,3,0,0,0
7809,7809,Eduardo,3544,2009,Arsenal FC,11,8,3,660,2,0,13,5,8,463,2,0,24,13,11,1123,4,0,0,0,0,0,1,1,0,0,0,0,0,0
7810,7810,Andrey Arshavin,2750,2009,Arsenal FC,15,13,2,1162,6,0,15,12,3,1101,4,0,30,25,5,2263,10,0,0,3,3,3,3,6,0,0,0,0,0,0
7811,7811,Carlos Vela,3285,2009,Arsenal FC,7,0,7,126,1,0,4,1,3,99,0,0,11,1,10,225,1,0,0,0,0,0,0,0,0,0,0,0,0,0
7812,7812,Danny Simpson,2395,2011,Newcastle United,18,18,0,1599,0,0,17,17,0,1521,0,0,35,35,0,3120,0,0,0,0,0,0,0,0,0,0,0,0,0,0
7813,7813,Steven Taylor,2014,2011,Newcastle United,7,7,0,630,0,0,7,7,0,630,0,0,14,14,0,1260,0,0,0,0,0,0,0,0,0,0,0,0,0,0
7814,7814,Leon Best,2399,2011,Newcastle United,11,9,2,613,3,0,7,7,0,549,1,0,18,16,2,1162,4,0,3,1,4,2,1,3,0,0,0,0,0,0
7815,7815,Sammy Ameobi,2459,2011,Newcastle United,4,0,4,85,0,0,8,1,7,137,0,0,12,1,11,222,0,0,0,0,0,0,0,0,0,0,0,0,0,0
7816,7816,Danny Guthrie,2397,2011,Newcastle United,7,6,1,525,0,0,9,7,2,606,1,0,16,13,3,1131,1,0,0,0,0,0,1,1,0,0,0,0,0,0
7817,7817,Peter Løvenkrands,2401,2011,Newcastle United,4,2,2,143,0,0,5,0,5,59,0,0,9,2,7,202,0,0,0,0,0,0,0,0,0,0,0,0,0,0
7818,7818,Paul Smith,3586,2004,Southampton FC,2,2,0,180,0,0,2,1,1,174,0,0,4,3,1,354,0,0,0,0,0,0,0,0,0,0,0,0,0,0
7819,7819,Henri Camara,1818,2004,Southampton FC,6,4,2,361,2,0,5,4,1,368,2,0,11,8,3,729,4,0,3,0,3,2,0,2,0,0,0,0,0,0
7820,7820,Gaël Clichy,1230,2004,Arsenal FC,8,4,4,412,0,0,6,2,4,271,0,0,14,6,8,683,0,0,0,0,0,0,0,0,0,0,0,0,0,0
7821,7821,Emmanuel Eboué,1231,2004,Arsenal FC,0,0,0,0,0,0,1,0,1,15,0,0,1,0,1,15,0,0,0,0,0,0,0,0,0,0,0,0,0,0
7822,7822,Stern John,1971,2004,Birmingham City,2,0,2,40,0,0,1,0,1,11,0,0,3,0,3,51,0,0,0,0,0,0,0,0,0,0,0,0,0,0
7823,7823,Geremi,1764,2004,Chelsea FC,5,2,3,201,0,0,8,4,4,387,0,0,13,6,7,588,0,0,0,0,0,0,0,0,0,0,0,0,0,0
7824,7824,Wayne Routledge,1758,2010,Newcastle United,8,4,4,361,0,0,8,5,3,556,0,0,16,9,7,917,0,0,0,0,0,0,0,0,0,0,0,0,0,0
7825,7825,Ole Söderberg,3587,2010,Newcastle United,0,0,0,0,0,0,0,0,0,0,0,0,0,0,0,0,0,0,0,0,0,0,0,0,0,0,0,0,0,0
7826,7826,Alan Smith,1300,2010,Newcastle United,3,1,2,86,0,0,7,5,2,416,0,0,10,6,4,502,0,0,0,0,0,0,0,0,0,0,0,0,0,0
7827,7827,Christopher Samba,2109,2010,Blackburn Rovers,18,18,0,1574,2,0,15,15,0,1350,2,0,33,33,0,2924,4,0,0,0,0,1,0,1,0,0,0,0,0,0
7828,7828,Gaël Givet,2654,2010,Blackburn Rovers,15,15,0,1246,0,0,14,14,0,1209,1,0,29,29,0,2455,1,0,0,0,0,0,0,0,0,0,0,0,0,0
7829,7829,Ryan Nelsen,2007,2010,Blackburn Rovers,14,14,0,1205,2,0,14,14,0,1210,1,0,28,28,0,2415,3,0,0,0,0,1,0,1,0,0,0,0,0,0
7830,7830,Míchel Salgado,2655,2010,Blackburn Rovers,19,19,0,1656,0,0,17,17,0,1377,0,0,36,36,0,3033,0,0,0,0,0,0,0,0,0,0,0,0,0,0
7831,7831,Phil Jones,1650,2010,Blackburn Rovers,14,12,2,1144,0,0,12,12,0,1054,0,0,26,24,2,2198,0,0,0,0,0,0,0,0,0,0,0,0,0,0
7832,7832,Pascal Chimbonda,1392,2010,Blackburn Rovers,2,0,2,48,0,0,4,3,1,314,0,0,6,3,3,362,0,0,0,0,0,0,0,0,0,0,0,0,0,0
7833,7833,Brett Emerton,1141,2010,Blackburn Rovers,13,10,3,943,2,0,17,14,3,1248,2,0,30,24,6,2191,4,0,0,3,3,1,1,2,0,0,0,0,0,0
7834,7834,Morten Gamst Pedersen,2009,2010,Blackburn Rovers,18,13,5,1243,3,0,17,14,3,1274,1,0,35,27,8,2517,4,0,0,0,0,2,1,3,0,0,0,0,0,0
7835,7835,Junior Hoilett,2535,2010,Blackburn Rovers,9,8,1,623,3,0,15,9,6,876,2,0,24,17,7,1499,5,0,2,0,2,2,1,3,0,0,0,0,0,0
7836,7836,Nikola Kalinić,3588,2010,Blackburn Rovers,9,7,2,543,1,0,9,8,1,557,4,0,18,15,3,1100,5,0,3,0,3,1,3,4,0,0,0,0,0,0
7837,7837,David Dunn,1456,2010,Blackburn Rovers,16,11,5,861,1,0,11,6,5,528,1,0,27,17,10,1389,2,0,0,0,0,1,0,1,0,1,1,0,0,0
7838,7838,Jason Roberts,1820,2010,Blackburn Rovers,13,7,6,780,1,0,12,6,6,707,4,0,25,13,12,1487,5,0,0,3,3,0,4,4,0,0,0,0,0,0
7839,7839,Mark Bunn,1380,2010,Blackburn Rovers,1,1,0,90,0,0,2,1,1,134,0,0,3,2,1,224,0,0,0,0,0,0,0,0,0,0,0,0,0,0
7840,7840,Grant Hanley,1837,2010,Blackburn Rovers,3,1,2,127,0,0,4,4,0,316,1,0,7,5,2,443,1,0,0,0,0,0,1,1,0,0,0,0,0,0
7841,7841,Hérold Goulon,3589,2010,Blackburn Rovers,2,0,2,24,0,0,2,1,1,34,0,0,4,1,3,58,0,0,0,0,0,0,0,0,0,0,0,0,0,0
7842,7842,El-Hadji Diouf,1719,2010,Blackburn Rovers,10,9,1,797,0,0,10,9,1,769,0,0,20,18,2,1566,0,0,0,0,0,0,0,0,0,0,0,0,0,0
7843,7843,Mame Diouf,1584,2010,Blackburn Rovers,15,9,6,858,1,0,11,8,3,750,2,0,26,17,9,1608,3,0,0,0,0,1,1,2,0,0,0,0,0,0
7844,7844,Ugo Ehiogu,2134,2003,Middlesbrough FC,7,7,0,630,0,0,8,8,0,675,0,0,15,15,0,1305,0,0,0,0,0,0,0,0,0,0,0,0,0,0
7845,7845,Nolberto Solano,1791,2003,Aston Villa,5,5,0,384,0,0,5,5,0,450,0,0,10,10,0,834,0,0,0,0,0,0,0,0,0,0,0,0,0,0
7846,7846,Peter Whittingham,2969,2003,Aston Villa,15,10,5,1002,0,0,15,9,6,857,0,0,30,19,11,1859,0,0,0,0,0,0,0,0,0,0,0,0,0,0
7847,7847,Peter Crouch,1273,2003,Aston Villa,9,4,5,350,0,0,6,2,4,213,4,0,15,6,9,563,4,0,0,3,3,0,2,2,0,0,0,0,0,0
7848,7848,Miguel Britos,1930,2018,Watford FC,1,0,1,13,0,0,2,2,0,172,0,0,3,2,1,185,0,0,0,0,0,0,0,0,0,0,0,0,0,0
7849,7849,Jak Alnwick,3590,2014,Newcastle United,4,3,1,314,0,0,2,2,0,180,0,0,6,5,1,494,0,0,0,0,0,0,0,0,0,0,0,0,0,0
7850,7850,Steven Taylor,2014,2014,Newcastle United,5,5,0,420,1,0,5,2,3,241,0,0,10,7,3,661,1,0,0,0,0,1,0,1,0,0,0,0,0,0
7851,7851,Cheick Tioté,2289,2014,Newcastle United,5,5,0,429,0,0,6,5,1,467,0,0,11,10,1,896,0,0,0,0,0,0,0,0,0,0,0,0,0,0
7852,7852,Danny Rose,1399,2010,Tottenham Hotspur,2,2,0,180,0,0,2,2,0,172,0,0,4,4,0,352,0,0,0,0,0,0,0,0,0,0,0,0,0,0
7853,7853,Stephen Crainey,3162,2010,Blackpool FC,15,15,0,1309,0,0,16,16,0,1440,0,0,31,31,0,2749,0,0,0,0,0,0,0,0,0,0,0,0,0,0
7854,7854,Alex Baptiste,3591,2010,Blackpool FC,11,10,1,906,0,0,10,9,1,823,2,0,21,19,2,1729,2,0,0,0,0,0,1,1,0,0,0,0,0,0
7855,7855,David Vaughan,1412,2010,Blackpool FC,17,17,0,1530,1,0,18,18,0,1620,1,0,35,35,0,3150,2,0,0,0,0,1,1,2,0,0,0,0,0,0
7856,7856,Gary Taylor-Fletcher,3592,2010,Blackpool FC,16,15,1,1260,3,0,15,14,1,1201,3,0,31,29,2,2461,6,0,0,0,0,1,3,4,0,0,0,0,0,0
7857,7857,Sergey Kornilenko,3593,2010,Blackpool FC,3,1,2,82,0,0,3,2,1,97,0,0,6,3,3,179,0,0,0,0,0,0,0,0,0,0,0,0,0,0
7858,7858,Craig Cathcart,1918,2010,Blackpool FC,16,15,1,1275,1,0,14,13,1,1113,0,0,30,28,2,2388,1,0,0,0,0,1,0,1,0,0,0,0,0,0
7859,7859,Jason Puncheon,1026,2010,Blackpool FC,6,3,3,342,2,0,5,3,2,306,1,0,11,6,5,648,3,0,0,0,0,1,1,2,0,0,0,0,0,0
7860,7860,James Beattie,2050,2010,Blackpool FC,5,2,3,222,0,0,4,3,1,211,0,0,9,5,4,433,0,0,0,0,0,0,0,0,0,0,0,0,0,0
7861,7861,Andy Reid,1220,2010,Blackpool FC,4,2,2,181,0,0,1,0,1,9,0,0,5,2,3,190,0,0,0,0,0,0,0,0,0,0,0,0,0,0
7862,7862,Jürgen Macho,3594,2001,Sunderland AFC,1,1,0,90,0,0,2,2,0,180,0,0,3,3,0,270,0,0,0,0,0,0,0,0,0,0,0,0,0,0
7863,7863,Michael Duff,1488,2009,Burnley FC,4,4,0,360,0,0,7,6,1,591,0,0,11,10,1,951,0,0,0,0,0,0,0,0,0,0,0,0,0,0
7864,7864,Sylvinho,3496,2009,Manchester City,4,2,2,164,0,0,6,4,2,322,0,0,10,6,4,486,0,0,0,0,0,0,0,0,0,0,0,0,0,0
7865,7865,Vincent Kompany,1414,2009,Manchester City,14,11,3,1010,1,0,11,10,1,902,1,0,25,21,4,1912,2,0,0,0,0,0,0,0,0,0,0,0,0,0
7866,7866,Adam Johnson,1405,2009,Manchester City,8,8,0,625,0,0,8,6,2,553,1,0,16,14,2,1178,1,0,0,1,1,0,1,1,0,0,0,0,0,0
7867,7867,Patrick Vieira,1524,2009,Manchester City,6,3,3,344,0,0,7,5,2,469,1,0,13,8,5,813,1,0,0,0,0,0,0,0,0,0,0,0,0,0
7868,7868,Alex Nimely-Tchuimeni,3595,2009,Manchester City,0,0,0,0,0,0,1,0,1,7,0,0,1,0,1,7,0,0,0,0,0,0,0,0,0,0,0,0,0,0
7869,7869,Roy Carroll,1939,2007,Derby County,7,7,0,630,0,0,7,7,0,630,0,0,14,14,0,1260,0,0,0,0,0,0,0,0,0,0,0,0,0,0
7870,7870,Lewin Nyatanga,3596,2007,Derby County,1,1,0,90,0,0,1,1,0,90,1,0,2,2,0,180,1,0,0,0,0,0,1,1,0,0,0,0,0,0
7871,7871,David Jones,1490,2007,Derby County,9,8,1,633,0,0,5,4,1,349,1,0,14,12,2,982,1,0,0,0,0,0,0,0,0,0,0,0,0,0
7872,7872,Mile Sterjovski,3597,2007,Derby County,6,5,1,370,0,0,6,4,2,321,0,0,12,9,3,691,0,0,0,0,0,0,0,0,0,0,0,0,0,0
7873,7873,Hossam Ghaly,1396,2007,Derby County,7,6,1,538,0,0,8,7,1,569,0,0,15,13,2,1107,0,0,0,0,0,0,0,0,0,0,0,0,0,0
7874,7874,Emanuel Villa,3598,2007,Derby County,9,7,2,599,2,0,7,2,5,327,1,0,16,9,7,926,3,0,1,1,2,2,1,3,0,0,0,0,0,0
7875,7875,Marc Edworthy,2386,2007,Derby County,7,5,2,478,0,0,2,2,0,180,0,0,9,7,2,658,0,0,0,0,0,0,0,0,0,0,0,0,0,0
7876,7876,Benny Feilhaber,3599,2007,Derby County,6,0,6,180,0,0,4,1,3,113,0,0,10,1,9,293,0,0,0,0,0,0,0,0,0,0,0,0,0,0
7877,7877,Paris Simmons,3600,2007,Derby County,1,0,1,27,0,0,0,0,0,0,0,0,1,0,1,27,0,0,0,0,0,0,0,0,0,0,0,0,0,0
7878,7878,Federico Fernández,1697,2018,Newcastle United,8,7,1,607,0,0,11,10,1,877,0,0,19,17,2,1484,0,0,0,0,0,0,0,0,0,0,0,0,0,0
7879,7879,Freddie Woodman,2630,2018,Newcastle United,0,0,0,0,0,0,0,0,0,0,0,0,0,0,0,0,0,0,0,0,0,0,0,0,0,0,0,0,0,0
7880,7880,Philip Stamp,3601,2000,Sunderland AFC,1,1,0,14,0,0,0,0,0,0,0,0,1,1,0,14,0,0,0,0,0,0,0,0,0,0,0,0,0,0
7881,7881,Robbie Mustoe,2919,2000,Sunderland AFC,1,1,0,90,0,0,0,0,0,0,0,0,1,1,0,90,0,0,0,0,0,0,0,0,0,0,0,0,0,0
7882,7882,Simon Moore,3602,2019,Sheffield United,1,1,0,90,0,0,1,1,0,90,0,0,2,2,0,180,0,0,0,0,0,0,0,0,0,0,0,0,0,0
7883,7883,Luke Freeman,3603,2019,Sheffield United,4,1,3,178,0,0,7,2,5,184,0,0,11,3,8,362,0,0,0,0,0,0,0,0,0,0,0,0,0,0
7884,7884,Nick Barmby,2133,2001,Liverpool FC,5,2,3,194,0,0,1,0,1,19,0,0,6,2,4,213,0,0,0,0,0,0,0,0,0,0,0,0,0,0
7885,7885,Grégory Vignal,2645,2001,Liverpool FC,2,1,1,120,0,0,1,1,0,90,0,0,3,2,1,210,0,0,0,0,0,0,0,0,0,0,0,0,0,0
7886,7886,Peter Schmeichel,3198,2001,Aston Villa,15,15,0,1350,0,0,13,13,0,1170,1,0,28,28,0,2520,1,0,0,0,0,0,0,0,0,0,0,0,0,0
7887,7887,Mark Delaney,3269,2001,Aston Villa,15,15,0,1274,0,0,14,14,0,1241,0,0,29,29,0,2515,0,0,0,0,0,0,0,0,0,0,0,0,0,0
7888,7888,Olof Mellberg,1790,2001,Aston Villa,15,15,0,1305,0,0,15,15,0,1350,0,0,30,30,0,2655,0,0,0,0,0,0,0,0,0,0,0,0,0,0
7889,7889,Alpay Özalan,2765,2001,Aston Villa,8,8,0,690,0,0,5,5,0,423,0,0,13,13,0,1113,0,0,0,0,0,0,0,0,0,0,0,0,0,0
7890,7890,Alan Wright,2766,2001,Aston Villa,12,12,0,1062,0,0,9,9,0,810,0,0,21,21,0,1872,0,0,0,0,0,0,0,0,0,0,0,0,0,0
7891,7891,George Boateng,1333,2001,Aston Villa,19,19,0,1682,0,0,16,16,0,1430,1,0,35,35,0,3112,1,0,0,0,0,0,1,1,0,0,0,0,0,0
7892,7892,Lee Hendrie,1797,2001,Aston Villa,15,14,1,1093,1,0,12,9,3,883,1,0,27,23,4,1976,2,0,0,0,0,1,1,2,0,0,0,0,0,0
7893,7893,Hassan Kachloul,3484,2001,Aston Villa,13,11,2,848,1,0,8,5,3,465,1,0,21,16,5,1313,2,0,3,1,4,1,1,2,0,0,0,0,0,0
7894,7894,Dion Dublin,2768,2001,Aston Villa,9,2,7,317,1,0,10,6,4,614,3,0,19,8,11,931,4,0,0,0,0,0,2,2,0,0,0,0,0,0
7895,7895,Paul Merson,2769,2001,Aston Villa,12,10,2,857,1,0,7,6,1,565,1,0,19,16,3,1422,2,0,0,0,0,1,1,2,0,0,0,0,0,0
7896,7896,Darius Vassell,1798,2001,Aston Villa,19,16,3,1355,8,0,15,13,2,1147,4,0,34,29,5,2502,12,0,3,0,3,6,2,8,0,0,0,0,0,0
7897,7897,Steve Staunton,3494,2001,Aston Villa,16,15,1,1380,0,0,16,14,2,1283,0,0,32,29,3,2663,0,0,0,0,0,0,0,0,0,0,0,0,0,0
7898,7898,Mustapha Hadji,2103,2001,Aston Villa,12,8,4,800,0,0,11,9,2,758,2,0,23,17,6,1558,2,0,0,0,0,0,0,0,0,0,0,0,0,0
7899,7899,Connor Wickham,1035,2016,Crystal Palace,4,2,2,220,1,0,4,2,2,190,1,0,8,4,4,410,2,0,0,0,0,1,0,1,0,0,0,0,0,0
7900,7900,Adrian Mariappa,1917,2006,Watford FC,9,9,0,810,0,0,10,8,2,746,0,0,19,17,2,1556,0,0,0,0,0,0,0,0,0,0,0,0,0,0
7901,7901,Anthony McNamee,3604,2006,Watford FC,5,3,2,229,0,0,2,1,1,120,0,0,7,4,3,349,0,0,0,0,0,0,0,0,0,0,0,0,0,0
7902,7902,Al Bangura,3605,2006,Watford FC,8,6,2,517,0,0,8,6,2,567,0,0,16,12,4,1084,0,0,0,0,0,0,0,0,0,0,0,0,0,0
7903,7903,Will Hoskins,3606,2006,Watford FC,5,3,2,303,0,0,4,1,3,118,0,0,9,4,5,421,0,0,0,0,0,0,0,0,0,0,0,0,0,0
7904,7904,Sami Hyypiä,2361,2006,Liverpool FC,10,10,0,900,1,0,13,13,0,1133,1,0,23,23,0,2033,2,0,0,0,0,0,0,0,0,0,0,0,0,0
7905,7905,Rafael,1787,2010,Manchester United,9,8,1,654,0,0,7,7,0,565,0,0,16,15,1,1219,0,0,0,0,0,0,0,0,0,0,0,0,0,0
7906,7906,Ryan Giggs,1110,2010,Manchester United,13,10,3,824,2,0,12,9,3,853,0,0,25,19,6,1677,2,0,0,0,0,0,0,0,0,0,0,0,0,0
7907,7907,Wayne Rooney,1058,2010,Manchester United,15,12,3,1111,4,0,13,13,0,1115,7,0,28,25,3,2226,11,0,3,1,4,3,5,8,1,2,3,0,0,0
7908,7908,Jonny Evans,1216,2010,Manchester United,8,6,2,594,0,0,5,5,0,425,0,0,13,11,2,1019,0,0,0,0,0,0,0,0,0,0,0,0,0,0
7909,7909,Neil Taylor,1695,2019,Aston Villa,8,6,2,594,0,0,6,5,1,495,0,0,14,11,3,1089,0,0,0,0,0,0,0,0,0,0,0,0,0,0
7910,7910,Borja Bastón,3195,2019,Aston Villa,1,0,1,7,0,0,1,0,1,9,0,0,2,0,2,16,0,0,0,0,0,0,0,0,0,0,0,0,0,0
7911,7911,Jack Robinson,3118,2019,Sheffield United,1,1,0,90,0,0,5,5,0,415,0,0,6,6,0,505,0,0,0,0,0,0,0,0,0,0,0,0,0,0
7912,7912,Jack Rodwell,1748,2019,Sheffield United,0,0,0,0,0,0,1,0,1,15,0,0,1,0,1,15,0,0,0,0,0,0,0,0,0,0,0,0,0,0
7913,7913,Leon Clarke,3607,2019,Sheffield United,1,0,1,13,0,0,1,0,1,20,0,0,2,0,2,33,0,0,0,0,0,0,0,0,0,0,0,0,0,0
7914,7914,John Stones,1197,2014,Everton FC,11,11,0,964,1,0,12,12,0,1080,0,0,23,23,0,2044,1,0,0,0,0,0,0,0,0,0,0,0,0,0
7915,7915,James McCarthy,1053,2014,Everton FC,15,15,0,1323,2,0,13,12,1,1080,0,0,28,27,1,2403,2,0,0,0,0,2,0,2,0,0,0,0,0,0
7916,7916,Aaron Lennon,1052,2014,Everton FC,7,6,1,560,0,0,7,6,1,510,2,0,14,12,2,1070,2,0,0,3,3,0,2,2,0,0,0,0,0,0
7917,7917,Tyias Browning,3608,2014,Everton FC,0,0,0,0,0,0,2,0,2,29,0,0,2,0,2,29,0,0,0,0,0,0,0,0,0,0,0,0,0,0
7918,7918,Darron Gibson,2538,2014,Everton FC,4,1,3,132,0,0,5,2,3,279,0,0,9,3,6,411,0,0,0,0,0,0,0,0,0,0,0,0,0,0
7919,7919,Mamadou Sakho,2250,2014,Liverpool FC,7,7,0,630,0,0,9,8,1,788,0,0,16,15,1,1418,0,0,0,0,0,0,0,0,0,0,0,0,0,0
7920,7920,Daniel Sturridge,1428,2014,Liverpool FC,6,4,2,373,4,0,6,3,3,376,0,0,12,7,5,749,4,0,3,0,3,1,0,1,0,0,0,0,0,0
7921,7921,Santi Cazorla,1502,2016,Arsenal FC,3,3,0,270,1,0,4,4,0,320,1,0,7,7,0,590,2,0,3,0,3,1,1,2,1,1,2,0,0,0
7922,7922,Paul Scharner,1734,2010,West Bromwich Albion,18,18,0,1513,0,0,15,15,0,1265,4,0,33,33,0,2778,4,0,0,3,3,0,2,2,0,0,0,0,0,0
7923,7923,James Chambers,3609,2002,West Bromwich Albion,6,1,5,204,0,0,2,1,1,94,0,0,8,2,6,298,0,0,0,0,0,0,0,0,0,0,0,0,0,0
7924,7924,Micah Richards,1364,2005,Manchester City,6,5,1,462,0,0,6,6,0,540,0,0,12,11,1,1002,0,0,0,0,0,0,0,0,0,0,0,0,0,0
7925,7925,Albert Riera,1890,2005,Manchester City,7,7,0,579,1,0,8,5,3,489,0,0,15,12,3,1068,1,0,0,0,0,1,0,1,0,0,0,0,0,0
7926,7926,Willo Flood,3610,2005,Manchester City,3,0,3,36,0,0,2,1,1,94,0,0,5,1,4,130,0,0,0,0,0,0,0,0,0,0,0,0,0,0
7927,7927,Brad Jones,1431,2005,Middlesbrough FC,4,4,0,360,0,0,5,5,0,450,0,0,9,9,0,810,0,0,0,0,0,0,0,0,0,0,0,0,0,0
7928,7928,Stewart Downing,1335,2005,Middlesbrough FC,6,5,1,457,1,0,6,6,0,527,0,0,12,11,1,984,1,0,0,0,0,0,0,0,0,0,0,0,0,0
7929,7929,Lee Cattermole,1687,2005,Middlesbrough FC,5,3,2,320,0,0,9,7,2,671,1,0,14,10,4,991,1,0,0,3,3,0,1,1,0,0,0,0,0,0
7930,7930,Andrew Davies,2295,2005,Middlesbrough FC,5,2,3,245,0,0,7,2,5,325,0,0,12,4,8,570,0,0,0,0,0,0,0,0,0,0,0,0,0,0
7931,7931,Leroy Fer,1375,2015,Swansea City,4,3,1,305,0,0,7,6,1,453,0,0,11,9,2,758,0,0,0,0,0,0,0,0,0,0,0,0,0,0
7932,7932,Chung-yong Lee,2126,2015,Crystal Palace,7,2,5,247,0,0,6,2,4,138,1,0,13,4,9,385,1,0,0,3,3,0,1,1,0,0,0,0,0,0
7933,7933,Hiram Boateng,3611,2015,Crystal Palace,0,0,0,0,0,0,1,0,1,18,0,0,1,0,1,18,0,0,0,0,0,0,0,0,0,0,0,0,0,0
7934,7934,Sullay Kaikai,2777,2015,Crystal Palace,0,0,0,0,0,0,1,0,1,44,0,0,1,0,1,44,0,0,0,0,0,0,0,0,0,0,0,0,0,0
7935,7935,Hakan Ünsal,3612,2001,Blackburn Rovers,4,3,1,244,0,0,4,4,0,306,0,0,8,7,1,550,0,0,0,0,0,0,0,0,0,0,0,0,0,0
7936,7936,Yordi,3613,2001,Blackburn Rovers,4,2,2,173,1,0,4,3,1,236,1,0,8,5,3,409,2,0,0,0,0,0,1,1,0,0,0,0,0,0
7937,7937,Mace Goodridge,3614,2019,Burnley FC,0,0,0,0,0,0,0,0,0,0,0,0,0,0,0,0,0,0,0,0,0,0,0,0,0,0,0,0,0,0
7938,7938,Tom Cleverley,2091,2019,Watford FC,8,5,3,415,1,0,10,6,4,552,0,0,18,11,7,967,1,0,0,0,0,0,0,0,0,0,0,0,0,0
7939,7939,Adrian Mariappa,1917,2019,Watford FC,8,6,2,623,0,0,12,9,3,919,0,0,20,15,5,1542,0,0,0,0,0,0,0,0,0,0,0,0,0,0
7940,7940,João Pedro,3615,2019,Watford FC,1,0,1,16,0,0,2,0,2,6,0,0,3,0,3,22,0,0,0,0,0,0,0,0,0,0,0,0,0,0
7941,7941,Connor Wickham,1035,2019,Crystal Palace,3,0,3,43,0,0,3,0,3,47,1,0,6,0,6,90,1,0,0,1,1,0,1,1,0,0,0,0,0,0
7942,7942,André Gomes,3115,2019,Everton FC,10,10,0,838,0,0,9,7,2,622,0,0,19,17,2,1460,0,0,0,0,0,0,0,0,0,0,0,0,0,0
7943,7943,Jean-Philippe Gbamin,3616,2019,Everton FC,1,1,0,90,0,0,1,0,1,45,0,0,2,1,1,135,0,0,0,0,0,0,0,0,0,0,0,0,0,0
7944,7944,Titus Bramble,1411,2006,Newcastle United,12,12,0,1060,0,0,4,4,0,360,0,0,16,16,0,1420,0,0,0,0,0,0,0,0,0,0,0,0,0,0
7945,7945,Kieron Dyer,2033,2006,Newcastle United,12,12,0,987,2,0,9,7,2,613,3,0,21,19,2,1600,5,0,0,0,0,1,3,4,0,0,0,0,0,0
7946,7946,Andy Carroll,1779,2006,Newcastle United,1,0,1,12,0,0,3,0,3,75,0,0,4,0,4,87,0,0,0,0,0,0,0,0,0,0,0,0,0,0
7947,7947,Fabian Delph,1198,2009,Aston Villa,5,2,3,147,0,0,3,2,1,146,0,0,8,4,4,293,0,0,0,0,0,0,0,0,0,0,0,0,0,0
7948,7948,Aaron Mokoena,2008,2009,Portsmouth FC,12,12,0,922,0,0,11,9,2,808,0,0,23,21,2,1730,0,0,0,0,0,0,0,0,0,0,0,0,0,0
7949,7949,Anthony Vanden Borre,3617,2009,Portsmouth FC,8,6,2,598,0,0,11,9,2,759,0,0,19,15,4,1357,0,0,0,0,0,0,0,0,0,0,0,0,0,0
7950,7950,Tommy Smith,2121,2009,Portsmouth FC,10,7,3,575,1,0,6,5,1,451,0,0,16,12,4,1026,1,0,0,0,0,1,0,1,0,0,0,0,0,0
7951,7951,Nwankwo Kanu,1324,2009,Portsmouth FC,15,2,13,443,2,0,8,4,4,380,0,0,23,6,17,823,2,0,3,0,3,1,0,1,0,0,0,0,0,0
7952,7952,Pablo Maffeo,1591,2015,Manchester City,0,0,0,0,0,0,0,0,0,0,0,0,0,0,0,0,0,0,0,0,0,0,0,0,0,0,0,0,0,0
7953,7953,Patrick Roberts,3352,2015,Manchester City,0,0,0,0,0,0,1,0,1,4,0,0,1,0,1,4,0,0,0,0,0,0,0,0,0,0,0,0,0,0
7954,7954,Arthur Masuaku,2209,2016,West Ham United,6,5,1,467,0,0,7,6,1,505,0,0,13,11,2,972,0,0,0,0,0,0,0,0,0,0,0,0,0,0
7955,7955,Gökhan Töre,3618,2016,West Ham United,3,2,1,140,0,0,2,1,1,101,0,0,5,3,2,241,0,0,0,0,0,0,0,0,0,0,0,0,0,0
7956,7956,Reece Burke,3447,2016,West Ham United,0,0,0,0,0,0,0,0,0,0,0,0,0,0,0,0,0,0,0,0,0,0,0,0,0,0,0,0,0,0
7957,7957,Lewis Grabban,3207,2016,AFC Bournemouth,1,0,1,23,0,0,2,0,2,34,0,0,3,0,3,57,0,0,0,0,0,0,0,0,0,0,0,0,0,0
7958,7958,Kazenga LuaLua,3619,2010,Newcastle United,1,0,1,26,0,0,1,0,1,21,0,0,2,0,2,47,0,0,0,0,0,0,0,0,0,0,0,0,0,0
7959,7959,George Thorne,1740,2010,West Bromwich Albion,0,0,0,0,0,0,1,0,1,30,0,0,1,0,1,30,0,0,0,0,0,0,0,0,0,0,0,0,0,0
7960,7960,Tim Howard,1743,2010,Everton FC,19,19,0,1710,0,0,19,19,0,1710,0,0,38,38,0,3420,0,0,0,0,0,0,0,0,0,0,0,0,0,0
7961,7961,Tony Hibbert,1744,2010,Everton FC,11,10,1,808,0,0,9,7,2,645,0,0,20,17,3,1453,0,0,0,0,0,0,0,0,0,0,0,0,0,0
7962,7962,Leighton Baines,1466,2010,Everton FC,19,19,0,1710,2,0,19,19,0,1710,3,0,38,38,0,3420,5,0,1,1,2,1,2,3,2,1,3,0,0,0
7963,7963,John Heitinga,1745,2010,Everton FC,16,15,1,1150,1,0,11,8,3,745,0,0,27,23,4,1895,1,0,1,0,1,1,0,1,0,0,0,0,0,0
7964,7964,Phil Jagielka,1048,2010,Everton FC,17,16,1,1444,0,0,16,15,1,1352,1,0,33,31,2,2796,1,0,0,3,3,0,1,1,0,0,0,0,0,0
7965,7965,Sylvain Distin,1015,2010,Everton FC,19,19,0,1700,1,0,19,19,0,1710,1,0,38,38,0,3410,2,0,0,0,0,1,1,2,0,0,0,0,0,0
7966,7966,Phil Neville,1114,2010,Everton FC,13,13,0,1136,0,0,18,18,0,1528,1,0,31,31,0,2664,1,0,0,0,0,0,0,0,0,0,0,0,0,0
7967,7967,Diniyar Bilyaletdinov,1753,2010,Everton FC,12,5,7,510,1,0,14,5,9,429,1,0,26,10,16,939,2,0,0,0,0,1,0,1,0,0,0,0,0,0
7968,7968,Leon Osman,1747,2010,Everton FC,13,11,2,958,3,0,13,9,4,851,1,0,26,20,6,1809,4,0,3,0,3,3,1,4,0,0,0,0,0,0
7969,7969,Jermaine Beckford,3620,2010,Everton FC,17,9,8,824,5,0,15,5,10,497,3,0,32,14,18,1321,8,0,4,1,5,4,3,7,0,0,0,0,0,0
7970,7970,Magaye Gueye,1750,2010,Everton FC,2,1,1,103,0,0,3,1,2,88,0,0,5,2,3,191,0,0,0,0,0,0,0,0,0,0,0,0,0,0
7971,7971,Séamus Coleman,1467,2010,Everton FC,17,11,6,1124,2,0,17,14,3,1173,2,0,34,25,9,2297,4,0,3,2,5,2,2,4,0,0,0,0,0,0
7972,7972,Jack Rodwell,1748,2010,Everton FC,12,6,6,682,0,0,12,8,4,733,0,0,24,14,10,1415,0,0,0,0,0,0,0,0,0,0,0,0,0,0
7973,7973,Apostolos Vellios,3259,2010,Everton FC,2,0,2,15,0,0,1,0,1,17,0,0,3,0,3,32,0,0,0,0,0,0,0,0,0,0,0,0,0,0
7974,7974,Ján Mucha,1752,2010,Everton FC,0,0,0,0,0,0,0,0,0,0,0,0,0,0,0,0,0,0,0,0,0,0,0,0,0,0,0,0,0,0
7975,7975,Shkodran Mustafi,1483,2010,Everton FC,0,0,0,0,0,0,0,0,0,0,0,0,0,0,0,0,0,0,0,0,0,0,0,0,0,0,0,0,0,0
7976,7976,Adam Forshaw,3007,2010,Everton FC,0,0,0,0,0,0,1,0,1,8,0,0,1,0,1,8,0,0,0,0,0,0,0,0,0,0,0,0,0,0
7977,7977,Victor Anichebe,1751,2010,Everton FC,6,3,3,261,0,0,10,5,5,537,0,0,16,8,8,798,0,0,0,0,0,0,0,0,0,0,0,0,0,0
7978,7978,Martin Olsson,1372,2010,Blackburn Rovers,14,12,2,1143,2,0,15,13,2,1228,0,0,29,25,4,2371,2,0,3,0,3,2,0,2,0,0,0,0,0,0
7979,7979,Jermaine Jones,3621,2010,Blackburn Rovers,8,8,0,678,0,0,7,7,0,618,0,0,15,15,0,1296,0,0,0,0,0,0,0,0,0,0,0,0,0,0
7980,7980,Roque Santa Cruz,2110,2010,Blackburn Rovers,4,4,0,289,0,0,5,3,2,251,0,0,9,7,2,540,0,0,0,0,0,0,0,0,0,0,0,0,0,0
7981,7981,Rubén Rochina,3423,2010,Blackburn Rovers,1,0,1,27,0,0,3,1,2,90,0,0,4,1,3,117,0,0,0,0,0,0,0,0,0,0,0,0,0,0
7982,7982,Benjani,1391,2010,Blackburn Rovers,11,5,6,468,3,0,7,1,6,194,0,0,18,6,12,662,3,0,0,0,0,1,0,1,0,0,0,0,0,0
7983,7983,John O'Shea,1729,2004,Manchester United,13,9,4,877,1,0,10,7,3,609,1,0,23,16,7,1486,2,0,0,0,0,0,0,0,0,0,0,0,0,0
7984,7984,Mathieu Berson,3622,2004,Aston Villa,5,3,2,299,0,0,6,4,2,331,0,0,11,7,4,630,0,0,0,0,0,0,0,0,0,0,0,0,0,0
7985,7985,Julio Arca,1341,2000,Sunderland AFC,10,10,0,844,2,0,11,10,1,760,0,0,21,20,1,1604,2,0,0,0,0,2,0,2,0,0,0,0,0,0
7986,7986,Grégory Vignal,2645,2000,Liverpool FC,2,1,1,116,0,0,4,3,1,276,0,0,6,4,2,392,0,0,0,0,0,0,0,0,0,0,0,0,0,0
7987,7987,Igor Bišćan,2365,2000,Liverpool FC,5,3,2,221,0,0,8,5,3,437,0,0,13,8,5,658,0,0,0,0,0,0,0,0,0,0,0,0,0,0
7988,7988,Stephen Wright,3024,2000,Liverpool FC,1,0,1,57,0,0,1,0,1,4,0,0,2,0,2,61,0,0,0,0,0,0,0,0,0,0,0,0,0,0
7989,7989,Jari Litmanen,2900,2000,Liverpool FC,2,2,0,141,0,0,3,2,1,195,1,0,5,4,1,336,1,0,0,1,1,0,1,1,0,1,1,0,0,0
7990,7990,Chris Kirkland,2056,2008,Wigan Athletic,14,14,0,1260,0,0,17,17,0,1450,0,0,31,31,0,2710,0,0,0,0,0,0,0,0,0,0,0,0,0,0
7991,7991,Ryan Taylor,2341,2008,Wigan Athletic,6,5,1,410,1,0,5,5,0,396,1,0,11,10,1,806,2,0,0,0,0,1,1,2,0,0,0,0,0,0
7992,7992,Emmerson Boyce,2023,2008,Wigan Athletic,13,12,1,1124,1,0,14,14,0,1233,0,0,27,26,1,2357,1,0,3,0,3,1,0,1,0,0,0,0,0,0
7993,7993,Titus Bramble,1411,2008,Wigan Athletic,17,17,0,1518,0,0,17,17,0,1527,1,0,34,34,0,3045,1,0,0,1,1,0,1,1,0,0,0,0,0,0
7994,7994,Maynor Figueroa,2057,2008,Wigan Athletic,18,18,0,1611,1,0,19,19,0,1645,0,0,37,37,0,3256,1,0,3,0,3,1,0,1,0,0,0,0,0,0
7995,7995,Lee Cattermole,1687,2008,Wigan Athletic,16,16,0,1394,1,0,16,16,0,1383,0,0,32,32,0,2777,1,0,0,0,0,0,0,0,0,0,0,0,0,0
7996,7996,Michael Brown,1122,2008,Wigan Athletic,14,11,3,915,0,0,11,7,4,613,0,0,25,18,7,1528,0,0,0,0,0,0,0,0,0,0,0,0,0,0
7997,7997,Antonio Valencia,1641,2008,Wigan Athletic,15,15,0,1275,2,0,15,15,0,1331,1,0,30,30,0,2606,3,0,0,0,0,1,0,1,0,0,0,0,0,0
7998,7998,Henri Camara,1818,2008,Wigan Athletic,8,1,7,203,2,0,9,2,7,255,0,0,17,3,14,458,2,0,3,0,3,2,0,2,0,0,0,0,0,0
7999,7999,Mario Melchiot,1512,2008,Wigan Athletic,16,15,1,1310,0,0,17,17,0,1522,0,0,33,32,1,2832,0,0,0,0,0,0,0,0,0,0,0,0,0,0
8000,8000,Jason Koumas,2062,2008,Wigan Athletic,9,2,7,371,0,0,7,3,4,302,0,0,16,5,11,673,0,0,0,0,0,0,0,0,0,0,0,0,0,0
8001,8001,Luke Moore,1796,2008,West Bromwich Albion,12,3,9,413,1,0,9,2,7,262,0,0,21,5,16,675,1,0,0,0,0,1,0,1,0,0,0,0,0,0
8002,8002,Vince Grella,3623,2008,Blackburn Rovers,9,8,1,629,0,0,7,6,1,509,0,0,16,14,2,1138,0,0,0,0,0,0,0,0,0,0,0,0,0,0
8003,8003,Aaron Doran,3624,2008,Blackburn Rovers,0,0,0,0,0,0,2,0,2,70,0,0,2,0,2,70,0,0,0,0,0,0,0,0,0,0,0,0,0,0
8004,8004,Jay Fulton,3196,2015,Swansea City,1,0,1,1,0,0,1,0,1,19,0,0,2,0,2,20,0,0,0,0,0,0,0,0,0,0,0,0,0,0
8005,8005,Danny Ward,2444,2015,Liverpool FC,0,0,0,0,0,0,2,2,0,180,0,0,2,2,0,180,0,0,0,0,0,0,0,0,0,0,0,0,0,0
8006,8006,Brad Smith,2369,2015,Liverpool FC,0,0,0,0,0,0,4,3,1,299,0,0,4,3,1,299,0,0,0,0,0,0,0,0,0,0,0,0,0,0
8007,8007,Kevin Stewart,3625,2015,Liverpool FC,3,3,0,270,0,0,4,3,1,294,0,0,7,6,1,564,0,0,0,0,0,0,0,0,0,0,0,0,0,0
8008,8008,Sheyi Ojo,3626,2015,Liverpool FC,4,2,2,133,0,0,4,3,1,264,0,0,8,5,3,397,0,0,0,0,0,0,0,0,0,0,0,0,0,0
8009,8009,Pedro Chirivella,3627,2015,Liverpool FC,0,0,0,0,0,0,1,1,0,46,0,0,1,1,0,46,0,0,0,0,0,0,0,0,0,0,0,0,0,0
8010,8010,Daniel Sturridge,1428,2015,Liverpool FC,8,6,2,550,5,0,6,5,1,430,3,0,14,11,3,980,8,0,0,0,0,2,1,3,0,0,0,0,0,0
8011,8011,Cameron Brannagan,3250,2015,Liverpool FC,1,0,1,12,0,0,2,1,1,100,0,0,3,1,2,112,0,0,0,0,0,0,0,0,0,0,0,0,0,0
8012,8012,Adam Lallana,1190,2015,Liverpool FC,16,14,2,1241,3,0,14,9,5,872,1,0,30,23,7,2113,4,0,0,3,3,1,1,2,0,0,0,0,0,0
8013,8013,João Carlos Teixeira,3628,2015,Liverpool FC,0,0,0,0,0,0,1,0,1,3,0,0,1,0,1,3,0,0,0,0,0,0,0,0,0,0,0,0,0,0
8014,8014,Hayden Mullins,1941,2009,Portsmouth FC,9,6,3,522,0,0,9,9,0,795,0,0,18,15,3,1317,0,0,0,0,0,0,0,0,0,0,0,0,0,0
8015,8015,Andrea Dossena,3629,2009,Liverpool FC,0,0,0,0,0,0,2,1,1,54,0,0,2,1,1,54,0,0,0,0,0,0,0,0,0,0,0,0,0,0
8016,8016,Jay Spearing,2995,2009,Liverpool FC,1,0,1,2,0,0,2,1,1,75,0,0,3,1,2,77,0,0,0,0,0,0,0,0,0,0,0,0,0,0
8017,8017,Brad Smith,2369,2013,Liverpool FC,0,0,0,0,0,0,1,0,1,30,0,0,1,0,1,30,0,0,0,0,0,0,0,0,0,0,0,0,0,0
8018,8018,Magaye Gueye,1750,2013,Everton FC,0,0,0,0,0,0,0,0,0,0,0,0,0,0,0,0,0,0,0,0,0,0,0,0,0,0,0,0,0,0
8019,8019,Kevin Foley,2888,2010,Wolverhampton Wanderers,17,15,2,1417,2,0,16,15,1,1313,0,0,33,30,3,2730,2,0,0,0,0,1,0,1,0,0,0,0,0,0
8020,8020,Stephen Hunt,2596,2010,Wolverhampton Wanderers,10,8,2,763,3,0,10,6,4,575,0,0,20,14,6,1338,3,0,3,0,3,2,0,2,0,0,0,0,0,0
8021,8021,Matt Doherty,2142,2010,Wolverhampton Wanderers,0,0,0,0,0,0,0,0,0,0,0,0,0,0,0,0,0,0,0,0,0,0,0,0,0,0,0,0,0,0
8022,8022,Geoffrey Mujangi Bia,3630,2010,Wolverhampton Wanderers,0,0,0,0,0,0,1,0,1,10,0,0,1,0,1,10,0,0,0,0,0,0,0,0,0,0,0,0,0,0
8023,8023,Marcus Bent,1349,2010,Wolverhampton Wanderers,0,0,0,0,0,0,3,0,3,13,0,0,3,0,3,13,0,0,0,0,0,0,0,0,0,0,0,0,0,0
8024,8024,Antolín Alcaráz,2235,2010,Wigan Athletic,18,18,0,1620,1,0,16,16,0,1440,0,0,34,34,0,3060,1,0,1,0,1,1,0,1,0,0,0,0,0,0
8025,8025,Gary Caldwell,2673,2010,Wigan Athletic,10,10,0,827,0,0,12,12,0,1080,0,0,22,22,0,1907,0,0,0,0,0,0,0,0,0,0,0,0,0,0
8026,8026,Tom Cleverley,2091,2010,Wigan Athletic,12,9,3,800,2,0,13,10,3,835,2,0,25,19,6,1635,4,0,1,0,1,2,0,2,0,0,0,0,0,0
8027,8027,Jordan Robinson,3631,2010,Wigan Athletic,0,0,0,0,0,0,0,0,0,0,0,0,0,0,0,0,0,0,0,0,0,0,0,0,0,0,0,0,0,0
8028,8028,Mauro Boselli,3632,2010,Wigan Athletic,5,4,1,376,0,0,3,1,2,118,0,0,8,5,3,494,0,0,0,0,0,0,0,0,0,0,0,0,0,0
8029,8029,Daniël de Ridder,3242,2010,Wigan Athletic,0,0,0,0,0,0,0,0,0,0,0,0,0,0,0,0,0,0,0,0,0,0,0,0,0,0,0,0,0,0
8030,8030,Robbie Keane,1126,2011,Aston Villa,3,2,1,189,0,0,3,3,0,270,3,0,6,5,1,459,3,0,0,3,3,0,3,3,0,0,0,0,0,0
8031,8031,David Pizarro,3633,2011,Manchester City,4,1,3,91,0,0,1,0,1,73,0,0,5,1,4,164,0,0,0,0,0,0,0,0,0,0,0,0,0,0
8032,8032,Ian Harte,1291,2007,Sunderland AFC,3,1,2,114,0,0,5,2,3,194,0,0,8,3,5,308,0,0,0,0,0,0,0,0,0,0,0,0,0,0
8033,8033,Mat Sadler,3634,2007,Birmingham City,2,1,1,101,0,0,3,2,1,142,0,0,5,3,2,243,0,0,0,0,0,0,0,0,0,0,0,0,0,0
8034,8034,Kieron Dyer,2033,2007,West Ham United,1,1,0,90,0,0,1,1,0,90,0,0,2,2,0,180,0,0,0,0,0,0,0,0,0,0,0,0,0,0
8035,8035,Craig Bellamy,2012,2007,West Ham United,4,4,0,281,1,0,4,3,1,248,1,0,8,7,1,529,2,0,0,0,0,0,1,1,0,0,0,0,0,0
8036,8036,Matt Kilgallon,1400,2009,Sunderland AFC,3,2,1,252,0,0,4,4,0,360,0,0,7,6,1,612,0,0,0,0,0,0,0,0,0,0,0,0,0,0
8037,8037,Víctor Ibarbo,3635,2015,Watford FC,2,0,2,23,0,0,2,0,2,41,0,0,4,0,4,64,0,0,0,0,0,0,0,0,0,0,0,0,0,0
8038,8038,Steven Berghuis,3636,2015,Watford FC,5,0,5,105,0,0,4,0,4,117,0,0,9,0,9,222,0,0,0,0,0,0,0,0,0,0,0,0,0,0
8039,8039,Rene Gilmartin,3637,2015,Watford FC,0,0,0,0,0,0,0,0,0,0,0,0,0,0,0,0,0,0,0,0,0,0,0,0,0,0,0,0,0,0
8040,8040,José Cholevas,1920,2015,Watford FC,5,5,0,406,1,0,6,6,0,540,0,0,11,11,0,946,1,0,1,0,1,1,0,1,0,0,0,0,0,0
8041,8041,Matt Macey,2858,2015,Arsenal FC,0,0,0,0,0,0,0,0,0,0,0,0,0,0,0,0,0,0,0,0,0,0,0,0,0,0,0,0,0,0
8042,8042,Mathieu Debuchy,2453,2015,Arsenal FC,2,2,0,144,0,0,0,0,0,0,0,0,2,2,0,144,0,0,0,0,0,0,0,0,0,0,0,0,0,0
8043,8043,Richard Wright,2977,2002,Everton FC,16,16,0,1440,0,0,16,16,0,1440,0,0,32,32,0,2880,0,0,0,0,0,0,0,0,0,0,0,0,0,0
8044,8044,Alan Stubbs,2795,2002,Everton FC,18,17,1,1510,0,0,17,17,0,1473,0,0,35,34,1,2983,0,0,0,0,0,0,0,0,0,0,0,0,0,0
8045,8045,Joseph Yobo,1801,2002,Everton FC,10,10,0,855,0,0,13,11,2,1005,0,0,23,21,2,1860,0,0,0,0,0,0,0,0,0,0,0,0,0,0
8046,8046,Lee Carsley,1803,2002,Everton FC,12,10,2,937,1,0,11,10,1,838,2,0,23,20,3,1775,3,0,0,3,3,1,1,2,0,0,0,0,0,0
8047,8047,Gary Naysmith,1804,2002,Everton FC,16,14,2,1192,1,0,12,10,2,908,0,0,28,24,4,2100,1,0,0,0,0,0,0,0,0,0,0,0,0,0
8048,8048,Robbie Mustoe,2919,2002,Charlton Athletic,3,3,0,256,0,0,3,3,0,234,0,0,6,6,0,490,0,0,0,0,0,0,0,0,0,0,0,0,0,0
8049,8049,Adalberto Peñaranda,3638,2018,Watford FC,0,0,0,0,0,0,0,0,0,0,0,0,0,0,0,0,0,0,0,0,0,0,0,0,0,0,0,0,0,0
8050,8050,James McCarthy,1053,2018,Everton FC,1,0,1,14,0,0,0,0,0,0,0,0,1,0,1,14,0,0,0,0,0,0,0,0,0,0,0,0,0,0
8051,8051,Philippe Senderos,1228,2012,Fulham FC,11,9,2,871,0,0,10,9,1,811,0,0,21,18,3,1682,0,0,0,0,0,0,0,0,0,0,0,0,0,0
8052,8052,Ashkan Dejagah,3351,2012,Fulham FC,11,6,5,550,0,0,10,7,3,646,0,0,21,13,8,1196,0,0,0,0,0,0,0,0,0,0,0,0,0,0
8053,8053,Bryan Ruiz,3265,2012,Fulham FC,15,14,1,1240,3,0,14,12,2,1143,1,0,29,26,3,2383,4,0,0,0,0,0,1,1,0,0,0,0,0,0
8054,8054,Urby Emanuelson,3639,2012,Fulham FC,7,3,4,420,0,0,6,2,4,233,1,0,13,5,8,653,1,0,0,0,0,0,0,0,0,0,0,0,0,0
8055,8055,Mladen Petrić,3640,2012,Fulham FC,14,6,8,520,4,0,9,3,6,361,1,0,23,9,14,881,5,0,0,0,0,2,0,2,1,0,1,0,0,0
8056,8056,Neil Etheridge,3142,2012,Fulham FC,0,0,0,0,0,0,0,0,0,0,0,0,0,0,0,0,0,0,0,0,0,0,0,0,0,0,0,0,0,0
8057,8057,Brek Shea,3641,2012,Stoke City,1,0,1,23,0,0,1,0,1,66,0,0,2,0,2,89,0,0,0,0,0,0,0,0,0,0,0,0,0,0
8058,8058,Craig Gordon,1691,2011,Sunderland AFC,1,1,0,90,0,0,0,0,0,0,0,0,1,1,0,90,0,0,0,0,0,0,0,0,0,0,0,0,0,0
8059,8059,David Vaughan,1412,2011,Sunderland AFC,11,8,3,722,1,0,11,9,2,765,1,0,22,17,5,1487,2,0,0,0,0,1,0,1,0,0,0,0,0,0
8060,8060,Abel Xavier,2824,2006,Middlesbrough FC,8,8,0,718,1,0,6,6,0,540,0,0,14,14,0,1258,1,0,0,0,0,0,0,0,0,0,0,0,0,0
8061,8061,Julio Arca,1341,2006,Middlesbrough FC,10,8,2,743,1,0,10,9,1,753,1,0,20,17,3,1496,2,0,0,0,0,0,1,1,0,0,0,0,0,0
8062,8062,David Wright,3642,2006,Wigan Athletic,7,2,5,329,0,0,5,4,1,345,0,0,12,6,6,674,0,0,0,0,0,0,0,0,0,0,0,0,0,0
8063,8063,Mike Pollitt,2880,2006,Wigan Athletic,1,1,0,90,0,0,2,1,1,134,0,0,3,2,1,224,0,0,0,0,0,0,0,0,0,0,0,0,0,0
8064,8064,Zat Knight,1755,2005,Fulham FC,13,13,0,1160,0,0,15,14,1,1195,0,0,28,27,1,2355,0,0,0,0,0,0,0,0,0,0,0,0,0,0
8065,8065,Dean Leacock,1570,2005,Fulham FC,3,3,0,237,0,0,2,2,0,180,0,0,5,5,0,417,0,0,0,0,0,0,0,0,0,0,0,0,0,0
8066,8066,Ian Pearce,1082,2005,Fulham FC,6,6,0,484,0,0,4,4,0,339,0,0,10,10,0,823,0,0,0,0,0,0,0,0,0,0,0,0,0,0
8067,8067,Sylvain Legwinski,1083,2005,Fulham FC,7,5,2,424,0,0,5,4,1,379,0,0,12,9,3,803,0,0,0,0,0,0,0,0,0,0,0,0,0,0
8068,8068,Tomasz Radzinski,1935,2005,Fulham FC,15,10,5,940,1,0,16,11,5,1161,1,0,31,21,10,2101,2,0,0,0,0,0,0,0,0,0,0,0,0,0
8069,8069,Heiðar Helguson,1759,2005,Fulham FC,15,7,8,765,4,0,12,8,4,620,4,0,27,15,12,1385,8,0,3,0,3,3,2,5,2,1,3,0,0,0
8070,8070,Danny Collins,1215,2005,Sunderland AFC,11,11,0,932,0,0,12,11,1,1068,1,0,23,22,1,2000,1,0,0,0,0,0,0,0,0,0,0,0,0,0
8071,8071,Anthony Le Tallec,3111,2005,Sunderland AFC,13,6,7,695,2,0,14,6,8,536,1,0,27,12,15,1231,3,0,0,0,0,1,1,2,0,0,0,0,0,0
8072,8072,Celestine Babayaro,2015,2004,Newcastle United,4,4,0,356,0,0,3,3,0,270,0,0,7,7,0,626,0,0,0,0,0,0,0,0,0,0,0,0,0,0
8073,8073,Kostas Stafylidis,3643,2017,Stoke City,1,1,0,90,0,0,3,2,1,155,0,0,4,3,1,245,0,0,0,0,0,0,0,0,0,0,0,0,0,0
8074,8074,Alan Stubbs,2795,2006,Everton FC,12,12,0,1051,2,0,9,9,0,768,0,0,21,21,0,1819,2,0,0,0,0,2,0,2,0,0,0,0,0,0
8075,8075,Manuel Fernandes,3644,2006,Everton FC,5,5,0,444,1,0,4,3,1,273,1,0,9,8,1,717,2,0,0,0,0,0,1,1,0,0,0,0,0,0
8076,8076,James Vaughan,3240,2006,Everton FC,6,4,2,344,2,0,7,2,5,219,2,0,13,6,7,563,4,0,0,1,1,0,2,2,0,0,0,0,0,0
8077,8077,Abou Diaby,2434,2006,Arsenal FC,6,3,3,254,0,0,5,5,0,398,1,0,11,8,3,652,1,0,0,3,3,0,1,1,0,0,0,0,0,0
8078,8078,Denilson,1232,2006,Arsenal FC,5,2,3,181,0,0,5,2,3,202,0,0,10,4,6,383,0,0,0,0,0,0,0,0,0,0,0,0,0,0
8079,8079,Edwin van der Sar,1077,2002,Fulham FC,9,9,0,810,0,0,8,8,0,692,0,0,17,17,0,1502,0,0,0,0,0,0,0,0,0,0,0,0,0,0
8080,8080,Pierre Womé,3645,2002,Fulham FC,8,7,1,555,1,0,4,4,0,327,0,0,12,11,1,882,1,0,0,0,0,0,0,0,0,0,0,0,0,0
8081,8081,Junichi Inamoto,1084,2002,Fulham FC,11,5,6,536,1,0,6,2,4,256,1,0,17,7,10,792,2,0,0,0,0,0,1,1,0,0,0,0,0,0
8082,8082,Sylvain Legwinski,1083,2002,Fulham FC,15,13,2,1225,4,0,15,15,0,1215,0,0,30,28,2,2440,4,0,3,0,3,3,0,3,0,0,0,0,0,0
8083,8083,Barry Hayles,2897,2002,Fulham FC,8,2,6,327,0,0,4,1,3,118,1,0,12,3,9,445,1,0,0,0,0,0,0,0,0,0,0,0,0,0
8084,8084,Andrejs Štolcers,3646,2002,Fulham FC,4,0,4,38,0,0,1,0,1,18,0,0,5,0,5,56,0,0,0,0,0,0,0,0,0,0,0,0,0,0
8085,8085,Tim Howard,1743,2015,Everton FC,14,14,0,1260,0,0,11,11,0,990,0,0,25,25,0,2250,0,0,0,0,0,0,0,0,0,0,0,0,0,0
8086,8086,Leighton Baines,1466,2015,Everton FC,7,6,1,568,2,0,11,10,1,909,0,0,18,16,2,1477,2,0,3,0,3,1,0,1,1,0,1,0,0,0
8087,8087,John Stones,1197,2015,Everton FC,16,15,1,1350,0,0,17,16,1,1429,0,0,33,31,2,2779,0,0,0,0,0,0,0,0,0,0,0,0,0,0
8088,8088,Matthew Pennington,3647,2015,Everton FC,2,2,0,119,0,0,2,2,0,180,0,0,4,4,0,299,0,0,0,0,0,0,0,0,0,0,0,0,0,0
8089,8089,Darron Gibson,2538,2015,Everton FC,3,2,1,179,0,0,4,0,4,60,0,0,7,2,5,239,0,0,0,0,0,0,0,0,0,0,0,0,0,0
8090,8090,Aaron Lennon,1052,2015,Everton FC,11,7,4,654,3,0,14,10,4,884,2,0,25,17,8,1538,5,0,0,0,0,2,0,2,0,0,0,0,0,0
8091,8091,Tom Cleverley,2091,2015,Everton FC,11,9,2,917,1,0,11,8,3,721,1,0,22,17,5,1638,2,0,0,3,3,1,1,2,0,0,0,0,0,0
8092,8092,James McCarthy,1053,2015,Everton FC,14,14,0,1145,1,0,15,15,0,1328,1,0,29,29,0,2473,2,0,0,0,0,1,1,2,0,0,0,0,0,0
8093,8093,Muhamed Bešić,2236,2015,Everton FC,7,5,2,276,0,0,5,2,3,281,0,0,12,7,5,557,0,0,0,0,0,0,0,0,0,0,0,0,0,0
8094,8094,Ross Barkley,1754,2015,Everton FC,19,17,2,1541,5,0,19,19,0,1546,3,0,38,36,2,3087,8,0,0,0,0,2,1,3,2,0,2,0,0,0
8095,8095,Oumar Niasse,1059,2015,Everton FC,2,1,1,74,0,0,3,1,2,68,0,0,5,2,3,142,0,0,0,0,0,0,0,0,0,0,0,0,0,0
8096,8096,Tony Hibbert,1744,2015,Everton FC,1,0,1,44,0,0,0,0,0,0,0,0,1,0,1,44,0,0,0,0,0,0,0,0,0,0,0,0,0,0
8097,8097,Kieran Dowell,2742,2015,Everton FC,2,1,1,72,0,0,0,0,0,0,0,0,2,1,1,72,0,0,0,0,0,0,0,0,0,0,0,0,0,0
8098,8098,Romelu Lukaku,1645,2015,Everton FC,18,17,1,1503,9,0,19,19,0,1673,9,0,37,36,1,3176,18,0,2,4,6,6,5,11,0,1,1,0,0,0
8099,8099,Joel,1060,2015,Everton FC,5,5,0,450,0,0,8,8,0,720,0,0,13,13,0,1170,0,0,0,0,0,0,0,0,0,0,0,0,0,0
8100,8100,Bryan Oviedo,2240,2015,Everton FC,7,6,1,465,0,0,7,6,1,533,0,0,14,12,2,998,0,0,0,0,0,0,0,0,0,0,0,0,0,0
8101,8101,Leon Osman,1747,2015,Everton FC,4,1,3,126,0,0,5,1,4,92,0,0,9,2,7,218,0,0,0,0,0,0,0,0,0,0,0,0,0,0
8102,8102,Kevin Mirallas,2238,2015,Everton FC,8,5,3,432,2,0,15,5,10,629,2,0,23,10,13,1061,4,0,0,0,0,0,0,0,0,0,0,0,0,0
8103,8103,Rhoys Wiggins,3648,2015,AFC Bournemouth,0,0,0,0,0,0,0,0,0,0,0,0,0,0,0,0,0,0,0,0,0,0,0,0,0,0,0,0,0,0
8104,8104,Fabio Borini,1777,2014,Liverpool FC,6,0,6,122,0,0,6,3,3,270,1,0,12,3,9,392,1,0,0,0,0,0,1,1,0,0,0,0,0,0
8105,8105,Sebastián Blanco,3649,2014,West Bromwich Albion,2,0,2,27,0,0,1,0,1,9,0,0,3,0,3,36,0,0,0,0,0,0,0,0,0,0,0,0,0,0
8106,8106,Georgios Samaras,1814,2014,West Bromwich Albion,4,0,4,64,0,0,1,0,1,3,0,0,5,0,5,67,0,0,0,0,0,0,0,0,0,0,0,0,0,0
8107,8107,Eyal Berkovic,3123,2003,Portsmouth FC,7,7,0,531,0,0,4,3,1,288,1,0,11,10,1,819,1,0,0,0,0,0,1,1,0,0,0,0,0,0
8108,8108,Ivica Mornar,3566,2003,Portsmouth FC,4,2,2,164,0,0,4,1,3,190,1,0,8,3,5,354,1,0,0,0,0,0,1,1,0,0,0,0,0,0
8109,8109,John Terry,1534,2015,Chelsea FC,13,13,0,1118,1,0,11,11,0,909,0,0,24,24,0,2027,1,0,1,0,1,1,0,1,0,0,0,0,0,0
8110,8110,Ramires,2460,2015,Chelsea FC,6,3,3,258,1,0,6,4,2,350,1,0,12,7,5,608,2,0,0,0,0,1,0,1,0,0,0,0,0,0
8111,8111,Radamel Falcao,2379,2015,Chelsea FC,4,1,3,134,1,0,6,0,6,94,0,0,10,1,9,228,1,0,0,0,0,1,0,1,0,0,0,0,0,0
8112,8112,Loïc Rémy,2455,2015,Chelsea FC,8,1,7,141,0,0,5,2,3,144,1,0,13,3,10,285,1,0,0,0,0,0,0,0,0,0,0,0,0,0
8113,8113,Jamal Blackman,3650,2015,Chelsea FC,0,0,0,0,0,0,0,0,0,0,0,0,0,0,0,0,0,0,0,0,0,0,0,0,0,0,0,0,0,0
8114,8114,Kurt Zouma,1903,2015,Chelsea FC,11,10,1,883,1,0,12,11,1,1034,0,0,23,21,2,1917,1,0,0,0,0,1,0,1,0,0,0,0,0,0
8115,8115,Jay Rodriguez,1247,2015,Southampton FC,6,0,6,102,0,0,6,3,3,243,0,0,12,3,9,345,0,0,0,0,0,0,0,0,0,0,0,0,0,0
8116,8116,Paulo Ferreira,1761,2007,Chelsea FC,5,5,0,426,0,0,13,10,3,867,0,0,18,15,3,1293,0,0,0,0,0,0,0,0,0,0,0,0,0,0
8117,8117,David Dunn,1456,2002,Blackburn Rovers,14,14,0,1177,5,0,14,12,2,1017,3,0,28,26,2,2194,8,0,3,3,6,4,3,7,2,2,4,0,0,0
8118,8118,Corrado Grabbi,1457,2002,Blackburn Rovers,6,0,6,76,1,0,5,1,4,124,0,0,11,1,10,200,1,0,1,0,1,1,0,1,0,0,0,0,0,0
8119,8119,Abel Xavier,2824,2002,Liverpool FC,2,2,0,180,0,0,2,2,0,180,0,0,4,4,0,360,0,0,0,0,0,0,0,0,0,0,0,0,0,0
8120,8120,Mark Delaney,3269,2005,Aston Villa,7,7,0,630,1,0,5,5,0,450,0,0,12,12,0,1080,1,0,0,0,0,0,0,0,0,0,0,0,0,0
8121,8121,Wilfred Bouma,2707,2005,Aston Villa,9,9,0,778,0,0,11,11,0,959,0,0,20,20,0,1737,0,0,0,0,0,0,0,0,0,0,0,0,0,0
8122,8122,Eirik Bakke,1298,2005,Aston Villa,7,5,2,386,0,0,7,3,4,299,0,0,14,8,6,685,0,0,0,0,0,0,0,0,0,0,0,0,0,0
8123,8123,Craig Gardner,1403,2005,Aston Villa,4,1,3,188,0,0,4,2,2,112,0,0,8,3,5,300,0,0,0,0,0,0,0,0,0,0,0,0,0,0
8124,8124,Per Krøldrup,3651,2005,Everton FC,0,0,0,0,0,0,1,1,0,90,0,0,1,1,0,90,0,0,0,0,0,0,0,0,0,0,0,0,0,0
8125,8125,Shane Duffy,2429,2011,Everton FC,2,1,1,91,0,0,2,1,1,121,0,0,4,2,2,212,0,0,0,0,0,0,0,0,0,0,0,0,0,0
8126,8126,Adam Drury,2384,2011,Norwich City,7,7,0,523,0,0,5,5,0,384,0,0,12,12,0,907,0,0,0,0,0,0,0,0,0,0,0,0,0,0
8127,8127,Joe Gomez,1180,2018,Liverpool FC,8,5,3,493,0,0,8,7,1,567,0,0,16,12,4,1060,0,0,0,0,0,0,0,0,0,0,0,0,0,0
8128,8128,Alberto Moreno,2128,2018,Liverpool FC,1,1,0,90,0,0,1,1,0,65,0,0,2,2,0,155,0,0,0,0,0,0,0,0,0,0,0,0,0,0
8129,8129,Mikel Arteta,1802,2012,Arsenal FC,16,16,0,1440,5,0,18,18,0,1545,1,0,34,34,0,2985,6,0,3,3,6,3,1,4,4,1,5,0,0,0
8130,8130,Lukas Podolski,3095,2012,Arsenal FC,19,13,6,1053,9,0,14,12,2,949,2,0,33,25,8,2002,11,0,3,0,3,5,2,7,0,0,0,0,0,0
8131,8131,Gervinho,3301,2012,Arsenal FC,9,7,2,574,4,0,9,5,4,450,1,0,18,12,6,1024,5,0,0,0,0,2,0,2,0,0,0,0,0,0
8132,8132,Emiliano Martínez,1482,2012,Arsenal FC,0,0,0,0,0,0,0,0,0,0,0,0,0,0,0,0,0,0,0,0,0,0,0,0,0,0,0,0,0,0
8133,8133,Hogan Ephraim,3652,2012,Queens Park Rangers,0,0,0,0,0,0,0,0,0,0,0,0,0,0,0,0,0,0,0,0,0,0,0,0,0,0,0,0,0,0
8134,8134,Mark Pembridge,1933,2005,Fulham FC,2,2,0,162,0,0,3,3,0,270,0,0,5,5,0,432,0,0,0,0,0,0,0,0,0,0,0,0,0,0
8135,8135,Simon Elliott,3653,2005,Fulham FC,6,6,0,508,0,0,6,6,0,493,0,0,12,12,0,1001,0,0,0,0,0,0,0,0,0,0,0,0,0,0
8136,8136,Philippe Christanval,3247,2005,Fulham FC,8,3,5,369,0,0,6,3,3,347,0,0,14,6,8,716,0,0,0,0,0,0,0,0,0,0,0,0,0,0
8137,8137,Valentino Lazaro,3654,2019,Newcastle United,6,1,5,191,0,0,7,3,4,283,1,0,13,4,9,474,1,0,0,0,0,0,0,0,0,0,0,0,0,0
8138,8138,Nabil Bentaleb,1167,2019,Newcastle United,6,3,3,287,0,0,6,5,1,462,0,0,12,8,4,749,0,0,0,0,0,0,0,0,0,0,0,0,0,0
8139,8139,Richairo Živković,3655,2019,Sheffield United,2,0,2,26,0,0,3,0,3,81,0,0,5,0,5,107,0,0,0,0,0,0,0,0,0,0,0,0,0,0
8140,8140,Paul Scharner,1734,2008,Wigan Athletic,13,11,2,967,0,0,15,15,0,1329,0,0,28,26,2,2296,0,0,0,0,0,0,0,0,0,0,0,0,0,0
8141,8141,Amr Zaki,3656,2008,Wigan Athletic,13,10,3,935,3,0,15,11,4,1044,7,0,28,21,7,1979,10,0,4,3,7,2,4,6,2,2,4,0,0,0
8142,8142,Daniël de Ridder,3242,2008,Wigan Athletic,8,3,5,342,0,0,10,2,8,233,0,0,18,5,13,575,0,0,0,0,0,0,0,0,0,0,0,0,0,0
8143,8143,Adam Green,3657,2004,Fulham FC,2,2,0,180,0,0,2,2,0,180,0,0,4,4,0,360,0,0,0,0,0,0,0,0,0,0,0,0,0,0
8144,8144,Chris Kirkland,2056,2004,Liverpool FC,4,4,0,360,0,0,6,6,0,540,0,0,10,10,0,900,0,0,0,0,0,0,0,0,0,0,0,0,0,0
8145,8145,Daniel Sturridge,1428,2012,Chelsea FC,3,0,3,38,0,0,4,1,3,124,1,0,7,1,6,162,1,0,0,0,0,0,0,0,0,0,0,0,0,0
8146,8146,Declan John,3658,2013,Cardiff City,10,7,3,655,0,0,10,9,1,832,0,0,20,16,4,1487,0,0,0,0,0,0,0,0,0,0,0,0,0,0
8147,8147,Wilfried Zaha,1028,2013,Cardiff City,6,3,3,275,0,0,6,2,4,307,0,0,12,5,7,582,0,0,0,0,0,0,0,0,0,0,0,0,0,0
8148,8148,Magnus Eikrem,3659,2013,Cardiff City,4,1,3,183,0,0,2,0,2,17,0,0,6,1,5,200,0,0,0,0,0,0,0,0,0,0,0,0,0,0
8149,8149,Mats Møller Dæhli,3660,2013,Cardiff City,7,3,4,337,0,0,6,2,4,287,1,0,13,5,8,624,1,0,0,1,1,0,1,1,0,0,0,0,0,0
8150,8150,Cala,3661,2013,Cardiff City,3,3,0,270,0,0,4,4,0,360,2,0,7,7,0,630,2,0,0,3,3,0,2,2,0,0,0,0,0,0
8151,8151,Jo Inge Berget,3662,2013,Cardiff City,1,0,1,11,0,0,0,0,0,0,0,0,1,0,1,11,0,0,0,0,0,0,0,0,0,0,0,0,0,0
8152,8152,Nathan Baker,1973,2013,Aston Villa,16,15,1,1292,0,0,14,14,0,1187,0,0,30,29,1,2479,0,0,0,0,0,0,0,0,0,0,0,0,0,0
8153,8153,Joe Bennett,2978,2013,Aston Villa,3,2,1,159,0,0,2,1,1,84,0,0,5,3,2,243,0,0,0,0,0,0,0,0,0,0,0,0,0,0
8154,8154,Michael Essien,1763,2013,Chelsea FC,2,2,0,136,0,0,3,0,3,12,0,0,5,2,3,148,0,0,0,0,0,0,0,0,0,0,0,0,0,0
8155,8155,Kevin De Bruyne,1201,2013,Chelsea FC,2,1,1,72,0,0,1,1,0,60,0,0,3,2,1,132,0,0,0,0,0,0,0,0,0,0,0,0,0,0
8156,8156,Rudy Gestede,1874,2013,Cardiff City,0,0,0,0,0,0,3,0,3,49,0,0,3,0,3,49,0,0,0,0,0,0,0,0,0,0,0,0,0,0
8157,8157,Simon Moore,3602,2013,Cardiff City,0,0,0,0,0,0,0,0,0,0,0,0,0,0,0,0,0,0,0,0,0,0,0,0,0,0,0,0,0,0
8158,8158,Wilfried Bony,1597,2017,Swansea City,7,4,3,373,1,0,8,4,4,331,1,0,15,8,7,704,2,0,3,0,3,1,1,2,0,0,0,0,0,0
8159,8159,Brad Jones,1431,2004,Middlesbrough FC,3,3,0,270,0,0,2,2,0,180,0,0,5,5,0,450,0,0,0,0,0,0,0,0,0,0,0,0,0,0
8160,8160,Andrew Davies,2295,2004,Middlesbrough FC,1,0,1,53,0,0,2,2,0,180,0,0,3,2,1,233,0,0,0,0,0,0,0,0,0,0,0,0,0,0
8161,8161,Danny Graham,2317,2004,Middlesbrough FC,5,0,5,58,1,0,6,0,6,71,0,0,11,0,11,129,1,0,1,0,1,1,0,1,0,0,0,0,0,0
8162,8162,Paddy Kenny,2163,2006,Sheffield United,16,16,0,1411,0,0,16,16,0,1440,0,0,32,32,0,2851,0,0,0,0,0,0,0,0,0,0,0,0,0,0
8163,8163,Claude Davis,1571,2006,Sheffield United,10,7,3,650,0,0,11,11,0,904,0,0,21,18,3,1554,0,0,0,0,0,0,0,0,0,0,0,0,0,0
8164,8164,Derek Geary,3663,2006,Sheffield United,12,12,0,1016,0,0,12,12,0,1024,0,0,24,24,0,2040,0,0,0,0,0,0,0,0,0,0,0,0,0,0
8165,8165,Nick Montgomery,3664,2006,Sheffield United,11,10,1,942,0,0,13,10,3,867,0,0,24,20,4,1809,0,0,0,0,0,0,0,0,0,0,0,0,0,0
8166,8166,Colin Kâzım-Richards,3665,2006,Sheffield United,12,7,5,705,1,0,14,7,7,707,0,0,26,14,12,1412,1,0,1,0,1,1,0,1,0,0,0,0,0,0
8167,8167,Michael Tonge,1997,2006,Sheffield United,12,9,3,787,2,0,13,12,1,1047,0,0,25,21,4,1834,2,0,0,0,0,1,0,1,0,0,0,0,0,0
8168,8168,Piscu,3666,2011,Wigan Athletic,3,3,0,262,0,0,2,2,0,180,0,0,5,5,0,442,0,0,0,0,0,0,0,0,0,0,0,0,0,0
8169,8169,Hendry Thomas,2058,2011,Wigan Athletic,0,0,0,0,0,0,0,0,0,0,0,0,0,0,0,0,0,0,0,0,0,0,0,0,0,0,0,0,0,0
8170,8170,Bruno Perone,3667,2011,Queens Park Rangers,0,0,0,0,0,0,1,1,0,90,0,0,1,1,0,90,0,0,0,0,0,0,0,0,0,0,0,0,0,0
8171,8171,Patrick Agyemang,3668,2011,Queens Park Rangers,0,0,0,0,0,0,2,2,0,147,0,0,2,2,0,147,0,0,0,0,0,0,0,0,0,0,0,0,0,0
8172,8172,Michael Harriman,3669,2011,Queens Park Rangers,0,0,0,0,0,0,1,0,1,29,0,0,1,0,1,29,0,0,0,0,0,0,0,0,0,0,0,0,0,0
8173,8173,Bruno Andrade,3670,2011,Queens Park Rangers,0,0,0,0,0,0,1,0,1,10,0,0,1,0,1,10,0,0,0,0,0,0,0,0,0,0,0,0,0,0
8174,8174,Hogan Ephraim,3652,2011,Queens Park Rangers,0,0,0,0,0,0,2,0,2,41,0,0,2,0,2,41,0,0,0,0,0,0,0,0,0,0,0,0,0,0
8175,8175,Troy Hewitt,3671,2011,Queens Park Rangers,0,0,0,0,0,0,0,0,0,0,0,0,0,0,0,0,0,0,0,0,0,0,0,0,0,0,0,0,0,0
8176,8176,Zat Knight,1755,2003,Fulham FC,15,15,0,1350,0,0,14,13,1,1189,0,0,29,28,1,2539,0,0,0,0,0,0,0,0,0,0,0,0,0,0
8177,8177,Jérôme Bonnissel,3672,2003,Fulham FC,9,9,0,743,0,0,7,7,0,613,0,0,16,16,0,1356,0,0,0,0,0,0,0,0,0,0,0,0,0,0
8178,8178,Dean Leacock,1570,2003,Fulham FC,3,3,0,260,0,0,1,0,1,44,0,0,4,3,1,304,0,0,0,0,0,0,0,0,0,0,0,0,0,0
8179,8179,Mark Pembridge,1933,2003,Fulham FC,7,5,2,398,0,0,5,4,1,300,1,0,12,9,3,698,1,0,0,0,0,0,1,1,0,0,0,0,0,0
8180,8180,Lee Clark,2017,2003,Fulham FC,13,13,0,1126,1,0,10,10,0,875,1,0,23,23,0,2001,2,0,0,0,0,1,1,2,0,0,0,0,0,0
8181,8181,Malik Buari,3673,2003,Fulham FC,1,1,0,45,0,0,2,0,2,36,0,0,3,1,2,81,0,0,0,0,0,0,0,0,0,0,0,0,0,0
8182,8182,Louis Saha,1727,2003,Fulham FC,10,10,0,808,9,0,8,7,1,621,4,0,18,17,1,1429,13,0,0,0,0,5,2,7,2,0,2,0,0,0
8183,8183,Barry Hayles,2897,2003,Fulham FC,13,4,9,471,0,0,11,6,5,528,4,0,24,10,14,999,4,0,0,0,0,0,1,1,0,0,0,0,0,0
8184,8184,Neil Mellor,3391,2004,Liverpool FC,6,3,3,266,2,0,3,3,0,213,0,0,9,6,3,479,2,0,3,0,3,2,0,2,0,0,0,0,0,0
8185,8185,Martin Taylor,1345,2007,Birmingham City,2,2,0,180,0,0,2,2,0,162,0,0,4,4,0,342,0,0,0,0,0,0,0,0,0,0,0,0,0,0
8186,8186,Ashley Young,1619,2012,Manchester United,9,8,1,630,0,0,10,9,1,744,0,0,19,17,2,1374,0,0,0,0,0,0,0,0,0,0,0,0,0,0
8187,8187,Wayne Rooney,1058,2012,Manchester United,14,11,3,1042,7,0,13,11,2,977,5,0,27,22,5,2019,12,0,6,3,9,4,4,8,0,1,1,0,0,0
8188,8188,Anderson,2018,2012,Manchester United,10,6,4,567,0,0,7,3,4,259,1,0,17,9,8,826,1,0,0,0,0,0,1,1,0,0,0,0,0,0
8189,8189,Anderson,2018,2009,Manchester United,7,4,3,355,0,0,6,5,1,420,1,0,13,9,4,775,1,0,0,0,0,0,1,1,0,0,0,0,0,0
8190,8190,Apostolos Vellios,3259,2013,Everton FC,0,0,0,0,0,0,0,0,0,0,0,0,0,0,0,0,0,0,0,0,0,0,0,0,0,0,0,0,0,0
8191,8191,Robert Snodgrass,2207,2013,Norwich City,15,15,0,1311,4,0,15,14,1,1260,2,0,30,29,1,2571,6,0,3,0,3,3,1,4,0,0,0,0,0,0
8192,8192,Ricky van Wolfswinkel,3674,2013,Norwich City,14,9,5,803,1,0,11,7,4,593,0,0,25,16,9,1396,1,0,1,0,1,1,0,1,0,0,0,0,0,0
8193,8193,Nathan Redmond,1244,2013,Norwich City,18,12,6,1156,1,0,16,11,5,1001,0,0,34,23,11,2157,1,0,3,0,3,1,0,1,0,0,0,0,0,0
8194,8194,David Fox,3046,2013,Norwich City,0,0,0,0,0,0,0,0,0,0,0,0,0,0,0,0,0,0,0,0,0,0,0,0,0,0,0,0,0,0
8195,8195,Kostas Mitroglou,3675,2013,Fulham FC,0,0,0,0,0,0,3,1,2,152,0,0,3,1,2,152,0,0,0,0,0,0,0,0,0,0,0,0,0,0
8196,8196,Dan Burn,2420,2013,Fulham FC,4,2,2,258,0,0,5,4,1,348,0,0,9,6,3,606,0,0,0,0,0,0,0,0,0,0,0,0,0,0
8197,8197,William Kvist,3676,2013,Fulham FC,5,4,1,333,0,0,3,3,0,260,0,0,8,7,1,593,0,0,0,0,0,0,0,0,0,0,0,0,0,0
8198,8198,Michael Chopra,1226,2003,Newcastle United,4,1,3,125,0,0,2,0,2,8,0,0,6,1,5,133,0,0,0,0,0,0,0,0,0,0,0,0,0,0
8199,8199,Brad Friedel,1343,2003,Blackburn Rovers,18,18,0,1620,0,0,17,17,0,1530,1,0,35,35,0,3150,1,0,0,0,0,0,0,0,0,0,0,0,0,0
8200,8200,Markus Babbel,2688,2003,Blackburn Rovers,12,11,1,933,3,0,12,11,1,1012,0,0,24,22,2,1945,3,0,1,0,1,3,0,3,0,0,0,0,0,0
8201,8201,Andy Todd,1672,2003,Blackburn Rovers,9,9,0,804,0,0,10,10,0,869,0,0,19,19,0,1673,0,0,0,0,0,0,0,0,0,0,0,0,0,0
8202,8202,Vratislav Greško,2010,2003,Blackburn Rovers,11,9,2,822,2,0,12,12,0,974,0,0,23,21,2,1796,2,0,3,0,3,2,0,2,0,0,0,0,0,0
8203,8203,Alan Mahon,1347,2003,Blackburn Rovers,2,0,2,79,0,0,1,1,0,90,0,0,3,1,2,169,0,0,0,0,0,0,0,0,0,0,0,0,0,0
8204,8204,Barry Ferguson,1782,2003,Blackburn Rovers,7,7,0,597,0,0,8,7,1,613,1,0,15,14,1,1210,1,0,0,0,0,0,1,1,0,0,0,0,0,0
8205,8205,Matt Jansen,1350,2003,Blackburn Rovers,12,5,7,558,1,0,7,4,3,291,1,0,19,9,10,849,2,0,0,0,0,1,1,2,0,0,0,0,0,0
8206,8206,Dwight Yorke,1223,2003,Blackburn Rovers,12,8,4,670,2,0,10,6,4,598,2,0,22,14,8,1268,4,0,0,2,2,1,2,3,0,0,0,0,0,0
8207,8207,Young-Pyo Lee,1393,2007,Tottenham Hotspur,8,7,1,645,0,0,9,9,0,785,0,0,17,16,1,1430,0,0,0,0,0,0,0,0,0,0,0,0,0,0
8208,8208,Andreas Isaksson,3677,2007,Manchester City,2,2,0,180,0,0,3,3,0,270,0,0,5,5,0,450,0,0,0,0,0,0,0,0,0,0,0,0,0,0
8209,8209,Kelvin Etuhu,3678,2007,Manchester City,1,0,1,44,1,0,5,2,3,160,0,0,6,2,4,204,1,0,0,0,0,0,0,0,0,0,0,0,0,0
8210,8210,Roy Carroll,1939,2003,Manchester United,2,2,0,180,0,0,4,4,0,360,0,0,6,6,0,540,0,0,0,0,0,0,0,0,0,0,0,0,0,0
8211,8211,Wes Brown,1108,2003,Manchester United,8,7,1,651,0,0,9,8,1,760,0,0,17,15,2,1411,0,0,0,0,0,0,0,0,0,0,0,0,0,0
8212,8212,Ole Gunnar Solskjær,1116,2003,Manchester United,6,3,3,270,0,0,7,4,3,380,0,0,13,7,6,650,0,0,0,0,0,0,0,0,0,0,0,0,0,0
8213,8213,David Bellion,1944,2003,Manchester United,11,4,7,413,2,0,3,0,3,46,0,0,14,4,10,459,2,0,0,0,0,0,0,0,0,0,0,0,0,0
8214,8214,Danny Mills,1292,2004,Manchester City,17,15,2,1363,0,0,10,9,1,807,0,0,27,24,3,2170,0,0,0,0,0,0,0,0,0,0,0,0,0,0
8215,8215,Steve McManaman,3679,2004,Manchester City,8,3,5,384,0,0,3,1,2,117,0,0,11,4,7,501,0,0,0,0,0,0,0,0,0,0,0,0,0,0
8216,8216,Willo Flood,3610,2004,Manchester City,3,2,1,169,1,0,4,0,4,73,0,0,7,2,5,242,1,0,0,0,0,1,0,1,0,0,0,0,0,0
8217,8217,Jim Brennan,3680,2004,Norwich City,3,1,2,127,0,0,7,5,2,477,0,0,10,6,4,604,0,0,0,0,0,0,0,0,0,0,0,0,0,0
8218,8218,Ian Henderson,3681,2004,Norwich City,2,0,2,45,0,0,1,0,1,9,0,0,3,0,3,54,0,0,0,0,0,0,0,0,0,0,0,0,0,0
8219,8219,Jody Morris,2293,2001,Chelsea FC,2,0,2,49,0,0,2,1,1,117,0,0,4,1,3,166,0,0,0,0,0,0,0,0,0,0,0,0,0,0
8220,8220,Mark Crossley,1932,2001,Middlesbrough FC,8,7,1,688,0,0,9,9,0,738,0,0,17,16,1,1426,0,0,0,0,0,0,0,0,0,0,0,0,0,0
8221,8221,Curtis Fleming,2065,2001,Middlesbrough FC,4,4,0,360,0,0,4,4,0,344,0,0,8,8,0,704,0,0,0,0,0,0,0,0,0,0,0,0,0,0
8222,8222,Jason Gavin,3682,2001,Middlesbrough FC,5,2,3,217,0,0,4,3,1,242,0,0,9,5,4,459,0,0,0,0,0,0,0,0,0,0,0,0,0,0
8223,8223,Colin Cooper,2138,2001,Middlesbrough FC,6,5,1,482,1,0,12,9,3,906,1,0,18,14,4,1388,2,0,0,0,0,1,1,2,0,0,0,0,0,0
8224,8224,Allan Johnston,3683,2001,Middlesbrough FC,9,7,2,550,1,0,8,6,2,436,0,0,17,13,4,986,1,0,0,0,0,0,0,0,0,0,0,0,0,0
8225,8225,Mark Wilson,3684,2001,Middlesbrough FC,5,1,4,130,0,0,5,1,4,183,0,0,10,2,8,313,0,0,0,0,0,0,0,0,0,0,0,0,0,0
8226,8226,Carlos Marinelli,2698,2001,Middlesbrough FC,10,6,4,610,2,0,10,6,4,586,0,0,20,12,8,1196,2,0,0,0,0,0,0,0,0,0,0,0,0,0
8227,8227,Manuel Fernandes,3644,2007,Everton FC,7,6,1,538,0,0,5,3,2,332,0,0,12,9,3,870,0,0,0,0,0,0,0,0,0,0,0,0,0,0
8228,8228,Andy Johnson,1322,2007,Everton FC,13,8,5,762,1,0,16,12,4,1081,5,0,29,20,9,1843,6,0,0,3,3,0,4,4,0,0,0,0,0,0
8229,8229,Luis García,3230,2006,Liverpool FC,10,7,3,608,2,0,7,4,3,391,1,0,17,11,6,999,3,0,0,3,3,0,1,1,0,0,0,0,0,0
8230,8230,Jan Laštůvka,3685,2006,Fulham FC,4,3,1,299,0,0,4,4,0,360,0,0,8,7,1,659,0,0,0,0,0,0,0,0,0,0,0,0,0,0
8231,8231,Stefan Savić,3300,2012,Manchester City,0,0,0,0,0,0,0,0,0,0,0,0,0,0,0,0,0,0,0,0,0,0,0,0,0,0,0,0,0,0
8232,8232,Nigel de Jong,1680,2012,Manchester City,0,0,0,0,0,0,1,1,0,90,0,0,1,1,0,90,0,0,0,0,0,0,0,0,0,0,0,0,0,0
8233,8233,Billy Sharp,3470,2012,Southampton FC,1,0,1,14,0,0,1,0,1,4,0,0,2,0,2,18,0,0,0,0,0,0,0,0,0,0,0,0,0,0
8234,8234,Hayden Mullins,1941,2008,West Ham United,9,2,7,287,0,0,7,3,4,365,1,0,16,5,11,652,1,0,0,0,0,0,1,1,0,0,0,0,0,0
8235,8235,Kieron Dyer,2033,2008,West Ham United,4,1,3,109,0,0,3,0,3,84,0,0,7,1,6,193,0,0,0,0,0,0,0,0,0,0,0,0,0,0
8236,8236,Leon Andreasen,3686,2008,Fulham FC,3,0,3,18,0,0,3,0,3,14,0,0,6,0,6,32,0,0,0,0,0,0,0,0,0,0,0,0,0,0
8237,8237,Loris Karius,1178,2018,Liverpool FC,0,0,0,0,0,0,0,0,0,0,0,0,0,0,0,0,0,0,0,0,0,0,0,0,0,0,0,0,0,0
8238,8238,Jack Wilshere,1694,2018,West Ham United,4,2,2,181,0,0,4,2,2,208,0,0,8,4,4,389,0,0,0,0,0,0,0,0,0,0,0,0,0,0
8239,8239,Seyi Olofinjana,1614,2008,Stoke City,8,6,2,555,2,0,10,8,2,674,0,0,18,14,4,1229,2,0,0,0,0,0,0,0,0,0,0,0,0,0
8240,8240,Demarai Gray,2568,2019,Leicester City,10,1,9,271,1,0,11,2,9,336,1,0,21,3,18,607,2,0,0,3,3,0,1,1,0,0,0,0,0,0
8241,8241,Emmanuel Petit,2616,2003,Chelsea FC,3,2,1,181,0,0,1,1,0,81,0,0,4,3,1,262,0,0,0,0,0,0,0,0,0,0,0,0,0,0
8242,8242,Alpay Özalan,2765,2003,Aston Villa,3,2,1,194,1,0,3,2,1,234,0,0,6,4,2,428,1,0,0,0,0,1,0,1,0,0,0,0,0,0
8243,8243,Clint Dempsey,1565,2013,Fulham FC,3,2,1,194,0,0,2,2,0,161,0,0,5,4,1,355,0,0,0,0,0,0,0,0,0,0,0,0,0,0
8244,8244,Muamer Tanković,3687,2013,Fulham FC,1,0,1,7,0,0,2,1,1,53,0,0,3,1,2,60,0,0,0,0,0,0,0,0,0,0,0,0,0,0
8245,8245,Joshua Passley,3688,2013,Fulham FC,0,0,0,0,0,0,0,0,0,0,0,0,0,0,0,0,0,0,0,0,0,0,0,0,0,0,0,0,0,0
8246,8246,Sam Gallagher,3689,2013,Southampton FC,8,2,6,229,1,0,10,1,9,154,0,0,18,3,15,383,1,0,0,0,0,0,0,0,0,0,0,0,0,0
8247,8247,Edgar Davids,3344,2006,Tottenham Hotspur,4,3,1,280,0,0,5,3,2,236,0,0,9,6,3,516,0,0,0,0,0,0,0,0,0,0,0,0,0,0
8248,8248,Björn Runström,3690,2006,Fulham FC,0,0,0,0,0,0,1,0,1,8,0,0,1,0,1,8,0,0,0,0,0,0,0,0,0,0,0,0,0,0
8249,8249,André Santos,2751,2011,Arsenal FC,8,4,4,475,0,0,7,6,1,537,2,0,15,10,5,1012,2,0,0,0,0,0,2,2,0,0,0,0,0,0
8250,8250,Francis Coquelin,1503,2011,Arsenal FC,4,1,3,199,0,0,5,4,1,370,0,0,9,5,4,569,0,0,0,0,0,0,0,0,0,0,0,0,0,0
8251,8251,Łukasz Fabiański,1227,2011,Arsenal FC,0,0,0,0,0,0,0,0,0,0,0,0,0,0,0,0,0,0,0,0,0,0,0,0,0,0,0,0,0,0
8252,8252,Youssef Safri,3691,2004,Norwich City,10,7,3,634,1,0,8,6,2,449,0,0,18,13,5,1083,1,0,0,0,0,1,0,1,0,0,0,0,0,0
8253,8253,Wayne Hennessey,1018,2018,Crystal Palace,8,7,1,675,0,0,10,10,0,900,0,0,18,17,1,1575,0,0,0,0,0,0,0,0,0,0,0,0,0,0
8254,8254,Kevin Long,2350,2018,Burnley FC,1,1,0,90,0,0,5,4,1,423,0,0,6,5,1,513,0,0,0,0,0,0,0,0,0,0,0,0,0,0
8255,8255,Steven Defour,1255,2018,Burnley FC,2,2,0,172,0,0,4,4,0,280,0,0,6,6,0,452,0,0,0,0,0,0,0,0,0,0,0,0,0,0
8256,8256,Aaron Lennon,1052,2018,Burnley FC,7,5,2,487,1,0,9,9,0,730,0,0,16,14,2,1217,1,0,0,0,0,0,0,0,0,0,0,0,0,0
8257,8257,Sam Vokes,1257,2018,Burnley FC,10,5,5,456,2,0,10,5,5,459,1,0,20,10,10,915,3,0,0,3,3,1,1,2,0,0,0,0,0,0
8258,8258,Ashley Westwood,1440,2018,Burnley FC,18,17,1,1530,0,0,16,14,2,1292,2,0,34,31,3,2822,2,0,0,0,0,0,2,2,0,0,0,0,0,0
8259,8259,Bruno N'Gotty,3076,2005,Bolton Wanderers,13,12,1,1086,0,0,16,15,1,1363,0,0,29,27,2,2449,0,0,0,0,0,0,0,0,0,0,0,0,0,0
8260,8260,Hidetoshi Nakata,3692,2005,Bolton Wanderers,10,7,3,626,1,0,11,7,4,725,0,0,21,14,7,1351,1,0,0,0,0,1,0,1,0,0,0,0,0,0
8261,8261,Joey O'Brien,2412,2005,Bolton Wanderers,13,12,1,1121,0,0,10,10,0,855,0,0,23,22,1,1976,0,0,0,0,0,0,0,0,0,0,0,0,0,0
8262,8262,Craig Hignett,1455,2002,Blackburn Rovers,2,0,2,34,0,0,1,1,0,76,1,0,3,1,2,110,1,0,0,0,0,0,0,0,0,0,0,0,0,0
8263,8263,Joachim Björklund,1633,2002,Sunderland AFC,9,9,0,810,0,0,11,10,1,786,0,0,20,19,1,1596,0,0,0,0,0,0,0,0,0,0,0,0,0,0
8264,8264,Claudio Reyna,1634,2002,Sunderland AFC,5,5,0,439,0,0,6,6,0,489,0,0,11,11,0,928,0,0,0,0,0,0,0,0,0,0,0,0,0,0
8265,8265,Jason McAteer,1352,2002,Sunderland AFC,4,4,0,303,0,0,5,5,0,405,1,0,9,9,0,708,1,0,0,3,3,0,1,1,0,0,0,0,0,0
8266,8266,Thomas Butler,1637,2002,Sunderland AFC,3,3,0,236,0,0,4,4,0,334,0,0,7,7,0,570,0,0,0,0,0,0,0,0,0,0,0,0,0,0
8267,8267,Niall Quinn,1099,2002,Sunderland AFC,5,0,5,118,0,0,3,0,3,62,0,0,8,0,8,180,0,0,0,0,0,0,0,0,0,0,0,0,0,0
8268,8268,Rafael,1787,2014,Manchester United,6,4,2,350,0,0,4,2,2,239,0,0,10,6,4,589,0,0,0,0,0,0,0,0,0,0,0,0,0,0
8269,8269,Luke Shaw,2576,2014,Manchester United,6,6,0,495,0,0,10,9,1,631,0,0,16,15,1,1126,0,0,0,0,0,0,0,0,0,0,0,0,0,0
8270,8270,John Mikel Obi,1769,2014,Chelsea FC,9,3,6,350,0,0,9,3,6,346,0,0,18,6,12,696,0,0,0,0,0,0,0,0,0,0,0,0,0,0
8271,8271,André Schürrle,1540,2014,Chelsea FC,6,3,3,224,0,0,8,2,6,211,3,0,14,5,9,435,3,0,0,0,0,0,2,2,0,0,0,0,0,0
8272,8272,Nathan Aké,1037,2014,Chelsea FC,0,0,0,0,0,0,1,0,1,17,0,0,1,0,1,17,0,0,0,0,0,0,0,0,0,0,0,0,0,0
8273,8273,Lewis Baker,3693,2014,Chelsea FC,0,0,0,0,0,0,0,0,0,0,0,0,0,0,0,0,0,0,0,0,0,0,0,0,0,0,0,0,0,0
8274,8274,Mohamed Salah,1187,2014,Chelsea FC,1,0,1,8,0,0,2,0,2,22,0,0,3,0,3,30,0,0,0,0,0,0,0,0,0,0,0,0,0,0
8275,8275,Tie Li,3387,2003,Everton FC,2,2,0,135,0,0,3,2,1,193,0,0,5,4,1,328,0,0,0,0,0,0,0,0,0,0,0,0,0,0
8276,8276,Kevin Campbell,1601,2003,Everton FC,7,2,5,207,0,0,10,6,4,553,1,0,17,8,9,760,1,0,0,0,0,0,0,0,0,0,0,0,0,0
8277,8277,David Seaman,2354,2003,Manchester City,8,8,0,720,0,0,10,10,0,785,0,0,18,18,0,1505,0,0,0,0,0,0,0,0,0,0,0,0,0,0
8278,8278,David Sommeil,1806,2003,Manchester City,9,9,0,810,1,0,8,8,0,720,0,0,17,17,0,1530,1,0,1,0,1,1,0,1,0,0,0,0,0,0
8279,8279,Sylvain Distin,1015,2003,Manchester City,19,19,0,1710,1,0,17,17,0,1530,1,0,36,36,0,3240,2,0,0,1,1,1,1,2,0,0,0,0,0,0
8280,8280,Jihai Sun,1808,2003,Manchester City,16,14,2,1276,0,0,15,14,1,1260,1,0,31,28,3,2536,1,0,0,0,0,0,0,0,0,0,0,0,0,0
8281,8281,Richard Dunne,1617,2003,Manchester City,15,14,1,1240,0,0,13,13,0,1170,0,0,28,27,1,2410,0,0,0,0,0,0,0,0,0,0,0,0,0,0
8282,8282,Steve McManaman,3679,2003,Manchester City,11,10,1,726,0,0,11,10,1,887,0,0,22,20,2,1613,0,0,0,0,0,0,0,0,0,0,0,0,0,0
8283,8283,Joey Barton,1876,2003,Manchester City,13,10,3,904,0,0,13,12,1,1102,1,0,26,22,4,2006,1,0,0,0,0,0,1,1,0,0,0,0,0,0
8284,8284,Trevor Sinclair,1628,2003,Manchester City,13,8,5,840,1,0,15,11,4,1062,0,0,28,19,9,1902,1,0,0,0,0,0,0,0,0,0,0,0,0,0
8285,8285,Shaun Wright-Phillips,1683,2003,Manchester City,18,16,2,1464,5,0,14,14,0,1234,2,0,32,30,2,2698,7,0,1,0,1,2,1,3,0,0,0,0,0,0
8286,8286,Robbie Fowler,2691,2003,Manchester City,15,11,4,893,3,0,15,11,4,936,4,0,30,22,8,1829,7,0,1,0,1,3,4,7,0,0,0,0,0,0
8287,8287,Nicolas Anelka,1720,2003,Manchester City,16,16,0,1414,10,0,14,13,1,1145,7,0,30,29,1,2559,17,0,0,3,3,3,6,9,3,1,4,0,0,0
8288,8288,Kevin Stuhr-Ellegaard,3694,2003,Manchester City,2,2,0,180,0,0,2,0,2,115,0,0,4,2,2,295,0,0,0,0,0,0,0,0,0,0,0,0,0,0
8289,8289,Paulo Wanchope,3310,2003,Manchester City,11,6,5,613,3,0,11,6,5,581,3,0,22,12,10,1194,6,0,3,1,4,2,1,3,0,0,0,0,0,0
8290,8290,Séamus Coleman,1467,2015,Everton FC,16,15,1,1324,0,0,12,12,0,1062,1,0,28,27,1,2386,1,0,0,0,0,0,0,0,0,0,0,0,0,0
8291,8291,Ramiro Funes Mori,3109,2015,Everton FC,14,13,1,1183,1,0,14,11,3,1048,3,0,28,24,4,2231,4,0,0,0,0,1,3,4,0,0,0,0,0,0
8292,8292,Gareth Barry,1418,2015,Everton FC,16,15,1,1351,0,0,17,17,0,1486,0,0,33,32,1,2837,0,0,0,0,0,0,0,0,0,0,0,0,0,0
8293,8293,Arouna Koné,2237,2015,Everton FC,14,9,5,878,4,0,11,7,4,579,1,0,25,16,9,1457,5,0,1,0,1,1,1,2,0,0,0,0,0,0
8294,8294,Steven Pienaar,2406,2015,Everton FC,1,0,1,62,0,0,3,0,3,56,0,0,4,0,4,118,0,0,0,0,0,0,0,0,0,0,0,0,0,0
8295,8295,Gerard Deulofeu,1927,2015,Everton FC,13,8,5,691,2,0,13,8,5,693,0,0,26,16,10,1384,2,0,0,0,0,2,0,2,0,0,0,0,0,0
8296,8296,Isaac Success,2331,2019,Watford FC,3,0,3,33,0,0,2,0,2,32,0,0,5,0,5,65,0,0,0,0,0,0,0,0,0,0,0,0,0,0
8297,8297,Ashley Young,1619,2019,Manchester United,5,4,1,416,0,0,7,6,1,538,0,0,12,10,2,954,0,0,0,0,0,0,0,0,0,0,0,0,0,0
8298,8298,Morgan Gibbs-White,2705,2019,Wolverhampton Wanderers,6,1,5,125,0,0,1,0,1,1,0,0,7,1,6,126,0,0,0,0,0,0,0,0,0,0,0,0,0,0
8299,8299,Stephen McPhail,3695,2001,Leeds United,0,0,0,0,0,0,1,0,1,24,0,0,1,0,1,24,0,0,0,0,0,0,0,0,0,0,0,0,0,0
8300,8300,Neil Lennon,3696,2000,Leicester City,7,7,0,586,0,0,8,8,0,720,0,0,15,15,0,1306,0,0,0,0,0,0,0,0,0,0,0,0,0,0
8301,8301,Richard Cresswell,1998,2000,Leicester City,3,1,2,123,0,0,5,2,3,202,0,0,8,3,5,325,0,0,0,0,0,0,0,0,0,0,0,0,0,0
8302,8302,Bob Taylor,3697,2002,West Bromwich Albion,3,2,1,107,0,0,1,0,1,7,0,0,4,2,2,114,0,0,0,0,0,0,0,0,0,0,0,0,0,0
8303,8303,Henning Berg,1346,2002,Blackburn Rovers,8,8,0,640,0,0,8,7,1,636,1,0,16,15,1,1276,1,0,0,0,0,0,1,1,0,0,0,0,0,0
8304,8304,Bakary Sako,2253,2018,Crystal Palace,3,0,3,9,0,0,1,0,1,17,0,0,4,0,4,26,0,0,0,0,0,0,0,0,0,0,0,0,0,0
8305,8305,Connor Wickham,1035,2018,Crystal Palace,3,0,3,49,0,0,3,0,3,12,0,0,6,0,6,61,0,0,0,0,0,0,0,0,0,0,0,0,0,0
8306,8306,Stephen Hendrie,3698,2015,West Ham United,0,0,0,0,0,0,0,0,0,0,0,0,0,0,0,0,0,0,0,0,0,0,0,0,0,0,0,0,0,0
8307,8307,Danny Welbeck,1506,2015,Arsenal FC,5,2,3,211,2,0,6,5,1,367,2,0,11,7,4,578,4,0,6,0,6,2,1,3,0,0,0,0,0,0
8308,8308,Matthew Upson,1279,2003,Birmingham City,15,15,0,1350,0,0,15,15,0,1335,0,0,30,30,0,2685,0,0,0,0,0,0,0,0,0,0,0,0,0,0
8309,8309,Aliou Cissé,2622,2003,Birmingham City,9,3,6,296,0,0,6,2,4,238,0,0,15,5,10,534,0,0,0,0,0,0,0,0,0,0,0,0,0,0
8310,8310,Stan Lazaridis,2624,2003,Birmingham City,15,14,1,1124,2,0,15,11,4,999,0,0,30,25,5,2123,2,0,0,0,0,0,0,0,0,0,0,0,0,0
8311,8311,Pascal Cygan,3439,2003,Arsenal FC,11,4,7,448,0,0,7,6,1,541,0,0,18,10,8,989,0,0,0,0,0,0,0,0,0,0,0,0,0,0
8312,8312,Justin Hoyte,3282,2003,Arsenal FC,0,0,0,0,0,0,1,0,1,1,0,0,1,0,1,1,0,0,0,0,0,0,0,0,0,0,0,0,0,0
8313,8313,Nwankwo Kanu,1324,2003,Arsenal FC,4,1,3,174,0,0,6,2,4,255,1,0,10,3,7,429,1,0,0,0,0,0,1,1,0,0,0,0,0,0
8314,8314,James Morrison,1735,2015,West Bromwich Albion,9,8,1,655,3,0,9,9,0,689,0,0,18,17,1,1344,3,0,0,0,0,1,0,1,0,0,0,0,0,0
8315,8315,Chris Brunt,1658,2015,West Bromwich Albion,12,12,0,1010,0,0,10,8,2,792,0,0,22,20,2,1802,0,0,0,0,0,0,0,0,0,0,0,0,0,0
8316,8316,Anders Lindegaard,2319,2015,West Bromwich Albion,0,0,0,0,0,0,0,0,0,0,0,0,0,0,0,0,0,0,0,0,0,0,0,0,0,0,0,0,0,0
8317,8317,Callum McManaman,3001,2015,West Bromwich Albion,7,2,5,196,0,0,5,0,5,79,0,0,12,2,10,275,0,0,0,0,0,0,0,0,0,0,0,0,0,0
8318,8318,David Bellion,1944,2001,Sunderland AFC,2,0,2,54,0,0,7,0,7,141,0,0,9,0,9,195,0,0,0,0,0,0,0,0,0,0,0,0,0,0
8319,8319,Matthew Briggs,2559,2010,Fulham FC,1,1,0,90,0,0,2,2,0,108,0,0,3,3,0,198,0,0,0,0,0,0,0,0,0,0,0,0,0,0
8320,8320,Carlo Cudicini,2370,2004,Chelsea FC,1,1,0,82,0,0,2,2,0,180,0,0,3,3,0,262,0,0,0,0,0,0,0,0,0,0,0,0,0,0
8321,8321,Glen Johnson,1386,2004,Chelsea FC,8,6,2,506,0,0,8,7,1,614,0,0,16,13,3,1120,0,0,0,0,0,0,0,0,0,0,0,0,0,0
8322,8322,William Gallas,2040,2004,Chelsea FC,13,13,0,1142,0,0,15,15,0,1306,2,0,28,28,0,2448,2,0,0,0,0,0,1,1,0,0,0,0,0,0
8323,8323,Lenny Pidgeley,2973,2004,Chelsea FC,1,0,1,8,0,0,0,0,0,0,0,0,1,0,1,8,0,0,0,0,0,0,0,0,0,0,0,0,0,0
8324,8324,Jiří Jarošík,2774,2004,Chelsea FC,5,1,4,160,0,0,8,2,6,276,0,0,13,3,10,436,0,0,0,0,0,0,0,0,0,0,0,0,0,0
8325,8325,Mikael Forssell,1965,2004,Chelsea FC,1,0,1,23,0,0,0,0,0,0,0,0,1,0,1,23,0,0,0,0,0,0,0,0,0,0,0,0,0,0
8326,8326,Rob Holding,2510,2018,Arsenal FC,6,5,1,501,0,0,4,4,0,306,0,0,10,9,1,807,0,0,0,0,0,0,0,0,0,0,0,0,0,0
8327,8327,Henrikh Mkhitaryan,2572,2018,Arsenal FC,11,8,3,650,3,0,14,11,3,993,3,0,25,19,6,1643,6,0,1,0,1,1,2,3,0,0,0,0,0,0
8328,8328,Stephan Lichtsteiner,3699,2018,Arsenal FC,7,5,2,408,0,0,7,5,2,532,0,0,14,10,4,940,0,0,0,0,0,0,0,0,0,0,0,0,0,0
8329,8329,Michael Duberry,2291,2006,Reading FC,4,4,0,316,0,0,4,4,0,360,0,0,8,8,0,676,0,0,0,0,0,0,0,0,0,0,0,0,0,0
8330,8330,Greg Halford,1968,2006,Reading FC,2,1,1,91,0,0,1,1,0,90,0,0,3,2,1,181,0,0,0,0,0,0,0,0,0,0,0,0,0,0
8331,8331,Dave Kitson,1995,2006,Reading FC,8,6,2,503,2,0,5,3,2,300,0,0,13,9,4,803,2,0,3,0,3,1,0,1,0,0,0,0,0,0
8332,8332,Chris Powell,1669,2006,Watford FC,6,4,2,371,0,0,9,5,4,491,0,0,15,9,6,862,0,0,0,0,0,0,0,0,0,0,0,0,0,0
8333,8333,Douglas,3700,2006,Watford FC,3,3,0,262,0,0,4,3,1,174,1,0,7,6,1,436,1,0,0,0,0,0,0,0,0,0,0,0,0,0
8334,8334,Cedric Avinel,3701,2006,Watford FC,0,0,0,0,0,0,1,1,0,46,0,0,1,1,0,46,0,0,0,0,0,0,0,0,0,0,0,0,0,0
8335,8335,Lee Williamson,3702,2006,Watford FC,2,2,0,136,0,0,3,2,1,197,0,0,5,4,1,333,0,0,0,0,0,0,0,0,0,0,0,0,0,0
8336,8336,Michel Vorm,1174,2012,Swansea City,15,15,0,1350,0,0,11,11,0,959,0,0,26,26,0,2309,0,0,0,0,0,0,0,0,0,0,0,0,0,0
8337,8337,Chico,2935,2012,Swansea City,14,14,0,1181,0,0,12,12,0,1080,0,0,26,26,0,2261,0,0,0,0,0,0,0,0,0,0,0,0,0,0
8338,8338,Ashley Williams,1061,2012,Swansea City,19,19,0,1710,0,0,18,18,0,1620,0,0,37,37,0,3330,0,0,0,0,0,0,0,0,0,0,0,0,0,0
8339,8339,Àngel Rangel,1696,2012,Swansea City,17,17,0,1530,2,0,16,13,3,1220,1,0,33,30,3,2750,3,0,0,0,0,1,1,2,0,0,0,0,0,0
8340,8340,Ben Davies,1164,2012,Swansea City,19,17,2,1597,1,0,18,16,2,1456,0,0,37,33,4,3053,1,0,0,0,0,1,0,1,0,0,0,0,0,0
8341,8341,Leon Britton,1707,2012,Swansea City,17,15,2,1318,0,0,16,15,1,1216,0,0,33,30,3,2534,0,0,0,0,0,0,0,0,0,0,0,0,0,0
8342,8342,Pablo Hernández,3492,2012,Swansea City,15,14,1,1128,3,0,15,13,2,1070,0,0,30,27,3,2198,3,0,1,0,1,2,0,2,0,0,0,0,0,0
8343,8343,Jonathan de Guzmán,2937,2012,Swansea City,19,17,2,1430,3,0,18,16,2,1424,2,0,37,33,4,2854,5,0,0,0,0,0,0,0,0,0,0,0,0,0
8344,8344,Sung-yueng Ki,1698,2012,Swansea City,16,9,7,990,0,0,13,11,2,1049,0,0,29,20,9,2039,0,0,0,0,0,0,0,0,0,0,0,0,0,0
8345,8345,Michu,2939,2012,Swansea City,19,19,0,1637,11,0,16,16,0,1377,7,0,35,35,0,3014,18,0,2,0,2,4,5,9,0,0,0,0,0,0
8346,8346,Wayne Routledge,1758,2012,Swansea City,19,17,2,1446,5,0,17,13,4,1079,0,0,36,30,6,2525,5,0,1,0,1,3,0,3,0,0,0,0,0,0
8347,8347,Neil Taylor,1695,2012,Swansea City,3,2,1,113,0,0,3,2,1,162,0,0,6,4,2,275,0,0,0,0,0,0,0,0,0,0,0,0,0,0
8348,8348,Nathan Dyer,1702,2012,Swansea City,18,13,5,1202,0,0,19,12,7,1139,3,0,37,25,12,2341,3,0,0,1,1,0,1,1,0,0,0,0,0,0
8349,8349,Itay Shechter,3703,2012,Swansea City,8,2,6,201,0,0,10,5,5,422,1,0,18,7,11,623,1,0,0,0,0,0,1,1,0,0,0,0,0,0
8350,8350,Gerhard Tremmel,1706,2012,Swansea City,4,4,0,360,0,0,10,8,2,751,0,0,14,12,2,1111,0,0,0,0,0,0,0,0,0,0,0,0,0,0
8351,8351,Garry Monk,2808,2012,Swansea City,5,4,1,383,0,0,6,6,0,540,0,0,11,10,1,923,0,0,0,0,0,0,0,0,0,0,0,0,0,0
8352,8352,Dwight Tiendalli,2936,2012,Swansea City,4,2,2,187,0,0,10,9,1,826,1,0,14,11,3,1013,1,0,0,3,3,0,1,1,0,0,0,0,0,0
8353,8353,Luke Moore,1796,2012,Swansea City,9,1,8,204,1,0,8,3,5,322,2,0,17,4,13,526,3,0,3,1,4,1,2,3,0,0,0,0,0,0
8354,8354,Wayne Bridge,1768,2005,Fulham FC,6,6,0,540,0,0,6,6,0,540,0,0,12,12,0,1080,0,0,0,0,0,0,0,0,0,0,0,0,0,0
8355,8355,Michael Brown,1122,2005,Fulham FC,3,3,0,270,0,0,4,3,1,247,0,0,7,6,1,517,0,0,0,0,0,0,0,0,0,0,0,0,0,0
8356,8356,Ben Foster,1653,2013,West Bromwich Albion,12,12,0,1080,0,0,12,12,0,1068,0,0,24,24,0,2148,0,0,0,0,0,0,0,0,0,0,0,0,0,0
8357,8357,Graham Dorrans,1737,2013,West Bromwich Albion,7,5,2,503,1,0,7,7,0,602,1,0,14,12,2,1105,2,0,0,0,0,0,0,0,0,0,0,0,0,0
8358,8358,Alessandro Pistone,1799,2002,Everton FC,7,4,3,374,0,0,8,6,2,568,0,0,15,10,5,942,0,0,0,0,0,0,0,0,0,0,0,0,0,0
8359,8359,Mark Bunn,1380,2012,Norwich City,12,12,0,1005,0,0,11,10,1,908,0,0,23,22,1,1913,0,0,0,0,0,0,0,0,0,0,0,0,0,0
8360,8360,Russell Martin,1368,2012,Norwich City,15,15,0,1350,2,0,16,15,1,1341,1,0,31,30,1,2691,3,0,0,0,0,0,0,0,0,0,0,0,0,0
8361,8361,Sébastien Bassong,1370,2012,Norwich City,18,18,0,1620,1,0,16,16,0,1342,2,0,34,34,0,2962,3,0,0,1,1,1,1,2,0,0,0,0,0,0
8362,8362,Michael Turner,1371,2012,Norwich City,14,14,0,1153,1,0,12,11,1,1072,2,0,26,25,1,2225,3,0,0,1,1,1,2,3,0,0,0,0,0,0
8363,8363,Javi Garrido,1381,2012,Norwich City,19,19,0,1689,0,0,15,15,0,1350,0,0,34,34,0,3039,0,0,0,0,0,0,0,0,0,0,0,0,0,0
8364,8364,Bradley Johnson,1373,2012,Norwich City,19,19,0,1701,1,0,18,18,0,1526,0,0,37,37,0,3227,1,0,3,0,3,1,0,1,0,0,0,0,0,0
8365,8365,Robert Snodgrass,2207,2012,Norwich City,19,18,1,1586,2,0,18,17,1,1477,4,0,37,35,2,3063,6,0,0,2,2,2,3,5,0,0,0,0,0,0
8366,8366,Jonny Howson,1374,2012,Norwich City,15,9,6,868,1,0,15,13,2,1176,1,0,30,22,8,2044,2,0,0,3,3,0,1,1,0,0,0,0,0,0
8367,8367,Anthony Pilkington,1376,2012,Norwich City,15,13,2,1122,4,0,15,12,3,1035,1,0,30,25,5,2157,5,0,3,0,3,2,1,3,0,0,0,0,0,0
8368,8368,Grant Holt,1446,2012,Norwich City,17,14,3,1304,5,0,17,14,3,1268,3,0,34,28,6,2572,8,0,6,0,6,3,2,5,1,0,1,0,0,0
8369,8369,Kei Kamara,3704,2012,Norwich City,6,3,3,313,1,0,5,4,1,342,0,0,11,7,4,655,1,0,0,0,0,1,0,1,0,0,0,0,0,0
8370,8370,Wes Hoolahan,1383,2012,Norwich City,16,14,2,1248,2,0,17,14,3,1185,1,0,33,28,5,2433,3,0,3,0,3,2,1,3,0,0,0,0,0,0
8371,8371,Luciano Becchio,1384,2012,Norwich City,4,2,2,159,0,0,4,0,4,10,0,0,8,2,6,169,0,0,0,0,0,0,0,0,0,0,0,0,0,0
8372,8372,Lee Camp,3705,2012,Norwich City,1,0,1,75,0,0,2,1,1,147,0,0,3,1,2,222,0,0,0,0,0,0,0,0,0,0,0,0,0,0
8373,8373,Steven Whittaker,1369,2012,Norwich City,4,4,0,360,0,0,9,8,1,687,1,0,13,12,1,1047,1,0,0,0,0,0,1,1,0,0,0,0,0,0
8374,8374,Ryan Bennett,1382,2012,Norwich City,6,3,3,378,1,0,9,7,2,686,0,0,15,10,5,1064,1,0,0,0,0,1,0,1,0,0,0,0,0,0
8375,8375,David Fox,3046,2012,Norwich City,0,0,0,0,0,0,2,0,2,35,0,0,2,0,2,35,0,0,0,0,0,0,0,0,0,0,0,0,0,0
8376,8376,Elliott Bennett,3043,2012,Norwich City,11,4,7,370,1,0,13,5,8,566,0,0,24,9,15,936,1,0,0,0,0,0,0,0,0,0,0,0,0,0
8377,8377,Artur Boruc,1000,2012,Southampton FC,9,9,0,766,0,0,11,11,0,990,0,0,20,20,0,1756,0,0,0,0,0,0,0,0,0,0,0,0,0,0
8378,8378,Jack Cork,1701,2012,Southampton FC,14,14,0,1208,0,0,14,14,0,1223,0,0,28,28,0,2431,0,0,0,0,0,0,0,0,0,0,0,0,0,0
8379,8379,Vegard Forren,3706,2012,Southampton FC,0,0,0,0,0,0,0,0,0,0,0,0,0,0,0,0,0,0,0,0,0,0,0,0,0,0,0,0,0,0
8380,8380,Wayne Hennessey,1018,2011,Wolverhampton Wanderers,17,17,0,1530,0,0,17,17,0,1530,0,0,34,34,0,3060,0,0,0,0,0,0,0,0,0,0,0,0,0,0
8381,8381,Richard Stearman,3430,2011,Wolverhampton Wanderers,14,13,1,1178,0,0,16,15,1,1231,0,0,30,28,2,2409,0,0,0,0,0,0,0,0,0,0,0,0,0,0
8382,8382,Stephen Ward,1252,2011,Wolverhampton Wanderers,19,19,0,1710,2,0,19,19,0,1710,1,0,38,38,0,3420,3,0,0,3,3,1,1,2,0,0,0,0,0,0
8383,8383,Roger Johnson,1781,2011,Wolverhampton Wanderers,14,13,1,1186,0,0,13,13,0,1170,0,0,27,26,1,2356,0,0,0,0,0,0,0,0,0,0,0,0,0,0
8384,8384,Christophe Berra,2885,2011,Wolverhampton Wanderers,16,13,3,1258,0,0,16,16,0,1440,0,0,32,29,3,2698,0,0,0,0,0,0,0,0,0,0,0,0,0,0
8385,8385,Karl Henry,2921,2011,Wolverhampton Wanderers,14,13,1,1140,0,0,17,17,0,1455,0,0,31,30,1,2595,0,0,0,0,0,0,0,0,0,0,0,0,0,0
8386,8386,Stephen Hunt,2596,2011,Wolverhampton Wanderers,10,8,2,663,1,0,14,8,6,733,2,0,24,16,8,1396,3,0,0,0,0,1,1,2,1,2,3,0,0,0
8387,8387,Matthew Jarvis,2627,2011,Wolverhampton Wanderers,18,15,3,1413,2,0,19,16,3,1402,6,0,37,31,6,2815,8,0,0,1,1,0,4,4,0,0,0,0,0,0
8388,8388,Jamie O'Hara,2505,2011,Wolverhampton Wanderers,9,9,0,804,2,0,10,10,0,857,0,0,19,19,0,1661,2,0,1,0,1,2,0,2,0,0,0,0,0,0
8389,8389,Steven Fletcher,1408,2011,Wolverhampton Wanderers,16,14,2,1236,4,0,16,12,4,1115,8,0,32,26,6,2351,12,0,3,2,5,3,4,7,0,0,0,0,0,0
8390,8390,Kevin Doyle,2594,2011,Wolverhampton Wanderers,17,14,3,1216,2,0,16,12,4,1132,2,0,33,26,7,2348,4,0,0,4,4,1,2,3,0,0,0,0,0,0
8391,8391,George Elokobi,2884,2011,Wolverhampton Wanderers,3,1,2,83,0,0,6,2,4,210,0,0,9,3,6,293,0,0,0,0,0,0,0,0,0,0,0,0,0,0
8392,8392,Kevin Foley,2888,2011,Wolverhampton Wanderers,7,5,2,471,0,0,9,6,3,598,0,0,16,11,5,1069,0,0,0,0,0,0,0,0,0,0,0,0,0,0
8393,8393,Michael Kightly,1259,2011,Wolverhampton Wanderers,11,8,3,677,2,0,7,6,1,517,1,0,18,14,4,1194,3,0,0,0,0,2,1,3,0,0,0,0,0,0
8394,8394,Dorus de Vries,3707,2011,Wolverhampton Wanderers,2,2,0,180,0,0,2,2,0,141,0,0,4,4,0,321,0,0,0,0,0,0,0,0,0,0,0,0,0,0
8395,8395,Adam Hammill,3431,2011,Wolverhampton Wanderers,7,2,5,255,0,0,2,1,1,91,0,0,9,3,6,346,0,0,0,0,0,0,0,0,0,0,0,0,0,0
8396,8396,Nenad Milijaš,2890,2011,Wolverhampton Wanderers,10,2,8,311,0,0,10,4,6,431,0,0,20,6,14,742,0,0,0,0,0,0,0,0,0,0,0,0,0,0
8397,8397,Sylvain Ebanks-Blake,3432,2011,Wolverhampton Wanderers,12,4,8,466,1,0,11,4,7,548,0,0,23,8,15,1014,1,0,0,0,0,1,0,1,0,0,0,0,0,0
8398,8398,Kyle Walker-Peters,3113,2019,Tottenham Hotspur,2,2,0,152,0,0,1,1,0,90,0,0,3,3,0,242,0,0,0,0,0,0,0,0,0,0,0,0,0,0
8399,8399,Phil Jones,1650,2012,Manchester United,9,7,2,615,0,0,8,6,2,591,0,0,17,13,4,1206,0,0,0,0,0,0,0,0,0,0,0,0,0,0
8400,8400,Chris Smalling,1640,2012,Manchester United,9,7,2,623,0,0,6,3,3,392,0,0,15,10,5,1015,0,0,0,0,0,0,0,0,0,0,0,0,0,0
8401,8401,Ben Amos,2260,2012,Manchester United,0,0,0,0,0,0,0,0,0,0,0,0,0,0,0,0,0,0,0,0,0,0,0,0,0,0,0,0,0,0
8402,8402,Andre Wisdom,2625,2012,Liverpool FC,6,6,0,540,0,0,6,6,0,476,0,0,12,12,0,1016,0,0,0,0,0,0,0,0,0,0,0,0,0,0
8403,8403,Raheem Sterling,1203,2012,Liverpool FC,13,10,3,908,2,0,11,9,2,839,0,0,24,19,5,1747,2,0,3,0,3,2,0,2,0,0,0,0,0,0
8404,8404,Jack Robinson,3118,2012,Liverpool FC,0,0,0,0,0,0,0,0,0,0,0,0,0,0,0,0,0,0,0,0,0,0,0,0,0,0,0,0,0,0
8405,8405,Alan Smith,1300,2011,Newcastle United,1,0,1,4,0,0,1,0,1,1,0,0,2,0,2,5,0,0,0,0,0,0,0,0,0,0,0,0,0,0
8406,8406,Haris Vučkić,3708,2011,Newcastle United,3,1,2,109,0,0,1,1,0,65,0,0,4,2,2,174,0,0,0,0,0,0,0,0,0,0,0,0,0,0
8407,8407,Ole Söderberg,3587,2011,Newcastle United,0,0,0,0,0,0,0,0,0,0,0,0,0,0,0,0,0,0,0,0,0,0,0,0,0,0,0,0,0,0
8408,8408,Sam Ricketts,2489,2009,Bolton Wanderers,12,12,0,1080,0,0,15,13,2,1105,0,0,27,25,2,2185,0,0,0,0,0,0,0,0,0,0,0,0,0,0
8409,8409,Mark Davies,2493,2009,Bolton Wanderers,6,1,5,130,0,0,11,4,7,419,0,0,17,5,12,549,0,0,0,0,0,0,0,0,0,0,0,0,0,0
8410,8410,Chris Basham,2601,2009,Bolton Wanderers,5,1,4,114,0,0,3,1,2,123,0,0,8,2,6,237,0,0,0,0,0,0,0,0,0,0,0,0,0,0
8411,8411,Chris Smalling,1640,2009,Fulham FC,4,3,1,271,0,0,7,5,2,508,0,0,11,8,3,779,0,0,0,0,0,0,0,0,0,0,0,0,0,0
8412,8412,Lee Hendrie,1797,2005,Aston Villa,6,3,3,241,1,0,10,4,6,420,0,0,16,7,9,661,1,0,0,0,0,1,0,1,0,0,0,0,0,0
8413,8413,Patrik Berger,2689,2005,Aston Villa,4,2,2,221,0,0,4,1,3,164,0,0,8,3,5,385,0,0,0,0,0,0,0,0,0,0,0,0,0,0
8414,8414,Franck Tabanou,3709,2015,Swansea City,0,0,0,0,0,0,0,0,0,0,0,0,0,0,0,0,0,0,0,0,0,0,0,0,0,0,0,0,0,0
8415,8415,Richard Hughes,2812,2009,Portsmouth FC,5,5,0,391,0,0,5,4,1,390,0,0,10,9,1,781,0,0,0,0,0,0,0,0,0,0,0,0,0,0
8416,8416,Petr Čech,1531,2009,Chelsea FC,16,16,0,1440,0,0,17,17,0,1530,0,0,33,33,0,2970,0,0,0,0,0,0,0,0,0,0,0,0,0,0
8417,8417,Ricardo Carvalho,1760,2009,Chelsea FC,12,12,0,1030,0,0,10,10,0,821,0,0,22,22,0,1851,0,0,0,0,0,0,0,0,0,0,0,0,0,0
8418,8418,Paulo Ferreira,1761,2009,Chelsea FC,6,5,1,437,0,0,5,4,1,334,0,0,11,9,2,771,0,0,0,0,0,0,0,0,0,0,0,0,0,0
8419,8419,John Terry,1534,2009,Chelsea FC,18,18,0,1576,1,0,18,18,0,1618,1,0,36,36,0,3194,2,0,3,3,6,1,1,2,0,0,0,0,0,0
8420,8420,Frank Lampard,1536,2009,Chelsea FC,18,18,0,1620,16,0,17,17,0,1510,6,0,35,35,0,3130,22,0,3,1,4,4,3,7,7,3,10,0,0,0
8421,8421,John Mikel Obi,1769,2009,Chelsea FC,12,10,2,812,0,0,13,11,2,933,0,0,25,21,4,1745,0,0,0,0,0,0,0,0,0,0,0,0,0,0
8422,8422,Florent Malouda,2270,2009,Chelsea FC,15,11,4,1022,8,0,18,15,3,1281,4,0,33,26,7,2303,12,0,0,3,3,2,2,4,0,0,0,0,0,0
8423,8423,Yuriy Zhirkov,2953,2009,Chelsea FC,7,3,4,322,0,0,10,7,3,630,0,0,17,10,7,952,0,0,0,0,0,0,0,0,0,0,0,0,0,0
8424,8424,Deco,2892,2009,Chelsea FC,7,6,1,471,0,0,11,7,4,679,2,0,18,13,5,1150,2,0,0,0,0,0,0,0,0,0,0,0,0,0
8425,8425,Didier Drogba,1766,2009,Chelsea FC,14,14,0,1233,14,0,17,16,1,1451,15,0,31,30,1,2684,29,0,3,1,4,7,10,17,1,0,1,0,0,0
8426,8426,Daniel Sturridge,1428,2009,Chelsea FC,5,0,5,76,1,0,8,2,6,213,0,0,13,2,11,289,1,0,0,0,0,0,0,0,0,0,0,0,0,0
8427,8427,Alex,2269,2009,Chelsea FC,9,7,2,675,1,0,7,6,1,593,0,0,16,13,3,1268,1,0,0,0,0,1,0,1,0,0,0,0,0,0
8428,8428,Patrick van Aanholt,2254,2009,Chelsea FC,1,0,1,13,0,0,1,0,1,19,0,0,2,0,2,32,0,0,0,0,0,0,0,0,0,0,0,0,0,0
8429,8429,Joe Cole,1630,2009,Chelsea FC,15,8,7,788,1,0,11,6,5,494,1,0,26,14,12,1282,2,0,0,0,0,0,1,1,0,0,0,0,0,0
8430,8430,Ruben Loftus-Cheek,1852,2016,Chelsea FC,3,0,3,10,0,0,3,0,3,21,0,0,6,0,6,31,0,0,0,0,0,0,0,0,0,0,0,0,0,0
8431,8431,Sam Woods,3710,2018,Crystal Palace,0,0,0,0,0,0,0,0,0,0,0,0,0,0,0,0,0,0,0,0,0,0,0,0,0,0,0,0,0,0
8432,8432,Alexander Tettey,1830,2013,Norwich City,10,8,2,698,1,0,11,9,2,784,0,0,21,17,4,1482,1,0,0,0,0,0,0,0,0,0,0,0,0,0
8433,8433,Danny Fox,2870,2013,Southampton FC,2,2,0,168,0,0,1,1,0,90,0,0,3,3,0,258,0,0,0,0,0,0,0,0,0,0,0,0,0,0
8434,8434,Daniel Osvaldo,3711,2013,Southampton FC,7,4,3,424,3,0,6,5,1,431,0,0,13,9,4,855,3,0,1,0,1,3,0,3,0,0,0,0,0,0
8435,8435,Alexander Büttner,3712,2013,Manchester United,5,3,2,291,0,0,3,2,1,206,0,0,8,5,3,497,0,0,0,0,0,0,0,0,0,0,0,0,0,0
8436,8436,Anderson,2018,2013,Manchester United,3,2,1,151,0,0,1,0,1,5,0,0,4,2,2,156,0,0,0,0,0,0,0,0,0,0,0,0,0,0
8437,8437,Markus Rosenberg,2562,2013,West Bromwich Albion,2,0,2,21,0,0,2,1,1,67,0,0,4,1,3,88,0,0,0,0,0,0,0,0,0,0,0,0,0,0
8438,8438,Craig Dawson,1655,2013,West Bromwich Albion,5,4,1,365,0,0,7,6,1,584,0,0,12,10,2,949,0,0,0,0,0,0,0,0,0,0,0,0,0,0
8439,8439,Lukas Jutkiewicz,1494,2016,Burnley FC,2,0,2,11,0,0,0,0,0,0,0,0,2,0,2,11,0,0,0,0,0,0,0,0,0,0,0,0,0,0
8440,8440,Tendayi Darikwa,3713,2016,Burnley FC,0,0,0,0,0,0,0,0,0,0,0,0,0,0,0,0,0,0,0,0,0,0,0,0,0,0,0,0,0,0
8441,8441,Alexander Manninger,3714,2016,Liverpool FC,0,0,0,0,0,0,0,0,0,0,0,0,0,0,0,0,0,0,0,0,0,0,0,0,0,0,0,0,0,0
8442,8442,Kevin Stewart,3625,2016,Liverpool FC,1,0,1,14,0,0,2,0,2,2,0,0,3,0,3,16,0,0,0,0,0,0,0,0,0,0,0,0,0,0
8443,8443,John O'Shea,1729,2009,Manchester United,6,4,2,390,0,0,8,7,1,637,1,0,14,11,3,1027,1,0,0,0,0,0,0,0,0,0,0,0,0,0
8444,8444,Michael Owen,1949,2009,Manchester United,10,3,7,382,2,0,8,2,6,211,1,0,18,5,13,593,3,0,3,0,3,1,0,1,0,0,0,0,0,0
8445,8445,Gabriel Obertan,2283,2009,Manchester United,3,1,2,114,0,0,4,0,4,51,0,0,7,1,6,165,0,0,0,0,0,0,0,0,0,0,0,0,0,0
8446,8446,Brett Emerton,1141,2009,Blackburn Rovers,12,7,5,657,0,0,12,10,2,767,0,0,24,17,7,1424,0,0,0,0,0,0,0,0,0,0,0,0,0,0
8447,8447,David Dunn,1456,2009,Blackburn Rovers,12,10,2,845,6,0,11,10,1,868,3,0,23,20,3,1713,9,0,6,3,9,5,3,8,1,1,2,0,0,0
8448,8448,El-Hadji Diouf,1719,2009,Blackburn Rovers,14,12,2,964,3,0,12,12,0,979,0,0,26,24,2,1943,3,0,2,0,2,3,0,3,0,0,0,0,0,0
8449,8449,Nikola Kalinić,3588,2009,Blackburn Rovers,12,8,4,696,2,0,14,6,8,752,0,0,26,14,12,1448,2,0,3,0,3,2,0,2,0,0,0,0,0,0
8450,8450,Tom Heaton,1249,2019,Aston Villa,10,10,0,900,0,0,10,10,0,895,0,0,20,20,0,1795,0,0,0,0,0,0,0,0,0,0,0,0,0,0
8451,8451,Björn Engels,3715,2019,Aston Villa,9,8,1,787,1,0,8,7,1,659,0,0,17,15,2,1446,1,0,0,0,0,1,0,1,0,0,0,0,0,0
8452,8452,Wesley,3716,2019,Aston Villa,10,10,0,880,1,0,11,11,0,910,4,0,21,21,0,1790,5,0,0,0,0,1,3,4,0,0,0,0,0,0
8453,8453,Jed Steer,1447,2019,Aston Villa,0,0,0,0,0,0,1,1,0,8,0,0,1,1,0,8,0,0,0,0,0,0,0,0,0,0,0,0,0,0
8454,8454,Charlie Daniels,1003,2019,AFC Bournemouth,1,1,0,37,0,0,1,1,0,90,0,0,2,2,0,127,0,0,0,0,0,0,0,0,0,0,0,0,0,0
8455,8455,Philip Billing,3192,2019,AFC Bournemouth,17,14,3,1227,1,0,17,15,2,1308,0,0,34,29,5,2535,1,0,0,0,0,1,0,1,0,0,0,0,0,0
8456,8456,Ryan Fraser,1041,2019,AFC Bournemouth,13,12,1,1113,1,0,15,9,6,949,0,0,28,21,7,2062,1,0,0,0,0,1,0,1,0,0,0,0,0,0
8457,8457,Jordon Ibe,1042,2019,AFC Bournemouth,1,0,1,22,0,0,1,0,1,26,0,0,2,0,2,48,0,0,0,0,0,0,0,0,0,0,0,0,0,0
8458,8458,Brendan Galloway,3717,2016,West Bromwich Albion,2,2,0,158,0,0,1,1,0,90,0,0,3,3,0,248,0,0,0,0,0,0,0,0,0,0,0,0,0,0
8459,8459,Dean Whitehead,1218,2017,Huddersfield Town,3,0,3,55,0,0,1,0,1,12,0,0,4,0,4,67,0,0,0,0,0,0,0,0,0,0,0,0,0,0
8460,8460,N'Golo Kanté,1848,2017,Chelsea FC,18,18,0,1590,0,0,16,16,0,1408,1,0,34,34,0,2998,1,0,0,0,0,0,0,0,0,0,0,0,0,0
8461,8461,Ethan Ampadu,3167,2017,Chelsea FC,0,0,0,0,0,0,1,0,1,10,0,0,1,0,1,10,0,0,0,0,0,0,0,0,0,0,0,0,0,0
8462,8462,Danny Drinkwater,2522,2017,Chelsea FC,5,2,3,205,1,0,7,3,4,317,0,0,12,5,7,522,1,0,0,0,0,0,0,0,0,0,0,0,0,0
8463,8463,Graham Dorrans,1737,2015,Norwich City,11,7,4,654,0,0,10,7,3,633,0,0,21,14,7,1287,0,0,0,0,0,0,0,0,0,0,0,0,0,0
8464,8464,Vadis Odjidja-Ofoe,3718,2015,Norwich City,5,0,5,59,0,0,5,3,2,216,0,0,10,3,7,275,0,0,0,0,0,0,0,0,0,0,0,0,0,0
8465,8465,Russell Martin,1368,2015,Norwich City,14,14,0,1260,1,0,16,16,0,1440,2,0,30,30,0,2700,3,0,1,1,2,1,2,3,0,0,0,0,0,0
8466,8466,Winston Reid,2638,2017,West Ham United,10,10,0,900,0,0,7,7,0,554,0,0,17,17,0,1454,0,0,0,0,0,0,0,0,0,0,0,0,0,0
8467,8467,Javier Hernández,2257,2017,West Ham United,14,7,7,691,3,0,14,9,5,853,5,0,28,16,12,1544,8,0,1,1,2,2,4,6,0,0,0,0,0,0
8468,8468,Diafra Sakho,3418,2017,West Ham United,5,0,5,60,1,0,9,0,9,233,1,0,14,0,14,293,2,0,3,0,3,1,0,1,0,0,0,0,0,0
8469,8469,José Fonte,1146,2017,West Ham United,4,4,0,344,0,0,4,4,0,346,0,0,8,8,0,690,0,0,0,0,0,0,0,0,0,0,0,0,0,0
8470,8470,James Collins,1618,2017,West Ham United,6,5,1,452,0,0,7,7,0,597,1,0,13,12,1,1049,1,0,0,0,0,0,1,1,0,0,0,0,0,0
8471,8471,Sam Byram,1823,2017,West Ham United,3,1,2,104,0,0,2,1,1,143,0,0,5,2,3,247,0,0,0,0,0,0,0,0,0,0,0,0,0,0
8472,8472,Steven N'Zonzi,1550,2010,Blackburn Rovers,10,5,5,588,0,0,11,8,3,694,1,0,21,13,8,1282,1,0,0,0,0,0,1,1,0,0,0,0,0,0
8473,8473,Josh Morris,3719,2010,Blackburn Rovers,2,0,2,31,0,0,2,0,2,50,0,0,4,0,4,81,0,0,0,0,0,0,0,0,0,0,0,0,0,0
8474,8474,Titus Bramble,1411,2010,Sunderland AFC,11,10,1,958,0,0,12,12,0,1080,0,0,23,22,1,2038,0,0,0,0,0,0,0,0,0,0,0,0,0,0
8475,8475,Paulo da Silva,2951,2010,Sunderland AFC,0,0,0,0,0,0,1,1,0,90,0,0,1,1,0,90,0,0,0,0,0,0,0,0,0,0,0,0,0,0
8476,8476,Michael Tarnat,3720,2003,Manchester City,17,17,0,1511,1,0,13,13,0,1170,2,0,30,30,0,2681,3,0,0,0,0,1,2,3,0,0,0,0,0,0
8477,8477,Paul Bosvelt,3124,2003,Manchester City,13,11,2,980,0,0,10,9,1,761,0,0,23,20,3,1741,0,0,0,0,0,0,0,0,0,0,0,0,0,0
8478,8478,Claudio Reyna,1634,2003,Manchester City,14,10,4,820,1,0,9,9,0,746,0,0,23,19,4,1566,1,0,0,0,0,0,0,0,0,0,0,0,0,0
8479,8479,Antoine Sibierski,1810,2003,Manchester City,18,11,7,1030,3,0,13,5,8,527,2,0,31,16,15,1557,5,0,1,0,1,2,1,3,0,0,0,0,0,0
8480,8480,Andriy Shevchenko,1765,2007,Chelsea FC,9,4,5,410,5,0,8,4,4,335,0,0,17,8,9,745,5,0,0,0,0,3,0,3,1,0,1,0,0,0
8481,8481,Georgios Samaras,1814,2007,Manchester City,3,0,3,85,0,0,2,2,0,168,0,0,5,2,3,253,0,0,0,0,0,0,0,0,0,0,0,0,0,0
8482,8482,Joey Barton,1876,2016,Burnley FC,6,5,1,467,1,0,8,7,1,637,0,0,14,12,2,1104,1,0,3,0,3,1,0,1,0,0,0,0,0,0
8483,8483,Robbie Brady,2230,2016,Burnley FC,6,3,3,278,1,0,8,4,4,438,0,0,14,7,7,716,1,0,1,0,1,1,0,1,0,0,0,0,0,0
8484,8484,Ashley Westwood,1440,2016,Burnley FC,3,3,0,258,0,0,6,3,3,292,0,0,9,6,3,550,0,0,0,0,0,0,0,0,0,0,0,0,0,0
8485,8485,Daniel Agyei,3721,2016,Burnley FC,1,0,1,15,0,0,2,0,2,8,0,0,3,0,3,23,0,0,0,0,0,0,0,0,0,0,0,0,0,0
8486,8486,Jordan Thomas,3722,2019,Norwich City,0,0,0,0,0,0,1,0,1,1,0,0,1,0,1,1,0,0,0,0,0,0,0,0,0,0,0,0,0,0
8487,8487,Akin Famewo,3723,2019,Norwich City,0,0,0,0,0,0,1,0,1,1,0,0,1,0,1,1,0,0,0,0,0,0,0,0,0,0,0,0,0,0
8488,8488,Josh Martin,3724,2019,Norwich City,2,0,2,21,0,0,3,0,3,11,0,0,5,0,5,32,0,0,0,0,0,0,0,0,0,0,0,0,0,0
8489,8489,Archie Mair,3725,2019,Norwich City,0,0,0,0,0,0,0,0,0,0,0,0,0,0,0,0,0,0,0,0,0,0,0,0,0,0,0,0,0,0
8490,8490,Dan Adshead,3726,2019,Norwich City,0,0,0,0,0,0,0,0,0,0,0,0,0,0,0,0,0,0,0,0,0,0,0,0,0,0,0,0,0,0
8491,8491,Kasey Keller,1117,2007,Fulham FC,5,5,0,450,0,0,8,8,0,720,0,0,13,13,0,1170,0,0,0,0,0,0,0,0,0,0,0,0,0,0
8492,8492,Brede Hangeland,1033,2007,Fulham FC,7,7,0,630,0,0,8,8,0,720,0,0,15,15,0,1350,0,0,0,0,0,0,0,0,0,0,0,0,0,0
8493,8493,Paul Stalteri,2955,2007,Fulham FC,6,6,0,512,0,0,7,7,0,624,0,0,13,13,0,1136,0,0,0,0,0,0,0,0,0,0,0,0,0,0
8494,8494,Jimmy Bullard,1610,2007,Fulham FC,8,7,1,667,1,0,9,8,1,721,1,0,17,15,2,1388,2,0,3,1,4,1,1,2,0,0,0,0,0,0
8495,8495,Brian McBride,1088,2007,Fulham FC,9,8,1,659,3,0,8,6,2,548,1,0,17,14,3,1207,4,0,3,0,3,3,1,4,0,0,0,0,0,0
8496,8496,Erik Nevland,2197,2007,Fulham FC,4,1,3,108,1,0,4,1,3,107,1,0,8,2,6,215,2,0,0,0,0,0,0,0,0,0,0,0,0,0
8497,8497,Richard Lee,3727,2006,Watford FC,5,5,0,450,0,0,3,2,1,224,0,0,8,7,1,674,0,0,0,0,0,0,0,0,0,0,0,0,0,0
8498,8498,Matthew Spring,3728,2006,Watford FC,4,1,3,164,0,0,2,1,1,96,0,0,6,2,4,260,0,0,0,0,0,0,0,0,0,0,0,0,0,0
8499,8499,Mikel Arteta,1802,2014,Arsenal FC,5,4,1,272,0,0,2,2,0,177,0,0,7,6,1,449,0,0,0,0,0,0,0,0,0,0,0,0,0,0
8500,8500,Emiliano Martínez,1482,2014,Arsenal FC,2,1,1,121,0,0,2,2,0,180,0,0,4,3,1,301,0,0,0,0,0,0,0,0,0,0,0,0,0,0
8501,8501,Lukas Podolski,3095,2014,Arsenal FC,3,0,3,36,0,0,4,0,4,63,0,0,7,0,7,99,0,0,0,0,0,0,0,0,0,0,0,0,0,0
8502,8502,Angel Gomes,3278,2019,Manchester United,1,0,1,10,0,0,1,0,1,9,0,0,2,0,2,19,0,0,0,0,0,0,0,0,0,0,0,0,0,0
8503,8503,Marcos Rojo,1651,2019,Manchester United,2,1,1,91,0,0,1,0,1,30,0,0,3,1,2,121,0,0,0,0,0,0,0,0,0,0,0,0,0,0
8504,8504,Axel Tuanzebe,3211,2019,Manchester United,2,1,1,91,0,0,3,1,2,96,0,0,5,2,3,187,0,0,0,0,0,0,0,0,0,0,0,0,0,0
8505,8505,Tahith Chong,3729,2019,Manchester United,2,0,2,30,0,0,1,0,1,4,0,0,3,0,3,34,0,0,0,0,0,0,0,0,0,0,0,0,0,0
8506,8506,Kléberson,3499,2003,Manchester United,9,8,1,633,2,0,3,2,1,157,0,0,12,10,2,790,2,0,0,0,0,1,0,1,0,0,0,0,0,0
8507,8507,Sheyi Ojo,3626,2014,Liverpool FC,0,0,0,0,0,0,0,0,0,0,0,0,0,0,0,0,0,0,0,0,0,0,0,0,0,0,0,0,0,0
8508,8508,Danny Simpson,2395,2014,Leicester City,5,5,0,439,0,0,9,8,1,746,0,0,14,13,1,1185,0,0,0,0,0,0,0,0,0,0,0,0,0,0
8509,8509,Dean Hammond,3575,2014,Leicester City,7,4,3,412,0,0,5,5,0,368,0,0,12,9,3,780,0,0,0,0,0,0,0,0,0,0,0,0,0,0
8510,8510,Adam Smith,1004,2014,Leicester City,0,0,0,0,0,0,0,0,0,0,0,0,0,0,0,0,0,0,0,0,0,0,0,0,0,0,0,0,0,0
8511,8511,Tom Lawrence,3730,2014,Leicester City,3,0,3,51,0,0,0,0,0,0,0,0,3,0,3,51,0,0,0,0,0,0,0,0,0,0,0,0,0,0
8512,8512,Jonathan Williams,3415,2013,Crystal Palace,4,0,4,76,0,0,5,0,5,104,0,0,9,0,9,180,0,0,0,0,0,0,0,0,0,0,0,0,0,0
8513,8513,Petr Čech,1531,2005,Chelsea FC,17,17,0,1486,0,0,17,17,0,1530,0,0,34,34,0,3016,0,0,0,0,0,0,0,0,0,0,0,0,0,0
8514,8514,Del Horno,3731,2005,Chelsea FC,14,14,0,1145,0,0,11,11,0,900,1,0,25,25,0,2045,1,0,0,0,0,0,1,1,0,0,0,0,0,0
8515,8515,John Terry,1534,2005,Chelsea FC,19,19,0,1710,3,0,17,17,0,1530,1,0,36,36,0,3240,4,0,6,0,6,2,1,3,0,0,0,0,0,0
8516,8516,Claude Makélélé,1762,2005,Chelsea FC,16,14,2,1194,0,0,15,15,0,1350,0,0,31,29,2,2544,0,0,0,0,0,0,0,0,0,0,0,0,0,0
8517,8517,Frank Lampard,1536,2005,Chelsea FC,19,19,0,1710,11,0,16,16,0,1440,5,0,35,35,0,3150,16,0,3,1,4,7,3,10,2,2,4,0,0,0
8518,8518,Hernán Crespo,2372,2005,Chelsea FC,16,12,4,938,5,0,14,8,6,743,5,0,30,20,10,1681,10,0,3,3,6,3,5,8,0,0,0,0,0,0
8519,8519,Eiður Guðjohnsen,2373,2005,Chelsea FC,14,7,7,697,2,0,12,9,3,852,0,0,26,16,10,1549,2,0,0,0,0,1,0,1,0,0,0,0,0,0
8520,8520,Roland Lamah,3732,2013,Swansea City,6,2,4,293,1,0,3,2,1,161,1,0,9,4,5,454,2,0,0,1,1,1,1,2,0,0,0,0,0,0
8521,8521,Gregor Zabret,3733,2013,Swansea City,0,0,0,0,0,0,0,0,0,0,0,0,0,0,0,0,0,0,0,0,0,0,0,0,0,0,0,0,0,0
8522,8522,Stuart Taylor,1684,2002,Arsenal FC,3,3,0,270,0,0,4,4,0,360,0,0,7,7,0,630,0,0,0,0,0,0,0,0,0,0,0,0,0,0
8523,8523,Pascal Cygan,3439,2002,Arsenal FC,6,6,0,540,1,0,11,9,2,799,0,0,17,15,2,1339,1,0,0,0,0,1,0,1,0,0,0,0,0,0
8524,8524,Freddie Ljungberg,1525,2002,Arsenal FC,9,8,1,673,1,0,9,9,0,752,5,0,18,17,1,1425,6,0,0,0,0,0,2,2,0,0,0,0,0,0
8525,8525,Kolo Touré,1415,2002,Arsenal FC,13,4,9,391,0,0,12,5,7,494,2,0,25,9,16,885,2,0,0,1,1,0,1,1,0,0,0,0,0,0
8526,8526,Steve Watson,2794,2002,Everton FC,9,9,0,787,1,0,9,5,4,544,4,0,18,14,4,1331,5,0,0,0,0,1,3,4,0,0,0,0,0,0
8527,8527,Scott Gemmill,3734,2002,Everton FC,8,4,4,401,0,0,8,6,2,535,0,0,16,10,6,936,0,0,0,0,0,0,0,0,0,0,0,0,0,0
8528,8528,Duncan Ferguson,1805,2002,Everton FC,3,0,3,105,0,0,4,0,4,77,0,0,7,0,7,182,0,0,0,0,0,0,0,0,0,0,0,0,0,0
8529,8529,Dean Marney,1253,2014,Burnley FC,11,11,0,946,0,0,9,9,0,742,0,0,20,20,0,1688,0,0,0,0,0,0,0,0,0,0,0,0,0,0
8530,8530,Kevin Long,2350,2014,Burnley FC,0,0,0,0,0,0,1,0,1,73,0,0,1,0,1,73,0,0,0,0,0,0,0,0,0,0,0,0,0,0
8531,8531,Zoltán Gera,1323,2011,West Bromwich Albion,2,2,0,112,0,0,1,1,0,63,0,0,3,3,0,175,0,0,0,0,0,0,0,0,0,0,0,0,0,0
8532,8532,Hugo Lloris,1160,2015,Tottenham Hotspur,19,19,0,1710,0,0,18,18,0,1620,0,0,37,37,0,3330,0,0,0,0,0,0,0,0,0,0,0,0,0,0
8533,8533,Kyle Walker,1196,2015,Tottenham Hotspur,17,17,0,1530,1,0,16,16,0,1413,0,0,33,33,0,2943,1,0,0,0,0,0,0,0,0,0,0,0,0,0
8534,8534,Toby Alderweireld,1147,2015,Tottenham Hotspur,19,19,0,1710,4,0,19,19,0,1710,0,0,38,38,0,3420,4,0,0,0,0,2,0,2,0,0,0,0,0,0
8535,8535,Jan Vertonghen,1161,2015,Tottenham Hotspur,15,15,0,1350,0,0,14,14,0,1245,0,0,29,29,0,2595,0,0,0,0,0,0,0,0,0,0,0,0,0,0
8536,8536,Eric Dier,1162,2015,Tottenham Hotspur,18,18,0,1605,3,0,19,19,0,1663,0,0,37,37,0,3268,3,0,0,0,0,3,0,3,0,0,0,0,0,0
8537,8537,Ben Davies,1164,2015,Tottenham Hotspur,8,6,2,560,0,0,9,8,1,728,0,0,17,14,3,1288,0,0,0,0,0,0,0,0,0,0,0,0,0,0
8538,8538,Ryan Mason,1166,2015,Tottenham Hotspur,11,4,7,390,0,0,11,4,7,410,1,0,22,8,14,800,1,0,0,3,3,0,1,1,0,0,0,0,0,0
8539,8539,Christian Eriksen,1165,2015,Tottenham Hotspur,18,17,1,1495,3,0,17,16,1,1446,3,0,35,33,2,2941,6,0,0,4,4,1,3,4,0,0,0,0,0,0
8540,8540,Heung-min Son,1859,2015,Tottenham Hotspur,14,6,8,530,2,0,14,7,7,576,2,0,28,13,15,1106,4,0,3,3,6,2,1,3,0,0,0,0,0,0
8541,8541,Harry Kane,1169,2015,Tottenham Hotspur,19,19,0,1675,10,0,19,19,0,1695,15,0,38,38,0,3370,25,0,0,1,1,4,9,13,2,3,5,0,0,0
8542,8542,Érik Lamela,1168,2015,Tottenham Hotspur,17,15,2,1280,2,0,17,13,4,1105,3,0,34,28,6,2385,5,0,0,0,0,0,1,1,0,0,0,0,0,0
8543,8543,Joshua Onomah,2800,2015,Tottenham Hotspur,5,0,5,30,0,0,3,0,3,47,0,0,8,0,8,77,0,0,0,0,0,0,0,0,0,0,0,0,0,0
8544,8544,Tom Carroll,2816,2015,Tottenham Hotspur,9,2,7,211,1,0,10,2,8,293,0,0,19,4,15,504,1,0,0,0,0,0,0,0,0,0,0,0,0,0
8545,8545,Nacer Chadli,1170,2015,Tottenham Hotspur,13,5,8,392,2,0,16,5,11,546,1,0,29,10,19,938,3,0,0,0,0,1,0,1,0,0,0,0,0,0
8546,8546,Michel Vorm,1174,2015,Tottenham Hotspur,0,0,0,0,0,0,1,1,0,90,0,0,1,1,0,90,0,0,0,0,0,0,0,0,0,0,0,0,0,0
8547,8547,Danny Rose,1399,2015,Tottenham Hotspur,13,13,0,1150,1,0,11,11,0,982,0,0,24,24,0,2132,1,0,3,0,3,1,0,1,0,0,0,0,0,0
8548,8548,Kevin Wimmer,1902,2015,Tottenham Hotspur,4,4,0,360,0,0,6,5,1,452,0,0,10,9,1,812,0,0,0,0,0,0,0,0,0,0,0,0,0,0
8549,8549,Clinton N'Jie,3735,2015,Tottenham Hotspur,5,0,5,143,0,0,3,0,3,41,0,0,8,0,8,184,0,0,0,0,0,0,0,0,0,0,0,0,0,0
8550,8550,Ruben Loftus-Cheek,1852,2014,Chelsea FC,2,1,1,61,0,0,1,1,0,73,0,0,3,2,1,134,0,0,0,0,0,0,0,0,0,0,0,0,0,0
8551,8551,Yaya Sanogo,3435,2014,Crystal Palace,6,2,4,155,0,0,4,1,3,161,0,0,10,3,7,316,0,0,0,0,0,0,0,0,0,0,0,0,0,0
8552,8552,Kasey Keller,1117,2002,Tottenham Hotspur,19,19,0,1710,0,0,19,19,0,1710,0,0,38,38,0,3420,0,0,0,0,0,0,0,0,0,0,0,0,0,0
8553,8553,Stephen Carr,1780,2002,Tottenham Hotspur,15,15,0,1350,0,0,15,15,0,1305,0,0,30,30,0,2655,0,0,0,0,0,0,0,0,0,0,0,0,0,0
8554,8554,Mauricio Taricco,1118,2002,Tottenham Hotspur,10,10,0,736,1,0,11,11,0,947,0,0,21,21,0,1683,1,0,0,0,0,1,0,1,0,0,0,0,0,0
8555,8555,Goran Bunjevčević,1937,2002,Tottenham Hotspur,17,14,3,1260,0,0,18,17,1,1488,0,0,35,31,4,2748,0,0,0,0,0,0,0,0,0,0,0,0,0,0
8556,8556,Ledley King,1119,2002,Tottenham Hotspur,13,13,0,1144,0,0,12,12,0,1080,0,0,25,25,0,2224,0,0,0,0,0,0,0,0,0,0,0,0,0,0
8557,8557,Anthony Gardner,1120,2002,Tottenham Hotspur,5,4,1,420,1,0,7,7,0,577,0,0,12,11,1,997,1,0,3,0,3,1,0,1,0,0,0,0,0,0
8558,8558,Gustavo Poyet,1128,2002,Tottenham Hotspur,15,13,2,1099,4,0,13,9,4,822,1,0,28,22,6,1921,5,0,3,0,3,3,0,3,0,0,0,0,0,0
8559,8559,Simon Davies,1125,2002,Tottenham Hotspur,19,16,3,1526,3,0,17,17,0,1530,2,0,36,33,3,3056,5,0,0,3,3,1,2,3,0,0,0,0,0,0
8560,8560,Teddy Sheringham,1076,2002,Tottenham Hotspur,18,17,1,1529,6,0,18,17,1,1443,6,0,36,34,2,2972,12,0,4,3,7,4,5,9,3,0,3,0,0,0
8561,8561,Darren Anderton,2082,2002,Tottenham Hotspur,10,10,0,824,0,0,10,8,2,753,0,0,20,18,2,1577,0,0,0,0,0,0,0,0,0,0,0,0,0,0
8562,8562,Robbie Keane,1126,2002,Tottenham Hotspur,15,15,0,1227,9,0,14,14,0,1234,4,0,29,29,0,2461,13,0,3,3,6,6,4,10,0,0,0,0,0,0
8563,8563,Chris Perry,1954,2002,Tottenham Hotspur,9,8,1,707,0,0,9,7,2,647,1,0,18,15,3,1354,1,0,0,0,0,0,1,1,0,0,0,0,0,0
8564,8564,Milenko Ačimovič,3736,2002,Tottenham Hotspur,7,2,5,293,0,0,10,2,8,207,0,0,17,4,13,500,0,0,0,0,0,0,0,0,0,0,0,0,0,0
8565,8565,Kazuyuki Toda,3737,2002,Tottenham Hotspur,3,1,2,144,0,0,1,1,0,45,0,0,4,2,2,189,0,0,0,0,0,0,0,0,0,0,0,0,0,0
8566,8566,David Sommeil,1806,2002,Manchester City,8,8,0,720,0,0,5,5,0,450,1,0,13,13,0,1170,1,0,0,0,0,0,1,1,0,0,0,0,0,0
8567,8567,Sylvain Distin,1015,2002,Manchester City,16,16,0,1440,0,0,16,16,0,1440,0,0,32,32,0,2880,0,0,0,0,0,0,0,0,0,0,0,0,0,0
8568,8568,Joey Barton,1876,2002,Manchester City,4,4,0,340,0,0,2,2,0,180,1,0,6,6,0,520,1,0,0,0,0,0,0,0,0,0,0,0,0,0
8569,8569,Robbie Fowler,2691,2002,Manchester City,7,6,1,511,2,0,5,5,0,370,0,0,12,11,1,881,2,0,3,0,3,1,0,1,0,0,0,0,0,0
8570,8570,Jon Macken,3125,2002,Manchester City,2,0,2,46,0,0,3,0,3,51,0,0,5,0,5,97,0,0,0,0,0,0,0,0,0,0,0,0,0,0
8571,8571,Danny Wilson,3738,2010,Liverpool FC,0,0,0,0,0,0,2,1,1,155,0,0,2,1,1,155,0,0,0,0,0,0,0,0,0,0,0,0,0,0
8572,8572,Alan Tate,2807,2012,Swansea City,2,1,1,72,0,0,1,1,0,90,0,0,3,2,1,162,0,0,0,0,0,0,0,0,0,0,0,0,0,0
8573,8573,Danny Graham,2317,2012,Swansea City,9,6,3,503,2,0,9,4,5,395,1,0,18,10,8,898,3,0,1,0,1,1,1,2,0,0,0,0,0,0
8574,8574,Djimi Traoré,2364,2000,Liverpool FC,4,4,0,360,0,0,3,3,0,245,0,0,7,7,0,605,0,0,0,0,0,0,0,0,0,0,0,0,0,0
8575,8575,Erik Meijer,3739,2000,Liverpool FC,2,0,2,30,0,0,1,0,1,10,0,0,3,0,3,40,0,0,0,0,0,0,0,0,0,0,0,0,0,0
8576,8576,Lewis Holtby,2815,2014,Tottenham Hotspur,0,0,0,0,0,0,1,0,1,29,0,0,1,0,1,29,0,0,0,0,0,0,0,0,0,0,0,0,0,0
8577,8577,Brad Friedel,1343,2014,Tottenham Hotspur,0,0,0,0,0,0,0,0,0,0,0,0,0,0,0,0,0,0,0,0,0,0,0,0,0,0,0,0,0,0
8578,8578,Steve Kabba,3740,2006,Watford FC,6,4,2,402,0,0,5,2,3,241,0,0,11,6,5,643,0,0,0,0,0,0,0,0,0,0,0,0,0,0
8579,8579,Gary Naysmith,1804,2006,Everton FC,8,4,4,405,1,0,7,6,1,539,0,0,15,10,5,944,1,0,0,0,0,0,0,0,0,0,0,0,0,0
8580,8580,Mikaël Silvestre,1106,2007,Manchester United,1,1,0,57,0,0,2,2,0,131,0,0,3,3,0,188,0,0,0,0,0,0,0,0,0,0,0,0,0,0
8581,8581,Wayne Rooney,1058,2007,Manchester United,13,12,1,1021,4,0,14,13,1,1165,8,0,27,25,2,2186,12,0,0,1,1,1,7,8,0,0,0,0,0,0
8582,8582,Jake Livermore,1657,2012,Tottenham Hotspur,7,2,5,213,0,0,4,2,2,204,0,0,11,4,7,417,0,0,0,0,0,0,0,0,0,0,0,0,0,0
8583,8583,Guy Demel,3093,2012,West Ham United,15,14,1,1162,0,0,16,14,2,1318,0,0,31,28,3,2480,0,0,0,0,0,0,0,0,0,0,0,0,0,0
8584,8584,Ricardo Vaz Tê,3416,2012,West Ham United,12,11,1,853,2,0,12,7,5,751,1,0,24,18,6,1604,3,0,0,0,0,1,0,1,0,0,0,0,0,0
8585,8585,Jack Collison,1285,2012,West Ham United,8,1,7,177,0,0,9,4,5,453,2,0,17,5,12,630,2,0,0,3,3,0,2,2,0,0,0,0,0,0
8586,8586,Matthew Taylor,1069,2012,West Ham United,15,7,8,767,1,0,13,7,6,605,0,0,28,14,14,1372,1,0,0,0,0,0,0,0,0,0,0,0,0,0
8587,8587,Stephen Henderson,2314,2012,West Ham United,0,0,0,0,0,0,0,0,0,0,0,0,0,0,0,0,0,0,0,0,0,0,0,0,0,0,0,0,0,0
8588,8588,James Tomkins,1281,2012,West Ham United,11,7,4,656,0,0,15,11,4,1074,1,0,26,18,8,1730,1,0,0,0,0,0,0,0,0,0,0,0,0,0
8589,8589,Wellington Paulista,3741,2012,West Ham United,0,0,0,0,0,0,0,0,0,0,0,0,0,0,0,0,0,0,0,0,0,0,0,0,0,0,0,0,0,0
8590,8590,Alex McCarthy,1032,2012,Reading FC,6,6,0,540,0,0,7,7,0,630,0,0,13,13,0,1170,0,0,0,0,0,0,0,0,0,0,0,0,0,0
8591,8591,Chris Gunter,2506,2012,Reading FC,11,11,0,990,0,0,9,9,0,800,0,0,20,20,0,1790,0,0,0,0,0,0,0,0,0,0,0,0,0,0
8592,8592,Kaspars Gorkšs,3742,2012,Reading FC,7,7,0,630,0,0,7,7,0,630,1,0,14,14,0,1260,1,0,0,0,0,0,1,1,0,0,0,0,0,0
8593,8593,Jem Karacan,3743,2012,Reading FC,11,11,0,857,0,0,10,10,0,750,1,0,21,21,0,1607,1,0,0,0,0,0,0,0,0,0,0,0,0,0
8594,8594,Danny Guthrie,2397,2012,Reading FC,11,10,1,818,0,0,10,9,1,800,1,0,21,19,2,1618,1,0,0,0,0,0,1,1,0,0,0,0,0,0
8595,8595,Nick Blackman,3744,2012,Reading FC,5,1,4,144,0,0,6,2,4,245,0,0,11,3,8,389,0,0,0,0,0,0,0,0,0,0,0,0,0,0
8596,8596,Daniel Carriço,3745,2012,Reading FC,2,1,1,79,0,0,1,0,1,9,0,0,3,1,2,88,0,0,0,0,0,0,0,0,0,0,0,0,0,0
8597,8597,Hope Akpan,3746,2012,Reading FC,5,4,1,251,0,0,4,2,2,220,0,0,9,6,3,471,0,0,0,0,0,0,0,0,0,0,0,0,0,0
8598,8598,El-Hadji Diouf,1719,2004,Bolton Wanderers,14,12,2,1110,4,0,12,10,2,852,5,0,26,22,4,1962,9,0,1,9,10,4,5,9,1,0,1,0,0,0
8599,8599,Steve Stone,1071,2004,Portsmouth FC,13,13,0,1053,2,0,10,9,1,826,1,0,23,22,1,1879,3,0,1,1,2,1,1,2,0,0,0,0,0,0
8600,8600,Calum Chambers,1470,2017,Arsenal FC,6,4,2,364,0,0,6,6,0,505,0,0,12,10,2,869,0,0,0,0,0,0,0,0,0,0,0,0,0,0
8601,8601,Mohamed Elneny,1865,2017,Arsenal FC,8,7,1,555,0,0,5,4,1,315,0,0,13,11,2,870,0,0,0,0,0,0,0,0,0,0,0,0,0,0
8602,8602,Clarence Acuña,3573,2001,Newcastle United,8,5,3,471,0,0,8,5,3,503,3,0,16,10,6,974,3,0,0,1,1,0,2,2,0,0,0,0,0,0
8603,8603,Rob Lee,3396,2001,Newcastle United,8,7,1,551,1,0,8,8,0,719,0,0,16,15,1,1270,1,0,0,0,0,1,0,1,0,0,0,0,0,0
8604,8604,Shola Ameobi,1950,2001,Newcastle United,7,3,4,242,0,0,8,1,7,110,0,0,15,4,11,352,0,0,0,0,0,0,0,0,0,0,0,0,0,0
8605,8605,Cameron Carter-Vickers,3747,2016,Tottenham Hotspur,0,0,0,0,0,0,0,0,0,0,0,0,0,0,0,0,0,0,0,0,0,0,0,0,0,0,0,0,0,0
8606,8606,Jason Brown,3748,2009,Blackburn Rovers,2,2,0,180,0,0,2,1,1,155,0,0,4,3,1,335,0,0,0,0,0,0,0,0,0,0,0,0,0,0
8607,8607,Martin Olsson,1372,2009,Blackburn Rovers,9,9,0,790,0,0,12,10,2,929,0,0,21,19,2,1719,0,0,0,0,0,0,0,0,0,0,0,0,0,0
8608,8608,Phil Jones,1650,2009,Blackburn Rovers,5,4,1,365,0,0,4,3,1,297,0,0,9,7,2,662,0,0,0,0,0,0,0,0,0,0,0,0,0,0
8609,8609,Fabio Borini,1777,2015,Sunderland AFC,15,12,3,1032,2,0,11,10,1,865,3,0,26,22,4,1897,5,0,1,0,1,2,1,3,0,1,1,0,0,0
8610,8610,Jonathan Spector,1288,2004,Manchester United,2,1,1,96,0,0,1,1,0,75,0,0,3,2,1,171,0,0,0,0,0,0,0,0,0,0,0,0,0,0
8611,8611,David Bellion,1944,2004,Manchester United,4,1,3,164,1,0,6,0,6,44,1,0,10,1,9,208,2,0,0,0,0,1,1,2,0,0,0,0,0,0
8612,8612,Steve Watson,2794,2004,Everton FC,11,5,6,546,0,0,14,7,7,639,0,0,25,12,13,1185,0,0,0,0,0,0,0,0,0,0,0,0,0,0
8613,8613,Ched Evans,3749,2008,Manchester City,6,1,5,136,1,0,8,1,7,174,0,0,14,2,12,310,1,0,0,0,0,0,0,0,0,0,0,0,0,0
8614,8614,Andrea Dossena,3629,2008,Liverpool FC,6,6,0,498,0,0,10,6,4,544,1,0,16,12,4,1042,1,0,0,0,0,0,0,0,0,0,0,0,0,0
8615,8615,Danny Graham,2317,2015,Sunderland AFC,3,1,2,145,0,0,7,3,4,213,0,0,10,4,6,358,0,0,0,0,0,0,0,0,0,0,0,0,0,0
8616,8616,Wes Brown,1108,2015,Sunderland AFC,3,3,0,270,0,0,3,3,0,270,0,0,6,6,0,540,0,0,0,0,0,0,0,0,0,0,0,0,0,0
8617,8617,Liam Bridcutt,2264,2015,Sunderland AFC,0,0,0,0,0,0,0,0,0,0,0,0,0,0,0,0,0,0,0,0,0,0,0,0,0,0,0,0,0,0
8618,8618,Nicky Hunt,1711,2007,Bolton Wanderers,7,6,1,543,0,0,7,6,1,566,0,0,14,12,2,1109,0,0,0,0,0,0,0,0,0,0,0,0,0,0
8619,8619,Gérald Cid,3750,2007,Bolton Wanderers,4,4,0,316,0,0,3,2,1,193,0,0,7,6,1,509,0,0,0,0,0,0,0,0,0,0,0,0,0,0
8620,8620,Kevin Nolan,2396,2007,Bolton Wanderers,15,15,0,1245,2,0,16,16,0,1350,3,0,31,31,0,2595,5,0,0,1,1,2,3,5,0,0,0,0,0,0
8621,8621,Mikel Alonso,3751,2007,Bolton Wanderers,4,2,2,201,0,0,3,2,1,158,0,0,7,4,3,359,0,0,0,0,0,0,0,0,0,0,0,0,0,0
8622,8622,Christian Wilhelmsson,3752,2007,Bolton Wanderers,6,0,6,158,0,0,2,0,2,75,0,0,8,0,8,233,0,0,0,0,0,0,0,0,0,0,0,0,0,0
8623,8623,Tom Craddock,3753,2007,Middlesbrough FC,1,0,1,8,0,0,2,1,1,88,0,0,3,1,2,96,0,0,0,0,0,0,0,0,0,0,0,0,0,0
8624,8624,Ľubomír Šatka,3754,2014,Newcastle United,0,0,0,0,0,0,0,0,0,0,0,0,0,0,0,0,0,0,0,0,0,0,0,0,0,0,0,0,0,0
8625,8625,Didier Domi,3755,2003,Leeds United,5,3,2,282,0,0,6,5,1,441,0,0,11,8,3,723,0,0,0,0,0,0,0,0,0,0,0,0,0,0
8626,8626,Frazer Richardson,2873,2003,Leeds United,2,1,1,90,0,0,2,1,1,94,0,0,4,2,2,184,0,0,0,0,0,0,0,0,0,0,0,0,0,0
8627,8627,Jóhann Guðmundsson,1256,2019,Burnley FC,7,3,4,376,1,0,5,3,2,245,0,0,12,6,6,621,1,0,0,0,0,0,0,0,0,0,0,0,0,0
8628,8628,Anthony Driscoll-Glennon,3756,2019,Burnley FC,0,0,0,0,0,0,0,0,0,0,0,0,0,0,0,0,0,0,0,0,0,0,0,0,0,0,0,0,0,0
8629,8629,Josh Benson,3757,2019,Burnley FC,0,0,0,0,0,0,0,0,0,0,0,0,0,0,0,0,0,0,0,0,0,0,0,0,0,0,0,0,0,0
8630,8630,Joel Mumbongo,3758,2019,Burnley FC,0,0,0,0,0,0,0,0,0,0,0,0,0,0,0,0,0,0,0,0,0,0,0,0,0,0,0,0,0,0
8631,8631,Tomáš Rosický,1509,2007,Arsenal FC,9,8,1,719,3,0,8,6,2,528,3,0,17,14,3,1247,6,0,0,0,0,0,0,0,0,0,0,0,0,0
8632,8632,Will Smallbone,3759,2019,Southampton FC,4,2,2,219,0,0,5,2,3,174,0,0,9,4,5,393,0,0,0,0,0,0,0,0,0,0,0,0,0,0
8633,8633,Izzy Brown,2659,2014,Chelsea FC,0,0,0,0,0,0,1,0,1,11,0,0,1,0,1,11,0,0,0,0,0,0,0,0,0,0,0,0,0,0
8634,8634,Jamal Blackman,3650,2014,Chelsea FC,0,0,0,0,0,0,0,0,0,0,0,0,0,0,0,0,0,0,0,0,0,0,0,0,0,0,0,0,0,0
8635,8635,Andreas Christensen,1854,2014,Chelsea FC,1,0,1,12,0,0,0,0,0,0,0,0,1,0,1,12,0,0,0,0,0,0,0,0,0,0,0,0,0,0
8636,8636,Dan Gosling,1005,2009,Everton FC,5,0,5,68,1,0,6,3,3,274,1,0,11,3,8,342,2,0,0,0,0,1,0,1,0,0,0,0,0,0
8637,8637,Vince Grella,3623,2009,Blackburn Rovers,9,7,2,692,0,0,6,3,3,282,0,0,15,10,5,974,0,0,0,0,0,0,0,0,0,0,0,0,0,0
8638,8638,Liam Miller,1224,2004,Manchester United,5,2,3,159,0,0,3,1,2,106,0,0,8,3,5,265,0,0,0,0,0,0,0,0,0,0,0,0,0,0
8639,8639,Ricardo Vaz Tê,3416,2004,Bolton Wanderers,5,0,5,107,0,0,2,1,1,82,0,0,7,1,6,189,0,0,0,0,0,0,0,0,0,0,0,0,0,0
8640,8640,Jerome Thomas,1736,2014,Crystal Palace,0,0,0,0,0,0,1,0,1,6,0,0,1,0,1,6,0,0,0,0,0,0,0,0,0,0,0,0,0,0
8641,8641,Daryl Janmaat,1929,2019,Watford FC,4,3,1,267,0,0,4,4,0,341,0,0,8,7,1,608,0,0,0,0,0,0,0,0,0,0,0,0,0,0
8642,8642,José Cholevas,1920,2019,Watford FC,8,5,3,486,0,0,6,6,0,538,0,0,14,11,3,1024,0,0,0,0,0,0,0,0,0,0,0,0,0,0
8643,8643,Domingos Quina,2094,2019,Watford FC,1,0,1,4,0,0,3,0,3,14,0,0,4,0,4,18,0,0,0,0,0,0,0,0,0,0,0,0,0,0
8644,8644,Míchel,3338,2009,Birmingham City,3,0,3,50,0,0,6,3,3,255,0,0,9,3,6,305,0,0,0,0,0,0,0,0,0,0,0,0,0,0
8645,8645,Robbie Keane,1126,2009,Tottenham Hotspur,9,8,1,576,5,0,10,6,4,511,1,0,19,14,5,1087,6,0,0,0,0,2,0,2,1,0,1,0,0,0
8646,8646,Alex Song,1233,2014,West Ham United,14,14,0,1188,0,0,14,11,3,1060,0,0,28,25,3,2248,0,0,0,0,0,0,0,0,0,0,0,0,0,0
8647,8647,Gary Naysmith,1804,2005,Everton FC,4,4,0,351,0,0,3,3,0,270,0,0,7,7,0,621,0,0,0,0,0,0,0,0,0,0,0,0,0,0
8648,8648,George McCartney,1340,2005,Sunderland AFC,5,5,0,450,0,0,8,8,0,642,0,0,13,13,0,1092,0,0,0,0,0,0,0,0,0,0,0,0,0,0
8649,8649,Rory Delap,1993,2005,Sunderland AFC,2,2,0,136,0,0,4,3,1,286,1,0,6,5,1,422,1,0,0,1,1,0,1,1,0,0,0,0,0,0
8650,8650,Grant Leadbitter,1219,2005,Sunderland AFC,4,3,1,315,0,0,8,6,2,516,0,0,12,9,3,831,0,0,0,0,0,0,0,0,0,0,0,0,0,0
8651,8651,Chris Brown,3760,2005,Sunderland AFC,6,5,1,480,1,0,7,5,2,429,0,0,13,10,3,909,1,0,0,0,0,0,0,0,0,0,0,0,0,0
8652,8652,Dan Smith,3761,2005,Sunderland AFC,1,0,1,28,0,0,2,1,1,63,0,0,3,1,2,91,0,0,0,0,0,0,0,0,0,0,0,0,0,0
8653,8653,Didier Zokora,2465,2008,Tottenham Hotspur,14,11,3,1015,0,0,14,12,2,955,0,0,28,23,5,1970,0,0,0,0,0,0,0,0,0,0,0,0,0,0
8654,8654,Darren Bent,1958,2008,Tottenham Hotspur,16,10,6,1045,3,0,16,11,5,1086,9,0,32,21,11,2131,12,0,3,4,7,1,6,7,1,0,1,0,0,0
8655,8655,Jamie O'Hara,2505,2008,Tottenham Hotspur,8,4,4,348,0,0,6,1,5,162,1,0,14,5,9,510,1,0,0,0,0,0,0,0,0,0,0,0,0,0
8656,8656,Wes Morgan,2446,2016,Leicester City,14,14,0,1260,1,0,13,13,0,1170,0,0,27,27,0,2430,1,0,0,0,0,0,0,0,0,0,0,0,0,0
8657,8657,Islam Slimani,2667,2016,Leicester City,14,8,6,814,6,0,9,5,4,464,1,0,23,13,10,1278,7,0,4,0,4,5,1,6,1,0,1,0,0,0
8658,8658,Ben Hamer,2520,2016,Leicester City,0,0,0,0,0,0,0,0,0,0,0,0,0,0,0,0,0,0,0,0,0,0,0,0,0,0,0,0,0,0
8659,8659,Luis Hernández,3762,2016,Leicester City,0,0,0,0,0,0,4,3,1,326,0,0,4,3,1,326,0,0,0,0,0,0,0,0,0,0,0,0,0,0
8660,8660,Matty James,2516,2016,Leicester City,1,0,1,1,0,0,0,0,0,0,0,0,1,0,1,1,0,0,0,0,0,0,0,0,0,0,0,0,0,0
8661,8661,Nick Barmby,2133,2008,Hull City,12,8,4,660,1,0,9,5,4,440,0,0,21,13,8,1100,1,0,0,0,0,1,0,1,0,0,0,0,0,0
8662,8662,Kasper Schmeichel,2435,2008,Manchester City,0,0,0,0,0,0,1,0,1,71,0,0,1,0,1,71,0,0,0,0,0,0,0,0,0,0,0,0,0,0
8663,8663,Morgan Schneiderlin,1051,2016,Everton FC,8,7,1,578,1,0,6,5,1,481,0,0,14,12,2,1059,1,0,0,0,0,0,0,0,0,0,0,0,0,0
8664,8664,Ademola Lookman,3116,2016,Everton FC,4,2,2,133,1,0,4,1,3,156,0,0,8,3,5,289,1,0,0,0,0,0,0,0,0,0,0,0,0,0
8665,8665,Andrea Ranocchia,3763,2016,Hull City,8,8,0,720,1,0,8,7,1,610,1,0,16,15,1,1330,2,0,3,0,3,1,0,1,0,0,0,0,0,0
8666,8666,Alfred N'Diaye,3764,2016,Hull City,8,8,0,669,1,0,7,7,0,608,0,0,15,15,0,1277,1,0,0,0,0,1,0,1,0,0,0,0,0,0
8667,8667,Lazar Marković,3249,2016,Hull City,5,5,0,402,2,0,7,7,0,610,0,0,12,12,0,1012,2,0,0,0,0,2,0,2,0,0,0,0,0,0
8668,8668,Kamil Grosicki,3765,2016,Hull City,8,6,2,616,0,0,7,6,1,529,0,0,15,12,3,1145,0,0,0,0,0,0,0,0,0,0,0,0,0,0
8669,8669,Richard Wright,2977,2000,Ipswich Town,17,17,0,1530,0,0,17,17,0,1530,0,0,34,34,0,3060,0,0,0,0,0,0,0,0,0,0,0,0,0,0
8670,8670,Titus Bramble,1411,2000,Ipswich Town,15,13,2,1213,1,0,9,9,0,810,0,0,24,22,2,2023,1,0,3,0,3,1,0,1,0,0,0,0,0,0
8671,8671,Fabian Wilnis,3320,2000,Ipswich Town,15,14,1,1111,1,0,12,11,1,982,1,0,27,25,2,2093,2,0,0,3,3,1,1,2,0,0,0,0,0,0
8672,8672,Mark Venus,3766,2000,Ipswich Town,14,13,1,1161,2,0,10,9,1,808,1,0,24,22,2,1969,3,0,0,0,0,0,1,1,0,0,0,0,0,0
8673,8673,John McGreal,2718,2000,Ipswich Town,14,12,2,1117,0,0,12,11,1,998,1,0,26,23,3,2115,1,0,0,0,0,0,1,1,0,0,0,0,0,0
8674,8674,Jamie Clapham,1513,2000,Ipswich Town,18,13,5,1229,1,0,15,13,2,1159,1,0,33,26,7,2388,2,0,0,0,0,0,0,0,0,0,0,0,0,0
8675,8675,Jim Magilton,2719,2000,Ipswich Town,16,16,0,1364,0,0,15,14,1,1287,1,0,31,30,1,2651,1,0,0,0,0,0,0,0,0,1,1,0,0,0
8676,8676,Matt Holland,1955,2000,Ipswich Town,19,19,0,1669,3,0,17,17,0,1530,0,0,36,36,0,3199,3,0,0,0,0,3,0,3,0,0,0,0,0,0
8677,8677,Jermaine Wright,2720,2000,Ipswich Town,19,18,1,1483,1,0,16,15,1,1234,1,0,35,33,2,2717,2,0,0,3,3,0,1,1,0,0,0,0,0,0
8678,8678,Mark Burchill,3767,2000,Ipswich Town,2,2,0,180,1,0,5,0,5,35,0,0,7,2,5,215,1,0,0,0,0,0,0,0,0,0,0,0,0,0
8679,8679,James Scowcroft,2649,2000,Ipswich Town,17,11,6,1098,3,0,14,9,5,898,1,0,31,20,11,1996,4,0,0,0,0,1,1,2,0,0,0,0,0,0
8680,8680,Nabil Abidallah,3768,2000,Ipswich Town,2,0,2,14,0,0,0,0,0,0,0,0,2,0,2,14,0,0,0,0,0,0,0,0,0,0,0,0,0,0
8681,8681,Martijn Reuser,2721,2000,Ipswich Town,14,6,8,640,4,0,11,7,4,616,2,0,25,13,12,1256,6,0,3,3,6,4,2,6,0,0,0,0,0,0
8682,8682,Alun Armstrong,2725,2000,Ipswich Town,11,8,3,813,4,0,10,7,3,672,3,0,21,15,6,1485,7,0,1,3,4,2,3,5,0,0,0,0,0,0
8683,8683,Stephen Hughes,3769,2000,Everton FC,11,9,2,805,0,0,7,7,0,546,0,0,18,16,2,1351,0,0,0,0,0,0,0,0,0,0,0,0,0,0
8684,8684,Francis Jeffers,2359,2000,Everton FC,6,5,1,472,3,0,5,5,0,429,3,0,11,10,1,901,6,0,0,3,3,3,3,6,0,0,0,0,0,0
8685,8685,Kevin McLeod,3770,2000,Everton FC,2,0,2,33,0,0,2,0,2,24,0,0,4,0,4,57,0,0,0,0,0,0,0,0,0,0,0,0,0,0
8686,8686,Phil Jevons,3771,2000,Everton FC,0,0,0,0,0,0,4,0,4,105,0,0,4,0,4,105,0,0,0,0,0,0,0,0,0,0,0,0,0,0
8687,8687,Phil Bardsley,1409,2007,Sunderland AFC,6,6,0,540,0,0,5,5,0,450,0,0,11,11,0,990,0,0,0,0,0,0,0,0,0,0,0,0,0,0
8688,8688,Kieran Richardson,1898,2007,Sunderland AFC,9,8,1,576,3,0,7,6,1,448,0,0,16,14,2,1024,3,0,0,0,0,2,0,2,0,0,0,0,0,0
8689,8689,Liam Shephard,3772,2014,Swansea City,0,0,0,0,0,0,0,0,0,0,0,0,0,0,0,0,0,0,0,0,0,0,0,0,0,0,0,0,0,0
8690,8690,Jay Fulton,3196,2014,Swansea City,1,0,1,24,0,0,1,1,0,90,0,0,2,1,1,114,0,0,0,0,0,0,0,0,0,0,0,0,0,0
8691,8691,Thomas Myhre,1951,2000,Everton FC,3,3,0,270,0,0,3,3,0,270,0,0,6,6,0,540,0,0,0,0,0,0,0,0,0,0,0,0,0,0
8692,8692,Niclas Alexandersson,3386,2000,Everton FC,9,6,3,531,1,0,10,10,0,726,1,0,19,16,3,1257,2,0,3,0,3,1,0,1,0,0,0,0,0,0
8693,8693,Scott Gemmill,3734,2000,Everton FC,15,13,2,1218,1,0,12,11,1,976,1,0,27,24,3,2194,2,0,0,0,0,1,1,2,0,0,0,0,0,0
8694,8694,Danny Cadamarteri,3773,2000,Everton FC,9,4,5,428,3,0,7,3,4,297,1,0,16,7,9,725,4,0,0,0,0,3,0,3,0,0,0,0,0,0
8695,8695,David Unsworth,2582,2000,Everton FC,15,8,7,897,2,0,13,8,5,786,3,0,28,16,12,1683,5,0,1,1,2,2,3,5,2,1,3,0,0,0
8696,8696,Duncan Ferguson,1805,2000,Everton FC,7,6,1,464,6,0,4,2,2,241,0,0,11,8,3,705,6,0,0,0,0,4,0,4,0,0,0,0,0,0
8697,8697,Cesc Fàbregas,1526,2008,Arsenal FC,12,12,0,1003,2,0,10,10,0,900,1,0,22,22,0,1903,3,0,0,1,1,1,1,2,0,0,0,0,0,0
8698,8698,Gareth Bale,1274,2008,Tottenham Hotspur,6,5,1,440,0,0,9,6,3,536,0,0,15,11,4,976,0,0,0,0,0,0,0,0,0,0,0,0,0,0
8699,8699,Michael Dawson,1267,2008,Tottenham Hotspur,8,7,1,592,1,0,7,5,2,464,0,0,15,12,3,1056,1,0,0,0,0,0,0,0,0,0,0,0,0,0
8700,8700,David Bentley,2011,2008,Tottenham Hotspur,12,9,3,848,0,0,13,11,2,980,1,0,25,20,5,1828,1,0,0,0,0,0,1,1,0,0,0,0,0,0
8701,8701,Sol Campbell,1388,2008,Portsmouth FC,16,16,0,1396,0,0,16,16,0,1440,0,0,32,32,0,2836,0,0,0,0,0,0,0,0,0,0,0,0,0,0
8702,8702,Niko Kranjčar,1276,2008,Portsmouth FC,11,7,4,755,2,0,10,9,1,788,1,0,21,16,5,1543,3,0,1,0,1,2,1,3,0,0,0,0,0,0
8703,8703,Hermann Hreiðarsson,1953,2008,Portsmouth FC,11,9,2,774,2,0,12,10,2,914,0,0,23,19,4,1688,2,0,0,0,0,1,0,1,0,0,0,0,0,0
8704,8704,Marc Wilson,1546,2008,Portsmouth FC,1,1,0,90,0,0,2,1,1,92,0,0,3,2,1,182,0,0,0,0,0,0,0,0,0,0,0,0,0,0
8705,8705,Guido Carrillo,3774,2017,Southampton FC,3,2,1,213,0,0,4,3,1,238,0,0,7,5,2,451,0,0,0,0,0,0,0,0,0,0,0,0,0,0
8706,8706,Wayne Quinn,3775,2000,Newcastle United,7,6,1,552,0,0,7,7,0,630,0,0,14,13,1,1182,0,0,0,0,0,0,0,0,0,0,0,0,0,0
8707,8707,Christian Bassedas,3776,2000,Newcastle United,11,10,1,802,0,0,9,5,4,505,1,0,20,15,5,1307,1,0,0,0,0,0,1,1,0,0,0,0,0,0
8708,8708,Kevin Gallacher,3777,2000,Newcastle United,9,7,2,605,1,0,9,4,5,424,1,0,18,11,7,1029,2,0,0,0,0,1,0,1,0,0,0,0,0,0
8709,8709,Steven Caldwell,2375,2000,Newcastle United,4,2,2,308,0,0,5,3,2,361,0,0,9,5,4,669,0,0,0,0,0,0,0,0,0,0,0,0,0,0
8710,8710,Clarence Acuña,3573,2000,Newcastle United,11,8,3,697,1,0,13,13,0,1116,2,0,24,21,3,1813,3,0,3,1,4,1,2,3,0,0,0,0,0,0
8711,8711,Lomana LuaLua,1074,2000,Newcastle United,10,1,9,263,0,0,11,2,9,319,0,0,21,3,18,582,0,0,0,0,0,0,0,0,0,0,0,0,0,0
8712,8712,Shaka Hislop,1064,2000,West Ham United,12,12,0,1035,0,0,13,13,0,1170,0,0,25,25,0,2205,0,0,0,0,0,0,0,0,0,0,0,0,0,0
8713,8713,Igor Štimac,3778,2000,West Ham United,5,5,0,367,0,0,9,9,0,795,0,0,14,14,0,1162,0,0,0,0,0,0,0,0,0,0,0,0,0,0
8714,8714,Ian Pearce,1082,2000,West Ham United,5,5,0,450,1,0,7,5,2,427,0,0,12,10,2,877,1,0,0,0,0,0,0,0,0,0,0,0,0,0
8715,8715,Kaba Diawara,3779,2000,West Ham United,4,2,2,237,0,0,7,4,3,385,0,0,11,6,5,622,0,0,0,0,0,0,0,0,0,0,0,0,0,0
8716,8716,Svetoslav Todorov,2967,2000,West Ham United,3,1,2,197,0,0,5,1,4,218,1,0,8,2,6,415,1,0,0,0,0,0,1,1,0,0,0,0,0,0
8717,8717,Paolo Vernazza,3780,2000,Arsenal FC,1,0,1,23,1,0,1,0,1,20,0,0,2,0,2,43,1,0,0,0,0,0,0,0,0,0,0,0,0,0
8718,8718,Marc Edworthy,2386,2000,Coventry City,10,10,0,900,1,0,11,7,4,803,0,0,21,17,4,1703,1,0,1,0,1,1,0,1,0,0,0,0,0,0
8719,8719,Carlton Palmer,3781,2000,Coventry City,8,5,3,542,0,0,7,7,0,630,0,0,15,12,3,1172,0,0,0,0,0,0,0,0,0,0,0,0,0,0
8720,8720,Cédric Roussel,3782,2000,Coventry City,7,6,1,464,0,0,8,3,5,389,2,0,15,9,6,853,2,0,0,3,3,0,1,1,0,0,0,0,0,0
8721,8721,Ysrael Zuñiga,3783,2000,Coventry City,9,5,4,461,1,0,6,2,4,209,0,0,15,7,8,670,1,0,0,0,0,0,0,0,0,0,0,0,0,0
8722,8722,Pavel Srníček,3784,2003,Portsmouth FC,1,1,0,90,0,0,2,2,0,180,0,0,3,3,0,270,0,0,0,0,0,0,0,0,0,0,0,0,0,0
8723,8723,Kevin Harper,3785,2003,Portsmouth FC,3,0,3,25,0,0,4,0,4,33,0,0,7,0,7,58,0,0,0,0,0,0,0,0,0,0,0,0,0,0
8724,8724,Ian Pearce,1082,2004,Fulham FC,4,4,0,315,0,0,6,6,0,460,0,0,10,10,0,775,0,0,0,0,0,0,0,0,0,0,0,0,0,0
8725,8725,Liam Rosenior,1756,2004,Fulham FC,8,7,1,644,0,0,7,7,0,629,0,0,15,14,1,1273,0,0,0,0,0,0,0,0,0,0,0,0,0,0
8726,8726,Sylvain Legwinski,1083,2004,Fulham FC,8,8,0,641,1,0,6,4,2,401,0,0,14,12,2,1042,1,0,0,0,0,1,0,1,0,0,0,0,0,0
8727,8727,Dean Ashton,2245,2008,West Ham United,2,2,0,140,2,0,2,2,0,109,0,0,4,4,0,249,2,0,0,0,0,1,0,1,0,0,0,0,0,0
8728,8728,Olivier Kapo,1963,2008,Wigan Athletic,8,4,4,330,0,0,11,6,5,562,1,0,19,10,9,892,1,0,0,0,0,0,1,1,0,0,0,0,0,0
8729,8729,Morata,3786,2017,Chelsea FC,17,13,4,1127,6,0,14,11,3,940,5,0,31,24,7,2067,11,0,3,0,3,4,3,7,0,0,0,0,0,0
8730,8730,Fikayo Tomori,3506,2017,Chelsea FC,0,0,0,0,0,0,0,0,0,0,0,0,0,0,0,0,0,0,0,0,0,0,0,0,0,0,0,0,0,0
8731,8731,Leighton Baines,1466,2017,Everton FC,11,11,0,990,1,0,11,11,0,921,1,0,22,22,0,1911,2,0,3,0,3,1,1,2,1,1,2,0,0,0
8732,8732,Sandro,2409,2017,Everton FC,5,2,3,176,0,0,3,1,2,100,0,0,8,3,5,276,0,0,0,0,0,0,0,0,0,0,0,0,0,0
8733,8733,Muhamed Bešić,2236,2017,Everton FC,0,0,0,0,0,0,2,0,2,45,0,0,2,0,2,45,0,0,0,0,0,0,0,0,0,0,0,0,0,0
8734,8734,Maarten Stekelenburg,1465,2017,Everton FC,0,0,0,0,0,0,0,0,0,0,0,0,0,0,0,0,0,0,0,0,0,0,0,0,0,0,0,0,0,0
8735,8735,Ademola Lookman,3116,2017,Everton FC,5,0,5,82,0,0,2,1,1,72,0,0,7,1,6,154,0,0,0,0,0,0,0,0,0,0,0,0,0,0
8736,8736,Micah Richards,1364,2009,Manchester City,10,8,2,642,1,0,12,10,2,915,1,0,22,18,4,1557,2,0,0,0,0,0,1,1,0,0,0,0,0,0
8737,8737,Robinho,3088,2009,Manchester City,5,4,1,339,0,0,5,2,3,232,0,0,10,6,4,571,0,0,0,0,0,0,0,0,0,0,0,0,0,0
8738,8738,Martin Petrov,2492,2009,Manchester City,8,5,3,444,3,0,7,3,4,273,1,0,15,8,7,717,4,0,0,1,1,2,1,3,0,0,0,0,0,0
8739,8739,Florent Laville,3787,2002,Bolton Wanderers,5,5,0,450,0,0,5,5,0,450,0,0,10,10,0,900,0,0,0,0,0,0,0,0,0,0,0,0,0,0
8740,8740,Fabricio Coloccini,2278,2013,Newcastle United,14,14,0,1260,0,0,13,13,0,1145,0,0,27,27,0,2405,0,0,0,0,0,0,0,0,0,0,0,0,0,0
8741,8741,José Angeliño,2414,2015,Manchester City,0,0,0,0,0,0,0,0,0,0,0,0,0,0,0,0,0,0,0,0,0,0,0,0,0,0,0,0,0,0
8742,8742,David James,1385,2003,Manchester City,9,9,0,810,0,0,7,7,0,630,0,0,16,16,0,1440,0,0,0,0,0,0,0,0,0,0,0,0,0,0
8743,8743,Graeme Le Saux,2615,2003,Southampton FC,11,11,0,864,0,0,8,8,0,702,0,0,19,19,0,1566,0,0,0,0,0,0,0,0,0,0,0,0,0,0
8744,8744,Yoann Folly,3368,2003,Southampton FC,3,3,0,270,0,0,5,5,0,450,0,0,8,8,0,720,0,0,0,0,0,0,0,0,0,0,0,0,0,0
8745,8745,Raimond van der Gouw,3788,2000,Manchester United,3,1,2,117,0,0,6,3,3,324,0,0,9,4,5,441,0,0,0,0,0,0,0,0,0,0,0,0,0,0
8746,8746,Carlo Cudicini,2370,2000,Chelsea FC,12,11,1,1035,0,0,12,12,0,1080,0,0,24,23,1,2115,0,0,0,0,0,0,0,0,0,0,0,0,0,0
8747,8747,Christian Panucci,3789,2000,Chelsea FC,3,3,0,270,0,0,4,3,1,297,0,0,7,6,1,567,0,0,0,0,0,0,0,0,0,0,0,0,0,0
8748,8748,Graeme Le Saux,2615,2000,Chelsea FC,10,8,2,694,0,0,10,10,0,871,0,0,20,18,2,1565,0,0,0,0,0,0,0,0,0,0,0,0,0,0
8749,8749,Roberto Di Matteo,3790,2000,Chelsea FC,3,3,0,270,0,0,4,4,0,360,0,0,7,7,0,630,0,0,0,0,0,0,0,0,0,0,0,0,0,0
8750,8750,Tore André Flo,3482,2000,Chelsea FC,7,1,6,231,1,0,6,3,3,386,2,0,13,4,9,617,3,0,0,1,1,0,1,1,0,0,0,0,0,0
8751,8751,Jimmy Floyd Hasselbaink,1337,2000,Chelsea FC,17,17,0,1452,15,0,17,17,0,1397,8,0,34,34,0,2849,23,0,6,4,10,8,6,14,4,0,4,0,0,0
8752,8752,Jordon Mutch,1024,2016,Crystal Palace,1,0,1,1,0,0,3,0,3,49,0,0,4,0,4,50,0,0,0,0,0,0,0,0,0,0,0,0,0,0
8753,8753,Tom Soares,1991,2004,Crystal Palace,9,7,2,659,0,0,13,9,4,894,0,0,22,16,6,1553,0,0,0,0,0,0,0,0,0,0,0,0,0,0
8754,8754,James Milner,1189,2019,Liverpool FC,12,5,7,560,1,0,10,4,6,366,1,0,22,9,13,926,2,0,3,0,3,1,0,1,1,1,2,0,0,0
8755,8755,Jan Bednarek,2478,2017,Southampton FC,2,2,0,180,1,0,3,3,0,248,0,0,5,5,0,428,1,0,0,0,0,0,0,0,0,0,0,0,0,0
8756,8756,Josh Sims,3141,2017,Southampton FC,2,1,1,83,0,0,4,0,4,77,0,0,6,1,5,160,0,0,0,0,0,0,0,0,0,0,0,0,0,0
8757,8757,Tyrone Mings,2772,2017,AFC Bournemouth,2,1,1,91,0,0,2,2,0,112,0,0,4,3,1,203,0,0,0,0,0,0,0,0,0,0,0,0,0,0
8758,8758,Gary Neville,1105,2002,Manchester United,10,7,3,646,0,0,13,9,4,907,0,0,23,16,7,1553,0,0,0,0,0,0,0,0,0,0,0,0,0,0
8759,8759,Wes Brown,1108,2002,Manchester United,9,9,0,810,0,0,10,10,0,773,0,0,19,19,0,1583,0,0,0,0,0,0,0,0,0,0,0,0,0,0
8760,8760,Alex Oxlade-Chamberlain,1184,2012,Arsenal FC,15,5,10,522,1,0,10,6,4,554,0,0,25,11,14,1076,1,0,0,0,0,1,0,1,0,0,0,0,0,0
8761,8761,Boaz Myhill,1663,2009,Hull City,13,13,0,1170,0,0,14,14,0,1260,0,0,27,27,0,2430,0,0,0,0,0,0,0,0,0,0,0,0,0,0
8762,8762,Dean Marney,1253,2009,Hull City,8,8,0,686,1,0,8,7,1,537,0,0,16,15,1,1223,1,0,0,0,0,0,0,0,0,0,0,0,0,0
8763,8763,Richard García,1632,2009,Hull City,9,6,3,462,0,0,9,8,1,640,0,0,18,14,4,1102,0,0,0,0,0,0,0,0,0,0,0,0,0,0
8764,8764,Bjørn Helge Riise,3294,2009,Fulham FC,5,1,4,136,0,0,7,4,3,272,0,0,12,5,7,408,0,0,0,0,0,0,0,0,0,0,0,0,0,0
8765,8765,DJ Campbell,2167,2005,Birmingham City,6,2,4,243,0,0,5,2,3,259,0,0,11,4,7,502,0,0,0,0,0,0,0,0,0,0,0,0,0,0
8766,8766,Johan Djourou,1229,2005,Arsenal FC,5,4,1,383,0,0,2,2,0,180,0,0,7,6,1,563,0,0,0,0,0,0,0,0,0,0,0,0,0,0
8767,8767,Sebastian Larsson,1402,2005,Arsenal FC,2,1,1,117,0,0,1,1,0,90,0,0,3,2,1,207,0,0,0,0,0,0,0,0,0,0,0,0,0,0
8768,8768,Darren Williams,1094,2002,Sunderland AFC,7,6,1,553,0,0,9,6,3,660,0,0,16,12,4,1213,0,0,0,0,0,0,0,0,0,0,0,0,0,0
8769,8769,Sean Thornton,3791,2002,Sunderland AFC,5,5,0,405,1,0,6,6,0,540,0,0,11,11,0,945,1,0,0,0,0,1,0,1,0,0,0,0,0,0
8770,8770,Christopher Black,3792,2002,Sunderland AFC,1,1,0,45,0,0,1,1,0,85,0,0,2,2,0,130,0,0,0,0,0,0,0,0,0,0,0,0,0,0
8771,8771,Kevin Kyle,1636,2002,Sunderland AFC,10,5,5,477,0,0,7,4,3,388,0,0,17,9,8,865,0,0,0,0,0,0,0,0,0,0,0,0,0,0
8772,8772,John Oster,2704,2002,Sunderland AFC,2,1,1,105,0,0,1,0,1,6,0,0,3,1,2,111,0,0,0,0,0,0,0,0,0,0,0,0,0,0
8773,8773,Richie Ryan,3793,2002,Sunderland AFC,2,0,2,59,0,0,0,0,0,0,0,0,2,0,2,59,0,0,0,0,0,0,0,0,0,0,0,0,0,0
8774,8774,Oleg Luzhniy,3244,2002,Arsenal FC,8,7,1,618,0,0,8,3,5,355,0,0,16,10,6,973,0,0,0,0,0,0,0,0,0,0,0,0,0,0
8775,8775,Igors Stepanovs,3330,2002,Arsenal FC,1,1,0,90,0,0,1,1,0,90,0,0,2,2,0,180,0,0,0,0,0,0,0,0,0,0,0,0,0,0
8776,8776,Jermaine Pennant,1514,2002,Arsenal FC,2,1,1,103,3,0,3,0,3,65,0,0,5,1,4,168,3,0,0,0,0,0,0,0,0,0,0,0,0,0
8777,8777,Ben Amos,2260,2010,Manchester United,0,0,0,0,0,0,0,0,0,0,0,0,0,0,0,0,0,0,0,0,0,0,0,0,0,0,0,0,0,0
8778,8778,Bebé,3794,2010,Manchester United,1,0,1,81,0,0,1,0,1,10,0,0,2,0,2,91,0,0,0,0,0,0,0,0,0,0,0,0,0,0
8779,8779,Ben Foster,1653,2009,Manchester United,4,4,0,360,0,0,4,4,0,360,0,0,8,8,0,720,0,0,0,0,0,0,0,0,0,0,0,0,0,0
8780,8780,Darron Gibson,2538,2009,Manchester United,8,2,6,283,0,0,7,4,3,307,2,0,15,6,9,590,2,0,0,0,0,0,0,0,0,0,0,0,0,0
8781,8781,Kyle Walker,1196,2013,Tottenham Hotspur,12,12,0,1038,1,0,14,14,0,1260,0,0,26,26,0,2298,1,0,0,0,0,1,0,1,0,0,0,0,0,0
8782,8782,Jan Vertonghen,1161,2013,Tottenham Hotspur,11,11,0,990,0,0,12,12,0,1014,0,0,23,23,0,2004,0,0,0,0,0,0,0,0,0,0,0,0,0,0
8783,8783,Andros Townsend,1176,2013,Tottenham Hotspur,14,8,6,784,0,0,11,4,7,442,1,0,25,12,13,1226,1,0,0,0,0,0,1,1,0,0,0,0,0,0
8784,8784,Mousa Dembélé,1172,2013,Tottenham Hotspur,15,13,2,1043,1,0,13,9,4,776,0,0,28,22,6,1819,1,0,0,0,0,0,0,0,0,0,0,0,0,0
8785,8785,Jermain Defoe,1127,2013,Tottenham Hotspur,8,1,7,208,1,0,6,2,4,217,0,0,14,3,11,425,1,0,0,0,0,0,0,0,0,0,0,0,0,0
8786,8786,Érik Lamela,1168,2013,Tottenham Hotspur,4,0,4,64,0,0,5,3,2,263,0,0,9,3,6,327,0,0,0,0,0,0,0,0,0,0,0,0,0,0
8787,8787,Robbie Brady,2230,2013,Hull City,9,6,3,485,2,0,7,5,2,408,1,0,16,11,5,893,3,0,6,0,6,2,1,3,2,0,2,0,0,0
8788,8788,Aaron McLean,3795,2013,Hull City,0,0,0,0,0,0,1,0,1,6,0,0,1,0,1,6,0,0,0,0,0,0,0,0,0,0,0,0,0,0
8789,8789,Nick Proschwitz,3796,2013,Hull City,1,0,1,20,0,0,1,0,1,3,0,0,2,0,2,23,0,0,0,0,0,0,0,0,0,0,0,0,0,0
8790,8790,Gedo,3797,2013,Hull City,1,0,1,12,0,0,1,0,1,16,0,0,2,0,2,28,0,0,0,0,0,0,0,0,0,0,0,0,0,0
8791,8791,Varela,3798,2014,West Bromwich Albion,3,2,1,182,0,0,4,1,3,151,1,0,7,3,4,333,1,0,0,0,0,0,0,0,0,0,0,0,0,0
8792,8792,Joe Lolley,3799,2017,Huddersfield Town,4,1,3,131,1,0,2,1,1,88,0,0,6,2,4,219,1,0,0,0,0,1,0,1,0,0,0,0,0,0
8793,8793,Michael Hefele,3800,2017,Huddersfield Town,1,0,1,1,0,0,1,0,1,31,0,0,2,0,2,32,0,0,0,0,0,0,0,0,0,0,0,0,0,0
8794,8794,Dean Marney,1253,2017,Burnley FC,0,0,0,0,0,0,0,0,0,0,0,0,0,0,0,0,0,0,0,0,0,0,0,0,0,0,0,0,0,0
8795,8795,Jon Walters,1555,2017,Burnley FC,1,0,1,12,0,0,2,0,2,24,0,0,3,0,3,36,0,0,0,0,0,0,0,0,0,0,0,0,0,0
8796,8796,Andy Carroll,1779,2014,West Ham United,7,6,1,535,4,0,7,6,1,492,1,0,14,12,2,1027,5,0,0,0,0,4,1,5,0,0,0,0,0,0
8797,8797,Chuba Akpom,3801,2014,Arsenal FC,1,0,1,20,0,0,2,0,2,7,0,0,3,0,3,27,0,0,0,0,0,0,0,0,0,0,0,0,0,0
8798,8798,Michael Carrick,1627,2017,Manchester United,1,1,0,85,0,0,1,0,1,24,0,0,2,1,1,109,0,0,0,0,0,0,0,0,0,0,0,0,0,0
8799,8799,Emerson,3166,2017,Chelsea FC,1,0,1,7,0,0,4,3,1,272,0,0,5,3,2,279,0,0,0,0,0,0,0,0,0,0,0,0,0,0
8800,8800,Alen Bokšić,2699,2000,Middlesbrough FC,14,13,1,1146,3,0,14,13,1,1035,9,0,28,26,2,2181,12,0,1,0,1,2,5,7,1,1,2,0,0,0
8801,8801,Mark Hudson,2970,2000,Middlesbrough FC,3,0,3,46,0,0,0,0,0,0,0,0,3,0,3,46,0,0,0,0,0,0,0,0,0,0,0,0,0,0
8802,8802,Robert Green,1277,2010,West Ham United,19,19,0,1710,0,0,18,18,0,1620,0,0,37,37,0,3330,0,0,0,0,0,0,0,0,0,0,0,0,0,0
8803,8803,Tal Ben Haim,1715,2010,West Ham United,3,3,0,270,0,0,5,5,0,443,0,0,8,8,0,713,0,0,0,0,0,0,0,0,0,0,0,0,0,0
8804,8804,James Tomkins,1281,2010,West Ham United,8,8,0,685,1,0,11,10,1,898,0,0,19,18,1,1583,1,0,0,0,0,0,0,0,0,0,0,0,0,0
8805,8805,Matthew Upson,1279,2010,West Ham United,17,17,0,1413,0,0,13,13,0,1062,0,0,30,30,0,2475,0,0,0,0,0,0,0,0,0,0,0,0,0,0
8806,8806,Jonathan Spector,1288,2010,West Ham United,5,3,2,334,0,0,9,7,2,594,1,0,14,10,4,928,1,0,0,0,0,0,1,1,0,0,0,0,0,0
8807,8807,Scott Parker,1282,2010,West Ham United,16,15,1,1372,4,0,16,15,1,1365,1,0,32,30,2,2737,5,0,0,0,0,2,1,3,0,0,0,0,0,0
8808,8808,Julien Faubert,1283,2010,West Ham United,4,4,0,360,0,0,5,3,2,252,0,0,9,7,2,612,0,0,0,0,0,0,0,0,0,0,0,0,0,0
8809,8809,Junior Stanislas,1009,2010,West Ham United,3,3,0,225,0,0,3,1,2,124,1,0,6,4,2,349,1,0,0,1,1,0,1,1,0,0,0,0,0,0
8810,8810,Pablo Barrera,3802,2010,West Ham United,9,5,4,567,0,0,5,1,4,175,0,0,14,6,8,742,0,0,0,0,0,0,0,0,0,0,0,0,0,0
8811,8811,Frédéric Piquionne,3334,2010,West Ham United,17,14,3,1172,3,0,17,12,5,1082,3,0,34,26,8,2254,6,0,4,0,4,3,3,6,1,0,1,0,0,0
8812,8812,Victor Obinna,3803,2010,West Ham United,14,10,4,922,1,0,11,7,4,651,2,0,25,17,8,1573,3,0,0,0,0,0,1,1,0,0,0,0,0,0
8813,8813,Kieron Dyer,2033,2010,West Ham United,6,4,2,296,0,0,5,4,1,311,0,0,11,8,3,607,0,0,0,0,0,0,0,0,0,0,0,0,0,0
8814,8814,Carlton Cole,2326,2010,West Ham United,18,10,8,1024,2,0,17,11,6,1092,3,0,35,21,14,2116,5,0,0,0,0,1,1,2,0,0,0,0,0,0
8815,8815,Zavon Hines,3804,2010,West Ham United,5,2,3,190,0,0,4,2,2,212,0,0,9,4,5,402,0,0,0,0,0,0,0,0,0,0,0,0,0,0
8816,8816,Marek Štěch,3805,2010,West Ham United,0,0,0,0,0,0,0,0,0,0,0,0,0,0,0,0,0,0,0,0,0,0,0,0,0,0,0,0,0,0
8817,8817,Winston Reid,2638,2010,West Ham United,3,1,2,166,0,0,4,2,2,238,0,0,7,3,4,404,0,0,0,0,0,0,0,0,0,0,0,0,0,0
8818,8818,Radoslav Kováč,1278,2010,West Ham United,6,3,3,314,0,0,7,4,3,317,0,0,13,7,6,631,0,0,0,0,0,0,0,0,0,0,0,0,0,0
8819,8819,Boa Morte,1085,2010,West Ham United,9,8,1,626,0,0,13,11,2,881,0,0,22,19,3,1507,0,0,0,0,0,0,0,0,0,0,0,0,0,0
8820,8820,Micah Richards,1364,2010,Manchester City,8,7,1,636,0,0,10,9,1,765,1,0,18,16,2,1401,1,0,0,0,0,0,1,1,0,0,0,0,0,0
8821,8821,James Chester,2223,2019,Aston Villa,0,0,0,0,0,0,0,0,0,0,0,0,0,0,0,0,0,0,0,0,0,0,0,0,0,0,0,0,0,0
8822,8822,Jordan Ayew,1869,2016,Swansea City,7,5,2,470,1,0,7,4,3,394,0,0,14,9,5,864,1,0,0,0,0,1,0,1,0,0,0,0,0,0
8823,8823,Connor Roberts,3806,2016,Swansea City,0,0,0,0,0,0,0,0,0,0,0,0,0,0,0,0,0,0,0,0,0,0,0,0,0,0,0,0,0,0
8824,8824,Martin Taylor,1345,2003,Blackburn Rovers,6,6,0,540,0,0,5,4,1,366,0,0,11,10,1,906,0,0,0,0,0,0,0,0,0,0,0,0,0,0
8825,8825,Dino Baggio,3807,2003,Blackburn Rovers,4,0,4,78,0,0,5,0,5,88,1,0,9,0,9,166,1,0,0,0,0,0,0,0,0,0,0,0,0,0
8826,8826,Adama Diakhaby,3808,2018,Huddersfield Town,8,4,4,347,0,0,4,2,2,206,0,0,12,6,6,553,0,0,0,0,0,0,0,0,0,0,0,0,0,0
8827,8827,Matt Heath,3809,2003,Leicester City,6,6,0,540,0,0,7,7,0,618,0,0,13,13,0,1158,0,0,0,0,0,0,0,0,0,0,0,0,0,0
8828,8828,Nikolaos Dabizas,2161,2003,Leicester City,9,9,0,800,0,0,9,9,0,810,0,0,18,18,0,1610,0,0,0,0,0,0,0,0,0,0,0,0,0,0
8829,8829,Billy McKinlay,2837,2003,Leicester City,7,7,0,564,0,0,9,8,1,702,0,0,16,15,1,1266,0,0,0,0,0,0,0,0,0,0,0,0,0,0
8830,8830,Paul Brooker,3810,2003,Leicester City,1,0,1,22,0,0,2,0,2,32,0,0,3,0,3,54,0,0,0,0,0,0,0,0,0,0,0,0,0,0
8831,8831,Trevor Benjamin,1314,2003,Leicester City,2,1,1,46,0,0,2,1,1,85,0,0,4,2,2,131,0,0,0,0,0,0,0,0,0,0,0,0,0,0
8832,8832,José Enrique,2394,2012,Liverpool FC,14,12,2,1120,2,0,15,13,2,1136,0,0,29,25,4,2256,2,0,0,0,0,0,0,0,0,0,0,0,0,0
8833,8833,Coutinho,1425,2012,Liverpool FC,7,6,1,433,2,0,6,6,0,500,1,0,13,12,1,933,3,0,3,0,3,1,0,1,0,0,0,0,0,0
8834,8834,Péter Gulácsi,3527,2012,Liverpool FC,0,0,0,0,0,0,0,0,0,0,0,0,0,0,0,0,0,0,0,0,0,0,0,0,0,0,0,0,0,0
8835,8835,Suso,3811,2012,Liverpool FC,8,5,3,396,0,0,6,3,3,206,0,0,14,8,6,602,0,0,0,0,0,0,0,0,0,0,0,0,0,0
8836,8836,Jordon Ibe,1042,2012,Liverpool FC,1,1,0,64,0,0,0,0,0,0,0,0,1,1,0,64,0,0,0,0,0,0,0,0,0,0,0,0,0,0
8837,8837,Florent Laville,3787,2003,Bolton Wanderers,3,3,0,207,0,0,2,2,0,180,0,0,5,5,0,387,0,0,0,0,0,0,0,0,0,0,0,0,0,0
8838,8838,Lorenzo Amoruso,3812,2003,Blackburn Rovers,6,6,0,540,2,0,6,5,1,451,1,0,12,11,1,991,3,0,0,0,0,2,1,3,0,0,0,0,0,0
8839,8839,David Thompson,2102,2003,Blackburn Rovers,5,4,1,349,1,0,6,6,0,521,0,0,11,10,1,870,1,0,0,0,0,0,0,0,0,0,0,0,0,0
8840,8840,Corrado Grabbi,1457,2003,Blackburn Rovers,3,0,3,45,0,0,2,0,2,32,0,0,5,0,5,77,0,0,0,0,0,0,0,0,0,0,0,0,0,0
8841,8841,Federico Macheda,2019,2009,Manchester United,3,0,3,56,1,0,2,1,1,71,0,0,5,1,4,127,1,0,0,0,0,0,0,0,0,0,0,0,0,0
8842,8842,Ben Thatcher,1807,2004,Manchester City,10,9,1,825,0,0,7,7,0,630,0,0,17,16,1,1455,0,0,0,0,0,0,0,0,0,0,0,0,0,0
8843,8843,Martin Cranie,3103,2004,Southampton FC,1,1,0,90,0,0,2,2,0,180,0,0,3,3,0,270,0,0,0,0,0,0,0,0,0,0,0,0,0,0
8844,8844,Matt Oakley,1573,2004,Southampton FC,2,2,0,151,1,0,5,4,1,268,0,0,7,6,1,419,1,0,0,0,0,1,0,1,0,0,0,0,0,0
8845,8845,Neil McCann,2916,2004,Southampton FC,4,1,3,189,0,0,6,4,2,380,0,0,10,5,5,569,0,0,0,0,0,0,0,0,0,0,0,0,0,0
8846,8846,Paulinho,3536,2014,Tottenham Hotspur,8,0,8,141,0,0,7,3,4,338,0,0,15,3,12,479,0,0,0,0,0,0,0,0,0,0,0,0,0,0
8847,8847,Max Kilman,2185,2018,Wolverhampton Wanderers,1,0,1,1,0,0,0,0,0,0,0,0,1,0,1,1,0,0,0,0,0,0,0,0,0,0,0,0,0,0
8848,8848,Jlloyd Samuel,1789,2009,Bolton Wanderers,7,7,0,630,0,0,6,5,1,443,0,0,13,12,1,1073,0,0,0,0,0,0,0,0,0,0,0,0,0,0
8849,8849,Sean Davis,1087,2009,Bolton Wanderers,2,2,0,180,0,0,1,1,0,90,0,0,3,3,0,270,0,0,0,0,0,0,0,0,0,0,0,0,0,0
8850,8850,Riga Mustapha,2727,2009,Bolton Wanderers,1,0,1,1,0,0,0,0,0,0,0,0,1,0,1,1,0,0,0,0,0,0,0,0,0,0,0,0,0,0
8851,8851,Andriy Voronin,2746,2009,Liverpool FC,4,0,4,66,0,0,4,1,3,135,0,0,8,1,7,201,0,0,0,0,0,0,0,0,0,0,0,0,0,0
8852,8852,Nicolas Anelka,1720,2013,West Bromwich Albion,6,6,0,476,0,0,6,5,1,379,2,0,12,11,1,855,2,0,0,0,0,0,2,2,0,0,0,0,0,0
8853,8853,Jesper Blomqvist,3813,2002,Charlton Athletic,1,0,1,23,0,0,2,0,2,30,0,0,3,0,3,53,0,0,0,0,0,0,0,0,0,0,0,0,0,0
8854,8854,Edu,1529,2002,Arsenal FC,9,6,3,540,1,0,9,6,3,462,1,0,18,12,6,1002,2,0,0,0,0,1,0,1,0,0,0,0,0,0
8855,8855,Vincent Kompany,1414,2015,Manchester City,6,5,1,478,1,0,8,8,0,720,1,0,14,13,1,1198,2,0,0,0,0,0,0,0,0,0,0,0,0,0
8856,8856,Miguel Layún,3814,2015,Watford FC,1,1,0,55,0,0,2,1,1,77,1,0,3,2,1,132,1,0,0,0,0,0,1,1,0,0,0,0,0,0
8857,8857,Tommie Hoban,3815,2015,Watford FC,0,0,0,0,0,0,0,0,0,0,0,0,0,0,0,0,0,0,0,0,0,0,0,0,0,0,0,0,0,0
8858,8858,Matěj Vydra,2302,2015,Watford FC,0,0,0,0,0,0,0,0,0,0,0,0,0,0,0,0,0,0,0,0,0,0,0,0,0,0,0,0,0,0
8859,8859,Alessandro Diamanti,1287,2015,Watford FC,2,0,2,50,0,0,1,0,1,14,0,0,3,0,3,64,0,0,0,0,0,0,0,0,0,0,0,0,0,0
8860,8860,Arouna Koné,2237,2016,Everton FC,4,0,4,64,0,0,2,0,2,8,0,0,6,0,6,72,0,0,0,0,0,0,0,0,0,0,0,0,0,0
8861,8861,Matthew Pennington,3647,2016,Everton FC,1,1,0,90,0,0,2,1,1,90,1,0,3,2,1,180,1,0,0,0,0,0,1,1,0,0,0,0,0,0
8862,8862,Jonjoe Kenny,1050,2016,Everton FC,0,0,0,0,0,0,1,0,1,12,0,0,1,0,1,12,0,0,0,0,0,0,0,0,0,0,0,0,0,0
8863,8863,Ethan Robson,3816,2016,Sunderland AFC,0,0,0,0,0,0,0,0,0,0,0,0,0,0,0,0,0,0,0,0,0,0,0,0,0,0,0,0,0,0
8864,8864,Gomes,1266,2016,Watford FC,19,19,0,1686,0,0,19,19,0,1653,0,0,38,38,0,3339,0,0,0,0,0,0,0,0,0,0,0,0,0,0
8865,8865,Miguel Britos,1930,2016,Watford FC,13,13,0,1099,1,0,14,14,0,1211,0,0,27,27,0,2310,1,0,3,0,3,1,0,1,0,0,0,0,0,0
8866,8866,Younès Kaboul,2408,2016,Watford FC,12,12,0,945,1,0,10,10,0,880,1,0,22,22,0,1825,2,0,0,0,0,0,1,1,0,0,0,0,0,0
8867,8867,Sebastian Prödl,2366,2016,Watford FC,16,16,0,1392,1,0,17,16,1,1380,0,0,33,32,1,2772,1,0,0,0,0,1,0,1,0,0,0,0,0,0
8868,8868,Juan Zúñiga,3817,2016,Watford FC,9,3,6,374,1,0,12,3,9,444,0,0,21,6,15,818,1,0,0,0,0,1,0,1,0,0,0,0,0,0
8869,8869,José Cholevas,1920,2016,Watford FC,17,17,0,1473,0,0,16,16,0,1437,2,0,33,33,0,2910,2,0,0,3,3,0,1,1,0,0,0,0,0,0
8870,8870,Valon Behrami,1284,2016,Watford FC,15,14,1,1147,0,0,12,12,0,891,0,0,27,26,1,2038,0,0,0,0,0,0,0,0,0,0,0,0,0,0
8871,8871,Étienne Capoue,1924,2016,Watford FC,19,19,0,1637,4,0,18,18,0,1576,3,0,37,37,0,3213,7,0,3,0,3,4,3,7,0,0,0,0,0,0
8872,8872,Nordin Amrabat,3015,2016,Watford FC,15,14,1,1131,0,0,14,11,3,970,0,0,29,25,4,2101,0,0,0,0,0,0,0,0,0,0,0,0,0,0
8873,8873,Troy Deeney,1928,2016,Watford FC,18,16,2,1547,7,0,19,15,4,1395,3,0,37,31,6,2942,10,0,1,0,1,5,2,7,3,0,3,0,0,0
8874,8874,Odion Ighalo,2990,2016,Watford FC,8,7,1,632,0,0,10,7,3,659,1,0,18,14,4,1291,1,0,0,0,0,0,0,0,0,0,0,0,0,0
8875,8875,Daryl Janmaat,1929,2016,Watford FC,14,8,6,687,0,0,13,10,3,927,2,0,27,18,9,1614,2,0,0,0,0,0,0,0,0,0,0,0,0,0
8876,8876,Christian Kabasele,1921,2016,Watford FC,8,2,6,323,0,0,8,5,3,444,2,0,16,7,9,767,2,0,0,0,0,0,1,1,0,0,0,0,0,0
8877,8877,Isaac Success,2331,2016,Watford FC,9,0,9,148,1,0,10,2,8,356,0,0,19,2,17,504,1,0,1,0,1,1,0,1,0,0,0,0,0,0
8878,8878,Costel Pantilimon,1354,2016,Watford FC,1,0,1,24,0,0,1,0,1,57,0,0,2,0,2,81,0,0,0,0,0,0,0,0,0,0,0,0,0,0
8879,8879,Craig Cathcart,1918,2016,Watford FC,7,6,1,578,0,0,8,7,1,584,0,0,15,13,2,1162,0,0,0,0,0,0,0,0,0,0,0,0,0,0
8880,8880,Adlène Guédioura,3130,2016,Watford FC,7,5,2,389,0,0,5,4,1,334,0,0,12,9,3,723,0,0,0,0,0,0,0,0,0,0,0,0,0,0
8881,8881,Jerome Sinclair,1931,2016,Watford FC,2,0,2,20,0,0,3,1,2,94,0,0,5,1,4,114,0,0,0,0,0,0,0,0,0,0,0,0,0,0
8882,8882,Mamadou Sakho,2250,2016,Crystal Palace,5,5,0,417,0,0,3,3,0,270,0,0,8,8,0,687,0,0,0,0,0,0,0,0,0,0,0,0,0,0
8883,8883,Matt Macey,2858,2016,Arsenal FC,0,0,0,0,0,0,0,0,0,0,0,0,0,0,0,0,0,0,0,0,0,0,0,0,0,0,0,0,0,0
8884,8884,Per Mertesacker,1496,2016,Arsenal FC,1,0,1,37,0,0,0,0,0,0,0,0,1,0,1,37,0,0,0,0,0,0,0,0,0,0,0,0,0,0
8885,8885,Grétar Steinsson,2410,2011,Bolton Wanderers,10,9,1,785,1,0,13,11,2,1097,0,0,23,20,3,1882,1,0,0,0,0,0,0,0,0,0,0,0,0,0
8886,8886,Tuncay Şanlı,2220,2011,Bolton Wanderers,11,2,9,239,0,0,5,1,4,145,0,0,16,3,13,384,0,0,0,0,0,0,0,0,0,0,0,0,0,0
8887,8887,Fabrice Muamba,1964,2011,Bolton Wanderers,8,7,1,548,0,0,12,11,1,781,1,0,20,18,2,1329,1,0,0,0,0,0,0,0,0,0,0,0,0,0
8888,8888,Darren Pratley,3818,2011,Bolton Wanderers,12,7,5,632,1,0,13,7,6,641,0,0,25,14,11,1273,1,0,0,0,0,1,0,1,0,0,0,0,0,0
8889,8889,Łukasz Fabiański,1227,2008,Arsenal FC,2,1,1,102,0,0,4,4,0,360,0,0,6,5,1,462,0,0,0,0,0,0,0,0,0,0,0,0,0,0
8890,8890,Kieran Gibbs,1508,2008,Arsenal FC,4,3,1,276,0,0,4,3,1,259,0,0,8,6,2,535,0,0,0,0,0,0,0,0,0,0,0,0,0,0
8891,8891,Diego Tristán,3819,2008,West Ham United,8,3,5,326,1,0,6,5,1,403,2,0,14,8,6,729,3,0,3,4,7,1,2,3,0,0,0,0,0,0
8892,8892,Wayne Bridge,1768,2010,West Ham United,8,8,0,719,0,0,7,7,0,630,0,0,15,15,0,1349,0,0,0,0,0,0,0,0,0,0,0,0,0,0
8893,8893,Mark Noble,2204,2010,West Ham United,13,12,1,1023,3,0,13,13,0,1120,1,0,26,25,1,2143,4,0,0,1,1,1,1,2,3,1,4,0,0,0
8894,8894,Freddie Sears,2246,2010,West Ham United,6,5,1,401,1,0,5,4,1,361,0,0,11,9,2,762,1,0,0,0,0,0,0,0,0,0,0,0,0,0
8895,8895,Frank Nouble,3820,2010,West Ham United,1,0,1,1,0,0,1,0,1,1,0,0,2,0,2,2,0,0,0,0,0,0,0,0,0,0,0,0,0,0
8896,8896,Ruud Boffin,3821,2010,West Ham United,0,0,0,0,0,0,1,1,0,90,0,0,1,1,0,90,0,0,0,0,0,0,0,0,0,0,0,0,0,0
8897,8897,Daniel Gabbidon,2464,2010,West Ham United,12,10,2,977,0,0,14,14,0,1203,0,0,26,24,2,2180,0,0,0,0,0,0,0,0,0,0,0,0,0,0
8898,8898,Benny McCarthy,2112,2010,West Ham United,4,0,4,47,0,0,2,0,2,29,0,0,6,0,6,76,0,0,0,0,0,0,0,0,0,0,0,0,0,0
8899,8899,James Shea,3822,2010,Arsenal FC,0,0,0,0,0,0,0,0,0,0,0,0,0,0,0,0,0,0,0,0,0,0,0,0,0,0,0,0,0,0
8900,8900,Nampalys Mendy,2945,2019,Leicester City,3,2,1,110,0,0,4,2,2,181,0,0,7,4,3,291,0,0,0,0,0,0,0,0,0,0,0,0,0,0
8901,8901,Christian Fuchs,2564,2019,Leicester City,4,2,2,199,0,0,7,6,1,571,0,0,11,8,3,770,0,0,0,0,0,0,0,0,0,0,0,0,0,0
8902,8902,Shay Given,1581,2007,Newcastle United,10,10,0,856,0,0,9,9,0,774,0,0,19,19,0,1630,0,0,0,0,0,0,0,0,0,0,0,0,0,0
8903,8903,José Enrique,2394,2007,Newcastle United,13,10,3,885,0,0,10,8,2,735,0,0,23,18,5,1620,0,0,0,0,0,0,0,0,0,0,0,0,0,0
8904,8904,Damien Duff,1348,2007,Newcastle United,9,5,4,478,0,0,7,7,0,585,0,0,16,12,4,1063,0,0,0,0,0,0,0,0,0,0,0,0,0,0
8905,8905,Kazenga LuaLua,3619,2007,Newcastle United,1,0,1,10,0,0,1,0,1,11,0,0,2,0,2,21,0,0,0,0,0,0,0,0,0,0,0,0,0,0
8906,8906,David Jones,1490,2016,Burnley FC,1,1,0,87,0,0,0,0,0,0,0,0,1,1,0,87,0,0,0,0,0,0,0,0,0,0,0,0,0,0
8907,8907,Fredrik Ulvestad,1493,2016,Burnley FC,0,0,0,0,0,0,0,0,0,0,0,0,0,0,0,0,0,0,0,0,0,0,0,0,0,0,0,0,0,0
8908,8908,Jefferson Montero,1700,2016,Swansea City,5,0,5,140,0,0,8,2,6,271,0,0,13,2,11,411,0,0,0,0,0,0,0,0,0,0,0,0,0,0
8909,8909,Callum Robinson,3472,2013,Aston Villa,1,0,1,5,0,0,3,0,3,41,0,0,4,0,4,46,0,0,0,0,0,0,0,0,0,0,0,0,0,0
8910,8910,Joseph Yobo,1801,2013,Norwich City,5,5,0,450,0,0,3,3,0,270,0,0,8,8,0,720,0,0,0,0,0,0,0,0,0,0,0,0,0,0
8911,8911,John Ruddy,1367,2012,Norwich City,7,7,0,630,0,0,8,8,0,712,0,0,15,15,0,1342,0,0,0,0,0,0,0,0,0,0,0,0,0,0
8912,8912,Leon Barnett,3041,2012,Norwich City,4,3,1,291,0,0,4,3,1,271,0,0,8,6,2,562,0,0,0,0,0,0,0,0,0,0,0,0,0,0
8913,8913,Simeon Jackson,3047,2012,Norwich City,7,4,3,297,1,0,6,1,5,107,0,0,13,5,8,404,1,0,0,0,0,1,0,1,0,0,0,0,0,0
8914,8914,Chris Martin,3823,2012,Norwich City,1,0,1,2,0,0,0,0,0,0,0,0,1,0,1,2,0,0,0,0,0,0,0,0,0,0,0,0,0,0
8915,8915,Steve Morison,3044,2012,Norwich City,9,2,7,175,1,0,10,2,8,291,0,0,19,4,15,466,1,0,0,0,0,0,0,0,0,0,0,0,0,0
8916,8916,Declan Rudd,2629,2012,Norwich City,0,0,0,0,0,0,0,0,0,0,0,0,0,0,0,0,0,0,0,0,0,0,0,0,0,0,0,0,0,0
8917,8917,Marc Tierney,3042,2012,Norwich City,0,0,0,0,0,0,1,1,0,90,0,0,1,1,0,90,0,0,0,0,0,0,0,0,0,0,0,0,0,0
8918,8918,Andrew Surman,1006,2012,Norwich City,2,2,0,145,0,0,2,2,0,128,0,0,4,4,0,273,0,0,0,0,0,0,0,0,0,0,0,0,0,0
8919,8919,Jlloyd Samuel,1789,2006,Aston Villa,2,1,1,70,0,0,2,1,1,134,0,0,4,2,2,204,0,0,0,0,0,0,0,0,0,0,0,0,0,0
8920,8920,Moses Ashikodi,3824,2006,Watford FC,0,0,0,0,0,0,2,0,2,21,0,0,2,0,2,21,0,0,0,0,0,0,0,0,0,0,0,0,0,0
8921,8921,Daniel Ayala,3003,2009,Liverpool FC,2,1,1,123,0,0,3,1,2,111,0,0,5,2,3,234,0,0,0,0,0,0,0,0,0,0,0,0,0,0
8922,8922,Maxi Rodríguez,2993,2009,Liverpool FC,9,7,2,607,0,0,8,7,1,601,1,0,17,14,3,1208,1,0,0,0,0,0,0,0,0,0,0,0,0,0
8923,8923,Dani Pacheco,3171,2009,Liverpool FC,2,0,2,17,0,0,2,0,2,25,0,0,4,0,4,42,0,0,0,0,0,0,0,0,0,0,0,0,0,0
8924,8924,Richard Hughes,2812,2007,Portsmouth FC,7,4,3,395,0,0,6,4,2,371,0,0,13,8,5,766,0,0,0,0,0,0,0,0,0,0,0,0,0,0
8925,8925,Lewis Price,3235,2007,Derby County,4,4,0,360,0,0,2,2,0,180,0,0,6,6,0,540,0,0,0,0,0,0,0,0,0,0,0,0,0,0
8926,8926,Danny Mills,1292,2007,Derby County,1,1,0,90,0,0,1,1,0,32,0,0,2,2,0,122,0,0,0,0,0,0,0,0,0,0,0,0,0,0
8927,8927,Laurent Robert,2034,2007,Derby County,2,1,1,65,0,0,2,2,0,116,0,0,4,3,1,181,0,0,0,0,0,0,0,0,0,0,0,0,0,0
8928,8928,David Edgar,3825,2009,Burnley FC,2,0,2,59,0,0,2,2,0,180,0,0,4,2,2,239,0,0,0,0,0,0,0,0,0,0,0,0,0,0
8929,8929,Ken Sema,2092,2019,Watford FC,0,0,0,0,0,0,0,0,0,0,0,0,0,0,0,0,0,0,0,0,0,0,0,0,0,0,0,0,0,0
8930,8930,Jürgen Locadia,2487,2019,Brighton & Hove Albion,1,0,1,22,0,0,1,1,0,64,0,0,2,1,1,86,0,0,0,0,0,0,0,0,0,0,0,0,0,0
8931,8931,Florin Andone,2706,2019,Brighton & Hove Albion,2,1,1,106,0,0,1,0,1,26,1,0,3,1,2,132,1,0,0,0,0,0,0,0,0,0,0,0,0,0
8932,8932,Bradley Wright-Phillips,1811,2004,Manchester City,8,1,7,193,0,0,6,0,6,65,1,0,14,1,13,258,1,0,0,0,0,0,0,0,0,0,0,0,0,0
8933,8933,Darren Powell,3826,2004,Crystal Palace,2,2,0,180,0,0,4,2,2,261,1,0,6,4,2,441,1,0,0,0,0,0,0,0,0,0,0,0,0,0
8934,8934,Gary Borrowdale,3827,2004,Crystal Palace,4,0,4,64,0,0,3,2,1,210,0,0,7,2,5,274,0,0,0,0,0,0,0,0,0,0,0,0,0,0
8935,8935,Neil Shipperley,3828,2004,Crystal Palace,0,0,0,0,0,0,1,0,1,13,0,0,1,0,1,13,0,0,0,0,0,0,0,0,0,0,0,0,0,0
8936,8936,Wayne Andrews,3829,2004,Crystal Palace,4,0,4,21,0,0,4,0,4,65,0,0,8,0,8,86,0,0,0,0,0,0,0,0,0,0,0,0,0,0
8937,8937,Craig Short,1133,2001,Blackburn Rovers,10,9,1,766,0,0,10,10,0,900,0,0,20,19,1,1666,0,0,0,0,0,0,0,0,0,0,0,0,0,0
8938,8938,John Curtis,2461,2001,Blackburn Rovers,4,4,0,331,0,0,4,4,0,318,0,0,8,8,0,649,0,0,0,0,0,0,0,0,0,0,0,0,0,0
8939,8939,Nathan Blake,2908,2001,Blackburn Rovers,2,0,2,88,0,0,1,0,1,27,1,0,3,0,3,115,1,0,0,0,0,0,0,0,0,0,0,0,0,0
8940,8940,Wes Brown,1108,2001,Manchester United,8,7,1,640,0,0,9,8,1,732,0,0,17,15,2,1372,0,0,0,0,0,0,0,0,0,0,0,0,0,0
8941,8941,Dwight Yorke,1223,2001,Manchester United,6,4,2,351,1,0,4,0,4,115,0,0,10,4,6,466,1,0,0,0,0,0,0,0,0,0,0,0,0,0
8942,8942,Jon Ashton,3830,2001,Leicester City,5,3,2,259,0,0,2,0,2,83,0,0,7,3,4,342,0,0,0,0,0,0,0,0,0,0,0,0,0,0
8943,8943,Martin Reeves,3831,2001,Leicester City,2,0,2,22,0,0,3,1,2,100,0,0,5,1,4,122,0,0,0,0,0,0,0,0,0,0,0,0,0,0
8944,8944,Roy Carroll,1939,2001,Manchester United,1,0,1,7,0,0,6,6,0,540,0,0,7,6,1,547,0,0,0,0,0,0,0,0,0,0,0,0,0,0
8945,8945,Diego Forlán,2783,2001,Manchester United,5,4,1,356,0,0,8,2,6,213,0,0,13,6,7,569,0,0,0,0,0,0,0,0,0,0,0,0,0,0
8946,8946,John Hartson,3832,2000,West Ham United,1,1,0,90,0,0,0,0,0,0,0,0,1,1,0,90,0,0,0,0,0,0,0,0,0,0,0,0,0,0
8947,8947,Celestine Babayaro,2015,2000,Chelsea FC,13,11,2,968,0,0,10,7,3,595,0,0,23,18,5,1563,0,0,0,0,0,0,0,0,0,0,0,0,0,0
8948,8948,Rati Aleksidze,3833,2000,Chelsea FC,1,0,1,7,0,0,1,0,1,11,0,0,2,0,2,18,0,0,0,0,0,0,0,0,0,0,0,0,0,0
8949,8949,Lars Bohinen,3834,2000,Derby County,0,0,0,0,0,0,2,1,1,81,0,0,2,1,1,81,0,0,0,0,0,0,0,0,0,0,0,0,0,0
8950,8950,Adam Murray,3835,2000,Derby County,8,2,6,270,0,0,4,2,2,211,0,0,12,4,8,481,0,0,0,0,0,0,0,0,0,0,0,0,0,0
8951,8951,Paul Robinson,1262,2000,Leeds United,7,6,1,559,0,0,7,7,0,630,0,0,14,13,1,1189,0,0,0,0,0,0,0,0,0,0,0,0,0,0
8952,8952,Gary Kelly,2290,2000,Leeds United,9,9,0,810,0,0,12,10,2,948,0,0,21,19,2,1758,0,0,0,0,0,0,0,0,0,0,0,0,0,0
8953,8953,Darren Huckerby,2389,2000,Leeds United,3,0,3,59,0,0,3,1,2,99,0,0,6,1,5,158,0,0,0,0,0,0,0,0,0,0,0,0,0,0
8954,8954,Stuart Pearce,3836,2000,West Ham United,11,11,0,911,1,0,14,14,0,1252,1,0,25,25,0,2163,2,0,0,0,0,0,1,1,0,0,0,0,0,0
8955,8955,Trevor Sinclair,1628,2000,West Ham United,6,6,0,530,2,0,7,7,0,618,1,0,13,13,0,1148,3,0,0,3,3,1,1,2,0,0,0,0,0,0
8956,8956,Steve Lomas,1629,2000,West Ham United,6,6,0,540,1,0,8,8,0,720,0,0,14,14,0,1260,1,0,0,0,0,1,0,1,0,0,0,0,0,0
8957,8957,Steve Potts,3837,2000,West Ham United,4,2,2,250,0,0,2,0,2,30,0,0,6,2,4,280,0,0,0,0,0,0,0,0,0,0,0,0,0,0
8958,8958,Xabi Alonso,1891,2007,Liverpool FC,10,9,1,802,2,0,9,7,2,666,0,0,19,16,3,1468,2,0,0,0,0,1,0,1,0,0,0,0,0,0
8959,8959,Anthony Barness,3068,2004,Bolton Wanderers,6,4,2,354,0,0,2,1,1,125,0,0,8,5,3,479,0,0,0,0,0,0,0,0,0,0,0,0,0,0
8960,8960,Michael Reiziger,3838,2004,Middlesbrough FC,9,8,1,734,1,0,9,7,2,636,0,0,18,15,3,1370,1,0,0,0,0,0,0,0,0,0,0,0,0,0
8961,8961,James Morrison,1735,2004,Middlesbrough FC,6,1,5,168,0,0,8,3,5,361,0,0,14,4,10,529,0,0,0,0,0,0,0,0,0,0,0,0,0,0
8962,8962,Joseph-Désiré Job,2071,2004,Middlesbrough FC,12,7,5,596,3,0,11,3,8,428,1,0,23,10,13,1024,4,0,0,0,0,1,1,2,0,0,0,0,0,0
8963,8963,Samir Nasri,1358,2018,West Ham United,2,1,1,102,0,0,3,2,1,144,0,0,5,3,2,246,0,0,0,0,0,0,0,0,0,0,0,0,0,0
8964,8964,Kemy Agustien,3174,2012,Swansea City,8,1,7,186,0,0,10,3,7,379,0,0,18,4,14,565,0,0,0,0,0,0,0,0,0,0,0,0,0,0
8965,8965,David Cornell,3839,2012,Swansea City,0,0,0,0,0,0,0,0,0,0,0,0,0,0,0,0,0,0,0,0,0,0,0,0,0,0,0,0,0,0
8966,8966,Jazz Richards,1703,2012,Swansea City,0,0,0,0,0,0,0,0,0,0,0,0,0,0,0,0,0,0,0,0,0,0,0,0,0,0,0,0,0,0
8967,8967,Andy Carroll,1779,2018,West Ham United,6,1,5,180,0,0,6,2,4,274,0,0,12,3,9,454,0,0,0,0,0,0,0,0,0,0,0,0,0,0
8968,8968,Conor Coventry,3840,2018,West Ham United,0,0,0,0,0,0,0,0,0,0,0,0,0,0,0,0,0,0,0,0,0,0,0,0,0,0,0,0,0,0
8969,8969,James McFadden,1413,2006,Everton FC,10,3,7,336,1,0,9,3,6,450,1,0,19,6,13,786,2,0,3,0,3,1,0,1,0,0,0,0,0,0
8970,8970,Danny Webber,3335,2006,Sheffield United,11,6,5,517,1,0,11,7,4,638,2,0,22,13,9,1155,3,0,0,6,6,1,2,3,0,0,0,0,0,0
8971,8971,Richard Gough,3841,2000,Everton FC,7,7,0,484,0,0,2,2,0,180,0,0,9,9,0,664,0,0,0,0,0,0,0,0,0,0,0,0,0,0
8972,8972,Alessandro Pistone,1799,2000,Everton FC,3,2,1,157,0,0,4,3,1,281,0,0,7,5,2,438,0,0,0,0,0,0,0,0,0,0,0,0,0,0
8973,8973,Mark Hughes,1353,2000,Everton FC,5,3,2,219,0,0,4,3,1,231,0,0,9,6,3,450,0,0,0,0,0,0,0,0,0,0,0,0,0,0
8974,8974,Andy Hunt,3842,2000,Charlton Athletic,4,4,0,329,2,0,4,4,0,351,2,0,8,8,0,680,4,0,0,0,0,2,2,4,0,0,0,0,0,0
8975,8975,Shaun Newton,2862,2000,Charlton Athletic,5,1,4,129,0,0,5,0,5,91,0,0,10,1,9,220,0,0,0,0,0,0,0,0,0,0,0,0,0,0
8976,8976,Abou Diaby,2434,2011,Arsenal FC,2,0,2,46,0,0,2,0,2,54,0,0,4,0,4,100,0,0,0,0,0,0,0,0,0,0,0,0,0,0
8977,8977,Paul Rachubka,3843,2010,Blackpool FC,1,0,1,34,0,0,1,1,0,90,0,0,2,1,1,124,0,0,0,0,0,0,0,0,0,0,0,0,0,0
8978,8978,Nuri Şahin,3844,2012,Liverpool FC,4,4,0,283,0,0,3,3,0,172,1,0,7,7,0,455,1,0,0,0,0,0,0,0,0,0,0,0,0,0
8979,8979,Sebastián Coates,2526,2012,Liverpool FC,2,1,1,95,0,0,3,1,2,138,0,0,5,2,3,233,0,0,0,0,0,0,0,0,0,0,0,0,0,0
8980,8980,Oussama Assaidi,2382,2012,Liverpool FC,2,0,2,30,0,0,2,0,2,43,0,0,4,0,4,73,0,0,0,0,0,0,0,0,0,0,0,0,0,0
8981,8981,Ricardo Gardner,2411,2006,Bolton Wanderers,8,7,1,632,0,0,10,6,4,600,0,0,18,13,5,1232,0,0,0,0,0,0,0,0,0,0,0,0,0,0
8982,8982,David Thompson,2102,2006,Bolton Wanderers,2,0,2,81,0,0,5,3,2,204,0,0,7,3,4,285,0,0,0,0,0,0,0,0,0,0,0,0,0,0
8983,8983,Andranik Teymourian,2038,2006,Bolton Wanderers,8,3,5,363,0,0,9,3,6,462,2,0,17,6,11,825,2,0,0,0,0,0,1,1,0,0,0,0,0,0
8984,8984,Kolo Touré,1415,2015,Liverpool FC,8,6,2,608,0,0,6,3,3,251,1,0,14,9,5,859,1,0,0,0,0,0,0,0,0,0,0,0,0,0
8985,8985,Connor Randall,2129,2015,Liverpool FC,2,1,1,73,0,0,1,1,0,90,0,0,3,2,1,163,0,0,0,0,0,0,0,0,0,0,0,0,0,0
8986,8986,Joe Allen,1430,2015,Liverpool FC,11,4,7,357,2,0,8,4,4,374,0,0,19,8,11,731,2,0,1,0,1,2,0,2,0,0,0,0,0,0
8987,8987,Kevin Mbabu,3845,2015,Newcastle United,1,1,0,90,0,0,2,1,1,54,0,0,3,2,1,144,0,0,0,0,0,0,0,0,0,0,0,0,0,0
8988,8988,Scott Wootton,3846,2012,Manchester United,0,0,0,0,0,0,0,0,0,0,0,0,0,0,0,0,0,0,0,0,0,0,0,0,0,0,0,0,0,0
8989,8989,Manuel Almunia,2039,2004,Arsenal FC,6,6,0,540,0,0,4,4,0,360,0,0,10,10,0,900,0,0,0,0,0,0,0,0,0,0,0,0,0,0
8990,8990,Rob Elliot,2456,2014,Newcastle United,1,1,0,46,0,0,2,2,0,180,0,0,3,3,0,226,0,0,0,0,0,0,0,0,0,0,0,0,0,0
8991,8991,Ovie Ejaria,3847,2016,Liverpool FC,1,0,1,3,0,0,1,0,1,3,0,0,2,0,2,6,0,0,0,0,0,0,0,0,0,0,0,0,0,0
8992,8992,Rufus Brevett,2893,2002,Fulham FC,8,8,0,720,0,0,10,10,0,900,0,0,18,18,0,1620,0,0,0,0,0,0,0,0,0,0,0,0,0,0
8993,8993,Abdeslam Ouaddou,3848,2002,Fulham FC,7,5,2,524,0,0,5,3,2,316,0,0,12,8,4,840,0,0,0,0,0,0,0,0,0,0,0,0,0,0
8994,8994,Obafemi Martins,3121,2010,Birmingham City,3,3,0,224,0,0,1,0,1,26,0,0,4,3,1,250,0,0,0,0,0,0,0,0,0,0,0,0,0,0
8995,8995,Jonathan Woodgate,1882,2009,Tottenham Hotspur,3,3,0,194,0,0,0,0,0,0,0,0,3,3,0,194,0,0,0,0,0,0,0,0,0,0,0,0,0,0
8996,8996,David Healy,1567,2009,Sunderland AFC,0,0,0,0,0,0,3,0,3,33,0,0,3,0,3,33,0,0,0,0,0,0,0,0,0,0,0,0,0,0
8997,8997,Anthony Driscoll-Glennon,3756,2018,Burnley FC,0,0,0,0,0,0,0,0,0,0,0,0,0,0,0,0,0,0,0,0,0,0,0,0,0,0,0,0,0,0
8998,8998,Vincent Kompany,1414,2018,Manchester City,8,6,2,561,1,0,9,7,2,662,0,0,17,13,4,1223,1,0,3,0,3,1,0,1,0,0,0,0,0,0
8999,8999,David Silva,1211,2018,Manchester City,16,13,3,1088,4,0,17,15,2,1323,2,0,33,28,5,2411,6,0,0,0,0,1,2,3,0,0,0,0,0,0
9000,9000,Lassana Diarra,2975,2006,Chelsea FC,5,4,1,313,0,0,5,3,2,243,0,0,10,7,3,556,0,0,0,0,0,0,0,0,0,0,0,0,0,0
9001,9001,Ousmane Dabo,3849,2006,Manchester City,7,4,3,383,0,0,6,6,0,507,0,0,13,10,3,890,0,0,0,0,0,0,0,0,0,0,0,0,0,0
9002,9002,Colin Cooper,2138,2004,Middlesbrough FC,9,6,3,609,0,0,6,5,1,435,0,0,15,11,4,1044,0,0,0,0,0,0,0,0,0,0,0,0,0,0
9003,9003,James Beattie,2050,2004,Everton FC,6,4,2,354,0,0,4,2,2,208,1,0,10,6,4,562,1,0,0,0,0,0,1,1,0,0,0,0,0,0
9004,9004,Joel Coleman,3193,2018,Huddersfield Town,0,0,0,0,0,0,1,1,0,90,0,0,1,1,0,90,0,0,0,0,0,0,0,0,0,0,0,0,0,0
9005,9005,Joe Willock,1480,2018,Arsenal FC,0,0,0,0,0,0,2,1,1,64,0,0,2,1,1,64,0,0,0,0,0,0,0,0,0,0,0,0,0,0
9006,9006,Konstantinos Mavropanos,1484,2018,Arsenal FC,1,1,0,46,0,0,3,2,1,104,0,0,4,3,1,150,0,0,0,0,0,0,0,0,0,0,0,0,0,0
9007,9007,Jack Simpson,1045,2019,AFC Bournemouth,2,1,1,145,0,0,2,0,2,93,0,0,4,1,3,238,0,0,0,0,0,0,0,0,0,0,0,0,0,0
9008,9008,Thievy Bifouma,3850,2013,West Bromwich Albion,3,2,1,136,1,0,3,1,2,116,1,0,6,3,3,252,2,0,0,0,0,1,0,1,0,0,0,0,0,0
9009,9009,Armand Traoré,1238,2014,Queens Park Rangers,7,3,4,332,0,0,9,4,5,447,0,0,16,7,9,779,0,0,0,0,0,0,0,0,0,0,0,0,0,0
9010,9010,Rio Ferdinand,1294,2014,Queens Park Rangers,4,4,0,360,0,0,7,7,0,630,0,0,11,11,0,990,0,0,0,0,0,0,0,0,0,0,0,0,0,0
9011,9011,Eduardo Vargas,3851,2014,Queens Park Rangers,12,8,4,722,2,0,9,8,1,664,1,0,21,16,5,1386,3,0,0,0,0,2,1,3,0,0,0,0,0,0
9012,9012,Ikechi Anya,3184,2016,Watford FC,0,0,0,0,0,0,1,0,1,9,0,0,1,0,1,9,0,0,0,0,0,0,0,0,0,0,0,0,0,0
9013,9013,Ben Watson,2025,2016,Watford FC,1,0,1,9,0,0,3,0,3,56,0,0,4,0,4,65,0,0,0,0,0,0,0,0,0,0,0,0,0,0
9014,9014,Matěj Vydra,2302,2016,Watford FC,1,0,1,2,0,0,0,0,0,0,0,0,1,0,1,2,0,0,0,0,0,0,0,0,0,0,0,0,0,0
9015,9015,Mathias Svensson,2335,2003,Charlton Athletic,1,1,0,45,0,0,2,0,2,91,0,0,3,1,2,136,0,0,0,0,0,0,0,0,0,0,0,0,0,0
9016,9016,Nabil El Zhar,1896,2009,Liverpool FC,1,0,1,9,0,0,2,1,1,80,0,0,3,1,2,89,0,0,0,0,0,0,0,0,0,0,0,0,0,0
9017,9017,Izzy Brown,2659,2012,West Bromwich Albion,1,0,1,4,0,0,0,0,0,0,0,0,1,0,1,4,0,0,0,0,0,0,0,0,0,0,0,0,0,0
9018,9018,Ramon Vega,3852,2000,Tottenham Hotspur,4,3,1,310,0,0,5,5,0,450,0,0,9,8,1,760,0,0,0,0,0,0,0,0,0,0,0,0,0,0
9019,9019,Luke Young,1952,2000,Tottenham Hotspur,11,9,2,781,0,0,9,8,1,739,0,0,20,17,3,1520,0,0,0,0,0,0,0,0,0,0,0,0,0,0
9020,9020,Nicky Weaver,1875,2000,Manchester City,14,14,0,1260,0,0,14,14,0,1260,0,0,28,28,0,2520,0,0,0,0,0,0,0,0,0,0,0,0,0,0
9021,9021,Paul Ritchie,3853,2000,Manchester City,5,4,1,342,0,0,6,6,0,530,0,0,11,10,1,872,0,0,0,0,0,0,0,0,0,0,0,0,0,0
9022,9022,Danny Tiatto,3199,2000,Manchester City,17,15,2,1452,1,0,14,14,0,1158,1,0,31,29,2,2610,2,0,1,0,1,1,0,1,0,0,0,0,0,0
9023,9023,Kevin Horlock,3205,2000,Manchester City,6,6,0,369,1,0,7,7,0,566,1,0,13,13,0,935,2,0,0,0,0,0,1,1,0,1,1,0,0,0
9024,9024,Lee Crooks,3854,2000,Manchester City,1,0,1,13,0,0,1,0,1,70,0,0,2,0,2,83,0,0,0,0,0,0,0,0,0,0,0,0,0,0
9025,9025,Mark Kennedy,2907,2000,Manchester City,12,8,4,794,0,0,10,5,5,489,0,0,22,13,9,1283,0,0,0,0,0,0,0,0,0,0,0,0,0,0
9026,9026,George Weah,3855,2000,Manchester City,3,3,0,233,0,0,3,1,2,152,1,0,6,4,2,385,1,0,0,0,0,0,0,0,0,0,0,0,0,0
9027,9027,Martin Keown,2355,2001,Arsenal FC,9,8,1,765,0,0,12,12,0,1057,0,0,21,20,1,1822,0,0,0,0,0,0,0,0,0,0,0,0,0,0
9028,9028,Lauren,1602,2001,Arsenal FC,13,13,0,1170,2,0,14,14,0,1260,0,0,27,27,0,2430,2,0,3,0,3,2,0,2,1,0,1,0,0,0
9029,9029,Robert Pirés,1603,2001,Arsenal FC,14,13,1,1137,4,0,13,13,0,1123,5,0,27,26,1,2260,9,0,3,1,4,4,3,7,0,1,1,0,0,0
9030,9030,Ray Parlour,1334,2001,Arsenal FC,14,13,1,1054,0,0,12,11,1,984,0,0,26,24,2,2038,0,0,0,0,0,0,0,0,0,0,0,0,0,0
9031,9031,Kyle Walker,1196,2010,Aston Villa,7,7,0,618,1,0,8,8,0,720,0,0,15,15,0,1338,1,0,0,0,0,1,0,1,0,0,0,0,0,0
9032,9032,Paul Gallagher,1142,2006,Blackburn Rovers,4,0,4,57,1,0,12,2,10,272,0,0,16,2,14,329,1,0,0,0,0,0,0,0,0,0,0,0,0,0
9033,9033,Matt Grimes,1708,2015,Swansea City,0,0,0,0,0,0,1,1,0,90,0,0,1,1,0,90,0,0,0,0,0,0,0,0,0,0,0,0,0,0
9034,9034,Jimmy Bullard,1610,2006,Fulham FC,2,2,0,180,2,0,2,2,0,124,0,0,4,4,0,304,2,0,4,0,4,2,0,2,1,0,1,0,0,0
9035,9035,Siem de Jong,2633,2014,Newcastle United,2,1,1,95,1,0,2,0,2,53,0,0,4,1,3,148,1,0,0,0,0,0,0,0,0,0,0,0,0,0
9036,9036,Elliot Lee,3524,2014,West Ham United,0,0,0,0,0,0,1,0,1,13,0,0,1,0,1,13,0,0,0,0,0,0,0,0,0,0,0,0,0,0
9037,9037,Marvin Emnes,1709,2013,Swansea City,4,1,3,64,0,0,3,1,2,74,1,0,7,2,5,138,1,0,0,0,0,0,0,0,0,0,0,0,0,0
9038,9038,Leroy Lita,2593,2013,Swansea City,1,0,1,27,0,0,1,0,1,7,0,0,2,0,2,34,0,0,0,0,0,0,0,0,0,0,0,0,0,0
9039,9039,Liam O'Neil,3856,2013,West Bromwich Albion,1,0,1,7,0,0,2,0,2,8,0,0,3,0,3,15,0,0,0,0,0,0,0,0,0,0,0,0,0,0
9040,9040,Carlo Cudicini,2370,2005,Chelsea FC,3,2,1,224,0,0,1,1,0,90,0,0,4,3,1,314,0,0,0,0,0,0,0,0,0,0,0,0,0,0
9041,9041,Michael Essien,1763,2005,Chelsea FC,17,14,3,1378,2,0,14,13,1,1080,0,0,31,27,4,2458,2,0,0,0,0,1,0,1,0,0,0,0,0,0
9042,9042,Didier Drogba,1766,2005,Chelsea FC,16,9,7,996,10,0,13,11,2,992,2,0,29,20,9,1988,12,0,3,0,3,5,1,6,0,0,0,0,0,0
9043,9043,Chris Kirkland,2056,2005,West Bromwich Albion,5,5,0,450,0,0,5,5,0,450,0,0,10,10,0,900,0,0,0,0,0,0,0,0,0,0,0,0,0,0
9044,9044,Riccardo Scimeca,1316,2005,West Bromwich Albion,1,1,0,90,0,0,1,1,0,90,0,0,2,2,0,180,0,0,0,0,0,0,0,0,0,0,0,0,0,0
9045,9045,Thomas Gaardsøe,1598,2005,West Bromwich Albion,3,3,0,270,0,0,4,4,0,292,0,0,7,7,0,562,0,0,0,0,0,0,0,0,0,0,0,0,0,0
9046,9046,Neil Clement,1320,2005,West Bromwich Albion,16,15,1,1371,1,0,15,14,1,1302,0,0,31,29,2,2673,1,0,0,0,0,0,0,0,0,0,0,0,0,0
9047,9047,Martin Albrechtsen,1599,2005,West Bromwich Albion,14,11,3,1072,0,0,16,14,2,1350,1,0,30,25,5,2422,1,0,0,3,3,0,1,1,0,0,0,0,0,0
9048,9048,Jonathan Greening,1321,2005,West Bromwich Albion,18,18,0,1600,2,0,19,18,1,1602,0,0,37,36,1,3202,2,0,0,0,0,1,0,1,0,0,0,0,0,0
9049,9049,Andy Johnson,1322,2005,West Bromwich Albion,4,4,0,315,0,0,4,4,0,330,0,0,8,8,0,645,0,0,0,0,0,0,0,0,0,0,0,0,0,0
9050,9050,Richard Chaplow,3541,2005,West Bromwich Albion,2,0,2,37,0,0,5,4,1,336,0,0,7,4,3,373,0,0,0,0,0,0,0,0,0,0,0,0,0,0
9051,9051,Diomansy Kamara,1564,2005,West Bromwich Albion,12,11,1,895,1,0,14,10,4,895,0,0,26,21,5,1790,1,0,0,0,0,1,0,1,0,0,0,0,0,0
9052,9052,Nwankwo Kanu,1324,2005,West Bromwich Albion,12,8,4,761,4,0,12,8,4,749,1,0,24,16,8,1510,5,0,0,0,0,2,1,3,0,0,0,0,0,0
9053,9053,Junichi Inamoto,1084,2005,West Bromwich Albion,9,8,1,689,0,0,13,8,5,834,0,0,22,16,6,1523,0,0,0,0,0,0,0,0,0,0,0,0,0,0
9054,9054,Nathan Ellington,3857,2005,West Bromwich Albion,16,8,8,795,3,0,14,6,8,648,2,0,30,14,16,1443,5,0,0,1,1,1,2,3,1,0,1,0,0,0
9055,9055,Anthony Gardner,1120,2001,Tottenham Hotspur,6,4,2,406,0,0,8,6,2,555,0,0,14,10,4,961,0,0,0,0,0,0,0,0,0,0,0,0,0,0
9056,9056,Richard Rufus,1670,2001,Charlton Athletic,4,4,0,360,1,0,5,5,0,395,0,0,9,9,0,755,1,0,0,0,0,1,0,1,0,0,0,0,0,0
9057,9057,Vladimír Šmicer,2692,2004,Liverpool FC,4,1,3,118,0,0,6,1,5,209,0,0,10,2,8,327,0,0,0,0,0,0,0,0,0,0,0,0,0,0
9058,9058,Anthony Le Tallec,3111,2004,Liverpool FC,1,0,1,30,0,0,3,2,1,188,0,0,4,2,2,218,0,0,0,0,0,0,0,0,0,0,0,0,0,0
9059,9059,Aleksey Smertin,1072,2006,Fulham FC,4,4,0,325,0,0,3,2,1,208,0,0,7,6,1,533,0,0,0,0,0,0,0,0,0,0,0,0,0,0
9060,9060,Andreas Isaksson,3677,2006,Manchester City,6,5,1,505,0,0,8,7,1,674,0,0,14,12,2,1179,0,0,0,0,0,0,0,0,0,0,0,0,0,0
9061,9061,Michael Ball,2823,2006,Manchester City,6,6,0,536,0,0,6,6,0,540,0,0,12,12,0,1076,0,0,0,0,0,0,0,0,0,0,0,0,0,0
9062,9062,Nedum Onuoha,2533,2006,Manchester City,8,6,2,541,0,0,10,9,1,785,0,0,18,15,3,1326,0,0,0,0,0,0,0,0,0,0,0,0,0,0
9063,9063,Jihai Sun,1808,2006,Manchester City,6,3,3,388,0,0,7,7,0,610,0,0,13,10,3,998,0,0,0,0,0,0,0,0,0,0,0,0,0,0
9064,9064,Michael Johnson,3030,2006,Manchester City,3,3,0,270,0,0,7,7,0,630,0,0,10,10,0,900,0,0,0,0,0,0,0,0,0,0,0,0,0,0
9065,9065,Émile Mpenza,3033,2006,Manchester City,6,5,1,466,0,0,4,4,0,360,3,0,10,9,1,826,3,0,0,3,3,0,1,1,0,0,0,0,0,0
9066,9066,Ognjen Koroman,3858,2005,Portsmouth FC,1,0,1,28,1,0,2,1,1,90,0,0,3,1,2,118,1,0,0,0,0,0,0,0,0,0,0,0,0,0
9067,9067,Alexander Büttner,3712,2012,Manchester United,3,2,1,202,1,0,2,2,0,180,1,0,5,4,1,382,2,0,0,0,0,0,0,0,0,0,0,0,0,0
9068,9068,Amdy Faye,1070,2009,Stoke City,1,1,0,90,0,0,1,1,0,90,0,0,2,2,0,180,0,0,0,0,0,0,0,0,0,0,0,0,0,0
9069,9069,James Beattie,2050,2009,Stoke City,11,6,5,411,2,0,11,5,6,391,0,0,22,11,11,802,2,0,3,0,3,2,0,2,1,0,1,0,0,0
9070,9070,Richard Cresswell,1998,2009,Stoke City,1,0,1,2,0,0,1,1,0,62,0,0,2,1,1,64,0,0,0,0,0,0,0,0,0,0,0,0,0,0
9071,9071,Danny Pugh,2756,2009,Stoke City,3,1,2,97,1,0,4,0,4,83,0,0,7,1,6,180,1,0,0,0,0,1,0,1,0,0,0,0,0,0
9072,9072,Japhet Tanganga,3859,2019,Tottenham Hotspur,3,3,0,256,0,0,3,3,0,270,0,0,6,6,0,526,0,0,0,0,0,0,0,0,0,0,0,0,0,0
9073,9073,Simon Francis,1001,2019,AFC Bournemouth,7,6,1,541,0,0,8,4,4,477,0,0,15,10,5,1018,0,0,0,0,0,0,0,0,0,0,0,0,0,0
9074,9074,Fikayo Tomori,3506,2019,Chelsea FC,7,7,0,630,0,0,8,8,0,663,1,0,15,15,0,1293,1,0,0,0,0,0,1,1,0,0,0,0,0,0
9075,9075,Michy Batshuayi,2732,2019,Chelsea FC,8,1,7,141,0,0,8,0,8,84,1,0,16,1,15,225,1,0,0,0,0,0,0,0,0,0,0,0,0,0
9076,9076,Alex Palmer,3860,2016,West Bromwich Albion,0,0,0,0,0,0,0,0,0,0,0,0,0,0,0,0,0,0,0,0,0,0,0,0,0,0,0,0,0,0
9077,9077,Michael Ball,2823,2008,Manchester City,4,4,0,354,0,0,3,3,0,270,0,0,7,7,0,624,0,0,0,0,0,0,0,0,0,0,0,0,0,0
9078,9078,Keiren Westwood,1410,2013,Sunderland AFC,5,5,0,450,0,0,5,5,0,403,0,0,10,10,0,853,0,0,0,0,0,0,0,0,0,0,0,0,0,0
9079,9079,Dong-won Ji,3576,2013,Sunderland AFC,3,1,2,111,0,0,2,1,1,90,0,0,5,2,3,201,0,0,0,0,0,0,0,0,0,0,0,0,0,0
9080,9080,Carlos Cuéllar,1401,2013,Sunderland AFC,2,2,0,180,0,0,2,2,0,162,0,0,4,4,0,342,0,0,0,0,0,0,0,0,0,0,0,0,0,0
9081,9081,Cabral,3861,2013,Sunderland AFC,1,1,0,90,0,0,0,0,0,0,0,0,1,1,0,90,0,0,0,0,0,0,0,0,0,0,0,0,0,0
9082,9082,Ben Thatcher,1807,2001,Tottenham Hotspur,5,4,1,350,0,0,6,6,0,517,0,0,11,10,1,867,0,0,0,0,0,0,0,0,0,0,0,0,0,0
9083,9083,Dean Richards,2799,2002,Tottenham Hotspur,12,12,0,1020,0,0,14,14,0,1254,2,0,26,26,0,2274,2,0,0,0,0,0,2,2,0,0,0,0,0,0
9084,9084,Matthew Etherington,1557,2002,Tottenham Hotspur,11,8,3,682,0,0,12,7,5,628,1,0,23,15,8,1310,1,0,0,0,0,0,1,1,0,0,0,0,0,0
9085,9085,Steffen Freund,2079,2002,Tottenham Hotspur,7,5,2,456,0,0,10,8,2,742,0,0,17,13,4,1198,0,0,0,0,0,0,0,0,0,0,0,0,0,0
9086,9086,Gary Doherty,2792,2002,Tottenham Hotspur,9,4,5,617,1,0,6,3,3,366,0,0,15,7,8,983,1,0,0,0,0,1,0,1,0,0,0,0,0,0
9087,9087,Émerson Thome,1102,2002,Sunderland AFC,0,0,0,0,0,0,1,1,0,69,0,0,1,1,0,69,0,0,0,0,0,0,0,0,0,0,0,0,0,0
9088,9088,Talal El-Karkouri,1959,2002,Sunderland AFC,4,4,0,328,0,0,4,4,0,325,0,0,8,8,0,653,0,0,0,0,0,0,0,0,0,0,0,0,0,0
9089,9089,Paul Thirlwell,1635,2002,Sunderland AFC,8,4,4,406,0,0,11,8,3,743,0,0,19,12,7,1149,0,0,0,0,0,0,0,0,0,0,0,0,0,0
9090,9090,Matthew Piper,2683,2002,Sunderland AFC,6,4,2,385,0,0,7,4,3,398,0,0,13,8,5,783,0,0,0,0,0,0,0,0,0,0,0,0,0,0
9091,9091,Sam Baldock,3862,2017,Brighton & Hove Albion,1,0,1,6,0,0,1,0,1,24,0,0,2,0,2,30,0,0,0,0,0,0,0,0,0,0,0,0,0,0
9092,9092,Étienne Capoue,1924,2013,Tottenham Hotspur,5,2,3,274,1,0,7,6,1,411,0,0,12,8,4,685,1,0,0,0,0,0,0,0,0,0,0,0,0,0
9093,9093,Nacer Chadli,1170,2013,Tottenham Hotspur,12,8,4,719,0,0,12,7,5,735,1,0,24,15,9,1454,1,0,0,0,0,0,0,0,0,0,0,0,0,0
9094,9094,Isaac Hayden,2470,2013,Arsenal FC,0,0,0,0,0,0,0,0,0,0,0,0,0,0,0,0,0,0,0,0,0,0,0,0,0,0,0,0,0,0
9095,9095,Andy Griffin,1578,2001,Newcastle United,3,3,0,270,0,0,1,0,1,6,0,0,4,3,1,276,0,0,0,0,0,0,0,0,0,0,0,0,0,0
9096,9096,Ryan Shotton,3517,2013,Stoke City,0,0,0,0,0,0,0,0,0,0,0,0,0,0,0,0,0,0,0,0,0,0,0,0,0,0,0,0,0,0
9097,9097,Harry Winks,1857,2017,Tottenham Hotspur,8,6,2,440,0,0,8,3,5,332,0,0,16,9,7,772,0,0,0,0,0,0,0,0,0,0,0,0,0,0
9098,9098,Llorente,1860,2017,Tottenham Hotspur,7,0,7,78,0,0,9,1,8,147,1,0,16,1,15,225,1,0,0,0,0,0,1,1,0,0,0,0,0,0
9099,9099,Danny Rose,1399,2017,Tottenham Hotspur,5,4,1,362,0,0,5,5,0,440,0,0,10,9,1,802,0,0,0,0,0,0,0,0,0,0,0,0,0,0
9100,9100,Juan Foyth,1862,2017,Tottenham Hotspur,0,0,0,0,0,0,0,0,0,0,0,0,0,0,0,0,0,0,0,0,0,0,0,0,0,0,0,0,0,0
9101,9101,Gerry Taggart,2647,2000,Leicester City,14,14,0,1242,2,0,10,10,0,804,0,0,24,24,0,2046,2,0,3,0,3,1,0,1,0,0,0,0,0,0
9102,9102,Martin Pringle,3863,2000,Charlton Athletic,3,0,3,54,1,0,4,1,3,156,0,0,7,1,6,210,1,0,0,0,0,0,0,0,0,0,0,0,0,0
9103,9103,Peter Enckelman,1131,2001,Aston Villa,4,4,0,360,0,0,4,4,0,360,0,0,8,8,0,720,0,0,0,0,0,0,0,0,0,0,0,0,0,0
9104,9104,Jlloyd Samuel,1789,2001,Aston Villa,11,8,3,785,0,0,11,9,2,779,0,0,22,17,5,1564,0,0,0,0,0,0,0,0,0,0,0,0,0,0
9105,9105,Juan Pablo Ángel,1795,2001,Aston Villa,16,15,1,1279,8,0,12,10,2,789,4,0,28,25,3,2068,12,0,7,0,7,7,2,9,2,0,2,0,0,0
9106,9106,Steve Stone,1071,2001,Aston Villa,10,5,5,513,0,0,10,7,3,646,1,0,20,12,8,1159,1,0,0,0,0,0,0,0,0,0,0,0,0,0
9107,9107,Andrea Dossena,3629,2013,Sunderland AFC,2,2,0,180,0,0,5,4,1,356,0,0,7,6,1,536,0,0,0,0,0,0,0,0,0,0,0,0,0,0
9108,9108,Mario Suárez,3864,2015,Watford FC,7,3,4,313,0,0,8,5,3,432,0,0,15,8,7,745,0,0,0,0,0,0,0,0,0,0,0,0,0,0
9109,9109,Nordin Amrabat,3015,2015,Watford FC,7,2,5,269,0,0,5,2,3,232,0,0,12,4,8,501,0,0,0,0,0,0,0,0,0,0,0,0,0,0
9110,9110,Mikel Arteta,1802,2010,Everton FC,15,15,0,1232,2,0,14,14,0,1212,1,0,29,29,0,2444,3,0,1,1,2,1,1,2,0,0,0,0,0,0
9111,9111,Marouane Fellaini,2189,2010,Everton FC,9,8,1,680,1,0,11,11,0,977,0,0,20,19,1,1657,1,0,1,0,1,1,0,1,0,0,0,0,0,0
9112,9112,Louis Saha,1727,2010,Everton FC,12,8,4,791,6,0,10,6,4,578,1,0,22,14,8,1369,7,0,0,0,0,4,1,5,0,0,0,0,0,0
9113,9113,Tim Cahill,1746,2010,Everton FC,13,9,4,853,5,0,14,13,1,1162,4,0,27,22,5,2015,9,0,0,0,0,2,3,5,0,0,0,0,0,0
9114,9114,Jose Baxter,2107,2010,Everton FC,0,0,0,0,0,0,1,0,1,12,0,0,1,0,1,12,0,0,0,0,0,0,0,0,0,0,0,0,0,0
9115,9115,Kieran Richardson,1898,2010,Sunderland AFC,14,12,2,1030,1,0,12,11,1,1011,3,0,26,23,3,2041,4,0,0,0,0,1,2,3,0,0,0,0,0,0
9116,9116,Billy Knott,3865,2010,Sunderland AFC,0,0,0,0,0,0,0,0,0,0,0,0,0,0,0,0,0,0,0,0,0,0,0,0,0,0,0,0,0,0
9117,9117,Ian Bennett,2580,2002,Birmingham City,5,5,0,450,0,0,5,5,0,450,0,0,10,10,0,900,0,0,0,0,0,0,0,0,0,0,0,0,0,0
9118,9118,Michael Johnson,3030,2002,Birmingham City,2,2,0,180,0,0,4,3,1,263,0,0,6,5,1,443,0,0,0,0,0,0,0,0,0,0,0,0,0,0
9119,9119,Damien Johnson,2503,2002,Birmingham City,15,14,1,1198,1,0,15,14,1,1209,0,0,30,28,2,2407,1,0,3,0,3,1,0,1,0,0,0,0,0,0
9120,9120,Jamie Clapham,1513,2002,Birmingham City,9,9,0,810,0,0,7,7,0,630,0,0,16,16,0,1440,0,0,0,0,0,0,0,0,0,0,0,0,0,0
9121,9121,Christophe Dugarry,2791,2002,Birmingham City,9,9,0,722,4,0,7,7,0,572,1,0,16,16,0,1294,5,0,3,0,3,3,1,4,0,0,0,0,0,0
9122,9122,Jovan Kirovski,2913,2002,Birmingham City,9,2,7,208,1,0,8,3,5,317,1,0,17,5,12,525,2,0,0,3,3,1,1,2,0,0,0,0,0,0
9123,9123,Richard Kingson,2600,2008,Wigan Athletic,2,2,0,180,0,0,2,1,1,170,0,0,4,3,1,350,0,0,0,0,0,0,0,0,0,0,0,0,0,0
9124,9124,Charles N'Zogbia,2016,2008,Wigan Athletic,6,6,0,476,0,0,7,7,0,610,1,0,13,13,0,1086,1,0,0,3,3,0,1,1,0,0,0,0,0,0
9125,9125,Hugo Rodallega,2061,2008,Wigan Athletic,8,6,2,579,2,0,7,3,4,408,1,0,15,9,6,987,3,0,3,0,3,2,1,3,0,0,0,0,0,0
9126,9126,Mido,2636,2008,Wigan Athletic,7,6,1,433,2,0,5,4,1,327,0,0,12,10,2,760,2,0,1,0,1,2,0,2,1,0,1,0,0,0
9127,9127,Antti Niemi,1559,2005,Fulham FC,6,6,0,540,0,0,3,3,0,270,0,0,9,9,0,810,0,0,0,0,0,0,0,0,0,0,0,0,0,0
9128,9128,Bukayo Saka,1479,2018,Arsenal FC,1,0,1,7,0,0,0,0,0,0,0,0,1,0,1,7,0,0,0,0,0,0,0,0,0,0,0,0,0,0
9129,9129,François Grenet,3866,2001,Derby County,4,4,0,328,0,0,10,7,3,670,0,0,14,11,3,998,0,0,0,0,0,0,0,0,0,0,0,0,0,0
9130,9130,Adam Bolder,3867,2001,Derby County,4,0,4,101,0,0,7,2,5,307,0,0,11,2,9,408,0,0,0,0,0,0,0,0,0,0,0,0,0,0
9131,9131,Marcos Angeleri,3868,2010,Sunderland AFC,1,0,1,5,0,0,1,0,1,1,0,0,2,0,2,6,0,0,0,0,0,0,0,0,0,0,0,0,0,0
9132,9132,Dan Gosling,1005,2010,Newcastle United,0,0,0,0,0,0,1,0,1,1,0,0,1,0,1,1,0,0,0,0,0,0,0,0,0,0,0,0,0,0
9133,9133,Roberto Pereyra,2090,2016,Watford FC,6,5,1,494,2,0,7,7,0,551,0,0,13,12,1,1045,2,0,0,0,0,0,0,0,0,0,0,0,0,0
9134,9134,Kenedy,2932,2016,Watford FC,0,0,0,0,0,0,1,0,1,15,0,0,1,0,1,15,0,0,0,0,0,0,0,0,0,0,0,0,0,0
9135,9135,Abdoulaye Doucouré,1922,2016,Watford FC,11,7,4,707,1,0,9,7,2,651,0,0,20,14,6,1358,1,0,0,0,0,0,0,0,0,0,0,0,0,0
9136,9136,Mustapha Hadji,2103,2002,Aston Villa,6,3,3,265,0,0,5,4,1,352,0,0,11,7,4,617,0,0,0,0,0,0,0,0,0,0,0,0,0,0
9137,9137,Øyvind Leonhardsen,2078,2002,Aston Villa,8,5,3,539,2,0,10,7,3,636,1,0,18,12,6,1175,3,0,0,0,0,0,1,1,0,0,0,0,0,0
9138,9138,Tomasz Kuszczak,1786,2005,West Bromwich Albion,13,13,0,1170,0,0,14,14,0,1231,0,0,27,27,0,2401,0,0,0,0,0,0,0,0,0,0,0,0,0,0
9139,9139,Darren Moore,1317,2005,West Bromwich Albion,3,1,2,111,0,0,2,2,0,180,0,0,5,3,2,291,0,0,0,0,0,0,0,0,0,0,0,0,0,0
9140,9140,Steve Watson,2794,2005,West Bromwich Albion,16,15,1,1248,1,0,13,12,1,974,0,0,29,27,2,2222,1,0,0,0,0,1,0,1,0,0,0,0,0,0
9141,9141,Curtis Davies,2224,2005,West Bromwich Albion,15,15,0,1350,1,0,16,16,0,1440,1,0,31,31,0,2790,2,0,0,0,0,0,1,1,0,0,0,0,0,0
9142,9142,Darren Carter,1515,2005,West Bromwich Albion,11,6,5,598,1,0,8,5,3,504,0,0,19,11,8,1102,1,0,3,0,3,1,0,1,0,0,0,0,0,0
9143,9143,Robert Earnshaw,1325,2005,West Bromwich Albion,7,2,5,212,1,0,5,2,3,198,0,0,12,4,8,410,1,0,0,0,0,0,0,0,0,0,0,0,0,0
9144,9144,Geoff Horsfield,1326,2005,West Bromwich Albion,12,6,6,550,4,0,6,4,2,317,0,0,18,10,8,867,4,0,0,0,0,2,0,2,0,0,0,0,0,0
9145,9145,Carl Jenkinson,2752,2018,Arsenal FC,3,2,1,166,0,0,0,0,0,0,0,0,3,2,1,166,0,0,0,0,0,0,0,0,0,0,0,0,0,0
9146,9146,Steve Simonsen,2918,2001,Everton FC,11,11,0,990,0,0,14,14,0,1260,0,0,25,25,0,2250,0,0,0,0,0,0,0,0,0,0,0,0,0,0
9147,9147,Alessandro Pistone,1799,2001,Everton FC,13,13,0,1125,1,0,12,12,0,1024,0,0,25,25,0,2149,1,0,0,0,0,1,0,1,0,0,0,0,0,0
9148,9148,Alan Stubbs,2795,2001,Everton FC,15,14,1,1253,0,0,16,15,1,1362,2,0,31,29,2,2615,2,0,0,0,0,0,1,1,0,0,0,0,0,0
9149,9149,David Weir,1800,2001,Everton FC,19,19,0,1710,1,0,17,17,0,1505,3,0,36,36,0,3215,4,0,0,4,4,0,2,2,0,0,0,0,0,0
9150,9150,David Unsworth,2582,2001,Everton FC,17,15,2,1327,2,0,16,13,3,1218,1,0,33,28,5,2545,3,0,0,0,0,2,1,3,1,0,1,0,0,0
9151,9151,Niclas Alexandersson,3386,2001,Everton FC,15,15,0,1223,0,0,16,13,3,1155,2,0,31,28,3,2378,2,0,0,0,0,0,1,1,0,0,0,0,0,0
9152,9152,Jesper Blomqvist,3813,2001,Everton FC,9,7,2,574,1,0,6,3,3,312,0,0,15,10,5,886,1,0,3,0,3,1,0,1,0,0,0,0,0,0
9153,9153,Scott Gemmill,3734,2001,Everton FC,16,15,1,1398,1,0,16,16,0,1440,0,0,32,31,1,2838,1,0,0,0,0,0,0,0,0,0,0,0,0,0
9154,9154,Lee Carsley,1803,2001,Everton FC,3,3,0,270,0,0,5,5,0,367,1,0,8,8,0,637,1,0,0,0,0,0,1,1,0,0,0,0,0,0
9155,9155,Tomasz Radzinski,1935,2001,Everton FC,14,12,2,965,4,0,13,11,2,1046,2,0,27,23,4,2011,6,0,0,0,0,2,2,4,0,0,0,0,0,0
9156,9156,Kevin Campbell,1601,2001,Everton FC,12,11,1,976,3,0,11,10,1,905,1,0,23,21,2,1881,4,0,0,0,0,3,0,3,0,0,0,0,0,0
9157,9157,Thomas Gravesen,2796,2001,Everton FC,13,12,1,922,2,0,12,10,2,841,0,0,25,22,3,1763,2,0,0,0,0,0,0,0,0,0,0,0,0,0
9158,9158,Tobias Linderoth,2797,2001,Everton FC,4,2,2,216,0,0,4,2,2,192,0,0,8,4,4,408,0,0,0,0,0,0,0,0,0,0,0,0,0,0
9159,9159,David Ginola,3869,2001,Everton FC,2,1,1,100,0,0,3,1,2,84,0,0,5,2,3,184,0,0,0,0,0,0,0,0,0,0,0,0,0,0
9160,9160,Shaun Maloney,2738,2006,Aston Villa,3,1,2,133,0,0,5,4,1,318,1,0,8,5,3,451,1,0,0,0,0,0,0,0,0,0,0,0,0,0
9161,9161,Djibril Cissé,1899,2011,Queens Park Rangers,3,2,1,218,2,0,5,5,0,409,4,0,8,7,1,627,6,0,3,0,3,2,3,5,0,0,0,0,0,0
9162,9162,Neil Sullivan,2076,2003,Chelsea FC,2,2,0,180,0,0,1,1,0,90,0,0,3,3,0,270,0,0,0,0,0,0,0,0,0,0,0,0,0,0
9163,9163,Ian Walker,2646,2000,West Ham United,1,1,0,90,0,0,0,0,0,0,0,0,1,1,0,90,0,0,0,0,0,0,0,0,0,0,0,0,0,0
9164,9164,Andy Booth,3870,2000,West Ham United,1,1,0,90,0,0,0,0,0,0,0,0,1,1,0,90,0,0,0,0,0,0,0,0,0,0,0,0,0,0
9165,9165,Dave McEwen,3871,2000,West Ham United,1,0,1,6,0,0,0,0,0,0,0,0,1,0,1,6,0,0,0,0,0,0,0,0,0,0,0,0,0,0
9166,9166,Dionatan Teixeira,3872,2014,Stoke City,0,0,0,0,0,0,1,0,1,4,0,0,1,0,1,4,0,0,0,0,0,0,0,0,0,0,0,0,0,0
9167,9167,Andy Wilkinson,1553,2014,Stoke City,0,0,0,0,0,0,0,0,0,0,0,0,0,0,0,0,0,0,0,0,0,0,0,0,0,0,0,0,0,0
9168,9168,Jérémy Pied,3252,2017,Southampton FC,1,1,0,90,0,0,1,1,0,90,0,0,2,2,0,180,0,0,0,0,0,0,0,0,0,0,0,0,0,0
9169,9169,Jack Wilshere,1694,2017,Arsenal FC,10,6,4,578,1,0,10,6,4,609,0,0,20,12,8,1187,1,0,0,0,0,1,0,1,0,0,0,0,0,0
9170,9170,Adam Murray,3835,2001,Derby County,1,1,0,45,0,0,4,1,3,97,0,0,5,2,3,142,0,0,0,0,0,0,0,0,0,0,0,0,0,0
9171,9171,Richard Wright,2977,2001,Arsenal FC,4,4,0,354,0,0,7,7,0,630,0,0,11,11,0,984,0,0,0,0,0,0,0,0,0,0,0,0,0,0
9172,9172,Giovanni van Bronckhorst,2358,2001,Arsenal FC,10,6,4,638,0,0,10,7,3,669,1,0,20,13,7,1307,1,0,0,0,0,0,1,1,0,0,0,0,0,0
9173,9173,Matthew Upson,1279,2001,Arsenal FC,6,5,1,464,0,0,8,5,3,420,0,0,14,10,4,884,0,0,0,0,0,0,0,0,0,0,0,0,0,0
9174,9174,Terence Kongolo,3214,2017,Huddersfield Town,6,4,2,417,0,0,7,7,0,630,0,0,13,11,2,1047,0,0,0,0,0,0,0,0,0,0,0,0,0,0
9175,9175,Alex Pritchard,3028,2017,Huddersfield Town,7,6,1,521,1,0,7,6,1,481,0,0,14,12,2,1002,1,0,0,0,0,1,0,1,0,0,0,0,0,0
9176,9176,Florent Sinama-Pongolle,3873,2004,Liverpool FC,9,4,5,370,1,0,6,2,4,285,1,0,15,6,9,655,2,0,3,0,3,1,0,1,0,0,0,0,0,0
9177,9177,Arjen Robben,1767,2004,Chelsea FC,10,7,3,690,4,0,8,7,1,568,3,0,18,14,4,1258,7,0,3,3,6,1,3,4,0,0,0,0,0,0
9178,9178,Chris Herd,3040,2012,Aston Villa,5,5,0,419,0,0,3,3,0,245,0,0,8,8,0,664,0,0,0,0,0,0,0,0,0,0,0,0,0,0
9179,9179,Darren Bent,1958,2012,Aston Villa,9,3,6,343,1,0,7,5,2,464,2,0,16,8,8,807,3,0,1,0,1,1,2,3,0,0,0,0,0,0
9180,9180,Nathan Delfouneso,2175,2012,Aston Villa,1,1,0,46,0,0,0,0,0,0,0,0,1,1,0,46,0,0,0,0,0,0,0,0,0,0,0,0,0,0
9181,9181,Graham Burke,3874,2012,Aston Villa,0,0,0,0,0,0,0,0,0,0,0,0,0,0,0,0,0,0,0,0,0,0,0,0,0,0,0,0,0,0
9182,9182,Marco Borriello,3875,2013,West Ham United,1,0,1,44,0,0,1,0,1,44,0,0,2,0,2,88,0,0,0,0,0,0,0,0,0,0,0,0,0,0
9183,9183,Ian Bishop,3876,2000,Manchester City,8,2,6,392,0,0,2,1,1,133,0,0,10,3,7,525,0,0,0,0,0,0,0,0,0,0,0,0,0,0
9184,9184,Shaun Wright-Phillips,1683,2000,Manchester City,7,6,1,520,0,0,8,3,5,388,0,0,15,9,6,908,0,0,0,0,0,0,0,0,0,0,0,0,0,0
9185,9185,Hermann Hreiðarsson,1953,2000,Ipswich Town,18,18,0,1579,0,0,16,15,1,1349,1,0,34,33,1,2928,1,0,0,0,0,0,0,0,0,0,0,0,0,0
9186,9186,John Scales,3877,2000,Ipswich Town,0,0,0,0,0,0,2,2,0,180,0,0,2,2,0,180,0,0,0,0,0,0,0,0,0,0,0,0,0,0
9187,9187,Marcus Stewart,2722,2000,Ipswich Town,16,15,1,1287,8,0,16,16,0,1282,11,0,32,31,1,2569,19,0,4,3,7,6,6,12,1,1,2,0,0,0
9188,9188,David Johnson,3878,2000,Ipswich Town,7,4,3,335,0,0,6,2,4,272,0,0,13,6,7,607,0,0,0,0,0,0,0,0,0,0,0,0,0,0
9189,9189,Marouane Chamakh,1031,2012,Arsenal FC,0,0,0,0,0,0,0,0,0,0,0,0,0,0,0,0,0,0,0,0,0,0,0,0,0,0,0,0,0,0
9190,9190,Kieran Richardson,1898,2012,Fulham FC,5,4,1,299,0,0,9,8,1,527,1,0,14,12,2,826,1,0,0,0,0,0,1,1,0,0,0,0,0,0
9191,9191,Hugo Viana,2374,2002,Newcastle United,12,5,7,574,1,0,11,6,5,516,1,0,23,11,12,1090,2,0,3,1,4,1,1,2,0,0,0,0,0,0
9192,9192,Ian Harte,1291,2002,Leeds United,11,10,1,929,1,0,14,12,2,1112,2,0,25,22,3,2041,3,0,0,0,0,1,1,2,0,1,1,0,0,0
9193,9193,Jonathan Woodgate,1882,2002,Leeds United,8,8,0,720,1,0,9,9,0,781,0,0,17,17,0,1501,1,0,0,0,0,1,0,1,0,0,0,0,0,0
9194,9194,Dominic Matteo,1293,2002,Leeds United,9,9,0,759,0,0,10,10,0,881,0,0,19,19,0,1640,0,0,0,0,0,0,0,0,0,0,0,0,0,0
9195,9195,Olivier Dacourt,1295,2002,Leeds United,4,2,2,186,0,0,3,2,1,183,0,0,7,4,3,369,0,0,0,0,0,0,0,0,0,0,0,0,0,0
9196,9196,Harry Kewell,1296,2002,Leeds United,15,15,0,1291,5,0,15,15,0,1321,9,0,30,30,0,2612,14,0,3,0,3,4,5,9,0,0,0,0,0,0
9197,9197,Jermaine Pennant,1514,2013,Stoke City,4,0,4,101,0,0,4,0,4,78,1,0,8,0,8,179,1,0,0,3,3,0,1,1,0,0,0,0,0,0
9198,9198,Owen Garvan,3879,2013,Crystal Palace,1,1,0,65,0,0,1,0,1,26,0,0,2,1,1,91,0,0,0,0,0,0,0,0,0,0,0,0,0,0
9199,9199,Peter Ramage,1947,2013,Crystal Palace,0,0,0,0,0,0,0,0,0,0,0,0,0,0,0,0,0,0,0,0,0,0,0,0,0,0,0,0,0,0
9200,9200,Stephen Dobbie,3175,2013,Crystal Palace,1,1,0,66,0,0,0,0,0,0,0,0,1,1,0,66,0,0,0,0,0,0,0,0,0,0,0,0,0,0
9201,9201,Aaron Wilbraham,3048,2013,Crystal Palace,4,1,3,80,0,0,0,0,0,0,0,0,4,1,3,80,0,0,0,0,0,0,0,0,0,0,0,0,0,0
9202,9202,Kyle Walker-Peters,3113,2017,Tottenham Hotspur,1,1,0,90,0,0,2,1,1,98,0,0,3,2,1,188,0,0,0,0,0,0,0,0,0,0,0,0,0,0
9203,9203,Tashan Oakley-Boothe,3880,2017,Tottenham Hotspur,0,0,0,0,0,0,0,0,0,0,0,0,0,0,0,0,0,0,0,0,0,0,0,0,0,0,0,0,0,0
9204,9204,Vincent Janssen,2773,2017,Tottenham Hotspur,1,0,1,1,0,0,0,0,0,0,0,0,1,0,1,1,0,0,0,0,0,0,0,0,0,0,0,0,0,0
9205,9205,Tom Heaton,1249,2017,Burnley FC,2,2,0,126,0,0,2,2,0,180,0,0,4,4,0,306,0,0,0,0,0,0,0,0,0,0,0,0,0,0
9206,9206,Stuart Taylor,1684,2001,Arsenal FC,7,6,1,546,0,0,3,3,0,270,0,0,10,9,1,816,0,0,0,0,0,0,0,0,0,0,0,0,0,0
9207,9207,Carlo Cudicini,2370,2001,Chelsea FC,15,15,0,1350,0,0,11,10,1,910,0,0,26,25,1,2260,0,0,0,0,0,0,0,0,0,0,0,0,0,0
9208,9208,Dejan Stefanović,1066,2006,Portsmouth FC,10,10,0,876,0,0,10,10,0,830,0,0,20,20,0,1706,0,0,0,0,0,0,0,0,0,0,0,0,0,0
9209,9209,Lomana LuaLua,1074,2006,Portsmouth FC,14,5,9,586,1,0,8,3,5,360,1,0,22,8,14,946,2,0,3,3,6,1,1,2,1,0,1,0,0,0
9210,9210,Dedryck Boyata,1679,2013,Manchester City,1,1,0,55,0,0,0,0,0,0,0,0,1,1,0,55,0,0,0,0,0,0,0,0,0,0,0,0,0,0
9211,9211,Lloyd Dyer,3881,2004,West Bromwich Albion,4,0,4,79,0,0,0,0,0,0,0,0,4,0,4,79,0,0,0,0,0,0,0,0,0,0,0,0,0,0
9212,9212,Scott Dobie,3085,2004,West Bromwich Albion,3,0,3,79,0,0,2,1,1,104,1,0,5,1,4,183,1,0,0,0,0,0,1,1,0,0,0,0,0,0
9213,9213,Gary Cahill,1533,2005,Aston Villa,4,4,0,360,1,0,3,2,1,218,0,0,7,6,1,578,1,0,0,0,0,1,0,1,0,0,0,0,0,0
9214,9214,Gabriel Agbonlahor,1442,2005,Aston Villa,5,1,4,183,0,0,4,2,2,262,1,0,9,3,6,445,1,0,0,0,0,0,0,0,0,0,0,0,0,0
9215,9215,Javier Margas,3882,2000,West Ham United,2,2,0,148,0,0,1,1,0,90,0,0,3,3,0,238,0,0,0,0,0,0,0,0,0,0,0,0,0,0
9216,9216,Davor Šuker,3883,2000,West Ham United,5,3,2,244,1,0,5,3,2,276,1,0,10,6,4,520,2,0,1,1,2,1,1,2,0,0,0,0,0,0
9217,9217,Christian Bassila,3283,2000,West Ham United,3,0,3,78,0,0,0,0,0,0,0,0,3,0,3,78,0,0,0,0,0,0,0,0,0,0,0,0,0,0
9218,9218,Paul Kitson,3884,2000,West Ham United,2,0,2,35,0,0,0,0,0,0,0,0,2,0,2,35,0,0,0,0,0,0,0,0,0,0,0,0,0,0
9219,9219,Henning Berg,1346,2000,Manchester United,0,0,0,0,0,0,1,0,1,45,0,0,1,0,1,45,0,0,0,0,0,0,0,0,0,0,0,0,0,0
9220,9220,Jóhannes Guðjónsson,3064,2009,Burnley FC,4,0,4,108,0,0,6,1,5,203,0,0,10,1,9,311,0,0,0,0,0,0,0,0,0,0,0,0,0,0
9221,9221,Luke Young,1952,2009,Aston Villa,8,7,1,679,0,0,6,5,1,429,0,0,14,12,2,1108,0,0,0,0,0,0,0,0,0,0,0,0,0,0
9222,9222,Eldin Jakupović,2563,2014,Hull City,1,1,0,90,0,0,2,1,1,137,0,0,3,2,1,227,0,0,0,0,0,0,0,0,0,0,0,0,0,0
9223,9223,Nemanja Vidić,1725,2011,Manchester United,2,2,0,180,0,0,4,4,0,322,0,0,6,6,0,502,0,0,0,0,0,0,0,0,0,0,0,0,0,0
9224,9224,Darren Fletcher,1730,2011,Manchester United,4,4,0,360,1,0,4,3,1,284,0,0,8,7,1,644,1,0,0,0,0,0,0,0,0,0,0,0,0,0
9225,9225,Wes Brown,1108,2011,Sunderland AFC,11,11,0,926,0,0,9,9,0,810,1,0,20,20,0,1736,1,0,0,3,3,0,1,1,0,0,0,0,0,0
9226,9226,Trevor Carson,3885,2011,Sunderland AFC,0,0,0,0,0,0,0,0,0,0,0,0,0,0,0,0,0,0,0,0,0,0,0,0,0,0,0,0,0,0
9227,9227,John Egan,3467,2011,Sunderland AFC,0,0,0,0,0,0,0,0,0,0,0,0,0,0,0,0,0,0,0,0,0,0,0,0,0,0,0,0,0,0
9228,9228,Asmir Begović,1036,2011,Stoke City,11,11,0,990,0,0,12,11,1,1007,0,0,23,22,1,1997,0,0,0,0,0,0,0,0,0,0,0,0,0,0
9229,9229,Robert Huth,1884,2011,Stoke City,17,15,2,1380,1,0,17,16,1,1498,2,0,34,31,3,2878,3,0,0,4,4,1,2,3,0,0,0,0,0,0
9230,9230,Marc Wilson,1546,2011,Stoke City,17,17,0,1481,0,0,18,18,0,1426,0,0,35,35,0,2907,0,0,0,0,0,0,0,0,0,0,0,0,0,0
9231,9231,Ryan Shawcross,1547,2011,Stoke City,19,19,0,1639,1,0,17,17,0,1530,1,0,36,36,0,3169,2,0,0,0,0,0,0,0,0,0,0,0,0,0
9232,9232,Ryan Shotton,3517,2011,Stoke City,11,7,4,658,0,0,12,7,5,734,1,0,23,14,9,1392,1,0,0,3,3,0,1,1,0,0,0,0,0,0
9233,9233,Glenn Whelan,1549,2011,Stoke City,16,14,2,1288,1,0,14,13,1,1198,0,0,30,27,3,2486,1,0,0,0,0,0,0,0,0,0,0,0,0,0
9234,9234,Jermaine Pennant,1514,2011,Stoke City,15,11,4,1041,0,0,12,7,5,662,0,0,27,18,9,1703,0,0,0,0,0,0,0,0,0,0,0,0,0,0
9235,9235,Dean Whitehead,1218,2011,Stoke City,15,11,4,1045,0,0,18,13,5,1319,0,0,33,24,9,2364,0,0,0,0,0,0,0,0,0,0,0,0,0,0
9236,9236,Matthew Etherington,1557,2011,Stoke City,18,18,0,1470,3,0,12,12,0,909,0,0,30,30,0,2379,3,0,3,0,3,2,0,2,0,0,0,0,0,0
9237,9237,Jon Walters,1555,2011,Stoke City,19,19,0,1666,7,0,19,19,0,1670,0,0,38,38,0,3336,7,0,4,0,4,6,0,6,4,0,4,0,0,0
9238,9238,Peter Crouch,1273,2011,Stoke City,17,17,0,1450,6,0,15,14,1,1239,4,0,32,31,1,2689,10,0,4,3,7,4,3,7,0,0,0,0,0,0
9239,9239,Wilson Palacios,1271,2011,Stoke City,7,2,5,193,0,0,11,7,4,610,0,0,18,9,9,803,0,0,0,0,0,0,0,0,0,0,0,0,0,0
9240,9240,Rory Delap,1993,2011,Stoke City,16,11,5,961,2,0,10,7,3,566,0,0,26,18,8,1527,2,0,0,0,0,1,0,1,0,0,0,0,0,0
9241,9241,Cameron Jerome,1783,2011,Stoke City,11,2,9,258,3,0,12,5,7,581,1,0,23,7,16,839,4,0,1,0,1,3,1,4,0,0,0,0,0,0
9242,9242,Thomas Sørensen,1090,2011,Stoke City,8,8,0,720,0,0,8,8,0,703,0,0,16,16,0,1423,0,0,0,0,0,0,0,0,0,0,0,0,0,0
9243,9243,Matthew Upson,1279,2011,Stoke City,7,5,2,529,1,0,7,5,2,490,0,0,14,10,4,1019,1,0,0,0,0,1,0,1,0,0,0,0,0,0
9244,9244,Kenwyne Jones,1222,2011,Stoke City,10,3,7,367,0,0,11,7,4,610,1,0,21,10,11,977,1,0,0,1,1,0,1,1,0,0,0,0,0,0
9245,9245,Ricardo Fuller,2500,2011,Stoke City,4,1,3,147,0,0,9,2,7,269,0,0,13,3,10,416,0,0,0,0,0,0,0,0,0,0,0,0,0,0
9246,9246,Ronald Zubar,2887,2011,Wolverhampton Wanderers,7,7,0,630,1,0,8,7,1,583,0,0,15,14,1,1213,1,0,1,0,1,1,0,1,0,0,0,0,0,0
9247,9247,Dave Edwards,2889,2011,Wolverhampton Wanderers,12,12,0,937,2,0,14,12,2,1000,1,0,26,24,2,1937,3,0,0,0,0,2,0,2,0,0,0,0,0,0
9248,9248,David Davis,3886,2011,Wolverhampton Wanderers,5,5,0,304,0,0,2,1,1,94,0,0,7,6,1,398,0,0,0,0,0,0,0,0,0,0,0,0,0,0
9249,9249,Anthony Forde,3887,2011,Wolverhampton Wanderers,2,1,1,65,0,0,4,2,2,178,0,0,6,3,3,243,0,0,0,0,0,0,0,0,0,0,0,0,0,0
9250,9250,Stephen Glass,3888,2000,Newcastle United,8,4,4,441,3,0,6,1,5,127,0,0,14,5,9,568,3,0,1,0,1,2,0,2,0,0,0,0,0,0
9251,9251,Shola Ameobi,1950,2000,Newcastle United,9,4,5,394,1,0,9,7,2,596,1,0,18,11,7,990,2,0,0,0,0,0,0,0,0,0,0,0,0,0
9252,9252,Rade Prica,3889,2007,Sunderland AFC,4,0,4,151,1,0,2,0,2,89,0,0,6,0,6,240,1,0,0,0,0,0,0,0,0,0,0,0,0,0
9253,9253,Daniel Williams,3105,2018,Huddersfield Town,1,0,1,13,0,0,4,1,3,82,0,0,5,1,4,95,0,0,0,0,0,0,0,0,0,0,0,0,0,0
9254,9254,Ramadan Sobhi,1586,2018,Huddersfield Town,1,0,1,30,0,0,3,0,3,45,0,0,4,0,4,75,0,0,0,0,0,0,0,0,0,0,0,0,0,0
9255,9255,Kelvin Etuhu,3678,2008,Manchester City,2,1,1,77,0,0,1,0,1,24,0,0,3,1,2,101,0,0,0,0,0,0,0,0,0,0,0,0,0,0
9256,9256,Valeri Bojinov,3890,2008,Manchester City,4,2,2,155,0,0,4,0,4,66,1,0,8,2,6,221,1,0,0,0,0,0,1,1,0,0,0,0,0,0
9257,9257,Raphael Spiegel,2761,2016,West Ham United,0,0,0,0,0,0,0,0,0,0,0,0,0,0,0,0,0,0,0,0,0,0,0,0,0,0,0,0,0,0
9258,9258,Rob Kozluk,3891,2006,Sheffield United,8,7,1,655,0,0,10,9,1,744,0,0,18,16,2,1399,0,0,0,0,0,0,0,0,0,0,0,0,0,0
9259,9259,Albert Ferrer,3179,2000,Chelsea FC,9,8,1,598,0,0,5,4,1,404,0,0,14,12,2,1002,0,0,0,0,0,0,0,0,0,0,0,0,0,0
9260,9260,Joe Dodoo,3892,2015,Leicester City,0,0,0,0,0,0,1,0,1,19,0,0,1,0,1,19,0,0,0,0,0,0,0,0,0,0,0,0,0,0
9261,9261,Chris Marsden,2048,2003,Southampton FC,7,5,2,408,0,0,5,3,2,356,0,0,12,8,4,764,0,0,0,0,0,0,0,0,0,0,0,0,0,0
9262,9262,Craig Short,1133,2004,Blackburn Rovers,8,7,1,534,1,0,5,5,0,450,0,0,13,12,1,984,1,0,1,0,1,1,0,1,0,0,0,0,0,0
9263,9263,Dominic Matteo,1293,2004,Blackburn Rovers,15,14,1,1217,0,0,12,10,2,929,0,0,27,24,3,2146,0,0,0,0,0,0,0,0,0,0,0,0,0,0
9264,9264,Jay Bothroyd,1960,2004,Blackburn Rovers,5,3,2,270,1,0,6,3,3,264,0,0,11,6,5,534,1,0,0,0,0,1,0,1,0,0,0,0,0,0
9265,9265,Lewis Kinsella,3893,2014,Aston Villa,0,0,0,0,0,0,0,0,0,0,0,0,0,0,0,0,0,0,0,0,0,0,0,0,0,0,0,0,0,0
9266,9266,Stephen McPhail,3695,2000,Leeds United,2,0,2,69,0,0,4,2,2,197,0,0,6,2,4,266,0,0,0,0,0,0,0,0,0,0,0,0,0,0
9267,9267,Gary Cahill,1533,2011,Chelsea FC,5,5,0,450,0,0,5,4,1,405,1,0,10,9,1,855,1,0,0,0,0,0,1,1,0,0,0,0,0,0
9268,9268,Michael Essien,1763,2011,Chelsea FC,7,6,1,526,0,0,7,4,3,392,0,0,14,10,4,918,0,0,0,0,0,0,0,0,0,0,0,0,0,0
9269,9269,Sam Hutchinson,3894,2011,Chelsea FC,2,1,1,78,0,0,0,0,0,0,0,0,2,1,1,78,0,0,0,0,0,0,0,0,0,0,0,0,0,0
9270,9270,Ryan Bertrand,1148,2011,Chelsea FC,3,3,0,270,0,0,4,3,1,270,0,0,7,6,1,540,0,0,0,0,0,0,0,0,0,0,0,0,0,0
9271,9271,Lucas Piazón,3895,2011,Chelsea FC,0,0,0,0,0,0,0,0,0,0,0,0,0,0,0,0,0,0,0,0,0,0,0,0,0,0,0,0,0,0
9272,9272,Romelu Lukaku,1645,2011,Chelsea FC,3,1,2,79,0,0,5,0,5,78,0,0,8,1,7,157,0,0,0,0,0,0,0,0,0,0,0,0,0,0
9273,9273,Paul Pogba,1642,2011,Manchester United,2,0,2,34,0,0,1,0,1,32,0,0,3,0,3,66,0,0,0,0,0,0,0,0,0,0,0,0,0,0
9274,9274,Stuart Taylor,1684,2006,Aston Villa,3,2,1,200,0,0,3,2,1,224,0,0,6,4,2,424,0,0,0,0,0,0,0,0,0,0,0,0,0,0
9275,9275,Kevin Poole,3502,2004,Bolton Wanderers,1,1,0,90,0,0,1,0,1,2,0,0,2,1,1,92,0,0,0,0,0,0,0,0,0,0,0,0,0,0
9276,9276,Gianluca Festa,3551,2001,Middlesbrough FC,5,5,0,450,1,0,3,3,0,270,0,0,8,8,0,720,1,0,3,0,3,1,0,1,0,0,0,0,0,0
9277,9277,Luke Wilkshire,3429,2001,Middlesbrough FC,4,4,0,265,0,0,2,1,1,159,0,0,6,5,1,424,0,0,0,0,0,0,0,0,0,0,0,0,0,0
9278,9278,Mickaël Debève,3896,2001,Middlesbrough FC,2,0,2,90,0,0,2,1,1,104,0,0,4,1,3,194,0,0,0,0,0,0,0,0,0,0,0,0,0,0
9279,9279,Jay Lynch,3897,2011,Bolton Wanderers,0,0,0,0,0,0,0,0,0,0,0,0,0,0,0,0,0,0,0,0,0,0,0,0,0,0,0,0,0,0
9280,9280,Joe Riley,3898,2011,Bolton Wanderers,1,1,0,90,0,0,2,1,1,111,0,0,3,2,1,201,0,0,0,0,0,0,0,0,0,0,0,0,0,0
9281,9281,Michael O’Halloran,3899,2011,Bolton Wanderers,0,0,0,0,0,0,0,0,0,0,0,0,0,0,0,0,0,0,0,0,0,0,0,0,0,0,0,0,0,0
9282,9282,Darren Randolph,2637,2019,West Ham United,1,1,0,90,0,0,1,1,0,90,0,0,2,2,0,180,0,0,0,0,0,0,0,0,0,0,0,0,0,0
9283,9283,Winston Reid,2638,2019,West Ham United,0,0,0,0,0,0,0,0,0,0,0,0,0,0,0,0,0,0,0,0,0,0,0,0,0,0,0,0,0,0
9284,9284,Gonçalo Cardoso,3900,2019,West Ham United,0,0,0,0,0,0,0,0,0,0,0,0,0,0,0,0,0,0,0,0,0,0,0,0,0,0,0,0,0,0
9285,9285,Jeremy Ngakia,3901,2019,West Ham United,3,3,0,261,0,0,2,2,0,180,0,0,5,5,0,441,0,0,0,0,0,0,0,0,0,0,0,0,0,0
9286,9286,Lewis Gibson,3902,2019,Everton FC,0,0,0,0,0,0,0,0,0,0,0,0,0,0,0,0,0,0,0,0,0,0,0,0,0,0,0,0,0,0
9287,9287,Tamir Cohen,2671,2008,Bolton Wanderers,2,2,0,133,1,0,2,1,1,86,0,0,4,3,1,219,1,0,1,0,1,1,0,1,0,0,0,0,0,0
9288,9288,Roy Keane,1111,2002,Manchester United,9,8,1,751,0,0,12,11,1,1012,0,0,21,19,2,1763,0,0,0,0,0,0,0,0,0,0,0,0,0,0
9289,9289,Davy Klaassen,3903,2017,Everton FC,5,3,2,177,0,0,2,0,2,73,0,0,7,3,4,250,0,0,0,0,0,0,0,0,0,0,0,0,0,0
9290,9290,Kevin Mirallas,2238,2017,Everton FC,1,0,1,13,0,0,4,2,2,124,0,0,5,2,3,137,0,0,0,0,0,0,0,0,0,0,0,0,0,0
9291,9291,Gastón Ramírez,2226,2015,Southampton FC,0,0,0,0,0,0,3,0,3,28,0,0,3,0,3,28,0,0,0,0,0,0,0,0,0,0,0,0,0,0
9292,9292,Lee Tomlin,3904,2015,AFC Bournemouth,3,2,1,172,0,0,3,1,2,117,0,0,6,3,3,289,0,0,0,0,0,0,0,0,0,0,0,0,0,0
9293,9293,Ryan Allsop,3288,2015,AFC Bournemouth,1,0,1,44,0,0,0,0,0,0,0,0,1,0,1,44,0,0,0,0,0,0,0,0,0,0,0,0,0,0
9294,9294,Baily Cargill,3289,2015,AFC Bournemouth,0,0,0,0,0,0,0,0,0,0,0,0,0,0,0,0,0,0,0,0,0,0,0,0,0,0,0,0,0,0
9295,9295,Valon Behrami,1284,2010,West Ham United,3,3,0,239,1,0,4,3,1,277,1,0,7,6,1,516,2,0,0,0,0,1,0,1,0,0,0,0,0,0
9296,9296,Leon Balogun,2485,2019,Brighton & Hove Albion,0,0,0,0,0,0,0,0,0,0,0,0,0,0,0,0,0,0,0,0,0,0,0,0,0,0,0,0,0,0
9297,9297,Ronnie Wallwork,1600,2005,West Bromwich Albion,15,15,0,1305,0,0,15,15,0,1318,0,0,30,30,0,2623,0,0,0,0,0,0,0,0,0,0,0,0,0,0
9298,9298,Eduardo,3544,2016,Chelsea FC,0,0,0,0,0,0,0,0,0,0,0,0,0,0,0,0,0,0,0,0,0,0,0,0,0,0,0,0,0,0
9299,9299,Fabricio,3905,2018,Fulham FC,1,1,0,90,0,0,1,1,0,90,0,0,2,2,0,180,0,0,0,0,0,0,0,0,0,0,0,0,0,0
9300,9300,Calum Chambers,1470,2018,Fulham FC,17,16,1,1458,2,0,14,13,1,1129,0,0,31,29,2,2587,2,0,0,0,0,1,0,1,0,0,0,0,0,0
9301,9301,Maxime Le Marchand,3906,2018,Fulham FC,14,13,1,1171,0,0,12,12,0,1080,0,0,26,25,1,2251,0,0,0,0,0,0,0,0,0,0,0,0,0,0
9302,9302,Timothy Fosu-Mensah,2255,2018,Fulham FC,6,6,0,499,0,0,6,4,2,296,0,0,12,10,2,795,0,0,0,0,0,0,0,0,0,0,0,0,0,0
9303,9303,Joe Bryan,3907,2018,Fulham FC,15,14,1,1214,0,0,13,13,0,1136,0,0,28,27,1,2350,0,0,0,0,0,0,0,0,0,0,0,0,0,0
9304,9304,Tom Cairney,1611,2018,Fulham FC,16,11,5,1107,1,0,15,13,2,1091,0,0,31,24,7,2198,1,0,0,0,0,1,0,1,0,0,0,0,0,0
9305,9305,Jean Michaël Seri,3908,2018,Fulham FC,15,14,1,1112,1,0,17,13,4,1140,0,0,32,27,5,2252,1,0,0,0,0,1,0,1,0,0,0,0,0,0
9306,9306,André Anguissa,3909,2018,Fulham FC,10,6,4,587,0,0,12,10,2,953,0,0,22,16,6,1540,0,0,0,0,0,0,0,0,0,0,0,0,0,0
9307,9307,Ryan Sessegnon,2987,2018,Fulham FC,18,11,7,1095,1,0,17,15,2,1203,1,0,35,26,9,2298,2,0,0,0,0,1,1,2,0,0,0,0,0,0
9308,9308,Aleksandar Mitrović,2285,2018,Fulham FC,18,18,0,1616,8,0,19,19,0,1666,3,0,37,37,0,3282,11,0,7,3,10,7,2,9,0,1,1,0,0,0
9309,9309,Aboubakar Kamara,3910,2018,Fulham FC,8,4,4,468,1,0,5,1,4,219,2,0,13,5,8,687,3,0,0,0,0,1,0,1,0,1,1,0,0,0
9310,9310,Cyrus Christie,3911,2018,Fulham FC,15,10,5,1053,0,0,13,9,4,890,0,0,28,19,9,1943,0,0,0,0,0,0,0,0,0,0,0,0,0,0
9311,9311,Stefan Johansen,3912,2018,Fulham FC,5,1,4,130,0,0,7,3,4,282,0,0,12,4,8,412,0,0,0,0,0,0,0,0,0,0,0,0,0,0
9312,9312,André Schürrle,1540,2018,Fulham FC,12,11,1,829,3,0,12,10,2,823,3,0,24,21,3,1652,6,0,0,0,0,2,3,5,0,0,0,0,0,0
9313,9313,Sergio Rico,3913,2018,Fulham FC,15,15,0,1350,0,0,14,14,0,1260,0,0,29,29,0,2610,0,0,0,0,0,0,0,0,0,0,0,0,0,0
9314,9314,Kevin McDonald,2552,2018,Fulham FC,8,5,3,416,0,0,7,5,2,468,0,0,15,10,5,884,0,0,0,0,0,0,0,0,0,0,0,0,0,0
9315,9315,Neeskens Kebano,3914,2018,Fulham FC,5,0,5,74,0,0,2,0,2,27,0,0,7,0,7,101,0,0,0,0,0,0,0,0,0,0,0,0,0,0
9316,9316,Luciano Vietto,3915,2018,Fulham FC,9,6,3,549,1,0,11,4,7,434,0,0,20,10,10,983,1,0,0,0,0,0,0,0,0,0,0,0,0,0
9317,9317,David Bellion,1944,2002,Sunderland AFC,6,3,3,316,1,0,5,2,3,268,0,0,11,5,6,584,1,0,3,0,3,1,0,1,0,0,0,0,0,0
9318,9318,Michael Gray,1092,2004,Southampton FC,1,1,0,89,0,0,0,0,0,0,0,0,1,1,0,89,0,0,0,0,0,0,0,0,0,0,0,0,0,0
9319,9319,Vratislav Greško,2010,2004,Southampton FC,1,0,1,1,0,0,0,0,0,0,0,0,1,0,1,1,0,0,0,0,0,0,0,0,0,0,0,0,0,0
9320,9320,Tim Howard,1743,2014,Everton FC,16,16,0,1396,0,0,16,16,0,1440,0,0,32,32,0,2836,0,0,0,0,0,0,0,0,0,0,0,0,0,0
9321,9321,Leon Osman,1747,2014,Everton FC,10,9,1,870,1,0,11,4,7,405,1,0,21,13,8,1275,2,0,3,0,3,1,1,2,0,0,0,0,0,0
9322,9322,Tony Hibbert,1744,2014,Everton FC,1,1,0,90,0,0,3,3,0,241,0,0,4,4,0,331,0,0,0,0,0,0,0,0,0,0,0,0,0,0
9323,9323,Luke Garbutt,2297,2014,Everton FC,1,0,1,16,0,0,3,3,0,270,0,0,4,3,1,286,0,0,0,0,0,0,0,0,0,0,0,0,0,0
9324,9324,Steven Pienaar,2406,2014,Everton FC,5,1,4,99,0,0,4,2,2,215,0,0,9,3,6,314,0,0,0,0,0,0,0,0,0,0,0,0,0,0
9325,9325,Amdy Faye,1070,2006,Charlton Athletic,13,10,3,873,0,0,15,15,0,1216,1,0,28,25,3,2089,1,0,0,3,3,0,1,1,0,0,0,0,0,0
9326,9326,Omar Pouso,3916,2006,Charlton Athletic,1,1,0,57,0,0,0,0,0,0,0,0,1,1,0,57,0,0,0,0,0,0,0,0,0,0,0,0,0,0
9327,9327,Jonathan Fortune,2665,2006,Charlton Athletic,3,2,1,225,0,0,5,4,1,418,0,0,8,6,2,643,0,0,0,0,0,0,0,0,0,0,0,0,0,0
9328,9328,Kevin Lisbie,2337,2006,Charlton Athletic,5,1,4,140,0,0,3,0,3,45,0,0,8,1,7,185,0,0,0,0,0,0,0,0,0,0,0,0,0,0
9329,9329,Anton Ferdinand,1686,2006,West Ham United,15,15,0,1282,0,0,15,15,0,1278,0,0,30,30,0,2560,0,0,0,0,0,0,0,0,0,0,0,0,0,0
9330,9330,George McCartney,1340,2006,West Ham United,12,8,4,825,0,0,9,8,1,623,0,0,21,16,5,1448,0,0,0,0,0,0,0,0,0,0,0,0,0,0
9331,9331,Mark Noble,2204,2006,West Ham United,5,5,0,450,2,0,5,5,0,389,0,0,10,10,0,839,2,0,0,0,0,1,0,1,0,0,0,0,0,0
9332,9332,Bobby Zamora,1943,2006,West Ham United,17,13,4,1068,7,0,14,13,1,1038,4,0,31,26,5,2106,11,0,4,7,11,7,4,11,0,0,0,0,0,0
9333,9333,Steve Staunton,3494,2000,Aston Villa,6,6,0,461,0,0,7,6,1,562,0,0,13,12,1,1023,0,0,0,0,0,0,0,0,0,0,0,0,0,0
9334,9334,Jlloyd Samuel,1789,2000,Aston Villa,2,1,1,95,0,0,1,0,1,7,0,0,3,1,2,102,0,0,0,0,0,0,0,0,0,0,0,0,0,0
9335,9335,David Ginola,3869,2000,Aston Villa,15,9,6,834,2,0,11,4,7,405,1,0,26,13,13,1239,3,0,1,0,1,2,0,2,0,0,0,0,0,0
9336,9336,John McGrath,3917,2000,Aston Villa,1,0,1,45,0,0,1,0,1,1,0,0,2,0,2,46,0,0,0,0,0,0,0,0,0,0,0,0,0,0
9337,9337,Thomas Hitzlsperger,1792,2000,Aston Villa,1,0,1,6,0,0,0,0,0,0,0,0,1,0,1,6,0,0,0,0,0,0,0,0,0,0,0,0,0,0
9338,9338,Mark Halstead,3918,2010,Blackpool FC,1,0,1,23,0,0,0,0,0,0,0,0,1,0,1,23,0,0,0,0,0,0,0,0,0,0,0,0,0,0
9339,9339,Anthony Gardner,1120,2009,Hull City,13,13,0,1170,0,0,11,11,0,990,0,0,24,24,0,2160,0,0,0,0,0,0,0,0,0,0,0,0,0,0
9340,9340,Bernard Mendy,2612,2009,Hull City,11,10,1,884,0,0,10,5,5,547,0,0,21,15,6,1431,0,0,0,0,0,0,0,0,0,0,0,0,0,0
9341,9341,Nick Barmby,2133,2009,Hull City,8,2,6,298,0,0,12,4,8,453,0,0,20,6,14,751,0,0,0,0,0,0,0,0,0,0,0,0,0,0
9342,9342,Caleb Folan,2613,2009,Hull City,3,3,0,239,0,0,5,4,1,327,2,0,8,7,1,566,2,0,0,0,0,0,2,2,0,0,0,0,0,0
9343,9343,Mark Cullen,3919,2009,Hull City,2,1,1,105,0,0,1,1,0,90,1,0,3,2,1,195,1,0,0,0,0,0,1,1,0,0,0,0,0,0
9344,9344,Alan Hutton,2172,2009,Sunderland AFC,6,6,0,540,0,0,5,5,0,450,0,0,11,11,0,990,0,0,0,0,0,0,0,0,0,0,0,0,0,0
9345,9345,Jamal Campbell-Ryce,3920,2003,Charlton Athletic,2,0,2,34,0,0,0,0,0,0,0,0,2,0,2,34,0,0,0,0,0,0,0,0,0,0,0,0,0,0
9346,9346,Bruno N'Gotty,3076,2001,Bolton Wanderers,13,12,1,1092,0,0,13,12,1,1086,1,0,26,24,2,2178,1,0,0,0,0,0,0,0,0,0,0,0,0,0
9347,9347,Guðni Bergsson,3500,2001,Bolton Wanderers,15,15,0,1314,0,0,15,15,0,1336,1,0,30,30,0,2650,1,0,0,0,0,0,1,1,0,0,0,0,0,0
9348,9348,Bo Hansen,3921,2001,Bolton Wanderers,7,5,2,429,0,0,10,5,5,444,1,0,17,10,7,873,1,0,0,1,1,0,1,1,0,0,0,0,0,0
9349,9349,Michael Ricketts,2140,2001,Bolton Wanderers,18,11,7,1138,5,0,19,15,4,1323,7,0,37,26,11,2461,12,0,5,4,9,5,4,9,0,0,0,0,0,0
9350,9350,Ionel Ganea,3922,2003,Wolverhampton Wanderers,8,3,5,298,1,0,8,3,5,341,2,0,16,6,10,639,3,0,0,1,1,1,2,3,0,0,0,0,0,0
9351,9351,Mauricio Taricco,1118,2000,Tottenham Hotspur,3,1,2,126,0,0,2,1,1,109,0,0,5,2,3,235,0,0,0,0,0,0,0,0,0,0,0,0,0,0
9352,9352,Gary Croft,3923,2000,Ipswich Town,3,2,1,185,0,0,5,4,1,299,0,0,8,6,2,484,0,0,0,0,0,0,0,0,0,0,0,0,0,0
9353,9353,Wayne Brown,3924,2000,Ipswich Town,1,0,1,1,0,0,3,0,3,83,0,0,4,0,4,84,0,0,0,0,0,0,0,0,0,0,0,0,0,0
9354,9354,Ben Watson,2025,2008,Wigan Athletic,4,2,2,259,1,0,6,4,2,393,1,0,10,6,4,652,2,0,3,0,3,1,1,2,0,0,0,0,0,0
9355,9355,Hiram Boateng,3611,2014,Crystal Palace,0,0,0,0,0,0,0,0,0,0,0,0,0,0,0,0,0,0,0,0,0,0,0,0,0,0,0,0,0,0
9356,9356,Shola Ameobi,1950,2014,Crystal Palace,1,0,1,10,0,0,3,0,3,28,0,0,4,0,4,38,0,0,0,0,0,0,0,0,0,0,0,0,0,0
9357,9357,Cabral,3861,2014,Sunderland AFC,0,0,0,0,0,0,0,0,0,0,0,0,0,0,0,0,0,0,0,0,0,0,0,0,0,0,0,0,0,0
9358,9358,Dedryck Boyata,1679,2014,Manchester City,0,0,0,0,0,0,2,1,1,91,0,0,2,1,1,91,0,0,0,0,0,0,0,0,0,0,0,0,0,0
9359,9359,José Pozo,3925,2014,Manchester City,1,0,1,83,0,0,2,1,1,81,0,0,3,1,2,164,0,0,0,0,0,0,0,0,0,0,0,0,0,0
9360,9360,Alexander Cleland,3926,2000,Everton FC,2,1,1,171,0,0,3,1,2,50,0,0,5,2,3,221,0,0,0,0,0,0,0,0,0,0,0,0,0,0
9361,9361,Simon Davies,1125,2000,Tottenham Hotspur,5,5,0,375,1,0,6,3,3,287,1,0,11,8,3,662,2,0,3,0,3,1,1,2,0,0,0,0,0,0
9362,9362,Benjamin Mendy,2674,2017,Manchester City,5,2,3,181,0,0,2,2,0,180,0,0,7,4,3,361,0,0,0,0,0,0,0,0,0,0,0,0,0,0
9363,9363,Justin Hoyte,3282,2004,Arsenal FC,2,1,1,101,0,0,3,3,0,270,0,0,5,4,1,371,0,0,0,0,0,0,0,0,0,0,0,0,0,0
9364,9364,Aaron Wan-Bissaka,2702,2017,Crystal Palace,4,4,0,358,0,0,3,3,0,270,0,0,7,7,0,628,0,0,0,0,0,0,0,0,0,0,0,0,0,0
9365,9365,Georges-Kévin N'Koudou,2801,2017,Burnley FC,2,0,2,27,0,0,6,2,4,197,0,0,8,2,6,224,0,0,0,0,0,0,0,0,0,0,0,0,0,0
9366,9366,Andrey Arshavin,2750,2008,Arsenal FC,6,6,0,494,1,0,6,6,0,503,5,0,12,12,0,997,6,0,0,0,0,0,4,4,0,0,0,0,0,0
9367,9367,Kevin Campbell,1601,2005,West Bromwich Albion,14,9,5,724,2,0,15,10,5,816,1,0,29,19,10,1540,3,0,0,0,0,1,0,1,0,0,0,0,0,0
9368,9368,Stuart Taylor,1684,2005,Aston Villa,0,0,0,0,0,0,2,2,0,180,0,0,2,2,0,180,0,0,0,0,0,0,0,0,0,0,0,0,0,0
9369,9369,Jonathan Stevenson,3927,2001,Leicester City,2,0,2,71,1,0,4,0,4,44,0,0,6,0,6,115,1,0,1,0,1,1,0,1,0,0,0,0,0,0
9370,9370,Alex Oxlade-Chamberlain,1184,2013,Arsenal FC,6,3,3,223,2,0,8,3,5,300,0,0,14,6,8,523,2,0,0,0,0,1,0,1,0,0,0,0,0,0
9371,9371,Chu-young Park,3274,2013,Arsenal FC,0,0,0,0,0,0,0,0,0,0,0,0,0,0,0,0,0,0,0,0,0,0,0,0,0,0,0,0,0,0
9372,9372,Brandon Mason,3928,2016,Watford FC,2,1,1,112,0,0,0,0,0,0,0,0,2,1,1,112,0,0,0,0,0,0,0,0,0,0,0,0,0,0
9373,9373,M'Baye Niang,3929,2016,Watford FC,8,8,0,661,2,0,8,7,1,593,0,0,16,15,1,1254,2,0,0,0,0,1,0,1,0,0,0,0,0,0
9374,9374,Stefano Okaka,2333,2016,Watford FC,9,5,4,470,3,0,10,5,5,485,1,0,19,10,9,955,4,0,0,0,0,2,1,3,0,0,0,0,0,0
9375,9375,Andrew Eleftheriou,3930,2016,Watford FC,1,0,1,51,0,0,0,0,0,0,0,0,1,0,1,51,0,0,0,0,0,0,0,0,0,0,0,0,0,0
9376,9376,Dion Pereira,3931,2016,Watford FC,1,0,1,16,0,0,1,0,1,7,0,0,2,0,2,23,0,0,0,0,0,0,0,0,0,0,0,0,0,0
9377,9377,Rene Gilmartin,3637,2016,Watford FC,0,0,0,0,0,0,0,0,0,0,0,0,0,0,0,0,0,0,0,0,0,0,0,0,0,0,0,0,0,0
9378,9378,Angus Gunn,2159,2016,Manchester City,0,0,0,0,0,0,0,0,0,0,0,0,0,0,0,0,0,0,0,0,0,0,0,0,0,0,0,0,0,0
9379,9379,Alexander Tettey,1830,2012,Norwich City,14,10,4,909,0,0,13,11,2,993,0,0,27,21,6,1902,0,0,0,0,0,0,0,0,0,0,0,0,0,0
9380,9380,Celestine Babayaro,2015,2003,Chelsea FC,3,3,0,253,0,0,3,2,1,187,1,0,6,5,1,440,1,0,0,0,0,0,0,0,0,0,0,0,0,0
9381,9381,Davide Santon,2451,2014,Newcastle United,0,0,0,0,0,0,0,0,0,0,0,0,0,0,0,0,0,0,0,0,0,0,0,0,0,0,0,0,0,0
9382,9382,Benny Ashley-Seal,3932,2019,Wolverhampton Wanderers,0,0,0,0,0,0,0,0,0,0,0,0,0,0,0,0,0,0,0,0,0,0,0,0,0,0,0,0,0,0
9383,9383,Anthony Gardner,1120,2005,Tottenham Hotspur,7,7,0,630,0,0,10,9,1,775,0,0,17,16,1,1405,0,0,0,0,0,0,0,0,0,0,0,0,0,0
9384,9384,Aaron Lennon,1052,2005,Tottenham Hotspur,16,11,5,998,1,0,11,10,1,820,1,0,27,21,6,1818,2,0,3,0,3,1,1,2,0,0,0,0,0,0
9385,9385,Iain Turner,3933,2006,Everton FC,1,1,0,90,0,0,0,0,0,0,0,0,1,1,0,90,0,0,0,0,0,0,0,0,0,0,0,0,0,0
9386,9386,Tony Hibbert,1744,2006,Everton FC,6,5,1,455,0,0,6,6,0,483,0,0,12,11,1,938,0,0,0,0,0,0,0,0,0,0,0,0,0,0
9387,9387,Andy van der Meyde,3520,2006,Everton FC,6,4,2,306,0,0,2,1,1,81,0,0,8,5,3,387,0,0,0,0,0,0,0,0,0,0,0,0,0,0
9388,9388,Chris Eagles,2491,2006,Manchester United,0,0,0,0,0,0,2,1,1,94,1,0,2,1,1,94,1,0,0,0,0,0,0,0,0,0,0,0,0,0
9389,9389,Robert Huth,1884,2004,Chelsea FC,4,3,1,234,0,0,6,3,3,304,0,0,10,6,4,538,0,0,0,0,0,0,0,0,0,0,0,0,0,0
9390,9390,Luc Nilis,3934,2000,Aston Villa,1,1,0,70,1,0,2,2,0,97,0,0,3,3,0,167,1,0,0,0,0,1,0,1,0,0,0,0,0,0
9391,9391,Mario Stanić,3414,2000,Chelsea FC,6,5,1,375,2,0,6,3,3,188,0,0,12,8,4,563,2,0,0,0,0,0,0,0,0,0,0,0,0,0
9392,9392,Kyle Taylor,3935,2017,AFC Bournemouth,0,0,0,0,0,0,0,0,0,0,0,0,0,0,0,0,0,0,0,0,0,0,0,0,0,0,0,0,0,0
9393,9393,Morientes,3231,2004,Liverpool FC,7,6,1,489,1,0,6,6,0,526,2,0,13,12,1,1015,3,0,0,0,0,1,2,3,0,0,0,0,0,0
9394,9394,Darren Potter,3936,2004,Liverpool FC,0,0,0,0,0,0,2,0,2,54,0,0,2,0,2,54,0,0,0,0,0,0,0,0,0,0,0,0,0,0
9395,9395,Boudewijn Zenden,1336,2006,Liverpool FC,8,5,3,415,0,0,8,4,4,394,0,0,16,9,7,809,0,0,0,0,0,0,0,0,0,0,0,0,0,0
9396,9396,Didier Agathe,3937,2006,Aston Villa,2,0,2,69,0,0,3,0,3,97,0,0,5,0,5,166,0,0,0,0,0,0,0,0,0,0,0,0,0,0
9397,9397,Jack Simpson,1045,2018,AFC Bournemouth,3,2,1,240,0,0,3,2,1,163,0,0,6,4,2,403,0,0,0,0,0,0,0,0,0,0,0,0,0,0
9398,9398,Emerson Hyndman,3938,2018,AFC Bournemouth,0,0,0,0,0,0,1,0,1,37,0,0,1,0,1,37,0,0,0,0,0,0,0,0,0,0,0,0,0,0
9399,9399,Nathan Ofoborh,3939,2018,AFC Bournemouth,0,0,0,0,0,0,0,0,0,0,0,0,0,0,0,0,0,0,0,0,0,0,0,0,0,0,0,0,0,0
9400,9400,Sam Surridge,3940,2018,AFC Bournemouth,0,0,0,0,0,0,2,0,2,11,0,0,2,0,2,11,0,0,0,0,0,0,0,0,0,0,0,0,0,0
9401,9401,Denis Odoi,3941,2018,Fulham FC,15,13,2,1153,0,0,16,16,0,1440,0,0,31,29,2,2593,0,0,0,0,0,0,0,0,0,0,0,0,0,0
9402,9402,Tim Ream,2490,2018,Fulham FC,13,12,1,943,0,0,13,13,0,1108,0,0,26,25,1,2051,0,0,0,0,0,0,0,0,0,0,0,0,0,0
9403,9403,Ryan Babel,1897,2018,Fulham FC,9,8,1,668,3,0,7,7,0,592,2,0,16,15,1,1260,5,0,3,0,3,2,2,4,0,0,0,0,0,0
9404,9404,Håvard Nordtveit,2641,2018,Fulham FC,1,1,0,90,0,0,4,3,1,271,0,0,5,4,1,361,0,0,0,0,0,0,0,0,0,0,0,0,0,0
9405,9405,Floyd Ayité,3942,2018,Fulham FC,7,3,4,296,0,0,9,0,9,169,1,0,16,3,13,465,1,0,0,0,0,0,1,1,0,0,0,0,0,0
9406,9406,Harvey Elliott,2308,2018,Fulham FC,1,0,1,16,0,0,1,0,1,2,0,0,2,0,2,18,0,0,0,0,0,0,0,0,0,0,0,0,0,0
9407,9407,Matt Targett,1158,2017,Southampton FC,1,1,0,90,0,0,1,1,0,77,0,0,2,2,0,167,0,0,0,0,0,0,0,0,0,0,0,0,0,0
9408,9408,Jack Rodwell,1748,2007,Everton FC,1,0,1,1,0,0,1,0,1,3,0,0,2,0,2,4,0,0,0,0,0,0,0,0,0,0,0,0,0,0
9409,9409,Albert Adomah,3943,2016,Middlesbrough FC,1,1,0,90,0,0,1,0,1,31,0,0,2,1,1,121,0,0,0,0,0,0,0,0,0,0,0,0,0,0
9410,9410,David Nugent,2519,2016,Middlesbrough FC,1,0,1,2,0,0,3,0,3,38,0,0,4,0,4,40,0,0,0,0,0,0,0,0,0,0,0,0,0,0
9411,9411,Dimitrios Konstantopoulos,3944,2016,Middlesbrough FC,0,0,0,0,0,0,0,0,0,0,0,0,0,0,0,0,0,0,0,0,0,0,0,0,0,0,0,0,0,0
9412,9412,Alex Baptiste,3591,2016,Middlesbrough FC,0,0,0,0,0,0,0,0,0,0,0,0,0,0,0,0,0,0,0,0,0,0,0,0,0,0,0,0,0,0
9413,9413,Adlène Guédioura,3130,2011,Wolverhampton Wanderers,5,1,4,159,0,0,5,1,4,135,0,0,10,2,8,294,0,0,0,0,0,0,0,0,0,0,0,0,0,0
9414,9414,Sam Vokes,1257,2011,Wolverhampton Wanderers,3,0,3,61,0,0,1,0,1,1,0,0,4,0,4,62,0,0,0,0,0,0,0,0,0,0,0,0,0,0
9415,9415,Jody Craddock,1093,2011,Wolverhampton Wanderers,1,1,0,74,0,0,0,0,0,0,0,0,1,1,0,74,0,0,0,0,0,0,0,0,0,0,0,0,0,0
9416,9416,Matt Doherty,2142,2011,Wolverhampton Wanderers,0,0,0,0,0,0,1,0,1,44,0,0,1,0,1,44,0,0,0,0,0,0,0,0,0,0,0,0,0,0
9417,9417,Vangelis Moras,3945,2011,Swansea City,0,0,0,0,0,0,1,0,1,5,0,0,1,0,1,5,0,0,0,0,0,0,0,0,0,0,0,0,0,0
9418,9418,Orlandi,3946,2011,Swansea City,1,1,0,46,1,0,2,1,1,74,0,0,3,2,1,120,1,0,0,0,0,1,0,1,0,0,0,0,0,0
9419,9419,Muhamed Bešić,2236,2016,Everton FC,0,0,0,0,0,0,0,0,0,0,0,0,0,0,0,0,0,0,0,0,0,0,0,0,0,0,0,0,0,0
9420,9420,Joe Williams,3947,2016,Everton FC,0,0,0,0,0,0,0,0,0,0,0,0,0,0,0,0,0,0,0,0,0,0,0,0,0,0,0,0,0,0
9421,9421,Adrian Mariappa,1917,2016,Watford FC,3,2,1,201,0,0,4,4,0,360,0,0,7,6,1,561,0,0,0,0,0,0,0,0,0,0,0,0,0,0
9422,9422,Geremi,1764,2005,Chelsea FC,6,3,3,331,1,0,9,5,4,443,1,0,15,8,7,774,2,0,0,0,0,1,0,1,0,0,0,0,0,0
9423,9423,Paulo Gazzaniga,1156,2015,Southampton FC,1,1,0,90,0,0,1,1,0,90,0,0,2,2,0,180,0,0,0,0,0,0,0,0,0,0,0,0,0,0
9424,9424,Harrison Reed,1153,2015,Southampton FC,0,0,0,0,0,0,1,0,1,10,0,0,1,0,1,10,0,0,0,0,0,0,0,0,0,0,0,0,0,0
9425,9425,Phil Jagielka,1048,2015,Everton FC,10,10,0,900,0,0,11,11,0,952,0,0,21,21,0,1852,0,0,0,0,0,0,0,0,0,0,0,0,0,0
9426,9426,Brendan Galloway,3717,2015,Everton FC,9,8,1,685,0,0,6,6,0,538,0,0,15,14,1,1223,0,0,0,0,0,0,0,0,0,0,0,0,0,0
9427,9427,Tyias Browning,3608,2015,Everton FC,2,1,1,135,0,0,3,2,1,164,0,0,5,3,2,299,0,0,0,0,0,0,0,0,0,0,0,0,0,0
9428,9428,Jimmy Kébé,3134,2012,Reading FC,10,9,1,750,5,0,8,7,1,586,0,0,18,16,2,1336,5,0,3,0,3,3,0,3,0,0,0,0,0,0
9429,9429,Fabricio Coloccini,2278,2008,Newcastle United,17,17,0,1530,0,0,16,16,0,1440,0,0,33,33,0,2970,0,0,0,0,0,0,0,0,0,0,0,0,0,0
9430,9430,Caçapa,3543,2008,Newcastle United,3,1,2,100,0,0,3,3,0,260,0,0,6,4,2,360,0,0,0,0,0,0,0,0,0,0,0,0,0,0
9431,9431,Steven Taylor,2014,2008,Newcastle United,15,14,1,1279,1,0,11,10,1,908,3,0,26,24,2,2187,4,0,0,1,1,1,1,2,0,0,0,0,0,0
9432,9432,David Edgar,3825,2008,Newcastle United,4,2,2,167,1,0,7,5,2,433,0,0,11,7,4,600,1,0,0,0,0,0,0,0,0,0,0,0,0,0
9433,9433,Damien Duff,1348,2008,Newcastle United,16,14,2,1221,1,0,13,13,0,1159,2,0,29,27,2,2380,3,0,3,1,4,1,2,3,0,0,0,0,0,0
9434,9434,Geremi,1764,2008,Newcastle United,9,6,3,581,0,0,6,5,1,442,0,0,15,11,4,1023,0,0,0,0,0,0,0,0,0,0,0,0,0,0
9435,9435,Nicky Butt,1115,2008,Newcastle United,15,15,0,1298,0,0,17,17,0,1500,0,0,32,32,0,2798,0,0,0,0,0,0,0,0,0,0,0,0,0,0
9436,9436,Michael Owen,1949,2008,Newcastle United,13,9,4,863,6,0,15,12,3,1032,2,0,28,21,7,1895,8,0,3,0,3,4,1,5,1,0,1,0,0,0
9437,9437,Francisco Xisco,2404,2008,Newcastle United,3,2,1,192,1,0,2,1,1,91,0,0,5,3,2,283,1,0,0,0,0,0,0,0,0,0,0,0,0,0
9438,9438,Sébastien Bassong,1370,2008,Newcastle United,14,13,1,1140,0,0,16,13,3,1293,0,0,30,26,4,2433,0,0,0,0,0,0,0,0,0,0,0,0,0,0
9439,9439,Ignacio González,3948,2008,Newcastle United,1,0,1,29,0,0,1,0,1,10,0,0,2,0,2,39,0,0,0,0,0,0,0,0,0,0,0,0,0,0
9440,9440,Andy Marshall,3291,2001,Ipswich Town,7,7,0,630,0,0,6,6,0,540,0,0,13,13,0,1170,0,0,0,0,0,0,0,0,0,0,0,0,0,0
9441,9441,Mark Venus,3766,2001,Ipswich Town,15,15,0,1343,0,0,14,14,0,1215,1,0,29,29,0,2558,1,0,0,0,0,0,0,0,0,0,0,0,0,0
9442,9442,Aaron Mokoena,2008,2007,Blackburn Rovers,9,4,5,331,0,0,8,4,4,418,0,0,17,8,9,749,0,0,0,0,0,0,0,0,0,0,0,0,0,0
9443,9443,Jon Flanagan,1263,2015,Liverpool FC,2,2,0,180,0,0,3,3,0,241,0,0,5,5,0,421,0,0,0,0,0,0,0,0,0,0,0,0,0,0
9444,9444,Jordan Henderson,1426,2015,Liverpool FC,9,8,1,704,1,0,8,7,1,589,1,0,17,15,2,1293,2,0,0,0,0,1,0,1,0,0,0,0,0,0
9445,9445,John O'Shea,1729,2001,Manchester United,4,2,2,228,0,0,5,2,3,132,0,0,9,4,5,360,0,0,0,0,0,0,0,0,0,0,0,0,0,0
9446,9446,Titi Camara,3949,2001,West Ham United,0,0,0,0,0,0,1,0,1,6,0,0,1,0,1,6,0,0,0,0,0,0,0,0,0,0,0,0,0,0
9447,9447,Dimitri Foulquier,3950,2019,Watford FC,1,0,1,17,0,0,2,1,1,41,0,0,3,1,2,58,0,0,0,0,0,0,0,0,0,0,0,0,0,0
9448,9448,Tom Dele-Bashiru,3951,2019,Watford FC,0,0,0,0,0,0,0,0,0,0,0,0,0,0,0,0,0,0,0,0,0,0,0,0,0,0,0,0,0,0
9449,9449,Andrew Taylor,2574,2008,Middlesbrough FC,12,10,2,949,0,0,14,10,4,991,0,0,26,20,6,1940,0,0,0,0,0,0,0,0,0,0,0,0,0,0
9450,9450,Didier Digard,3952,2008,Middlesbrough FC,12,7,5,626,0,0,11,8,3,697,0,0,23,15,8,1323,0,0,0,0,0,0,0,0,0,0,0,0,0,0
9451,9451,Adam Johnson,1405,2008,Middlesbrough FC,14,5,9,592,0,0,12,5,7,507,0,0,26,10,16,1099,0,0,0,0,0,0,0,0,0,0,0,0,0,0
9452,9452,Wayne Hennessey,1018,2009,Wolverhampton Wanderers,6,6,0,540,0,0,7,7,0,630,0,0,13,13,0,1170,0,0,0,0,0,0,0,0,0,0,0,0,0,0
9453,9453,Greg Halford,1968,2009,Wolverhampton Wanderers,7,5,2,409,0,0,8,7,1,489,0,0,15,12,3,898,0,0,0,0,0,0,0,0,0,0,0,0,0,0
9454,9454,Segundo Castillo,3953,2009,Wolverhampton Wanderers,3,3,0,245,0,0,5,4,1,259,0,0,8,7,1,504,0,0,0,0,0,0,0,0,0,0,0,0,0,0
9455,9455,Michael Kightly,1259,2009,Wolverhampton Wanderers,5,1,4,217,0,0,4,2,2,229,0,0,9,3,6,446,0,0,0,0,0,0,0,0,0,0,0,0,0,0
9456,9456,Stefan Maierhofer,3954,2009,Wolverhampton Wanderers,3,0,3,40,0,0,5,1,4,139,1,0,8,1,7,179,1,0,0,0,0,0,0,0,0,0,0,0,0,0
9457,9457,Andy Johnson,1322,2009,Fulham FC,2,2,0,179,0,0,6,5,1,417,0,0,8,7,1,596,0,0,0,0,0,0,0,0,0,0,0,0,0,0
9458,9458,Diomansy Kamara,1564,2009,Fulham FC,4,2,2,162,1,0,5,3,2,292,0,0,9,5,4,454,1,0,0,0,0,0,0,0,0,0,0,0,0,0
9459,9459,Nathan Trott,3955,2017,West Ham United,0,0,0,0,0,0,0,0,0,0,0,0,0,0,0,0,0,0,0,0,0,0,0,0,0,0,0,0,0,0
9460,9460,Lukas Nmecha,3956,2017,Manchester City,1,0,1,4,0,0,1,0,1,10,0,0,2,0,2,14,0,0,0,0,0,0,0,0,0,0,0,0,0,0
9461,9461,Zurab Khizanishvili,2006,2008,Blackburn Rovers,2,2,0,180,0,0,2,1,1,78,0,0,4,3,1,258,0,0,0,0,0,0,0,0,0,0,0,0,0,0
9462,9462,Danny Simpson,2395,2008,Blackburn Rovers,6,5,1,439,0,0,6,5,1,450,0,0,12,10,2,889,0,0,0,0,0,0,0,0,0,0,0,0,0,0
9463,9463,Martin Olsson,1372,2008,Blackburn Rovers,4,3,1,266,0,0,5,3,2,288,0,0,9,6,3,554,0,0,0,0,0,0,0,0,0,0,0,0,0,0
9464,9464,Robbie Fowler,2691,2008,Blackburn Rovers,1,0,1,13,0,0,2,1,1,102,0,0,3,1,2,115,0,0,0,0,0,0,0,0,0,0,0,0,0,0
9465,9465,Paulo Ferreira,1761,2008,Chelsea FC,1,0,1,7,0,0,6,1,5,129,0,0,7,1,6,136,0,0,0,0,0,0,0,0,0,0,0,0,0,0
9466,9466,Kim Källström,3957,2013,Arsenal FC,3,1,2,128,0,0,0,0,0,0,0,0,3,1,2,128,0,0,0,0,0,0,0,0,0,0,0,0,0,0
9467,9467,Massadio Haïdara,2280,2013,Newcastle United,6,1,5,194,0,0,5,2,3,231,0,0,11,3,8,425,0,0,0,0,0,0,0,0,0,0,0,0,0,0
9468,9468,Kevin Kyle,1636,2005,Sunderland AFC,7,3,4,390,0,0,6,6,0,505,1,0,13,9,4,895,1,0,0,0,0,0,0,0,0,0,0,0,0,0
9469,9469,Michael Gray,1092,2005,Blackburn Rovers,15,15,0,1262,0,0,15,15,0,1305,0,0,30,30,0,2567,0,0,0,0,0,0,0,0,0,0,0,0,0,0
9470,9470,Brett Emerton,1141,2005,Blackburn Rovers,13,6,7,672,1,0,17,11,6,936,0,0,30,17,13,1608,1,0,0,0,0,1,0,1,0,0,0,0,0,0
9471,9471,Paul Dickov,1878,2005,Blackburn Rovers,10,9,1,660,5,0,11,8,3,606,0,0,21,17,4,1266,5,0,3,0,3,4,0,4,2,0,2,0,0,0
9472,9472,Mason Holgate,1062,2015,Everton FC,0,0,0,0,0,0,0,0,0,0,0,0,0,0,0,0,0,0,0,0,0,0,0,0,0,0,0,0,0,0
9473,9473,Iago Falqué,3477,2011,Tottenham Hotspur,0,0,0,0,0,0,0,0,0,0,0,0,0,0,0,0,0,0,0,0,0,0,0,0,0,0,0,0,0,0
9474,9474,Alan Hutton,2172,2008,Tottenham Hotspur,4,1,3,234,0,0,4,4,0,349,0,0,8,5,3,583,0,0,0,0,0,0,0,0,0,0,0,0,0,0
9475,9475,Tim Flowers,1302,2001,Leicester City,3,2,1,246,0,0,1,1,0,90,0,0,4,3,1,336,0,0,0,0,0,0,0,0,0,0,0,0,0,0
9476,9476,Arnar Gunnlaugsson,2831,2001,Leicester City,1,0,1,43,0,0,1,0,1,26,0,0,2,0,2,69,0,0,0,0,0,0,0,0,0,0,0,0,0,0
9477,9477,Ian Marshall,3958,2001,Bolton Wanderers,0,0,0,0,0,0,1,0,1,14,0,0,1,0,1,14,0,0,0,0,0,0,0,0,0,0,0,0,0,0
9478,9478,Pau López,3959,2016,Tottenham Hotspur,0,0,0,0,0,0,0,0,0,0,0,0,0,0,0,0,0,0,0,0,0,0,0,0,0,0,0,0,0,0
9479,9479,Dean Kiely,2334,2010,West Bromwich Albion,0,0,0,0,0,0,0,0,0,0,0,0,0,0,0,0,0,0,0,0,0,0,0,0,0,0,0,0,0,0
9480,9480,Florent Sinama-Pongolle,3873,2005,Blackburn Rovers,6,5,1,404,0,0,4,3,1,304,1,0,10,8,2,708,1,0,0,0,0,0,0,0,0,0,0,0,0,0
9481,9481,Sergio Peter,3087,2005,Blackburn Rovers,4,1,3,191,0,0,4,0,4,127,0,0,8,1,7,318,0,0,0,0,0,0,0,0,0,0,0,0,0,0
9482,9482,Gareth Williams,3960,2006,Watford FC,2,1,1,134,0,0,1,1,0,62,0,0,3,2,1,196,0,0,0,0,0,0,0,0,0,0,0,0,0,0
9483,9483,Scott Minto,2463,2001,West Ham United,1,1,0,90,0,0,4,4,0,331,0,0,5,5,0,421,0,0,0,0,0,0,0,0,0,0,0,0,0,0
9484,9484,Paul Kitson,3884,2001,West Ham United,2,1,1,101,0,0,5,2,3,193,3,0,7,3,4,294,3,0,0,0,0,0,3,3,0,0,0,0,0,0
9485,9485,Youri Tielemans,2439,2018,Leicester City,7,7,0,575,2,0,6,6,0,517,1,0,13,13,0,1092,3,0,0,0,0,2,1,3,0,0,0,0,0,0
9486,9486,Rachid Ghezzal,3961,2018,Leicester City,12,5,7,455,1,0,7,3,4,283,0,0,19,8,11,738,1,0,0,0,0,0,0,0,0,0,0,0,0,0
9487,9487,Louis Laing,3962,2011,Sunderland AFC,0,0,0,0,0,0,0,0,0,0,0,0,0,0,0,0,0,0,0,0,0,0,0,0,0,0,0,0,0,0
9488,9488,Ryan Noble,3238,2011,Sunderland AFC,1,0,1,2,0,0,1,0,1,3,0,0,2,0,2,5,0,0,0,0,0,0,0,0,0,0,0,0,0,0
9489,9489,Mladen Petrić,3640,2013,West Ham United,2,0,2,35,0,0,1,0,1,31,0,0,3,0,3,66,0,0,0,0,0,0,0,0,0,0,0,0,0,0
9490,9490,Tyias Browning,3608,2012,Everton FC,0,0,0,0,0,0,0,0,0,0,0,0,0,0,0,0,0,0,0,0,0,0,0,0,0,0,0,0,0,0
9491,9491,Lucas Piazón,3895,2012,Chelsea FC,0,0,0,0,0,0,0,0,0,0,0,0,0,0,0,0,0,0,0,0,0,0,0,0,0,0,0,0,0,0
9492,9492,George Evans,3963,2012,Manchester City,0,0,0,0,0,0,0,0,0,0,0,0,0,0,0,0,0,0,0,0,0,0,0,0,0,0,0,0,0,0
9493,9493,David Bentley,2011,2003,Arsenal FC,0,0,0,0,0,0,1,1,0,61,0,0,1,1,0,61,0,0,0,0,0,0,0,0,0,0,0,0,0,0
9494,9494,Nayron Nosworthy,1214,2008,Sunderland AFC,9,9,0,782,0,0,7,7,0,630,0,0,16,16,0,1412,0,0,0,0,0,0,0,0,0,0,0,0,0,0
9495,9495,Lee Bowyer,1297,2008,West Ham United,3,2,1,212,0,0,3,2,1,136,0,0,6,4,2,348,0,0,0,0,0,0,0,0,0,0,0,0,0,0
9496,9496,Alex Pike,3964,2016,West Ham United,0,0,0,0,0,0,0,0,0,0,0,0,0,0,0,0,0,0,0,0,0,0,0,0,0,0,0,0,0,0
9497,9497,Dan Gosling,1005,2008,Everton FC,6,3,3,319,2,0,4,2,2,178,0,0,10,5,5,497,2,0,0,0,0,0,0,0,0,0,0,0,0,0
9498,9498,Tom Huddlestone,1270,2008,Tottenham Hotspur,14,9,5,878,0,0,8,5,3,463,0,0,22,14,8,1341,0,0,0,0,0,0,0,0,0,0,0,0,0,0
9499,9499,Anthony Gardner,1120,2000,Tottenham Hotspur,3,2,1,158,0,0,4,2,2,296,0,0,7,4,3,454,0,0,0,0,0,0,0,0,0,0,0,0,0,0
9500,9500,John Piercy,3965,2000,Tottenham Hotspur,2,0,2,21,0,0,3,0,3,41,0,0,5,0,5,62,0,0,0,0,0,0,0,0,0,0,0,0,0,0
9501,9501,Matthew Etherington,1557,2000,Tottenham Hotspur,5,1,4,143,0,0,1,0,1,12,0,0,6,1,5,155,0,0,0,0,0,0,0,0,0,0,0,0,0,0
9502,9502,Jesper Grønkjær,2618,2000,Chelsea FC,7,3,4,332,1,0,7,3,4,325,0,0,14,6,8,657,1,0,0,0,0,0,0,0,0,0,0,0,0,0
9503,9503,Darío Silva,3966,2005,Portsmouth FC,7,7,0,595,1,0,6,6,0,382,1,0,13,13,0,977,2,0,0,0,0,1,0,1,0,0,0,0,0,0
9504,9504,Phil Neville,1114,2009,Everton FC,11,10,1,899,0,0,12,12,0,1055,0,0,23,22,1,1954,0,0,0,0,0,0,0,0,0,0,0,0,0,0
9505,9505,Mike Pollitt,2880,2009,Wigan Athletic,1,0,1,67,0,0,3,2,1,224,0,0,4,2,2,291,0,0,0,0,0,0,0,0,0,0,0,0,0,0
9506,9506,Won-hee Cho,3967,2009,Wigan Athletic,0,0,0,0,0,0,4,1,3,113,0,0,4,1,3,113,0,0,0,0,0,0,0,0,0,0,0,0,0,0
9507,9507,Gareth Southgate,1331,2005,Middlesbrough FC,14,14,0,1260,0,0,10,10,0,835,0,0,24,24,0,2095,0,0,0,0,0,0,0,0,0,0,0,0,0,0
9508,9508,Steve Harper,2231,2008,Newcastle United,8,8,0,720,0,0,8,8,0,720,0,0,16,16,0,1440,0,0,0,0,0,0,0,0,0,0,0,0,0,0
9509,9509,Habib Beye,2173,2008,Newcastle United,12,11,1,1042,0,0,10,10,0,847,0,0,22,21,1,1889,0,0,0,0,0,0,0,0,0,0,0,0,0,0
9510,9510,Danny Guthrie,2397,2008,Newcastle United,13,10,3,985,0,0,10,10,0,873,2,0,23,20,3,1858,2,0,0,0,0,0,0,0,0,1,1,0,0,0
9511,9511,Jonás Gutiérrez,2398,2008,Newcastle United,15,13,2,1153,0,0,14,9,5,945,0,0,29,22,7,2098,0,0,0,0,0,0,0,0,0,0,0,0,0,0
9512,9512,Obafemi Martins,3121,2008,Newcastle United,13,11,2,948,6,0,10,9,1,751,2,0,23,20,3,1699,8,0,0,0,0,4,1,5,0,0,0,0,0,0
9513,9513,Mark Viduka,1299,2008,Newcastle United,5,3,2,306,0,0,7,3,4,299,0,0,12,6,6,605,0,0,0,0,0,0,0,0,0,0,0,0,0,0
9514,9514,Peter Løvenkrands,2401,2008,Newcastle United,7,4,3,337,2,0,5,4,1,309,1,0,12,8,4,646,3,0,0,0,0,1,1,2,0,0,0,0,0,0
9515,9515,Andy Carroll,1779,2008,Newcastle United,9,2,7,247,1,0,5,3,2,284,2,0,14,5,9,531,3,0,1,1,2,1,1,2,0,0,0,0,0,0
9516,9516,Matteo Darmian,2187,2018,Manchester United,5,4,1,354,0,0,1,1,0,90,0,0,6,5,1,444,0,0,0,0,0,0,0,0,0,0,0,0,0,0
9517,9517,Alexis Sánchez,1505,2018,Manchester United,10,3,7,387,1,0,10,6,4,490,0,0,20,9,11,877,1,0,3,0,3,1,0,1,0,0,0,0,0,0
9518,9518,Viktor Gyökeres,3968,2018,Brighton & Hove Albion,0,0,0,0,0,0,0,0,0,0,0,0,0,0,0,0,0,0,0,0,0,0,0,0,0,0,0,0,0,0
9519,9519,Moritz Volz,1078,2007,Fulham FC,4,3,1,252,0,0,5,2,3,237,0,0,9,5,4,489,0,0,0,0,0,0,0,0,0,0,0,0,0,0
9520,9520,Elliot Omozusi,3969,2007,Fulham FC,4,4,0,329,0,0,4,4,0,360,0,0,8,8,0,689,0,0,0,0,0,0,0,0,0,0,0,0,0,0
9521,9521,Aleksey Smertin,1072,2007,Fulham FC,8,6,2,533,2,0,7,5,2,458,0,0,15,11,4,991,2,0,3,0,3,1,0,1,0,0,0,0,0,0
9522,9522,Hilário,2709,2007,Chelsea FC,1,1,0,90,0,0,2,1,1,116,0,0,3,2,1,206,0,0,0,0,0,0,0,0,0,0,0,0,0,0
9523,9523,Joy Mukena,3970,2017,Watford FC,0,0,0,0,0,0,0,0,0,0,0,0,0,0,0,0,0,0,0,0,0,0,0,0,0,0,0,0,0,0
9524,9524,Callum Hudson-Odoi,1855,2017,Chelsea FC,2,0,2,27,0,0,0,0,0,0,0,0,2,0,2,27,0,0,0,0,0,0,0,0,0,0,0,0,0,0
9525,9525,Vince Grella,3623,2010,Blackburn Rovers,2,2,0,133,0,0,3,2,1,177,0,0,5,4,1,310,0,0,0,0,0,0,0,0,0,0,0,0,0,0
9526,9526,Keith Andrews,2656,2010,Blackburn Rovers,2,1,1,103,0,0,3,1,2,124,0,0,5,2,3,227,0,0,0,0,0,0,0,0,0,0,0,0,0,0
9527,9527,Trevor Benjamin,1314,2001,Leicester City,5,2,3,244,0,0,6,2,4,219,0,0,11,4,7,463,0,0,0,0,0,0,0,0,0,0,0,0,0,0
9528,9528,Stanislav Varga,1091,2001,Sunderland AFC,4,4,0,360,0,0,4,4,0,289,0,0,8,8,0,649,0,0,0,0,0,0,0,0,0,0,0,0,0,0
9529,9529,Émerson Thome,1102,2001,Sunderland AFC,7,7,0,630,1,0,5,5,0,450,0,0,12,12,0,1080,1,0,1,0,1,1,0,1,0,0,0,0,0,0
9530,9530,Jamie McClen,3971,2001,Newcastle United,2,2,0,157,0,0,1,1,0,90,0,0,3,3,0,247,0,0,0,0,0,0,0,0,0,0,0,0,0,0
9531,9531,Fredi Bobic,3972,2001,Bolton Wanderers,9,7,2,551,4,0,7,7,0,535,0,0,16,14,2,1086,4,0,0,0,0,2,0,2,0,0,0,0,0,0
9532,9532,Chris Kirkland,2056,2000,Coventry City,11,11,0,990,0,0,10,10,0,900,0,0,21,21,0,1890,0,0,0,0,0,0,0,0,0,0,0,0,0,0
9533,9533,Craig Strachan,3973,2000,Coventry City,1,1,0,88,0,0,1,1,0,84,0,0,2,2,0,172,0,0,0,0,0,0,0,0,0,0,0,0,0,0
9534,9534,Calum Davenport,1394,2000,Coventry City,1,0,1,45,0,0,0,0,0,0,0,0,1,0,1,45,0,0,0,0,0,0,0,0,0,0,0,0,0,0
9535,9535,Robert Betts,3974,2000,Coventry City,1,0,1,2,0,0,0,0,0,0,0,0,1,0,1,2,0,0,0,0,0,0,0,0,0,0,0,0,0,0
9536,9536,Aidan Davison,3975,2000,Bradford City,0,0,0,0,0,0,2,2,0,180,0,0,2,2,0,180,0,0,0,0,0,0,0,0,0,0,0,0,0,0
9537,9537,Gunnar Halle,3976,2000,Bradford City,5,4,1,414,0,0,4,3,1,331,0,0,9,7,2,745,0,0,0,0,0,0,0,0,0,0,0,0,0,0
9538,9538,Gareth Whalley,3977,2000,Bradford City,8,6,2,497,0,0,7,7,0,627,0,0,15,13,2,1124,0,0,0,0,0,0,0,0,0,0,0,0,0,0
9539,9539,Gary Locke,3978,2000,Bradford City,2,2,0,117,0,0,4,3,1,254,0,0,6,5,1,371,0,0,0,0,0,0,0,0,0,0,0,0,0,0
9540,9540,Scott Kerr,3979,2000,Bradford City,0,0,0,0,0,0,1,0,1,7,0,0,1,0,1,7,0,0,0,0,0,0,0,0,0,0,0,0,0,0
9541,9541,Gareth Grant,3980,2000,Bradford City,3,0,3,21,0,0,2,0,2,22,0,0,5,0,5,43,0,0,0,0,0,0,0,0,0,0,0,0,0,0
9542,9542,Kamil Zayatte,2322,2009,Hull City,11,10,1,857,1,0,12,11,1,1013,1,0,23,21,2,1870,2,0,0,0,0,1,1,2,0,0,0,0,0,0
9543,9543,Stephen Hunt,2596,2009,Hull City,13,13,0,1150,3,0,14,14,0,1173,3,0,27,27,0,2323,6,0,0,1,1,2,2,4,1,0,1,0,0,0
9544,9544,Habib Beye,2173,2007,Newcastle United,14,14,0,1257,1,0,15,13,2,1214,0,0,29,27,2,2471,1,0,3,0,3,1,0,1,0,0,0,0,0,0
9545,9545,Abdoulaye Faye,1714,2007,Newcastle United,10,10,0,874,1,0,12,10,2,780,0,0,22,20,2,1654,1,0,0,0,0,0,0,0,0,0,0,0,0,0
9546,9546,Valeri Bojinov,3890,2007,Manchester City,2,1,1,20,0,0,1,0,1,29,0,0,3,1,2,49,0,0,0,0,0,0,0,0,0,0,0,0,0,0
9547,9547,Fraizer Campbell,1027,2007,Manchester United,0,0,0,0,0,0,1,0,1,17,0,0,1,0,1,17,0,0,0,0,0,0,0,0,0,0,0,0,0,0
9548,9548,Kyle Bartley,2276,2012,Swansea City,1,0,1,56,0,0,1,1,0,90,0,0,2,1,1,146,0,0,0,0,0,0,0,0,0,0,0,0,0,0
9549,9549,Roland Lamah,3732,2012,Swansea City,1,0,1,26,0,0,4,1,3,125,0,0,5,1,4,151,0,0,0,0,0,0,0,0,0,0,0,0,0,0
9550,9550,Jordan Archer,3981,2012,Tottenham Hotspur,0,0,0,0,0,0,0,0,0,0,0,0,0,0,0,0,0,0,0,0,0,0,0,0,0,0,0,0,0,0
9551,9551,Axel Tuanzebe,3211,2017,Manchester United,0,0,0,0,0,0,1,0,1,1,0,0,1,0,1,1,0,0,0,0,0,0,0,0,0,0,0,0,0,0
9552,9552,Lee Clark,2017,2002,Fulham FC,5,3,2,266,1,0,5,5,0,419,1,0,10,8,2,685,2,0,3,0,3,1,1,2,0,0,0,0,0,0
9553,9553,Mesca,3982,2013,Fulham FC,0,0,0,0,0,0,1,0,1,18,0,0,1,0,1,18,0,0,0,0,0,0,0,0,0,0,0,0,0,0
9554,9554,Martin Laursen,2124,2008,Aston Villa,8,8,0,718,0,0,7,7,0,630,1,0,15,15,0,1348,1,0,0,0,0,0,1,1,0,0,0,0,0,0
9555,9555,Steven Sidwell,1622,2008,Aston Villa,6,4,2,355,1,0,6,3,3,298,2,0,12,7,5,653,3,0,0,0,0,1,1,2,0,0,0,0,0,0
9556,9556,Leon Barnett,3041,2008,West Bromwich Albion,6,6,0,489,0,0,5,4,1,423,0,0,11,10,1,912,0,0,0,0,0,0,0,0,0,0,0,0,0,0
9557,9557,Brian Kerr,3983,2002,Newcastle United,4,1,3,89,0,0,4,3,1,220,0,0,8,4,4,309,0,0,0,0,0,0,0,0,0,0,0,0,0,0
9558,9558,Matthew Upson,1279,2002,Birmingham City,8,8,0,720,0,0,6,6,0,540,0,0,14,14,0,1260,0,0,0,0,0,0,0,0,0,0,0,0,0,0
9559,9559,Stephen Clemence,1516,2002,Birmingham City,9,9,0,730,2,0,6,6,0,540,0,0,15,15,0,1270,2,0,0,0,0,1,0,1,0,0,0,0,0,0
9560,9560,Justin Hoyte,3282,2008,Middlesbrough FC,9,8,1,745,0,0,13,9,4,858,0,0,22,17,5,1603,0,0,0,0,0,0,0,0,0,0,0,0,0,0
9561,9561,José Enrique,2394,2008,Newcastle United,13,13,0,1039,0,0,13,11,2,931,0,0,26,24,2,1970,0,0,0,0,0,0,0,0,0,0,0,0,0,0
9562,9562,Arbeloa,2744,2006,Liverpool FC,4,4,0,331,0,0,5,4,1,374,1,0,9,8,1,705,1,0,0,0,0,0,1,1,0,0,0,0,0,0
9563,9563,Gabriel Paletta,3984,2006,Liverpool FC,0,0,0,0,0,0,3,2,1,209,0,0,3,2,1,209,0,0,0,0,0,0,0,0,0,0,0,0,0,0
9564,9564,Emiliano Insúa,1889,2006,Liverpool FC,0,0,0,0,0,0,2,2,0,165,0,0,2,2,0,165,0,0,0,0,0,0,0,0,0,0,0,0,0,0
9565,9565,Harry Kewell,1296,2006,Liverpool FC,1,0,1,33,1,0,1,0,1,13,0,0,2,0,2,46,1,0,1,0,1,1,0,1,1,0,1,0,0,0
9566,9566,Nabil El Zhar,1896,2006,Liverpool FC,1,0,1,18,0,0,2,0,2,32,0,0,3,0,3,50,0,0,0,0,0,0,0,0,0,0,0,0,0,0
9567,9567,Morata,3786,2018,Chelsea FC,8,6,2,530,3,0,8,5,3,413,2,0,16,11,5,943,5,0,0,0,0,2,1,3,0,0,0,0,0,0
9568,9568,Tyrone Mings,2772,2018,AFC Bournemouth,2,0,2,8,0,0,3,2,1,134,0,0,5,2,3,142,0,0,0,0,0,0,0,0,0,0,0,0,0,0
9569,9569,Muhamed Konjić,3985,2000,Coventry City,4,4,0,296,0,0,3,3,0,193,0,0,7,7,0,489,0,0,0,0,0,0,0,0,0,0,0,0,0,0
9570,9570,John Aloisi,3986,2000,Coventry City,10,2,8,375,1,0,8,6,2,424,2,0,18,8,10,799,3,0,0,0,0,1,2,3,0,0,0,0,0,0
9571,9571,Mark Delaney,3269,2000,Aston Villa,10,6,4,698,0,0,9,6,3,644,0,0,19,12,7,1342,0,0,0,0,0,0,0,0,0,0,0,0,0,0
9572,9572,Paul Dummett,2467,2013,Newcastle United,8,5,3,521,1,0,10,6,4,622,0,0,18,11,7,1143,1,0,0,0,0,1,0,1,0,0,0,0,0,0
9573,9573,Luuk de Jong,3987,2013,Newcastle United,7,5,2,343,0,0,5,3,2,326,0,0,12,8,4,669,0,0,0,0,0,0,0,0,0,0,0,0,0,0
9574,9574,Sylvain Marveaux,2711,2013,Newcastle United,7,2,5,208,0,0,2,0,2,15,0,0,9,2,7,223,0,0,0,0,0,0,0,0,0,0,0,0,0,0
9575,9575,Steven Taylor,2014,2013,Newcastle United,4,3,1,281,1,0,6,6,0,494,0,0,10,9,1,775,1,0,0,0,0,0,0,0,0,0,0,0,0,0
9576,9576,Dan Gosling,1005,2013,Newcastle United,4,2,2,192,0,0,4,2,2,169,0,0,8,4,4,361,0,0,0,0,0,0,0,0,0,0,0,0,0,0
9577,9577,Vratislav Greško,2010,2002,Blackburn Rovers,4,4,0,360,0,0,6,6,0,528,0,0,10,10,0,888,0,0,0,0,0,0,0,0,0,0,0,0,0,0
9578,9578,Hérita Ilunga,1280,2010,West Ham United,6,5,1,431,0,0,5,5,0,436,0,0,11,10,1,867,0,0,0,0,0,0,0,0,0,0,0,0,0,0
9579,9579,Nicky Law,3988,2006,Sheffield United,2,1,1,120,0,0,2,1,1,91,0,0,4,2,2,211,0,0,0,0,0,0,0,0,0,0,0,0,0,0
9580,9580,Ivo Pinto,3989,2015,Norwich City,5,5,0,450,0,0,5,4,1,361,0,0,10,9,1,811,0,0,0,0,0,0,0,0,0,0,0,0,0,0
9581,9581,Jonathan Woodgate,1882,2011,Stoke City,7,6,1,522,0,0,10,10,0,758,0,0,17,16,1,1280,0,0,0,0,0,0,0,0,0,0,0,0,0,0
9582,9582,Andy Wilkinson,1553,2011,Stoke City,13,11,2,900,0,0,12,9,3,810,0,0,25,20,5,1710,0,0,0,0,0,0,0,0,0,0,0,0,0,0
9583,9583,Joe Mattock,3990,2011,West Bromwich Albion,0,0,0,0,0,0,0,0,0,0,0,0,0,0,0,0,0,0,0,0,0,0,0,0,0,0,0,0,0,0
9584,9584,Matt Kilgallon,1400,2006,Sheffield United,2,2,0,180,0,0,4,4,0,360,0,0,6,6,0,540,0,0,0,0,0,0,0,0,0,0,0,0,0,0
9585,9585,Jon Stead,1139,2006,Sheffield United,7,7,0,585,3,0,5,3,2,297,2,0,12,10,2,882,5,0,0,1,1,2,2,4,0,0,0,0,0,0
9586,9586,Clarke Carlisle,2547,2006,Watford FC,2,2,0,180,0,0,2,2,0,180,0,0,4,4,0,360,0,0,0,0,0,0,0,0,0,0,0,0,0,0
9587,9587,James Chambers,3609,2006,Watford FC,4,3,1,271,0,0,7,4,3,364,0,0,11,7,4,635,0,0,0,0,0,0,0,0,0,0,0,0,0,0
9588,9588,Eric Djemba-Djemba,1793,2005,Aston Villa,0,0,0,0,0,0,4,0,4,108,0,0,4,0,4,108,0,0,0,0,0,0,0,0,0,0,0,0,0,0
9589,9589,Jermaine Johnson,3074,2002,Bolton Wanderers,1,0,1,1,0,0,1,0,1,22,0,0,2,0,2,23,0,0,0,0,0,0,0,0,0,0,0,0,0,0
9590,9590,Delroy Facey,3991,2002,Bolton Wanderers,5,1,4,129,2,0,4,0,4,57,0,0,9,1,8,186,2,0,0,0,0,0,0,0,0,0,0,0,0,0
9591,9591,Gerard Wiekens,3306,2002,Manchester City,2,2,0,180,0,0,4,3,1,244,0,0,6,5,1,424,0,0,0,0,0,0,0,0,0,0,0,0,0,0
9592,9592,Stephen Jordan,2549,2002,Manchester City,0,0,0,0,0,0,1,0,1,21,0,0,1,0,1,21,0,0,0,0,0,0,0,0,0,0,0,0,0,0
9593,9593,Matt Macey,2858,2014,Arsenal FC,0,0,0,0,0,0,0,0,0,0,0,0,0,0,0,0,0,0,0,0,0,0,0,0,0,0,0,0,0,0
9594,9594,Landon Donovan,3992,2011,Everton FC,4,4,0,360,0,0,3,3,0,270,0,0,7,7,0,630,0,0,0,0,0,0,0,0,0,0,0,0,0,0
9595,9595,Ledley King,1119,2010,Tottenham Hotspur,4,4,0,360,0,0,2,2,0,134,0,0,6,6,0,494,0,0,0,0,0,0,0,0,0,0,0,0,0,0
9596,9596,Jake Livermore,1657,2010,Tottenham Hotspur,0,0,0,0,0,0,0,0,0,0,0,0,0,0,0,0,0,0,0,0,0,0,0,0,0,0,0,0,0,0
9597,9597,John Bostock,3993,2010,Tottenham Hotspur,0,0,0,0,0,0,0,0,0,0,0,0,0,0,0,0,0,0,0,0,0,0,0,0,0,0,0,0,0,0
9598,9598,Seb Hines,3994,2008,Middlesbrough FC,0,0,0,0,0,0,1,0,1,3,0,0,1,0,1,3,0,0,0,0,0,0,0,0,0,0,0,0,0,0
9599,9599,Jack Rodwell,1748,2015,Sunderland AFC,10,3,7,415,0,0,12,6,6,743,1,0,22,9,13,1158,1,0,0,0,0,0,1,1,0,0,0,0,0,0
9600,9600,Apostolos Vellios,3259,2011,Everton FC,8,1,7,161,1,0,5,1,4,90,2,0,13,2,11,251,3,0,0,0,0,1,0,1,0,0,0,0,0,0
9601,9601,Shkodran Mustafi,1483,2011,Everton FC,0,0,0,0,0,0,0,0,0,0,0,0,0,0,0,0,0,0,0,0,0,0,0,0,0,0,0,0,0,0
9602,9602,Richard Hughes,2812,2006,Portsmouth FC,7,5,2,455,0,0,11,6,5,595,0,0,18,11,7,1050,0,0,0,0,0,0,0,0,0,0,0,0,0,0
9603,9603,Greg Shields,3995,2000,Charlton Athletic,2,1,1,102,0,0,2,1,1,103,0,0,4,2,2,205,0,0,0,0,0,0,0,0,0,0,0,0,0,0
9604,9604,Philipp Degen,3996,2009,Liverpool FC,4,1,3,136,0,0,3,2,1,203,0,0,7,3,4,339,0,0,0,0,0,0,0,0,0,0,0,0,0,0
9605,9605,Chris McCann,3997,2009,Burnley FC,3,3,0,208,0,0,4,4,0,282,0,0,7,7,0,490,0,0,0,0,0,0,0,0,0,0,0,0,0,0
9606,9606,Mason Springthorpe,3998,2013,Everton FC,0,0,0,0,0,0,0,0,0,0,0,0,0,0,0,0,0,0,0,0,0,0,0,0,0,0,0,0,0,0
9607,9607,Paulo Gazzaniga,1156,2013,Southampton FC,4,4,0,360,0,0,4,3,1,302,0,0,8,7,1,662,0,0,0,0,0,0,0,0,0,0,0,0,0,0
9608,9608,Harrison Reed,1153,2013,Southampton FC,2,0,2,5,0,0,2,0,2,5,0,0,4,0,4,10,0,0,0,0,0,0,0,0,0,0,0,0,0,0
9609,9609,Pascal Chimbonda,1392,2008,Sunderland AFC,7,7,0,630,0,0,6,6,0,540,0,0,13,13,0,1170,0,0,0,0,0,0,0,0,0,0,0,0,0,0
9610,9610,Michael Chopra,1226,2008,Sunderland AFC,3,0,3,57,2,0,3,1,2,132,0,0,6,1,5,189,2,0,0,0,0,1,0,1,0,0,0,0,0,0
9611,9611,Damien Plessis,3160,2008,Liverpool FC,0,0,0,0,0,0,1,1,0,46,0,0,1,1,0,46,0,0,0,0,0,0,0,0,0,0,0,0,0,0
9612,9612,Kevin McNaughton,3999,2013,Cardiff City,0,0,0,0,0,0,5,3,2,281,0,0,5,3,2,281,0,0,0,0,0,0,0,0,0,0,0,0,0,0
9613,9613,Roger Johnson,1781,2013,West Ham United,2,1,1,171,0,0,2,1,1,102,0,0,4,2,2,273,0,0,0,0,0,0,0,0,0,0,0,0,0,0
9614,9614,Julien De Sart,4000,2016,Middlesbrough FC,0,0,0,0,0,0,0,0,0,0,0,0,0,0,0,0,0,0,0,0,0,0,0,0,0,0,0,0,0,0
9615,9615,Danny Welbeck,1506,2018,Arsenal FC,4,0,4,47,1,0,4,1,3,100,0,0,8,1,7,147,1,0,0,0,0,0,0,0,0,0,0,0,0,0
9616,9616,Davide Santon,2451,2012,Newcastle United,16,16,0,1311,0,0,15,15,0,1334,1,0,31,31,0,2645,1,0,0,0,0,0,1,1,0,0,0,0,0,0
9617,9617,Cheick Tioté,2289,2012,Newcastle United,13,12,1,960,0,0,11,10,1,866,0,0,24,22,2,1826,0,0,0,0,0,0,0,0,0,0,0,0,0,0
9618,9618,Sylvain Marveaux,2711,2012,Newcastle United,12,5,7,516,0,0,10,5,5,479,1,0,22,10,12,995,1,0,0,0,0,0,1,1,0,0,0,0,0,0
9619,9619,Jak Alnwick,3590,2012,Newcastle United,0,0,0,0,0,0,0,0,0,0,0,0,0,0,0,0,0,0,0,0,0,0,0,0,0,0,0,0,0,0
9620,9620,Gabriel Obertan,2283,2012,Newcastle United,8,1,7,176,0,0,6,3,3,237,0,0,14,4,10,413,0,0,0,0,0,0,0,0,0,0,0,0,0,0
9621,9621,Jason Gavin,3682,2000,Middlesbrough FC,7,5,2,560,0,0,7,5,2,475,0,0,14,10,4,1035,0,0,0,0,0,0,0,0,0,0,0,0,0,0
9622,9622,Patrice Carteron,4001,2000,Sunderland AFC,3,3,0,270,1,0,4,4,0,360,0,0,7,7,0,630,1,0,0,0,0,1,0,1,0,0,0,0,0,0
9623,9623,Thomas Butler,1637,2000,Sunderland AFC,2,0,2,33,0,0,2,0,2,13,0,0,4,0,4,46,0,0,0,0,0,0,0,0,0,0,0,0,0,0
9624,9624,Craig Beattie,4002,2008,West Bromwich Albion,4,0,4,58,1,0,3,1,2,92,0,0,7,1,6,150,1,0,0,0,0,0,0,0,0,0,0,0,0,0
9625,9625,George Thorne,1740,2012,West Bromwich Albion,2,0,2,7,0,0,3,3,0,223,0,0,5,3,2,230,0,0,0,0,0,0,0,0,0,0,0,0,0,0
9626,9626,José Enrique,2394,2014,Liverpool FC,1,1,0,90,0,0,3,1,2,113,0,0,4,2,2,203,0,0,0,0,0,0,0,0,0,0,0,0,0,0
9627,9627,Roy Carroll,1939,2006,West Ham United,6,6,0,540,0,0,6,6,0,540,0,0,12,12,0,1080,0,0,0,0,0,0,0,0,0,0,0,0,0,0
9628,9628,John Paintsil,2036,2006,West Ham United,1,0,1,45,0,0,4,3,1,299,0,0,5,3,2,344,0,0,0,0,0,0,0,0,0,0,0,0,0,0
9629,9629,Lee Bowyer,1297,2006,West Ham United,11,9,2,781,0,0,8,8,0,593,0,0,19,17,2,1374,0,0,0,0,0,0,0,0,0,0,0,0,0,0
9630,9630,Troy Parrott,4003,2019,Tottenham Hotspur,2,0,2,6,0,0,0,0,0,0,0,0,2,0,2,6,0,0,0,0,0,0,0,0,0,0,0,0,0,0
9631,9631,Alfie Whiteman,3399,2019,Tottenham Hotspur,0,0,0,0,0,0,0,0,0,0,0,0,0,0,0,0,0,0,0,0,0,0,0,0,0,0,0,0,0,0
9632,9632,Patrick Roberts,3352,2019,Norwich City,1,0,1,14,0,0,2,0,2,10,0,0,3,0,3,24,0,0,0,0,0,0,0,0,0,0,0,0,0,0
9633,9633,Mark Kinsella,1677,2003,Aston Villa,1,1,0,45,0,0,1,1,0,59,0,0,2,2,0,104,0,0,0,0,0,0,0,0,0,0,0,0,0,0
9634,9634,Freddie Woodman,2630,2017,Newcastle United,0,0,0,0,0,0,0,0,0,0,0,0,0,0,0,0,0,0,0,0,0,0,0,0,0,0,0,0,0,0
9635,9635,Eyong Enoh,4004,2012,Fulham FC,4,4,0,360,0,0,5,4,1,333,0,0,9,8,1,693,0,0,0,0,0,0,0,0,0,0,0,0,0,0
9636,9636,Stanislav Manolev,4005,2012,Fulham FC,1,1,0,90,0,0,4,3,1,340,0,0,5,4,1,430,0,0,0,0,0,0,0,0,0,0,0,0,0,0
9637,9637,Alou Diarra,3094,2012,West Ham United,0,0,0,0,0,0,3,1,2,138,0,0,3,1,2,138,0,0,0,0,0,0,0,0,0,0,0,0,0,0
9638,9638,Sebastian Lletget,4006,2012,West Ham United,0,0,0,0,0,0,0,0,0,0,0,0,0,0,0,0,0,0,0,0,0,0,0,0,0,0,0,0,0,0
9639,9639,George Moncur,4007,2012,West Ham United,0,0,0,0,0,0,0,0,0,0,0,0,0,0,0,0,0,0,0,0,0,0,0,0,0,0,0,0,0,0
9640,9640,Titus Bramble,1411,2011,Sunderland AFC,5,5,0,381,1,0,3,3,0,270,0,0,8,8,0,651,1,0,0,0,0,1,0,1,0,0,0,0,0,0
9641,9641,Adam Henley,4008,2011,Blackburn Rovers,2,1,1,112,0,0,5,3,2,358,0,0,7,4,3,470,0,0,0,0,0,0,0,0,0,0,0,0,0,0
9642,9642,Nick Blackman,3744,2011,Blackburn Rovers,1,0,1,6,0,0,0,0,0,0,0,0,1,0,1,6,0,0,0,0,0,0,0,0,0,0,0,0,0,0
9643,9643,Kagisho Dikgacoi,3401,2010,Fulham FC,1,0,1,4,0,0,0,0,0,0,0,0,1,0,1,4,0,0,0,0,0,0,0,0,0,0,0,0,0,0
9644,9644,Chris Kirkland,2056,2010,Wigan Athletic,3,3,0,270,0,0,1,1,0,62,0,0,4,4,0,332,0,0,0,0,0,0,0,0,0,0,0,0,0,0
9645,9645,Edu,1529,2000,Arsenal FC,2,1,1,69,0,0,3,1,2,131,0,0,5,2,3,200,0,0,0,0,0,0,0,0,0,0,0,0,0,0
9646,9646,Victor Anichebe,1751,2008,Everton FC,9,1,8,190,0,0,6,3,3,287,1,0,15,4,11,477,1,0,0,0,0,0,0,0,0,0,0,0,0,0
9647,9647,Andy van der Meyde,3520,2008,Everton FC,2,0,2,11,0,0,0,0,0,0,0,0,2,0,2,11,0,0,0,0,0,0,0,0,0,0,0,0,0,0
9648,9648,Kevin Davies,1718,2002,Southampton FC,3,0,3,52,1,0,5,1,4,96,0,0,8,1,7,148,1,0,1,0,1,1,0,1,0,0,0,0,0,0
9649,9649,Rickie Lambert,2597,2016,West Bromwich Albion,1,0,1,12,0,0,0,0,0,0,0,0,1,0,1,12,0,0,0,0,0,0,0,0,0,0,0,0,0,0
9650,9650,Kane Wilson,3525,2016,West Bromwich Albion,0,0,0,0,0,0,0,0,0,0,0,0,0,0,0,0,0,0,0,0,0,0,0,0,0,0,0,0,0,0
9651,9651,James McCarthy,1053,2016,Everton FC,7,5,2,382,1,0,5,2,3,231,0,0,12,7,5,613,1,0,0,0,0,0,0,0,0,0,0,0,0,0
9652,9652,Vito Mannone,2261,2008,Arsenal FC,1,1,0,90,0,0,0,0,0,0,0,0,1,1,0,90,0,0,0,0,0,0,0,0,0,0,0,0,0,0
9653,9653,Carl Dickinson,4009,2008,Stoke City,1,1,0,90,0,0,4,2,2,175,0,0,5,3,2,265,0,0,0,0,0,0,0,0,0,0,0,0,0,0
9654,9654,Lee Bowyer,1297,2007,West Ham United,9,7,2,574,2,0,6,5,1,440,2,0,15,12,3,1014,4,0,1,0,1,2,1,3,0,0,0,0,0,0
9655,9655,Harry Souttar,4010,2017,Stoke City,0,0,0,0,0,0,0,0,0,0,0,0,0,0,0,0,0,0,0,0,0,0,0,0,0,0,0,0,0,0
9656,9656,Goran Bunjevčević,1937,2001,Tottenham Hotspur,4,3,1,282,0,0,2,2,0,135,0,0,6,5,1,417,0,0,0,0,0,0,0,0,0,0,0,0,0,0
9657,9657,Yakubu Ayegbeni,1073,2010,Everton FC,8,3,5,338,1,0,6,4,2,328,0,0,14,7,7,666,1,0,3,0,3,1,0,1,0,0,0,0,0,0
9658,9658,Shefki Kuqi,2013,2007,Fulham FC,5,0,5,98,0,0,5,3,2,307,0,0,10,3,7,405,0,0,0,0,0,0,0,0,0,0,0,0,0,0
9659,9659,Johan Djourou,1229,2012,Arsenal FC,0,0,0,0,0,0,0,0,0,0,0,0,0,0,0,0,0,0,0,0,0,0,0,0,0,0,0,0,0,0
9660,9660,Nampalys Mendy,2945,2016,Leicester City,2,2,0,143,0,0,2,2,0,129,0,0,4,4,0,272,0,0,0,0,0,0,0,0,0,0,0,0,0,0
9661,9661,Marcin Wasilewski,2515,2016,Leicester City,1,1,0,90,0,0,0,0,0,0,0,0,1,1,0,90,0,0,0,0,0,0,0,0,0,0,0,0,0,0
9662,9662,Adrian Mariappa,1917,2015,Crystal Palace,0,0,0,0,0,0,3,3,0,256,0,0,3,3,0,256,0,0,0,0,0,0,0,0,0,0,0,0,0,0
9663,9663,Lucas Radebe,2131,2003,Leeds United,5,4,1,349,0,0,6,4,2,341,0,0,11,8,3,690,0,0,0,0,0,0,0,0,0,0,0,0,0,0
9664,9664,Stephen McPhail,3695,2003,Leeds United,4,2,2,244,1,0,7,5,2,439,0,0,11,7,4,683,1,0,0,0,0,1,0,1,0,0,0,0,0,0
9665,9665,Ross Barkley,1754,2017,Chelsea FC,1,1,0,54,0,0,1,1,0,77,0,0,2,2,0,131,0,0,0,0,0,0,0,0,0,0,0,0,0,0
9666,9666,John Collins,2895,2002,Fulham FC,2,0,2,10,0,0,3,0,3,14,0,0,5,0,5,24,0,0,0,0,0,0,0,0,0,0,0,0,0,0
9667,9667,Elvis Hammond,4011,2002,Fulham FC,5,1,4,200,0,0,4,1,3,114,0,0,9,2,7,314,0,0,0,0,0,0,0,0,0,0,0,0,0,0
9668,9668,Abdul Razak,1421,2011,Manchester City,1,0,1,10,0,0,0,0,0,0,0,0,1,0,1,10,0,0,0,0,0,0,0,0,0,0,0,0,0,0
9669,9669,Nathaniel Phillips,4012,2019,Liverpool FC,0,0,0,0,0,0,0,0,0,0,0,0,0,0,0,0,0,0,0,0,0,0,0,0,0,0,0,0,0,0
9670,9670,Phil Jones,1650,2019,Manchester United,1,1,0,90,0,0,1,1,0,46,0,0,2,2,0,136,0,0,0,0,0,0,0,0,0,0,0,0,0,0
9671,9671,Sam Vokes,1257,2009,Wolverhampton Wanderers,3,0,3,17,0,0,2,0,2,25,0,0,5,0,5,42,0,0,0,0,0,0,0,0,0,0,0,0,0,0
9672,9672,Joey Barton,1876,2007,Newcastle United,13,11,2,1003,0,0,10,9,1,826,1,0,23,20,3,1829,1,0,0,3,3,0,1,1,0,1,1,0,0,0
9673,9673,Emre Belözoğlu,2712,2007,Newcastle United,8,3,5,276,1,0,6,3,3,318,0,0,14,6,8,594,1,0,0,0,0,1,0,1,0,0,0,0,0,0
9674,9674,Jermaine Pennant,1514,2008,Portsmouth FC,6,5,1,382,0,0,7,4,3,383,0,0,13,9,4,765,0,0,0,0,0,0,0,0,0,0,0,0,0,0
9675,9675,Mark Noble,2204,2009,West Ham United,12,11,1,872,1,0,15,14,1,1263,1,0,27,25,2,2135,2,0,0,0,0,1,1,2,1,0,1,0,0,0
9676,9676,Frank Nouble,3820,2009,West Ham United,3,1,2,80,0,0,5,2,3,175,0,0,8,3,5,255,0,0,0,0,0,0,0,0,0,0,0,0,0,0
9677,9677,Manuel Da Costa,4013,2009,West Ham United,7,7,0,630,0,0,8,5,3,464,2,0,15,12,3,1094,2,0,0,1,1,0,2,2,0,0,0,0,0,0
9678,9678,Carlton Cole,2326,2009,West Ham United,15,14,1,1155,7,0,15,12,3,1134,3,0,30,26,4,2289,10,0,0,0,0,3,1,4,1,0,1,0,0,0
9679,9679,Timm Klose,2626,2019,Norwich City,5,5,0,406,0,0,2,2,0,180,0,0,7,7,0,586,0,0,0,0,0,0,0,0,0,0,0,0,0,0
9680,9680,João Virgínia,4014,2019,Everton FC,0,0,0,0,0,0,0,0,0,0,0,0,0,0,0,0,0,0,0,0,0,0,0,0,0,0,0,0,0,0
9681,9681,Cuco Martina,1049,2019,Everton FC,0,0,0,0,0,0,0,0,0,0,0,0,0,0,0,0,0,0,0,0,0,0,0,0,0,0,0,0,0,0
9682,9682,Jarrad Branthwaite,4015,2019,Everton FC,2,1,1,164,0,0,2,1,1,134,0,0,4,2,2,298,0,0,0,0,0,0,0,0,0,0,0,0,0,0
9683,9683,Beni Baningime,4016,2019,Everton FC,0,0,0,0,0,0,0,0,0,0,0,0,0,0,0,0,0,0,0,0,0,0,0,0,0,0,0,0,0,0
9684,9684,Marcus Bettinelli,4017,2018,Fulham FC,3,3,0,270,0,0,4,4,0,360,0,0,7,7,0,630,0,0,0,0,0,0,0,0,0,0,0,0,0,0
9685,9685,Alfie Mawson,3189,2018,Fulham FC,8,7,1,547,0,0,7,6,1,584,0,0,15,13,2,1131,0,0,0,0,0,0,0,0,0,0,0,0,0,0
9686,9686,Steven Sessegnon,4018,2018,Fulham FC,0,0,0,0,0,0,0,0,0,0,0,0,0,0,0,0,0,0,0,0,0,0,0,0,0,0,0,0,0,0
9687,9687,Emiliano Martínez,1482,2018,Arsenal FC,0,0,0,0,0,0,0,0,0,0,0,0,0,0,0,0,0,0,0,0,0,0,0,0,0,0,0,0,0,0
9688,9688,Valéry Mézague,4019,2004,Portsmouth FC,3,1,2,130,0,0,8,2,6,241,0,0,11,3,8,371,0,0,0,0,0,0,0,0,0,0,0,0,0,0
9689,9689,Phil Mulryne,4020,2004,Norwich City,4,3,1,238,0,0,5,4,1,312,0,0,9,7,2,550,0,0,0,0,0,0,0,0,0,0,0,0,0,0
9690,9690,Ryan Jarvis,4021,2004,Norwich City,1,0,1,12,1,0,3,1,2,102,0,0,4,1,3,114,1,0,0,0,0,0,0,0,0,0,0,0,0,0
9691,9691,Rodney Wallace,4022,2001,Bolton Wanderers,9,9,0,693,1,0,10,5,5,539,2,0,19,14,5,1232,3,0,0,0,0,1,2,3,0,0,0,0,0,0
9692,9692,Salif Diao,1992,2011,Stoke City,1,0,1,1,0,0,5,2,3,119,0,0,6,2,4,120,0,0,0,0,0,0,0,0,0,0,0,0,0,0
9693,9693,Ben Thatcher,1807,2002,Tottenham Hotspur,5,3,2,338,0,0,7,5,2,470,0,0,12,8,4,808,0,0,0,0,0,0,0,0,0,0,0,0,0,0
9694,9694,Denilson,1232,2009,Arsenal FC,12,11,1,923,3,0,8,8,0,650,1,0,20,19,1,1573,4,0,0,0,0,3,1,4,0,0,0,0,0,0
9695,9695,Alex Song,1233,2009,Arsenal FC,13,13,0,1107,0,0,13,12,1,1133,1,0,26,25,1,2240,1,0,0,0,0,0,0,0,0,0,0,0,0,0
9696,9696,John O'Shea,1729,2012,Sunderland AFC,17,17,0,1464,2,0,17,17,0,1530,0,0,34,34,0,2994,2,0,1,0,1,2,0,2,0,0,0,0,0,0
9697,9697,Alfred N'Diaye,3764,2012,Sunderland AFC,8,7,1,591,0,0,8,8,0,707,0,0,16,15,1,1298,0,0,0,0,0,0,0,0,0,0,0,0,0,0
9698,9698,Kader Mangane,4023,2012,Sunderland AFC,1,0,1,1,0,0,1,0,1,18,0,0,2,0,2,19,0,0,0,0,0,0,0,0,0,0,0,0,0,0
9699,9699,Mikael Mandron,4024,2012,Sunderland AFC,0,0,0,0,0,0,2,0,2,20,0,0,2,0,2,20,0,0,0,0,0,0,0,0,0,0,0,0,0,0
9700,9700,Jesper Grønkjær,2618,2001,Charlton Athletic,1,0,1,15,0,0,0,0,0,0,0,0,1,0,1,15,0,0,0,0,0,0,0,0,0,0,0,0,0,0
9701,9701,Danny Shittu,2116,2008,Bolton Wanderers,5,5,0,450,0,0,5,4,1,340,0,0,10,9,1,790,0,0,0,0,0,0,0,0,0,0,0,0,0,0
9702,9702,Ricardo Vaz Tê,3416,2008,Bolton Wanderers,1,0,1,8,0,0,1,0,1,24,0,0,2,0,2,32,0,0,0,0,0,0,0,0,0,0,0,0,0,0
9703,9703,Mahamadou Diarra,3350,2011,Fulham FC,6,4,2,373,0,0,5,4,1,379,1,0,11,8,3,752,1,0,0,0,0,0,0,0,0,0,0,0,0,0
9704,9704,Marcello Trotta,2561,2011,Fulham FC,0,0,0,0,0,0,1,0,1,2,0,0,1,0,1,2,0,0,0,0,0,0,0,0,0,0,0,0,0,0
9705,9705,Stuart Taylor,1684,2016,Southampton FC,0,0,0,0,0,0,0,0,0,0,0,0,0,0,0,0,0,0,0,0,0,0,0,0,0,0,0,0,0,0
9706,9706,Bartosz Kapustka,4025,2016,Leicester City,0,0,0,0,0,0,0,0,0,0,0,0,0,0,0,0,0,0,0,0,0,0,0,0,0,0,0,0,0,0
9707,9707,Brad Jones,1431,2008,Middlesbrough FC,9,9,0,810,0,0,7,7,0,630,0,0,16,16,0,1440,0,0,0,0,0,0,0,0,0,0,0,0,0,0
9708,9708,Robert Huth,1884,2008,Middlesbrough FC,12,12,0,1080,0,0,12,11,1,995,0,0,24,23,1,2075,0,0,0,0,0,0,0,0,0,0,0,0,0,0
9709,9709,Josh Walker,4026,2008,Middlesbrough FC,5,2,3,224,0,0,1,0,1,44,0,0,6,2,4,268,0,0,0,0,0,0,0,0,0,0,0,0,0,0
9710,9710,Collin Quaner,3107,2018,Huddersfield Town,1,0,1,9,0,0,1,0,1,28,0,0,2,0,2,37,0,0,0,0,0,0,0,0,0,0,0,0,0,0
9711,9711,Jacob Murphy,2578,2018,Newcastle United,3,2,1,167,0,0,6,1,5,133,0,0,9,3,6,300,0,0,0,0,0,0,0,0,0,0,0,0,0,0
9712,9712,Lee Grant,1908,2018,Manchester United,0,0,0,0,0,0,0,0,0,0,0,0,0,0,0,0,0,0,0,0,0,0,0,0,0,0,0,0,0,0
9713,9713,Hassan Kachloul,3484,2003,Wolverhampton Wanderers,3,0,3,66,0,0,1,0,1,4,0,0,4,0,4,70,0,0,0,0,0,0,0,0,0,0,0,0,0,0
9714,9714,Matt Elliott,2716,2003,Leicester City,5,2,3,299,0,0,2,1,1,129,0,0,7,3,4,428,0,0,0,0,0,0,0,0,0,0,0,0,0,0
9715,9715,Keith Gillespie,1351,2003,Leicester City,6,5,1,386,0,0,6,2,4,232,0,0,12,7,5,618,0,0,0,0,0,0,0,0,0,0,0,0,0,0
9716,9716,Craig Hignett,1455,2003,Leicester City,6,1,5,154,1,0,7,2,5,137,0,0,13,3,10,291,1,0,1,0,1,1,0,1,0,0,0,0,0,0
9717,9717,Ricardo Gardner,2411,2011,Bolton Wanderers,2,1,1,112,0,0,2,1,1,92,0,0,4,2,2,204,0,0,0,0,0,0,0,0,0,0,0,0,0,0
9718,9718,Gaël Kakuta,2651,2011,Bolton Wanderers,2,0,2,44,0,0,2,0,2,24,0,0,4,0,4,68,0,0,0,0,0,0,0,0,0,0,0,0,0,0
9719,9719,Dušan Kuciak,4027,2016,Hull City,0,0,0,0,0,0,0,0,0,0,0,0,0,0,0,0,0,0,0,0,0,0,0,0,0,0,0,0,0,0
9720,9720,Josh Clackstone,4028,2016,Hull City,0,0,0,0,0,0,0,0,0,0,0,0,0,0,0,0,0,0,0,0,0,0,0,0,0,0,0,0,0,0
9721,9721,Greg Olley,4029,2016,Hull City,0,0,0,0,0,0,0,0,0,0,0,0,0,0,0,0,0,0,0,0,0,0,0,0,0,0,0,0,0,0
9722,9722,Greg Luer,4030,2016,Hull City,0,0,0,0,0,0,0,0,0,0,0,0,0,0,0,0,0,0,0,0,0,0,0,0,0,0,0,0,0,0
9723,9723,Roman Bednář,2005,2010,West Bromwich Albion,1,0,1,36,0,0,3,1,2,93,0,0,4,1,3,129,0,0,0,0,0,0,0,0,0,0,0,0,0,0
9724,9724,Michael Folivi,4031,2016,Watford FC,0,0,0,0,0,0,1,0,1,9,0,0,1,0,1,9,0,0,0,0,0,0,0,0,0,0,0,0,0,0
9725,9725,Ryan Tunnicliffe,4032,2013,Fulham FC,2,1,1,101,0,0,1,1,0,65,0,0,3,2,1,166,0,0,0,0,0,0,0,0,0,0,0,0,0,0
9726,9726,Larnell Cole,4033,2013,Fulham FC,0,0,0,0,0,0,1,0,1,10,0,0,1,0,1,10,0,0,0,0,0,0,0,0,0,0,0,0,0,0
9727,9727,Jonathan Woodgate,1882,2000,Leeds United,6,6,0,466,1,0,6,6,0,421,0,0,12,12,0,887,1,0,0,0,0,0,0,0,0,0,0,0,0,0
9728,9728,Michael Duberry,2291,2000,Leeds United,1,1,0,90,0,0,2,2,0,180,0,0,3,3,0,270,0,0,0,0,0,0,0,0,0,0,0,0,0,0
9729,9729,Michael Bridges,2294,2000,Leeds United,3,2,1,179,0,0,3,3,0,270,0,0,6,5,1,449,0,0,0,0,0,0,0,0,0,0,0,0,0,0
9730,9730,Alex,2269,2011,Chelsea FC,1,1,0,66,0,0,2,2,0,180,0,0,3,3,0,246,0,0,0,0,0,0,0,0,0,0,0,0,0,0
9731,9731,Stuart Ripley,2052,2000,Southampton FC,3,1,2,103,0,0,0,0,0,0,0,0,3,1,2,103,0,0,0,0,0,0,0,0,0,0,0,0,0,0
9732,9732,Matt Le Tissier,4034,2000,Southampton FC,7,2,5,221,1,0,1,0,1,12,0,0,8,2,6,233,1,0,3,0,3,1,0,1,0,0,0,0,0,0
9733,9733,Didier Domi,3755,2000,Newcastle United,7,6,1,565,0,0,7,5,2,453,0,0,14,11,3,1018,0,0,0,0,0,0,0,0,0,0,0,0,0,0
9734,9734,Andy Griffin,1578,2000,Newcastle United,7,5,2,471,0,0,10,8,2,705,0,0,17,13,4,1176,0,0,0,0,0,0,0,0,0,0,0,0,0,0
9735,9735,Christian Ziege,1129,2002,Tottenham Hotspur,8,7,1,536,2,0,4,3,1,287,0,0,12,10,2,823,2,0,0,0,0,2,0,2,0,0,0,0,0,0
9736,9736,Steffen Iversen,2080,2002,Tottenham Hotspur,8,2,6,245,1,0,11,6,5,534,0,0,19,8,11,779,1,0,1,0,1,1,0,1,0,0,0,0,0,0
9737,9737,Hayden Foxe,4035,2000,West Ham United,2,1,1,144,0,0,2,1,1,95,0,0,4,2,2,239,0,0,0,0,0,0,0,0,0,0,0,0,0,0
9738,9738,Tyrone Mears,1572,2006,West Ham United,4,3,1,206,0,0,1,0,1,9,0,0,5,3,2,215,0,0,0,0,0,0,0,0,0,0,0,0,0,0
9739,9739,Sullay Kaikai,2777,2018,Crystal Palace,0,0,0,0,0,0,0,0,0,0,0,0,0,0,0,0,0,0,0,0,0,0,0,0,0,0,0,0,0,0
9740,9740,Sherjill MacDonald,4036,2008,West Bromwich Albion,2,0,2,30,0,0,3,0,3,128,0,0,5,0,5,158,0,0,0,0,0,0,0,0,0,0,0,0,0,0
9741,9741,Andy Reid,1220,2006,Charlton Athletic,8,8,0,660,1,0,8,7,1,548,1,0,16,15,1,1208,2,0,1,0,1,1,1,2,0,0,0,0,0,0
9742,9742,Hilário,2709,2011,Chelsea FC,2,2,0,180,0,0,0,0,0,0,0,0,2,2,0,180,0,0,0,0,0,0,0,0,0,0,0,0,0,0
9743,9743,Chris Martin,3823,2011,Norwich City,2,2,0,154,0,0,2,1,1,86,0,0,4,3,1,240,0,0,0,0,0,0,0,0,0,0,0,0,0,0
9744,9744,Mark Delaney,3269,2002,Aston Villa,5,5,0,444,0,0,7,7,0,617,0,0,12,12,0,1061,0,0,0,0,0,0,0,0,0,0,0,0,0,0
9745,9745,Ian Taylor,2767,2002,Aston Villa,4,4,0,360,0,0,9,5,4,559,0,0,13,9,4,919,0,0,0,0,0,0,0,0,0,0,0,0,0,0
9746,9746,Paul Konchesky,1560,2010,Liverpool FC,6,6,0,462,0,0,9,9,0,790,0,0,15,15,0,1252,0,0,0,0,0,0,0,0,0,0,0,0,0,0
9747,9747,Ian Feuer,4037,2001,Derby County,1,1,0,90,0,0,1,1,0,90,0,0,2,2,0,180,0,0,0,0,0,0,0,0,0,0,0,0,0,0
9748,9748,Michael Stewart,4038,2001,Manchester United,1,1,0,59,0,0,2,1,1,69,0,0,3,2,1,128,0,0,0,0,0,0,0,0,0,0,0,0,0,0
9749,9749,Raimond van der Gouw,3788,2001,Manchester United,1,0,1,13,0,0,0,0,0,0,0,0,1,0,1,13,0,0,0,0,0,0,0,0,0,0,0,0,0,0
9750,9750,Chris Basham,2601,2008,Bolton Wanderers,4,1,3,108,0,0,7,3,4,356,1,0,11,4,7,464,1,0,0,0,0,0,0,0,0,0,0,0,0,0
9751,9751,Branislav Ivanović,1532,2009,Chelsea FC,13,12,1,1064,0,0,14,12,2,1100,0,0,27,24,3,2164,0,0,0,0,0,0,0,0,0,0,0,0,0,0
9752,9752,Ashley Cole,1523,2009,Chelsea FC,14,13,1,1132,4,0,13,12,1,1024,0,0,27,25,2,2156,4,0,0,0,0,1,0,1,0,0,0,0,0,0
9753,9753,Michael Ballack,2271,2009,Chelsea FC,18,16,2,1440,3,0,13,9,4,845,1,0,31,25,6,2285,4,0,0,0,0,0,1,1,0,0,0,0,0,0
9754,9754,Salomon Kalou,1770,2009,Chelsea FC,14,6,8,524,5,0,9,5,4,432,0,0,23,11,12,956,5,0,0,0,0,1,0,1,0,0,0,0,0,0
9755,9755,Nicolas Anelka,1720,2009,Chelsea FC,18,18,0,1515,9,0,14,12,2,1100,2,0,32,30,2,2615,11,0,3,0,3,7,1,8,0,0,0,0,0,0
9756,9756,Belletti,2432,2009,Chelsea FC,7,3,4,330,0,0,4,1,3,167,0,0,11,4,7,497,0,0,0,0,0,0,0,0,0,0,0,0,0,0
9757,9757,Nemanja Matić,1537,2009,Chelsea FC,2,0,2,41,0,0,0,0,0,0,0,0,2,0,2,41,0,0,0,0,0,0,0,0,0,0,0,0,0,0
9758,9758,Andy Todd,1672,2001,Sunderland AFC,1,0,1,6,0,0,0,0,0,0,0,0,1,0,1,6,0,0,0,0,0,0,0,0,0,0,0,0,0,0
9759,9759,Stephen McPhail,3695,2002,Leeds United,6,3,3,333,0,0,6,3,3,272,0,0,12,6,6,605,0,0,0,0,0,0,0,0,0,0,0,0,0,0
9760,9760,Liam Miller,1224,2008,Sunderland AFC,1,0,1,27,0,0,2,1,1,62,0,0,3,1,2,89,0,0,0,0,0,0,0,0,0,0,0,0,0,0
9761,9761,Tom Huddlestone,1270,2010,Tottenham Hotspur,9,9,0,776,1,0,5,4,1,389,1,0,14,13,1,1165,2,0,0,3,3,0,1,1,0,0,0,0,0,0
9762,9762,Robbie Keane,1126,2010,Tottenham Hotspur,3,1,2,101,0,0,4,1,3,114,0,0,7,2,5,215,0,0,0,0,0,0,0,0,0,0,0,0,0,0
9763,9763,Michael Mancienne,2886,2010,Wolverhampton Wanderers,7,5,2,423,0,0,9,8,1,698,0,0,16,13,3,1121,0,0,0,0,0,0,0,0,0,0,0,0,0,0
9764,9764,Jelle Van Damme,4039,2010,Wolverhampton Wanderers,3,2,1,150,0,0,3,2,1,128,1,0,6,4,2,278,1,0,0,0,0,0,1,1,0,0,0,0,0,0
9765,9765,Adlène Guédioura,3130,2010,Wolverhampton Wanderers,6,3,3,268,1,0,4,1,3,99,0,0,10,4,6,367,1,0,0,0,0,0,0,0,0,0,0,0,0,0
9766,9766,Stefan Postma,3271,2002,Aston Villa,4,3,1,313,0,0,2,2,0,180,0,0,6,5,1,493,0,0,0,0,0,0,0,0,0,0,0,0,0,0
9767,9767,Alan Wright,2766,2002,Aston Villa,5,4,1,359,0,0,5,5,0,395,0,0,10,9,1,754,0,0,0,0,0,0,0,0,0,0,0,0,0,0
9768,9768,Mark Wilson,3684,2002,Middlesbrough FC,3,1,2,100,0,0,3,3,0,270,0,0,6,4,2,370,0,0,0,0,0,0,0,0,0,0,0,0,0,0
9769,9769,Billy Knott,3865,2012,Sunderland AFC,0,0,0,0,0,0,1,0,1,15,0,0,1,0,1,15,0,0,0,0,0,0,0,0,0,0,0,0,0,0
9770,9770,Adam Mitchell,4040,2012,Sunderland AFC,0,0,0,0,0,0,1,0,1,2,0,0,1,0,1,2,0,0,0,0,0,0,0,0,0,0,0,0,0,0
9771,9771,Liam Marrs,4041,2012,Sunderland AFC,0,0,0,0,0,0,0,0,0,0,0,0,0,0,0,0,0,0,0,0,0,0,0,0,0,0,0,0,0,0
9772,9772,David Ferguson,4042,2012,Sunderland AFC,0,0,0,0,0,0,0,0,0,0,0,0,0,0,0,0,0,0,0,0,0,0,0,0,0,0,0,0,0,0
9773,9773,Scott Harrison,4043,2012,Sunderland AFC,0,0,0,0,0,0,0,0,0,0,0,0,0,0,0,0,0,0,0,0,0,0,0,0,0,0,0,0,0,0
9774,9774,Ali Al Habsi,2877,2012,Wigan Athletic,15,15,0,1350,0,0,14,14,0,1260,0,0,29,29,0,2610,0,0,0,0,0,0,0,0,0,0,0,0,0,0
9775,9775,Gary Caldwell,2673,2012,Wigan Athletic,11,11,0,892,1,0,14,14,0,1195,0,0,25,25,0,2087,1,0,0,0,0,1,0,1,0,0,0,0,0,0
9776,9776,Emmerson Boyce,2023,2012,Wigan Athletic,18,18,0,1582,2,0,18,18,0,1563,2,0,36,36,0,3145,4,0,0,0,0,2,0,2,0,0,0,0,0,0
9777,9777,Iván Ramis,4044,2012,Wigan Athletic,8,8,0,679,1,0,8,8,0,720,1,0,16,16,0,1399,2,0,0,0,0,1,1,2,0,0,0,0,0,0
9778,9778,Maynor Figueroa,2057,2012,Wigan Athletic,16,16,0,1385,0,0,17,17,0,1509,1,0,33,33,0,2894,1,0,0,0,0,0,0,0,0,0,0,0,0,0
9779,9779,James McCarthy,1053,2012,Wigan Athletic,19,19,0,1710,3,0,19,19,0,1666,0,0,38,38,0,3376,3,0,1,0,1,3,0,3,0,0,0,0,0,0
9780,9780,Shaun Maloney,2738,2012,Wigan Athletic,18,17,1,1454,2,0,18,17,1,1492,4,0,36,34,2,2946,6,0,1,1,2,2,3,5,1,0,1,0,0,0
9781,9781,James McArthur,1023,2012,Wigan Athletic,17,13,4,1225,1,0,17,11,6,1181,2,0,34,24,10,2406,3,0,0,0,0,0,1,1,0,0,0,0,0,0
9782,9782,Jean Beausejour,2544,2012,Wigan Athletic,16,16,0,1339,1,0,18,16,2,1446,0,0,34,32,2,2785,1,0,0,0,0,1,0,1,0,0,0,0,0,0
9783,9783,Arouna Koné,2237,2012,Wigan Athletic,17,16,1,1463,5,0,17,16,1,1468,6,0,34,32,2,2931,11,0,6,0,6,3,2,5,0,0,0,0,0,0
9784,9784,Franco Di Santo,2272,2012,Wigan Athletic,17,12,5,1043,2,0,18,12,6,1090,3,0,35,24,11,2133,5,0,0,2,2,2,3,5,0,0,0,0,0,0
9785,9785,Ben Watson,2025,2012,Wigan Athletic,7,4,3,365,0,0,5,3,2,257,1,0,12,7,5,622,1,0,0,3,3,0,1,1,0,0,0,0,0,0
9786,9786,Jordi Gómez,2059,2012,Wigan Athletic,15,9,6,855,3,0,17,8,9,705,0,0,32,17,15,1560,3,0,3,0,3,3,0,3,0,0,0,0,0,0
9787,9787,Mauro Boselli,3632,2012,Wigan Athletic,4,0,4,51,0,0,3,1,2,80,0,0,7,1,6,131,0,0,0,0,0,0,0,0,0,0,0,0,0,0
9788,9788,Mike Pollitt,2880,2012,Wigan Athletic,0,0,0,0,0,0,0,0,0,0,0,0,0,0,0,0,0,0,0,0,0,0,0,0,0,0,0,0,0,0
9789,9789,David Jones,1490,2012,Wigan Athletic,5,4,1,384,0,0,8,4,4,423,0,0,13,8,5,807,0,0,0,0,0,0,0,0,0,0,0,0,0,0
9790,9790,Callum McManaman,3001,2012,Wigan Athletic,11,4,7,334,1,0,9,4,5,304,1,0,20,8,12,638,2,0,0,3,3,1,1,2,0,0,0,0,0,0
9791,9791,Ryo Miyaichi,2497,2012,Wigan Athletic,2,0,2,23,0,0,2,0,2,26,0,0,4,0,4,49,0,0,0,0,0,0,0,0,0,0,0,0,0,0
9792,9792,Callum Hudson-Odoi,1855,2019,Chelsea FC,12,4,8,457,1,0,10,3,7,394,0,0,22,7,15,851,1,0,0,0,0,0,0,0,0,0,0,0,0,0
9793,9793,Emerson,3166,2019,Chelsea FC,8,8,0,645,0,0,7,5,2,380,0,0,15,13,2,1025,0,0,0,0,0,0,0,0,0,0,0,0,0,0
9794,9794,Abdisalam Ibrahim,4045,2009,Manchester City,1,0,1,14,0,0,0,0,0,0,0,0,1,0,1,14,0,0,0,0,0,0,0,0,0,0,0,0,0,0
9795,9795,Carlo Cudicini,2370,2009,Tottenham Hotspur,3,3,0,270,0,0,4,3,1,344,0,0,7,6,1,614,0,0,0,0,0,0,0,0,0,0,0,0,0,0
9796,9796,Daniel Gabbidon,2464,2009,West Ham United,4,3,1,264,0,0,6,5,1,451,0,0,10,8,2,715,0,0,0,0,0,0,0,0,0,0,0,0,0,0
9797,9797,Zavon Hines,3804,2009,West Ham United,8,4,4,430,1,0,5,1,4,170,0,0,13,5,8,600,1,0,3,0,3,1,0,1,0,0,0,0,0,0
9798,9798,Franck Songo'o,4046,2005,Portsmouth FC,1,0,1,14,0,0,1,0,1,17,0,0,2,0,2,31,0,0,0,0,0,0,0,0,0,0,0,0,0,0
9799,9799,Grzegorz Rasiak,4047,2005,Tottenham Hotspur,3,1,2,97,0,0,5,3,2,240,0,0,8,4,4,337,0,0,0,0,0,0,0,0,0,0,0,0,0,0
9800,9800,Noureddine Naybet,1936,2005,Tottenham Hotspur,1,1,0,90,0,0,2,1,1,141,0,0,3,2,1,231,0,0,0,0,0,0,0,0,0,0,0,0,0,0
9801,9801,Lorenzo Amoruso,3812,2004,Blackburn Rovers,5,4,1,382,0,0,1,1,0,90,0,0,6,5,1,472,0,0,0,0,0,0,0,0,0,0,0,0,0,0
9802,9802,Youri Djorkaeff,3077,2004,Blackburn Rovers,2,2,0,149,0,0,1,1,0,53,0,0,3,3,0,202,0,0,0,0,0,0,0,0,0,0,0,0,0,0
9803,9803,Igors Stepanovs,3330,2001,Arsenal FC,3,3,0,270,0,0,3,3,0,225,0,0,6,6,0,495,0,0,0,0,0,0,0,0,0,0,0,0,0,0
9804,9804,Lee Dixon,3258,2001,Arsenal FC,6,1,5,190,0,0,6,2,4,308,0,0,12,3,9,498,0,0,0,0,0,0,0,0,0,0,0,0,0,0
9805,9805,Jérémie Aliadiére,1530,2001,Arsenal FC,1,0,1,9,0,0,0,0,0,0,0,0,1,0,1,9,0,0,0,0,0,0,0,0,0,0,0,0,0,0
9806,9806,Kyle Taylor,3935,2018,AFC Bournemouth,0,0,0,0,0,0,0,0,0,0,0,0,0,0,0,0,0,0,0,0,0,0,0,0,0,0,0,0,0,0
9807,9807,Jores Okore,2664,2013,Aston Villa,2,2,0,120,0,0,1,0,1,47,0,0,3,2,1,167,0,0,0,0,0,0,0,0,0,0,0,0,0,0
9808,9808,Matthew Lowton,1250,2013,Aston Villa,11,10,1,832,0,0,12,8,4,828,0,0,23,18,5,1660,0,0,0,0,0,0,0,0,0,0,0,0,0,0
9809,9809,Aleksandar Tonev,4048,2013,Aston Villa,9,3,6,305,0,0,8,3,5,291,0,0,17,6,11,596,0,0,0,0,0,0,0,0,0,0,0,0,0,0
9810,9810,Libor Kozák,3407,2013,Aston Villa,8,4,4,383,1,0,6,4,2,398,3,0,14,8,6,781,4,0,0,3,3,0,3,3,0,0,0,0,0,0
9811,9811,Stephen Kelly,1121,2005,Tottenham Hotspur,4,4,0,329,0,0,5,5,0,450,0,0,9,9,0,779,0,0,0,0,0,0,0,0,0,0,0,0,0,0
9812,9812,Tom Huddlestone,1270,2005,Tottenham Hotspur,2,0,2,70,0,0,2,0,2,68,0,0,4,0,4,138,0,0,0,0,0,0,0,0,0,0,0,0,0,0
9813,9813,Caleb Folan,2613,2006,Wigan Athletic,6,4,2,320,0,0,7,4,3,370,2,0,13,8,5,690,2,0,0,4,4,0,2,2,0,0,0,0,0,0
9814,9814,Lauren,1602,2006,Portsmouth FC,6,5,1,496,0,0,4,4,0,302,0,0,10,9,1,798,0,0,0,0,0,0,0,0,0,0,0,0,0,0
9815,9815,Rudolphe Douala,4049,2006,Portsmouth FC,3,0,3,86,0,0,4,1,3,158,0,0,7,1,6,244,0,0,0,0,0,0,0,0,0,0,0,0,0,0
9816,9816,Ainsley Maitland-Niles,1473,2014,Arsenal FC,1,0,1,1,0,0,0,0,0,0,0,0,1,0,1,1,0,0,0,0,0,0,0,0,0,0,0,0,0,0
9817,9817,Kieron Dyer,2033,2011,Queens Park Rangers,1,1,0,7,0,0,0,0,0,0,0,0,1,1,0,7,0,0,0,0,0,0,0,0,0,0,0,0,0,0
9818,9818,Robbie Blake,2551,2011,Bolton Wanderers,0,0,0,0,0,0,1,0,1,4,0,0,1,0,1,4,0,0,0,0,0,0,0,0,0,0,0,0,0,0
9819,9819,Paul Warhurst,3069,2002,Bolton Wanderers,4,4,0,270,0,0,3,1,2,127,0,0,7,5,2,397,0,0,0,0,0,0,0,0,0,0,0,0,0,0
9820,9820,Stig Tøfting,4050,2002,Bolton Wanderers,3,1,2,140,0,0,5,1,4,144,0,0,8,2,6,284,0,0,0,0,0,0,0,0,0,0,0,0,0,0
9821,9821,David Edgar,3825,2007,Newcastle United,3,1,2,96,0,0,2,1,1,91,0,0,5,2,3,187,0,0,0,0,0,0,0,0,0,0,0,0,0,0
9822,9822,Andy Carroll,1779,2007,Newcastle United,2,0,2,43,0,0,2,1,1,95,0,0,4,1,3,138,0,0,0,0,0,0,0,0,0,0,0,0,0,0
9823,9823,Jan Bednarek,2478,2018,Southampton FC,13,13,0,1126,0,0,12,11,1,1025,0,0,25,24,1,2151,0,0,0,0,0,0,0,0,0,0,0,0,0,0
9824,9824,Yan Valery,3027,2018,Southampton FC,13,12,1,1070,1,0,10,8,2,690,1,0,23,20,3,1760,2,0,0,0,0,1,1,2,0,0,0,0,0,0
9825,9825,Tyreke Johnson,4051,2018,Southampton FC,1,0,1,1,0,0,0,0,0,0,0,0,1,0,1,1,0,0,0,0,0,0,0,0,0,0,0,0,0,0
9826,9826,Bongani Khumalo,4052,2010,Tottenham Hotspur,0,0,0,0,0,0,0,0,0,0,0,0,0,0,0,0,0,0,0,0,0,0,0,0,0,0,0,0,0,0
9827,9827,Billy Jones,1733,2014,Sunderland AFC,7,7,0,626,0,0,7,7,0,630,0,0,14,14,0,1256,0,0,0,0,0,0,0,0,0,0,0,0,0,0
9828,9828,Bersant Celina,4053,2015,Manchester City,1,0,1,13,0,0,0,0,0,0,0,0,1,0,1,13,0,0,0,0,0,0,0,0,0,0,0,0,0,0
9829,9829,Aleix García,3128,2015,Manchester City,0,0,0,0,0,0,0,0,0,0,0,0,0,0,0,0,0,0,0,0,0,0,0,0,0,0,0,0,0,0
9830,9830,Mousa Dembélé,1172,2015,Tottenham Hotspur,14,13,1,1109,2,0,15,14,1,1164,1,0,29,27,2,2273,3,0,0,0,0,2,1,3,0,0,0,0,0,0
9831,9831,Dele Alli,1915,2015,Tottenham Hotspur,16,14,2,1287,2,0,17,14,3,1194,8,0,33,28,5,2481,10,0,0,1,1,1,5,6,0,0,0,0,0,0
9832,9832,Kieran Trippier,1487,2015,Tottenham Hotspur,2,2,0,180,1,0,4,3,1,278,0,0,6,5,1,458,1,0,3,0,3,1,0,1,0,0,0,0,0,0
9833,9833,Jimmy Walker,2952,2005,West Ham United,3,3,0,270,0,0,0,0,0,0,0,0,3,3,0,270,0,0,0,0,0,0,0,0,0,0,0,0,0,0
9834,9834,Clive Clarke,4054,2005,West Ham United,1,1,0,45,0,0,1,1,0,76,0,0,2,2,0,121,0,0,0,0,0,0,0,0,0,0,0,0,0,0
9835,9835,Jay Fulton,3196,2017,Swansea City,1,0,1,1,0,0,1,0,1,16,0,0,2,0,2,17,0,0,0,0,0,0,0,0,0,0,0,0,0,0
9836,9836,Leam Richardson,4055,2001,Bolton Wanderers,0,0,0,0,0,0,1,0,1,8,0,0,1,0,1,8,0,0,0,0,0,0,0,0,0,0,0,0,0,0
9837,9837,Ben Johnson,4056,2019,West Ham United,2,2,0,180,0,0,1,1,0,90,0,0,3,3,0,270,0,0,0,0,0,0,0,0,0,0,0,0,0,0
9838,9838,Tomáš Souček,4057,2019,West Ham United,6,6,0,535,2,0,7,6,1,506,1,0,13,12,1,1041,3,0,0,0,0,1,1,2,0,0,0,0,0,0
9839,9839,Jarrod Bowen,2739,2019,West Ham United,6,6,0,463,1,0,7,5,2,459,0,0,13,11,2,922,1,0,0,0,0,1,0,1,0,0,0,0,0,0
9840,9840,Conor Coventry,3840,2019,West Ham United,0,0,0,0,0,0,0,0,0,0,0,0,0,0,0,0,0,0,0,0,0,0,0,0,0,0,0,0,0,0
9841,9841,Xande Silva,4058,2019,West Ham United,0,0,0,0,0,0,0,0,0,0,0,0,0,0,0,0,0,0,0,0,0,0,0,0,0,0,0,0,0,0
9842,9842,Diogo Dalot,2910,2019,Manchester United,1,0,1,2,0,0,3,1,2,64,0,0,4,1,3,66,0,0,0,0,0,0,0,0,0,0,0,0,0,0
9843,9843,Xherdan Shaqiri,1904,2019,Liverpool FC,3,2,1,166,1,0,4,0,4,16,0,0,7,2,5,182,1,0,0,0,0,0,0,0,0,0,0,0,0,0
9844,9844,Danny Guthrie,2397,2006,Liverpool FC,1,0,1,6,0,0,2,0,2,26,0,0,3,0,3,32,0,0,0,0,0,0,0,0,0,0,0,0,0,0
9845,9845,Andy O'Brien,2160,2006,Portsmouth FC,0,0,0,0,0,0,3,1,2,106,0,0,3,1,2,106,0,0,0,0,0,0,0,0,0,0,0,0,0,0
9846,9846,James Vaughan,3240,2008,Everton FC,7,1,6,112,0,0,6,0,6,75,0,0,13,1,12,187,0,0,0,0,0,0,0,0,0,0,0,0,0,0
9847,9847,Matthew Jones,1310,2001,Leicester City,3,2,1,162,1,0,7,4,3,361,0,0,10,6,4,523,1,0,0,0,0,1,0,1,0,0,0,0,0,0
9848,9848,John Mikel Obi,1769,2015,Chelsea FC,11,8,3,753,0,0,14,11,3,1028,0,0,25,19,6,1781,0,0,0,0,0,0,0,0,0,0,0,0,0,0
9849,9849,Diego Costa,2731,2015,Chelsea FC,15,14,1,1242,7,0,13,13,0,1136,5,0,28,27,1,2378,12,0,5,3,8,6,2,8,0,0,0,0,0,0
9850,9850,Danny Butterfield,4059,2004,Crystal Palace,3,3,0,237,0,0,4,4,0,312,0,0,7,7,0,549,0,0,0,0,0,0,0,0,0,0,0,0,0,0
9851,9851,Sandor Torghelle,4060,2004,Crystal Palace,4,1,3,89,0,0,8,2,6,308,0,0,12,3,9,397,0,0,0,0,0,0,0,0,0,0,0,0,0,0
9852,9852,Semi Ajayi,4061,2014,Arsenal FC,0,0,0,0,0,0,0,0,0,0,0,0,0,0,0,0,0,0,0,0,0,0,0,0,0,0,0,0,0,0
9853,9853,Hatem Ben Arfa,2457,2014,Hull City,4,2,2,157,0,0,4,3,1,226,0,0,8,5,3,383,0,0,0,0,0,0,0,0,0,0,0,0,0,0
9854,9854,Igor Bišćan,2365,2001,Liverpool FC,3,2,1,155,0,0,1,1,0,46,0,0,4,3,1,201,0,0,0,0,0,0,0,0,0,0,0,0,0,0
9855,9855,Richard Naylor,4062,2001,Ipswich Town,8,3,5,266,1,0,6,2,4,242,0,0,14,5,9,508,1,0,0,0,0,0,0,0,0,0,0,0,0,0
9856,9856,Couñago,4063,2001,Ipswich Town,8,1,7,250,0,0,4,0,4,99,0,0,12,1,11,349,0,0,0,0,0,0,0,0,0,0,0,0,0,0
9857,9857,Gavin Peacock,4064,2001,Charlton Athletic,1,0,1,45,0,0,4,1,3,122,0,0,5,1,4,167,0,0,0,0,0,0,0,0,0,0,0,0,0,0
9858,9858,John Salako,2336,2001,Charlton Athletic,2,1,1,55,0,0,1,1,0,61,0,0,3,2,1,116,0,0,0,0,0,0,0,0,0,0,0,0,0,0
9859,9859,Sam Hughes,4065,2017,Leicester City,0,0,0,0,0,0,0,0,0,0,0,0,0,0,0,0,0,0,0,0,0,0,0,0,0,0,0,0,0,0
9860,9860,Layton Ndukwu,4066,2017,Leicester City,0,0,0,0,0,0,0,0,0,0,0,0,0,0,0,0,0,0,0,0,0,0,0,0,0,0,0,0,0,0
9861,9861,Ledley King,1119,2007,Tottenham Hotspur,2,2,0,141,0,0,1,1,0,90,0,0,3,3,0,231,0,0,0,0,0,0,0,0,0,0,0,0,0,0
9862,9862,Adel Taarabt,2165,2007,Tottenham Hotspur,3,0,3,67,0,0,3,0,3,57,0,0,6,0,6,124,0,0,0,0,0,0,0,0,0,0,0,0,0,0
9863,9863,Kieran Richardson,1898,2004,West Bromwich Albion,6,5,1,448,2,0,5,5,0,353,1,0,11,10,1,801,3,0,0,0,0,1,1,2,0,0,0,0,0,0
9864,9864,Timothy Eyoma,4067,2018,Tottenham Hotspur,0,0,0,0,0,0,0,0,0,0,0,0,0,0,0,0,0,0,0,0,0,0,0,0,0,0,0,0,0,0
9865,9865,Neil Moss,4068,2000,Southampton FC,1,1,0,90,0,0,2,2,0,180,0,0,3,3,0,270,0,0,0,0,0,0,0,0,0,0,0,0,0,0
9866,9866,Chris Kirkland,2056,2003,Liverpool FC,3,3,0,270,0,0,3,3,0,270,0,0,6,6,0,540,0,0,0,0,0,0,0,0,0,0,0,0,0,0
9867,9867,Djimi Traoré,2364,2003,Liverpool FC,2,2,0,156,0,0,5,5,0,421,0,0,7,7,0,577,0,0,0,0,0,0,0,0,0,0,0,0,0,0
9868,9868,Salif Diao,1992,2003,Liverpool FC,2,2,0,172,0,0,1,0,1,44,0,0,3,2,1,216,0,0,0,0,0,0,0,0,0,0,0,0,0,0
9869,9869,Florent Sinama-Pongolle,3873,2003,Liverpool FC,8,2,6,266,2,0,7,1,6,158,0,0,15,3,12,424,2,0,0,0,0,0,0,0,0,0,0,0,0,0
9870,9870,Alan Rogers,3165,2001,Leicester City,6,4,2,384,0,0,7,5,2,473,0,0,13,9,4,857,0,0,0,0,0,0,0,0,0,0,0,0,0,0
9871,9871,Keith Andrews,2656,2003,Wolverhampton Wanderers,1,1,0,90,0,0,0,0,0,0,0,0,1,1,0,90,0,0,0,0,0,0,0,0,0,0,0,0,0,0
9872,9872,Michail Antonio,2208,2017,West Ham United,10,10,0,707,0,0,11,6,5,650,3,0,21,16,5,1357,3,0,0,0,0,0,1,1,0,0,0,0,0,0
9873,9873,Gareth Barry,1418,2001,Aston Villa,8,6,2,562,0,0,11,9,2,778,0,0,19,15,4,1340,0,0,0,0,0,0,0,0,0,0,0,0,0,0
9874,9874,Thomas Hitzlsperger,1792,2001,Aston Villa,5,5,0,450,0,0,7,6,1,485,1,0,12,11,1,935,1,0,0,0,0,0,1,1,0,0,0,0,0,0
9875,9875,Steven Whittaker,1369,2015,Norwich City,3,3,0,270,0,0,5,5,0,450,1,0,8,8,0,720,1,0,0,0,0,0,0,0,0,0,0,0,0,0
9876,9876,Alexander Tettey,1830,2015,Norwich City,11,11,0,900,1,0,12,12,0,1052,1,0,23,23,0,1952,2,0,3,0,3,1,0,1,0,0,0,0,0,0
9877,9877,Steve Harper,2231,2000,Newcastle United,2,2,0,180,0,0,2,1,1,135,0,0,4,3,1,315,0,0,0,0,0,0,0,0,0,0,0,0,0,0
9878,9878,Shola Ameobi,1950,2008,Newcastle United,11,8,3,662,2,0,11,6,5,596,2,0,22,14,8,1258,4,0,1,0,1,2,2,4,1,0,1,0,0,0
9879,9879,Lasse Sørensen,4069,2017,Stoke City,0,0,0,0,0,0,1,1,0,76,0,0,1,1,0,76,0,0,0,0,0,0,0,0,0,0,0,0,0,0
9880,9880,Denis Suárez,2909,2012,Manchester City,0,0,0,0,0,0,0,0,0,0,0,0,0,0,0,0,0,0,0,0,0,0,0,0,0,0,0,0,0,0
9881,9881,Aaron Rowe,4070,2018,Huddersfield Town,1,0,1,14,0,0,1,1,0,55,0,0,2,1,1,69,0,0,0,0,0,0,0,0,0,0,0,0,0,0
9882,9882,Marc Pugh,1016,2018,AFC Bournemouth,0,0,0,0,0,0,0,0,0,0,0,0,0,0,0,0,0,0,0,0,0,0,0,0,0,0,0,0,0,0
9883,9883,James Garner,4071,2018,Manchester United,0,0,0,0,0,0,1,0,1,1,0,0,1,0,1,1,0,0,0,0,0,0,0,0,0,0,0,0,0,0
9884,9884,Tahith Chong,3729,2018,Manchester United,1,0,1,1,0,0,1,0,1,36,0,0,2,0,2,37,0,0,0,0,0,0,0,0,0,0,0,0,0,0
9885,9885,Diafra Sakho,3418,2016,West Ham United,1,0,1,28,0,0,3,2,1,153,1,0,4,2,2,181,1,0,0,0,0,0,1,1,0,0,0,0,0,0
9886,9886,Jérémie Aliadiére,1530,2002,Arsenal FC,2,0,2,22,1,0,0,0,0,0,0,0,2,0,2,22,1,0,0,0,0,0,0,0,0,0,0,0,0,0
9887,9887,Souleymane Diawara,4072,2006,Charlton Athletic,12,9,3,884,0,0,11,9,2,765,0,0,23,18,5,1649,0,0,0,0,0,0,0,0,0,0,0,0,0,0
9888,9888,Michael Chopra,1226,2004,Newcastle United,1,0,1,14,0,0,0,0,0,0,0,0,1,0,1,14,0,0,0,0,0,0,0,0,0,0,0,0,0,0
9889,9889,Steven Watt,4073,2004,Chelsea FC,0,0,0,0,0,0,1,0,1,1,0,0,1,0,1,1,0,0,0,0,0,0,0,0,0,0,0,0,0,0
9890,9890,Nuno Morais,4074,2004,Chelsea FC,0,0,0,0,0,0,2,0,2,6,0,0,2,0,2,6,0,0,0,0,0,0,0,0,0,0,0,0,0,0
9891,9891,Filipe Oliveira,4075,2004,Chelsea FC,0,0,0,0,0,0,1,0,1,6,0,0,1,0,1,6,0,0,0,0,0,0,0,0,0,0,0,0,0,0
9892,9892,Phil Jagielka,1048,2009,Everton FC,5,5,0,450,0,0,7,6,1,584,0,0,12,11,1,1034,0,0,0,0,0,0,0,0,0,0,0,0,0,0
9893,9893,Mikel Arteta,1802,2009,Everton FC,7,6,1,532,4,0,6,5,1,500,2,0,13,11,2,1032,6,0,3,0,3,4,1,5,1,1,2,0,0,0
9894,9894,Victor Anichebe,1751,2009,Everton FC,5,3,2,196,0,0,6,3,3,286,1,0,11,6,5,482,1,0,0,0,0,0,1,1,0,0,0,0,0,0
9895,9895,Richard Stearman,3430,2009,Wolverhampton Wanderers,8,6,2,607,1,0,8,6,2,561,0,0,16,12,4,1168,1,0,1,0,1,1,0,1,0,0,0,0,0,0
9896,9896,Sam Hutchinson,3894,2009,Chelsea FC,1,0,1,18,0,0,1,0,1,4,0,0,2,0,2,22,0,0,0,0,0,0,0,0,0,0,0,0,0,0
9897,9897,James Vaughan,3240,2011,Norwich City,3,0,3,76,0,0,2,1,1,72,0,0,5,1,4,148,0,0,0,0,0,0,0,0,0,0,0,0,0,0
9898,9898,Steve Watson,2794,2001,Everton FC,13,13,0,1145,2,0,12,11,1,976,2,0,25,24,1,2121,4,0,0,3,3,0,1,1,0,0,0,0,0,0
9899,9899,Gary Naysmith,1804,2001,Everton FC,13,12,1,1081,0,0,11,11,0,988,0,0,24,23,1,2069,0,0,0,0,0,0,0,0,0,0,0,0,0,0
9900,9900,Abel Xavier,2824,2001,Everton FC,6,6,0,428,0,0,6,5,1,475,0,0,12,11,1,903,0,0,0,0,0,0,0,0,0,0,0,0,0,0
9901,9901,Paul Gascoigne,2826,2001,Everton FC,11,3,8,371,0,0,7,5,2,506,1,0,18,8,10,877,1,0,0,0,0,0,1,1,0,0,0,0,0,0
9902,9902,Joe-Max Moore,2827,2001,Everton FC,8,1,7,298,1,0,8,2,6,339,1,0,16,3,13,637,2,0,3,0,3,1,0,1,0,0,0,0,0,0
9903,9903,Duncan Ferguson,1805,2001,Everton FC,12,7,5,777,3,0,10,10,0,894,3,0,22,17,5,1671,6,0,2,0,2,2,2,4,1,1,2,0,0,0
9904,9904,Giovani dos Santos,2499,2010,Tottenham Hotspur,2,0,2,30,0,0,1,0,1,12,0,0,3,0,3,42,0,0,0,0,0,0,0,0,0,0,0,0,0,0
9905,9905,Emmanuel Adebayor,1235,2010,Manchester City,4,0,4,75,0,0,4,2,2,165,1,0,8,2,6,240,1,0,0,0,0,0,1,1,0,1,1,0,0,0
9906,9906,Callum Connolly,4076,2015,Everton FC,1,0,1,36,0,0,0,0,0,0,0,0,1,0,1,36,0,0,0,0,0,0,0,0,0,0,0,0,0,0
9907,9907,Tom Davies,1063,2015,Everton FC,2,1,1,97,0,0,0,0,0,0,0,0,2,1,1,97,0,0,0,0,0,0,0,0,0,0,0,0,0,0
9908,9908,Tomasz Kuszczak,1786,2007,Manchester United,5,5,0,450,0,0,4,3,1,314,0,0,9,8,1,764,0,0,0,0,0,0,0,0,0,0,0,0,0,0
9909,9909,Danny Simpson,2395,2007,Manchester United,3,1,2,129,0,0,0,0,0,0,0,0,3,1,2,129,0,0,0,0,0,0,0,0,0,0,0,0,0,0
9910,9910,Alexander Manninger,3714,2000,Arsenal FC,4,4,0,360,0,0,6,6,0,540,0,0,10,10,0,900,0,0,0,0,0,0,0,0,0,0,0,0,0,0
9911,9911,Lassana Diarra,2975,2008,Portsmouth FC,5,5,0,443,0,0,7,6,1,464,0,0,12,11,1,907,0,0,0,0,0,0,0,0,0,0,0,0,0,0
9912,9912,Arnold Mvuemba,3449,2008,Portsmouth FC,2,1,1,65,0,0,4,0,4,72,0,0,6,1,5,137,0,0,0,0,0,0,0,0,0,0,0,0,0,0
9913,9913,Jamie Redknapp,1123,2002,Tottenham Hotspur,9,8,1,711,1,0,8,6,2,570,2,0,17,14,3,1281,3,0,3,3,6,1,1,2,0,0,0,0,0,0
9914,9914,Juan Pablo Ángel,1795,2000,Aston Villa,5,3,2,268,1,0,4,4,0,248,0,0,9,7,2,516,1,0,0,0,0,1,0,1,0,0,0,0,0,0
9915,9915,James Garner,4071,2019,Manchester United,0,0,0,0,0,0,1,0,1,8,0,0,1,0,1,8,0,0,0,0,0,0,0,0,0,0,0,0,0,0
9916,9916,Haris Vučkić,3708,2010,Newcastle United,0,0,0,0,0,0,0,0,0,0,0,0,0,0,0,0,0,0,0,0,0,0,0,0,0,0,0,0,0,0
9917,9917,Albert Ferrer,3179,2002,Chelsea FC,1,1,0,90,0,0,2,2,0,135,0,0,3,3,0,225,0,0,0,0,0,0,0,0,0,0,0,0,0,0
9918,9918,Jonathan Grounds,4077,2007,Middlesbrough FC,3,3,0,270,0,0,2,2,0,153,0,0,5,5,0,423,0,0,0,0,0,0,0,0,0,0,0,0,0,0
9919,9919,Vito Mannone,2261,2009,Arsenal FC,3,3,0,270,0,0,2,2,0,180,0,0,5,5,0,450,0,0,0,0,0,0,0,0,0,0,0,0,0,0
9920,9920,Kieran Gibbs,1508,2009,Arsenal FC,2,2,0,180,0,0,1,1,0,90,0,0,3,3,0,270,0,0,0,0,0,0,0,0,0,0,0,0,0,0
9921,9921,Garry O'Connor,1967,2009,Birmingham City,5,3,2,293,0,0,5,2,3,262,1,0,10,5,5,555,1,0,0,3,3,0,1,1,0,0,0,0,0,0
9922,9922,Andy Marshall,3291,2012,Aston Villa,0,0,0,0,0,0,0,0,0,0,0,0,0,0,0,0,0,0,0,0,0,0,0,0,0,0,0,0,0,0
9923,9923,Tony McMahon,1332,2008,Middlesbrough FC,7,7,0,595,0,0,6,6,0,450,0,0,13,13,0,1045,0,0,0,0,0,0,0,0,0,0,0,0,0,0
9924,9924,Mohamed Shawky,2635,2008,Middlesbrough FC,5,4,1,277,0,0,8,7,1,573,0,0,13,11,2,850,0,0,0,0,0,0,0,0,0,0,0,0,0,0
9925,9925,Marnick Vermijl,4078,2014,Manchester United,0,0,0,0,0,0,0,0,0,0,0,0,0,0,0,0,0,0,0,0,0,0,0,0,0,0,0,0,0,0
9926,9926,Kevin Doyle,2594,2014,Crystal Palace,1,0,1,29,0,0,2,0,2,5,0,0,3,0,3,34,0,0,0,0,0,0,0,0,0,0,0,0,0,0
9927,9927,Ezekiel Fryers,2127,2014,Crystal Palace,0,0,0,0,0,0,1,0,1,4,0,0,1,0,1,4,0,0,0,0,0,0,0,0,0,0,0,0,0,0
9928,9928,Harry Kane,1169,2012,Norwich City,2,0,2,64,0,0,1,1,0,70,0,0,3,1,2,134,0,0,0,0,0,0,0,0,0,0,0,0,0,0
9929,9929,Joey Barton,1876,2008,Newcastle United,3,3,0,196,1,0,6,3,3,267,0,0,9,6,3,463,1,0,0,0,0,1,0,1,1,0,1,0,0,0
9930,9930,Kazenga LuaLua,3619,2008,Newcastle United,2,0,2,19,0,0,1,0,1,1,0,0,3,0,3,20,0,0,0,0,0,0,0,0,0,0,0,0,0,0
9931,9931,Jayson Molumby,4079,2018,Brighton & Hove Albion,0,0,0,0,0,0,0,0,0,0,0,0,0,0,0,0,0,0,0,0,0,0,0,0,0,0,0,0,0,0
9932,9932,Brad Jones,1431,2007,Middlesbrough FC,0,0,0,0,0,0,1,1,0,90,0,0,1,1,0,90,0,0,0,0,0,0,0,0,0,0,0,0,0,0
9933,9933,Jonathan Leko,3553,2015,West Bromwich Albion,2,2,0,163,0,0,3,1,2,108,0,0,5,3,2,271,0,0,0,0,0,0,0,0,0,0,0,0,0,0
9934,9934,Stephen Howey,3305,2002,Manchester City,11,11,0,970,2,0,12,12,0,953,0,0,23,23,0,1923,2,0,0,0,0,2,0,2,0,0,0,0,0,0
9935,9935,Carlo Nash,3303,2002,Manchester City,3,3,0,270,0,0,6,6,0,540,0,0,9,9,0,810,0,0,0,0,0,0,0,0,0,0,0,0,0,0
9936,9936,Philippe Senderos,1228,2006,Arsenal FC,4,2,2,185,0,0,9,6,3,586,0,0,13,8,5,771,0,0,0,0,0,0,0,0,0,0,0,0,0,0
9937,9937,Nathaniel Chalobah,2330,2014,Burnley FC,2,0,2,11,0,0,2,0,2,54,0,0,4,0,4,65,0,0,0,0,0,0,0,0,0,0,0,0,0,0
9938,9938,James McFadden,1413,2010,Birmingham City,2,2,0,168,0,0,2,1,1,111,0,0,4,3,1,279,0,0,0,0,0,0,0,0,0,0,0,0,0,0
9939,9939,Garry O'Connor,1967,2010,Birmingham City,1,1,0,83,0,0,2,1,1,68,0,0,3,2,1,151,0,0,0,0,0,0,0,0,0,0,0,0,0,0
9940,9940,Lars Jacobsen,2657,2010,Blackburn Rovers,0,0,0,0,0,0,0,0,0,0,0,0,0,0,0,0,0,0,0,0,0,0,0,0,0,0,0,0,0,0
9941,9941,Alan Judge,4080,2010,Blackburn Rovers,0,0,0,0,0,0,0,0,0,0,0,0,0,0,0,0,0,0,0,0,0,0,0,0,0,0,0,0,0,0
9942,9942,Andy Todd,1672,2005,Blackburn Rovers,10,9,1,829,1,0,12,11,1,995,1,0,22,20,2,1824,2,0,0,0,0,1,1,2,0,0,0,0,0,0
9943,9943,Elliott Moore,4081,2016,Leicester City,0,0,0,0,0,0,0,0,0,0,0,0,0,0,0,0,0,0,0,0,0,0,0,0,0,0,0,0,0,0
9944,9944,Filip Lesniak,4082,2016,Tottenham Hotspur,0,0,0,0,0,0,1,0,1,4,0,0,1,0,1,4,0,0,0,0,0,0,0,0,0,0,0,0,0,0
9945,9945,Samuel Shashoua,4083,2016,Tottenham Hotspur,0,0,0,0,0,0,0,0,0,0,0,0,0,0,0,0,0,0,0,0,0,0,0,0,0,0,0,0,0,0
9946,9946,Anders Lindegaard,2319,2010,Manchester United,0,0,0,0,0,0,0,0,0,0,0,0,0,0,0,0,0,0,0,0,0,0,0,0,0,0,0,0,0,0
9947,9947,Richard Chaplow,3541,2004,West Bromwich Albion,1,1,0,63,0,0,3,2,1,184,0,0,4,3,1,247,0,0,0,0,0,0,0,0,0,0,0,0,0,0
9948,9948,Joey O'Brien,2412,2015,West Ham United,0,0,0,0,0,0,0,0,0,0,0,0,0,0,0,0,0,0,0,0,0,0,0,0,0,0,0,0,0,0
9949,9949,Jordan Rossiter,3521,2013,Liverpool FC,0,0,0,0,0,0,0,0,0,0,0,0,0,0,0,0,0,0,0,0,0,0,0,0,0,0,0,0,0,0
9950,9950,John Filan,1815,2006,Wigan Athletic,5,5,0,450,0,0,5,5,0,450,0,0,10,10,0,900,0,0,0,0,0,0,0,0,0,0,0,0,0,0
9951,9951,Piqué,4084,2007,Manchester United,4,3,1,287,0,0,5,2,3,191,0,0,9,5,4,478,0,0,0,0,0,0,0,0,0,0,0,0,0,0
9952,9952,Maik Taylor,2501,2009,Birmingham City,1,1,0,90,0,0,1,1,0,90,0,0,2,2,0,180,0,0,0,0,0,0,0,0,0,0,0,0,0,0
9953,9953,Cenk Tosun,1463,2017,Everton FC,6,6,0,503,1,0,8,6,2,488,4,0,14,12,2,991,5,0,0,3,3,0,4,4,0,0,0,0,0,0
9954,9954,Nabil Bentaleb,1167,2015,Tottenham Hotspur,2,1,1,111,0,0,3,1,2,57,0,0,5,2,3,168,0,0,0,0,0,0,0,0,0,0,0,0,0,0
9955,9955,Lee Grant,1908,2019,Manchester United,0,0,0,0,0,0,0,0,0,0,0,0,0,0,0,0,0,0,0,0,0,0,0,0,0,0,0,0,0,0
9956,9956,Rob Hulse,1327,2011,Queens Park Rangers,1,0,1,16,0,0,1,1,0,54,0,0,2,1,1,70,0,0,0,0,0,0,0,0,0,0,0,0,0,0
9957,9957,Bruno Berner,4085,2007,Arsenal FC,1,1,0,90,0,0,0,0,0,0,0,0,1,1,0,90,0,0,0,0,0,0,0,0,0,0,0,0,0,0
9958,9958,Maceo Rigters,4086,2007,Arsenal FC,1,0,1,10,0,0,0,0,0,0,0,0,1,0,1,10,0,0,0,0,0,0,0,0,0,0,0,0,0,0
9959,9959,Ben Hutchinson,4087,2007,Middlesbrough FC,4,0,4,83,0,0,4,0,4,104,1,0,8,0,8,187,1,0,0,0,0,0,0,0,0,0,0,0,0,0
9960,9960,Nuno Valente,2106,2007,Everton FC,4,3,1,271,0,0,5,5,0,450,0,0,9,8,1,721,0,0,0,0,0,0,0,0,0,0,0,0,0,0
9961,9961,Martin Grainger,4088,2002,Birmingham City,4,3,1,284,0,0,5,5,0,385,0,0,9,8,1,669,0,0,0,0,0,0,0,0,0,0,0,0,0,0
9962,9962,Tommy Mooney,4089,2002,Birmingham City,1,0,1,5,0,0,0,0,0,0,0,0,1,0,1,5,0,0,0,0,0,0,0,0,0,0,0,0,0,0
9963,9963,Landon Donovan,3992,2009,Everton FC,5,4,1,366,2,0,5,3,2,284,0,0,10,7,3,650,2,0,0,0,0,0,0,0,0,0,0,0,0,0
9964,9964,Danny Pugh,2756,2011,Stoke City,1,0,1,19,0,0,2,0,2,82,0,0,3,0,3,101,0,0,0,0,0,0,0,0,0,0,0,0,0,0
9965,9965,Danny Collins,1215,2011,Stoke City,0,0,0,0,0,0,0,0,0,0,0,0,0,0,0,0,0,0,0,0,0,0,0,0,0,0,0,0,0,0
9966,9966,Diego Arismendi,4090,2011,Stoke City,0,0,0,0,0,0,0,0,0,0,0,0,0,0,0,0,0,0,0,0,0,0,0,0,0,0,0,0,0,0
9967,9967,Jake Flannigan,4091,2014,Southampton FC,0,0,0,0,0,0,0,0,0,0,0,0,0,0,0,0,0,0,0,0,0,0,0,0,0,0,0,0,0,0
9968,9968,Ryan Seager,4092,2014,Southampton FC,1,0,1,1,0,0,0,0,0,0,0,0,1,0,1,1,0,0,0,0,0,0,0,0,0,0,0,0,0,0
9969,9969,Danny Lafferty,4093,2014,Burnley FC,1,0,1,16,0,0,0,0,0,0,0,0,1,0,1,16,0,0,0,0,0,0,0,0,0,0,0,0,0,0
9970,9970,Fraizer Campbell,1027,2010,Sunderland AFC,2,2,0,136,0,0,1,1,0,90,0,0,3,3,0,226,0,0,0,0,0,0,0,0,0,0,0,0,0,0
9971,9971,Martyn Waghorn,4094,2010,Sunderland AFC,1,0,1,1,0,0,1,0,1,6,0,0,2,0,2,7,0,0,0,0,0,0,0,0,0,0,0,0,0,0
9972,9972,Trevor Carson,3885,2010,Sunderland AFC,0,0,0,0,0,0,0,0,0,0,0,0,0,0,0,0,0,0,0,0,0,0,0,0,0,0,0,0,0,0
9973,9973,Grzegorz Rasiak,4047,2007,Bolton Wanderers,3,0,3,86,0,0,4,2,2,194,0,0,7,2,5,280,0,0,0,0,0,0,0,0,0,0,0,0,0,0
9974,9974,Danny Batth,4095,2010,Wolverhampton Wanderers,0,0,0,0,0,0,0,0,0,0,0,0,0,0,0,0,0,0,0,0,0,0,0,0,0,0,0,0,0,0
9975,9975,James Hurst,3297,2011,West Bromwich Albion,0,0,0,0,0,0,0,0,0,0,0,0,0,0,0,0,0,0,0,0,0,0,0,0,0,0,0,0,0,0
9976,9976,Carl Jenkinson,2752,2011,Arsenal FC,4,3,1,285,0,0,4,1,3,132,0,0,8,4,4,417,0,0,0,0,0,0,0,0,0,0,0,0,0,0
9977,9977,Kieran Gibbs,1508,2011,Arsenal FC,9,9,0,700,1,0,7,6,1,553,0,0,16,15,1,1253,1,0,0,0,0,1,0,1,0,0,0,0,0,0
9978,9978,Ross Barkley,1754,2010,Everton FC,0,0,0,0,0,0,0,0,0,0,0,0,0,0,0,0,0,0,0,0,0,0,0,0,0,0,0,0,0,0
9979,9979,Aaron Ramsey,1501,2010,Arsenal FC,2,2,0,180,1,0,5,3,2,175,0,0,7,5,2,355,1,0,3,0,3,1,0,1,0,0,0,0,0,0
9980,9980,Liam Agnew,4096,2014,Sunderland AFC,0,0,0,0,0,0,0,0,0,0,0,0,0,0,0,0,0,0,0,0,0,0,0,0,0,0,0,0,0,0
9981,9981,Sebastien Schemmel,1624,2003,Portsmouth FC,6,5,1,442,0,0,7,7,0,556,0,0,13,12,1,998,0,0,0,0,0,0,0,0,0,0,0,0,0,0
9982,9982,Vincent Péricard,2968,2003,Portsmouth FC,4,0,4,38,0,0,2,0,2,22,0,0,6,0,6,60,0,0,0,0,0,0,0,0,0,0,0,0,0,0
9983,9983,Tomasz Kuszczak,1786,2004,West Bromwich Albion,2,2,0,180,0,0,1,0,1,68,0,0,3,2,1,248,0,0,0,0,0,0,0,0,0,0,0,0,0,0
9984,9984,Junichi Inamoto,1084,2004,West Bromwich Albion,0,0,0,0,0,0,3,0,3,118,0,0,3,0,3,118,0,0,0,0,0,0,0,0,0,0,0,0,0,0
9985,9985,Lloyd Sam,4097,2004,Charlton Athletic,1,0,1,14,0,0,0,0,0,0,0,0,1,0,1,14,0,0,0,0,0,0,0,0,0,0,0,0,0,0
9986,9986,Ľubomir Michalík,3442,2006,Bolton Wanderers,2,1,1,159,0,0,2,2,0,180,1,0,4,3,1,339,1,0,0,0,0,0,1,1,0,0,0,0,0,0
9987,9987,Ulises De la Cruz,1794,2006,Reading FC,4,4,0,316,1,0,4,4,0,344,0,0,8,8,0,660,1,0,0,0,0,0,0,0,0,0,0,0,0,0
9988,9988,Shane Long,1154,2006,Reading FC,10,4,6,349,2,0,10,4,6,373,0,0,20,8,12,722,2,0,0,0,0,2,0,2,0,0,0,0,0,0
9989,9989,Jay McEveley,1569,2006,Blackburn Rovers,0,0,0,0,0,0,4,3,1,235,0,0,4,3,1,235,0,0,0,0,0,0,0,0,0,0,0,0,0,0
9990,9990,Danny Crow,4098,2004,Norwich City,1,0,1,23,0,0,2,0,2,17,0,0,3,0,3,40,0,0,0,0,0,0,0,0,0,0,0,0,0,0
9991,9991,Pavel Srníček,3784,2006,Newcastle United,1,0,1,3,0,0,1,1,0,90,0,0,2,1,1,93,0,0,0,0,0,0,0,0,0,0,0,0,0,0
9992,9992,David Edgar,3825,2006,Newcastle United,2,1,1,150,1,0,1,1,0,90,0,0,3,2,1,240,1,0,1,0,1,1,0,1,0,0,0,0,0,0
9993,9993,Giovani dos Santos,2499,2008,Tottenham Hotspur,3,0,3,78,0,0,3,2,1,156,0,0,6,2,4,234,0,0,0,0,0,0,0,0,0,0,0,0,0,0
9994,9994,Marlon Harewood,1942,2008,Aston Villa,3,0,3,30,0,0,3,0,3,31,0,0,6,0,6,61,0,0,0,0,0,0,0,0,0,0,0,0,0,0
9995,9995,Georges-Kévin N'Koudou,2801,2019,Tottenham Hotspur,1,0,1,2,0,0,0,0,0,0,0,0,1,0,1,2,0,0,0,0,0,0,0,0,0,0,0,0,0,0
9996,9996,Jonathan Kodjia,4099,2019,Aston Villa,2,0,2,38,0,0,4,0,4,73,0,0,6,0,6,111,0,0,0,0,0,0,0,0,0,0,0,0,0,0
9997,9997,Hayden Foxe,4035,2001,West Ham United,2,1,1,95,0,0,4,3,1,315,0,0,6,4,2,410,0,0,0,0,0,0,0,0,0,0,0,0,0,0
9998,9998,Andrejs Štolcers,3646,2001,Fulham FC,1,0,1,5,0,0,4,0,4,20,0,0,5,0,5,25,0,0,0,0,0,0,0,0,0,0,0,0,0,0
9999,9999,Piqué,4084,2005,Manchester United,2,1,1,94,0,0,1,0,1,1,0,0,3,1,2,95,0,0,0,0,0,0,0,0,0,0,0,0,0,0
10000,10000,Habib Beye,2173,2010,Aston Villa,1,1,0,90,0,0,1,1,0,90,0,0,2,2,0,180,0,0,0,0,0,0,0,0,0,0,0,0,0,0
10001,10001,Anthony Modeste,4100,2011,Blackburn Rovers,4,2,2,218,0,0,5,1,4,168,0,0,9,3,6,386,0,0,0,0,0,0,0,0,0,0,0,0,0,0
10002,10002,Gary Kelly,2290,2002,Leeds United,12,12,0,1080,0,0,11,10,1,926,0,0,23,22,1,2006,0,0,0,0,0,0,0,0,0,0,0,0,0,0
10003,10003,Michael Duberry,2291,2002,Leeds United,7,6,1,549,0,0,4,3,1,302,0,0,11,9,2,851,0,0,0,0,0,0,0,0,0,0,0,0,0,0
10004,10004,Simon Johnson,2780,2002,Leeds United,2,1,1,109,0,0,2,0,2,22,0,0,4,1,3,131,0,0,0,0,0,0,0,0,0,0,0,0,0,0
10005,10005,Matt Kilgallon,1400,2002,Leeds United,2,0,2,6,0,0,0,0,0,0,0,0,2,0,2,6,0,0,0,0,0,0,0,0,0,0,0,0,0,0
10006,10006,Peter Whittingham,2969,2002,Aston Villa,1,0,1,33,0,0,3,1,2,180,0,0,4,1,3,213,0,0,0,0,0,0,0,0,0,0,0,0,0,0
10007,10007,Steve Cooke,4101,2002,Aston Villa,2,0,2,13,0,0,1,0,1,16,0,0,3,0,3,29,0,0,0,0,0,0,0,0,0,0,0,0,0,0
10008,10008,Luke Dreher,3014,2018,Crystal Palace,1,0,1,1,0,0,0,0,0,0,0,0,1,0,1,1,0,0,0,0,0,0,0,0,0,0,0,0,0,0
10009,10009,Mark Travers,4102,2018,AFC Bournemouth,1,1,0,90,0,0,1,1,0,90,0,0,2,2,0,180,0,0,0,0,0,0,0,0,0,0,0,0,0,0
10010,10010,Matt Butcher,2828,2018,AFC Bournemouth,0,0,0,0,0,0,0,0,0,0,0,0,0,0,0,0,0,0,0,0,0,0,0,0,0,0,0,0,0,0
10011,10011,Joe Bennett,2978,2015,AFC Bournemouth,0,0,0,0,0,0,0,0,0,0,0,0,0,0,0,0,0,0,0,0,0,0,0,0,0,0,0,0,0,0
10012,10012,André Bikey,2548,2006,Reading FC,9,3,6,453,0,0,5,3,2,292,0,0,14,6,8,745,0,0,0,0,0,0,0,0,0,0,0,0,0,0
10013,10013,Andy Griffin,1578,2003,Newcastle United,3,3,0,270,0,0,1,1,0,90,0,0,4,4,0,360,0,0,0,0,0,0,0,0,0,0,0,0,0,0
10014,10014,Donervon Daniels,4103,2013,West Bromwich Albion,0,0,0,0,0,0,0,0,0,0,0,0,0,0,0,0,0,0,0,0,0,0,0,0,0,0,0,0,0,0
10015,10015,Trevoh Chalobah,4104,2017,Chelsea FC,0,0,0,0,0,0,0,0,0,0,0,0,0,0,0,0,0,0,0,0,0,0,0,0,0,0,0,0,0,0
10016,10016,Khalilou Fadiga,4105,2005,Bolton Wanderers,4,2,2,52,0,0,4,3,1,259,1,0,8,5,3,311,1,0,0,0,0,0,1,1,0,0,0,0,0,0
10017,10017,Elliot Lee,3524,2012,West Ham United,0,0,0,0,0,0,0,0,0,0,0,0,0,0,0,0,0,0,0,0,0,0,0,0,0,0,0,0,0,0
10018,10018,Korey Smith,4106,2012,Norwich City,0,0,0,0,0,0,0,0,0,0,0,0,0,0,0,0,0,0,0,0,0,0,0,0,0,0,0,0,0,0
10019,10019,Roberto Mancini,4107,2000,Leicester City,2,2,0,133,0,0,2,1,1,109,0,0,4,3,1,242,0,0,0,0,0,0,0,0,0,0,0,0,0,0
10020,10020,Michel Vorm,1174,2019,Tottenham Hotspur,0,0,0,0,0,0,0,0,0,0,0,0,0,0,0,0,0,0,0,0,0,0,0,0,0,0,0,0,0,0
10021,10021,Connor Roberts,3806,2017,Swansea City,2,2,0,153,0,0,2,1,1,115,0,0,4,3,1,268,0,0,0,0,0,0,0,0,0,0,0,0,0,0
10022,10022,Matt Macey,2858,2017,Arsenal FC,0,0,0,0,0,0,0,0,0,0,0,0,0,0,0,0,0,0,0,0,0,0,0,0,0,0,0,0,0,0
10023,10023,Joe Rodon,4108,2017,Swansea City,0,0,0,0,0,0,0,0,0,0,0,0,0,0,0,0,0,0,0,0,0,0,0,0,0,0,0,0,0,0
10024,10024,Michael Bridges,2294,2002,Leeds United,2,0,2,30,0,0,2,0,2,21,0,0,4,0,4,51,0,0,0,0,0,0,0,0,0,0,0,0,0,0
10025,10025,Faustino Anjorin,4109,2019,Chelsea FC,1,0,1,19,0,0,0,0,0,0,0,0,1,0,1,19,0,0,0,0,0,0,0,0,0,0,0,0,0,0
10026,10026,Armando Broja,4110,2019,Chelsea FC,1,0,1,4,0,0,0,0,0,0,0,0,1,0,1,4,0,0,0,0,0,0,0,0,0,0,0,0,0,0
10027,10027,Simon Davies,1125,2012,Fulham FC,0,0,0,0,0,0,0,0,0,0,0,0,0,0,0,0,0,0,0,0,0,0,0,0,0,0,0,0,0,0
10028,10028,Emanuel Pogatetz,1883,2012,West Ham United,2,0,2,19,0,0,4,1,3,130,0,0,6,1,5,149,0,0,0,0,0,0,0,0,0,0,0,0,0,0
10029,10029,Modibo Diakité,4111,2013,Sunderland AFC,2,2,0,180,0,0,5,5,0,450,0,0,7,7,0,630,0,0,0,0,0,0,0,0,0,0,0,0,0,0
10030,10030,David Vaughan,1412,2013,Sunderland AFC,1,1,0,46,0,0,2,1,1,127,0,0,3,2,1,173,0,0,0,0,0,0,0,0,0,0,0,0,0,0
10031,10031,Charis Mavrias,4112,2013,Sunderland AFC,2,1,1,76,0,0,2,0,2,73,0,0,4,1,3,149,0,0,0,0,0,0,0,0,0,0,0,0,0,0
10032,10032,David Moberg-Karlsson,4113,2013,Sunderland AFC,0,0,0,0,0,0,0,0,0,0,0,0,0,0,0,0,0,0,0,0,0,0,0,0,0,0,0,0,0,0
10033,10033,Aaron Ramsey,1501,2009,Arsenal FC,9,2,7,305,2,0,9,5,4,473,1,0,18,7,11,778,3,0,0,0,0,0,0,0,0,0,0,0,0,0
10034,10034,Daniel Cousin,2324,2009,Hull City,1,1,0,22,0,0,2,0,2,55,0,0,3,1,2,77,0,0,0,0,0,0,0,0,0,0,0,0,0,0
10035,10035,Charles N'Zogbia,2016,2015,Aston Villa,1,0,1,25,0,0,1,0,1,16,0,0,2,0,2,41,0,0,0,0,0,0,0,0,0,0,0,0,0,0
10036,10036,Jack Butland,1901,2016,Stoke City,2,2,0,180,0,0,3,3,0,270,0,0,5,5,0,450,0,0,0,0,0,0,0,0,0,0,0,0,0,0
10037,10037,Jack Young,4114,2019,Newcastle United,0,0,0,0,0,0,0,0,0,0,0,0,0,0,0,0,0,0,0,0,0,0,0,0,0,0,0,0,0,0
10038,10038,Tomáš Rosický,1509,2012,Arsenal FC,5,3,2,250,0,0,5,4,1,363,2,0,10,7,3,613,2,0,0,0,0,0,1,1,0,0,0,0,0,0
10039,10039,Łukasz Fabiański,1227,2012,Arsenal FC,2,2,0,180,0,0,2,2,0,180,0,0,4,4,0,360,0,0,0,0,0,0,0,0,0,0,0,0,0,0
10040,10040,Nacho Monreal,1498,2012,Arsenal FC,4,3,1,252,0,0,6,6,0,540,1,0,10,9,1,792,1,0,0,0,0,0,1,1,0,0,0,0,0,0
10041,10041,Joel,1060,2012,Wigan Athletic,4,4,0,360,0,0,5,5,0,450,0,0,9,9,0,810,0,0,0,0,0,0,0,0,0,0,0,0,0,0
10042,10042,Antolín Alcaráz,2235,2012,Wigan Athletic,4,3,1,308,0,0,6,5,1,383,0,0,10,8,2,691,0,0,0,0,0,0,0,0,0,0,0,0,0,0
10043,10043,Paul Scharner,1734,2012,Wigan Athletic,7,7,0,630,0,0,7,7,0,630,0,0,14,14,0,1260,0,0,0,0,0,0,0,0,0,0,0,0,0,0
10044,10044,Roger Espinoza,4115,2012,Wigan Athletic,6,3,3,348,1,0,6,3,3,257,0,0,12,6,6,605,1,0,0,0,0,1,0,1,0,0,0,0,0,0
10045,10045,Ángelo Henríquez,4116,2012,Wigan Athletic,3,0,3,41,1,0,1,0,1,5,0,0,4,0,4,46,1,0,0,0,0,0,0,0,0,0,0,0,0,0
10046,10046,Román Golobart,4117,2012,Wigan Athletic,1,1,0,90,0,0,2,1,1,122,0,0,3,2,1,212,0,0,0,0,0,0,0,0,0,0,0,0,0,0
10047,10047,Fraser Fyvie,4118,2012,Wigan Athletic,1,0,1,21,0,0,0,0,0,0,0,0,1,0,1,21,0,0,0,0,0,0,0,0,0,0,0,0,0,0
10048,10048,Antonio Barreca,4119,2018,Newcastle United,0,0,0,0,0,0,1,0,1,4,0,0,1,0,1,4,0,0,0,0,0,0,0,0,0,0,0,0,0,0
10049,10049,Alex Oxlade-Chamberlain,1184,2018,Liverpool FC,2,0,2,19,0,0,0,0,0,0,0,0,2,0,2,19,0,0,0,0,0,0,0,0,0,0,0,0,0,0
10050,10050,Diego Cavalieri,4120,2017,Crystal Palace,0,0,0,0,0,0,0,0,0,0,0,0,0,0,0,0,0,0,0,0,0,0,0,0,0,0,0,0,0,0
10051,10051,Zurab Khizanishvili,2006,2006,Blackburn Rovers,9,8,1,764,0,0,9,9,0,803,0,0,18,17,1,1567,0,0,0,0,0,0,0,0,0,0,0,0,0,0
10052,10052,Steven Reid,1140,2006,Blackburn Rovers,2,2,0,180,0,0,1,1,0,90,0,0,3,3,0,270,0,0,0,0,0,0,0,0,0,0,0,0,0,0
10053,10053,Francis Jeffers,2359,2006,Blackburn Rovers,5,2,3,134,0,0,5,1,4,217,0,0,10,3,7,351,0,0,0,0,0,0,0,0,0,0,0,0,0,0
10054,10054,Martin Woods,4121,2005,Sunderland AFC,1,0,1,30,0,0,6,1,5,139,0,0,7,1,6,169,0,0,0,0,0,0,0,0,0,0,0,0,0,0
10055,10055,Nelson Vivas,4122,2000,Arsenal FC,6,1,5,201,0,0,6,2,4,220,0,0,12,3,9,421,0,0,0,0,0,0,0,0,0,0,0,0,0,0
10056,10056,Jelle Van Damme,4039,2004,Southampton FC,3,2,1,225,0,0,3,2,1,166,0,0,6,4,2,391,0,0,0,0,0,0,0,0,0,0,0,0,0,0
10057,10057,Kenwyne Jones,1222,2004,Southampton FC,1,0,1,1,0,0,1,1,0,46,0,0,2,1,1,47,0,0,0,0,0,0,0,0,0,0,0,0,0,0
10058,10058,David Wright,3642,2005,Wigan Athletic,1,0,1,24,0,0,1,1,0,90,0,0,2,1,1,114,0,0,0,0,0,0,0,0,0,0,0,0,0,0
10059,10059,Jake Vokins,4123,2019,Southampton FC,1,1,0,90,0,0,0,0,0,0,0,0,1,1,0,90,0,0,0,0,0,0,0,0,0,0,0,0,0,0
10060,10060,Memphis Depay,2191,2016,Manchester United,2,0,2,14,0,0,2,0,2,6,0,0,4,0,4,20,0,0,0,0,0,0,0,0,0,0,0,0,0,0
10061,10061,Daniel Van Buyten,4124,2003,Manchester City,3,3,0,270,0,0,1,1,0,90,0,0,4,4,0,360,0,0,0,0,0,0,0,0,0,0,0,0,0,0
10062,10062,Jon Macken,3125,2003,Manchester City,10,4,6,405,1,0,5,3,2,253,0,0,15,7,8,658,1,0,0,0,0,0,0,0,0,0,0,0,0,0
10063,10063,Quinton Fortune,2782,2006,Bolton Wanderers,4,4,0,313,0,0,2,1,1,110,0,0,6,5,1,423,0,0,0,0,0,0,0,0,0,0,0,0,0,0
10064,10064,Fabricio Coloccini,2278,2012,Newcastle United,10,10,0,855,0,0,12,12,0,1069,0,0,22,22,0,1924,0,0,0,0,0,0,0,0,0,0,0,0,0,0
10065,10065,Lee Cattermole,1687,2016,Sunderland AFC,3,3,0,228,0,0,5,5,0,412,0,0,8,8,0,640,0,0,0,0,0,0,0,0,0,0,0,0,0,0
10066,10066,Ben Wynter,4125,2016,Crystal Palace,0,0,0,0,0,0,0,0,0,0,0,0,0,0,0,0,0,0,0,0,0,0,0,0,0,0,0,0,0,0
10067,10067,Andy Goram,4126,2000,Manchester United,1,1,0,66,0,0,1,1,0,58,0,0,2,2,0,124,0,0,0,0,0,0,0,0,0,0,0,0,0,0
10068,10068,Kasey Keller,1117,2004,Norwich City,1,1,0,90,0,0,0,0,0,0,0,0,1,1,0,90,0,0,0,0,0,0,0,0,0,0,0,0,0,0
10069,10069,Dexter Blackstock,4127,2004,Norwich City,1,1,0,60,0,0,0,0,0,0,0,0,1,1,0,60,0,0,0,0,0,0,0,0,0,0,0,0,0,0
10070,10070,Danny Tiatto,3199,2003,Manchester City,3,0,3,58,0,0,2,1,1,91,0,0,5,1,4,149,0,0,0,0,0,0,0,0,0,0,0,0,0,0
10071,10071,James Morrison,1735,2003,Middlesbrough FC,0,0,0,0,0,0,1,0,1,28,0,0,1,0,1,28,0,0,0,0,0,0,0,0,0,0,0,0,0,0
10072,10072,Xande Silva,4058,2018,West Ham United,0,0,0,0,0,0,1,0,1,17,0,0,1,0,1,17,0,0,0,0,0,0,0,0,0,0,0,0,0,0
10073,10073,Ben Hinchcliffe,4128,2016,Hull City,0,0,0,0,0,0,0,0,0,0,0,0,0,0,0,0,0,0,0,0,0,0,0,0,0,0,0,0,0,0
10074,10074,Eddie Johnson,3295,2009,Fulham FC,0,0,0,0,0,0,2,0,2,24,0,0,2,0,2,24,0,0,0,0,0,0,0,0,0,0,0,0,0,0
10075,10075,Haris Vučkić,3708,2014,Newcastle United,0,0,0,0,0,0,1,0,1,8,0,0,1,0,1,8,0,0,0,0,0,0,0,0,0,0,0,0,0,0
10076,10076,George Marsh,4129,2018,Tottenham Hotspur,0,0,0,0,0,0,0,0,0,0,0,0,0,0,0,0,0,0,0,0,0,0,0,0,0,0,0,0,0,0
10077,10077,Matthew Connolly,2170,2013,Cardiff City,2,2,0,180,0,0,1,1,0,90,0,0,3,3,0,270,0,0,0,0,0,0,0,0,0,0,0,0,0,0
10078,10078,Arouna Koné,2237,2013,Everton FC,2,0,2,41,0,0,3,0,3,39,0,0,5,0,5,80,0,0,0,0,0,0,0,0,0,0,0,0,0,0
10079,10079,Shane Duffy,2429,2010,Everton FC,0,0,0,0,0,0,0,0,0,0,0,0,0,0,0,0,0,0,0,0,0,0,0,0,0,0,0,0,0,0
10080,10080,Paul Gerrard,2822,2006,Sheffield United,1,1,0,90,0,0,1,1,0,90,0,0,2,2,0,180,0,0,0,0,0,0,0,0,0,0,0,0,0,0
10081,10081,Chris Lucketti,4130,2006,Sheffield United,3,3,0,270,0,0,3,3,0,212,0,0,6,6,0,482,0,0,0,0,0,0,0,0,0,0,0,0,0,0
10082,10082,Stephen Quinn,3177,2006,Sheffield United,8,8,0,633,2,0,5,5,0,394,0,0,13,13,0,1027,2,0,0,0,0,2,0,2,0,0,0,0,0,0
10083,10083,Brian McBride,1088,2002,Everton FC,4,4,0,262,2,0,4,3,1,295,2,0,8,7,1,557,4,0,3,0,3,2,2,4,0,0,0,0,0,0
10084,10084,Robin van Persie,1528,2006,Arsenal FC,12,8,4,723,6,0,10,9,1,737,5,0,22,17,5,1460,11,0,1,6,7,2,3,5,1,0,1,0,0,0
10085,10085,Dean Marney,1253,2004,Tottenham Hotspur,3,1,2,128,2,0,2,2,0,172,0,0,5,3,2,300,2,0,0,0,0,1,0,1,0,0,0,0,0,0
10086,10086,Facundo Sava,3063,2003,Fulham FC,3,1,2,143,1,0,3,0,3,44,0,0,6,1,5,187,1,0,3,0,3,1,0,1,0,0,0,0,0,0
10087,10087,Claudio Reyna,1634,2004,Manchester City,8,7,1,653,0,0,7,7,0,630,2,0,15,14,1,1283,2,0,0,0,0,0,2,2,0,0,0,0,0,0
10088,10088,Kiki Musampa,2917,2004,Manchester City,6,6,0,537,2,0,5,5,0,431,1,0,11,11,0,968,3,0,4,0,4,2,0,2,0,0,0,0,0,0
10089,10089,Lee Croft,1812,2004,Manchester City,4,0,4,46,0,0,2,0,2,26,0,0,6,0,6,72,0,0,0,0,0,0,0,0,0,0,0,0,0,0
10090,10090,Aleksandar Rodić,4131,2004,Portsmouth FC,2,0,2,27,0,0,2,1,1,91,0,0,4,1,3,118,0,0,0,0,0,0,0,0,0,0,0,0,0,0
10091,10091,Jordan Mustoe,4132,2010,Wigan Athletic,0,0,0,0,0,0,0,0,0,0,0,0,0,0,0,0,0,0,0,0,0,0,0,0,0,0,0,0,0,0
10092,10092,Ryan Shotton,3517,2010,Stoke City,0,0,0,0,0,0,2,0,2,50,0,0,2,0,2,50,0,0,0,0,0,0,0,0,0,0,0,0,0,0
10093,10093,Fraizer Campbell,1027,2008,Tottenham Hotspur,7,1,6,227,0,0,3,0,3,48,1,0,10,1,9,275,1,0,0,0,0,0,0,0,0,0,0,0,0,0
10094,10094,Christian Dailly,1626,2006,West Ham United,6,4,2,382,0,0,7,5,2,518,0,0,13,9,4,900,0,0,0,0,0,0,0,0,0,0,0,0,0,0
10095,10095,Nigel Quashie,1068,2006,West Ham United,4,4,0,340,0,0,3,3,0,270,0,0,7,7,0,610,0,0,0,0,0,0,0,0,0,0,0,0,0,0
10096,10096,Shaun Newton,2862,2006,West Ham United,1,0,1,9,0,0,2,0,2,89,0,0,3,0,3,98,0,0,0,0,0,0,0,0,0,0,0,0,0,0
10097,10097,Kepa,1853,2006,West Ham United,4,0,4,54,1,0,4,1,3,116,0,0,8,1,7,170,1,0,0,0,0,0,0,0,0,0,0,0,0,0
10098,10098,Matthew Upson,1279,2006,West Ham United,1,1,0,11,0,0,1,1,0,30,0,0,2,2,0,41,0,0,0,0,0,0,0,0,0,0,0,0,0,0
10099,10099,Henri Saivet,4133,2015,Newcastle United,2,0,2,34,0,0,2,2,0,114,0,0,4,2,2,148,0,0,0,0,0,0,0,0,0,0,0,0,0,0
10100,10100,Sylvain Marveaux,2711,2015,Newcastle United,0,0,0,0,0,0,0,0,0,0,0,0,0,0,0,0,0,0,0,0,0,0,0,0,0,0,0,0,0,0
10101,10101,Marco van Ginkel,2757,2013,Chelsea FC,2,0,2,12,0,0,0,0,0,0,0,0,2,0,2,12,0,0,0,0,0,0,0,0,0,0,0,0,0,0
10102,10102,Andy Marshall,3291,2011,Aston Villa,0,0,0,0,0,0,0,0,0,0,0,0,0,0,0,0,0,0,0,0,0,0,0,0,0,0,0,0,0,0
10103,10103,Louis Laing,3962,2010,Sunderland AFC,1,0,1,3,0,0,0,0,0,0,0,0,1,0,1,3,0,0,0,0,0,0,0,0,0,0,0,0,0,0
10104,10104,Jordan Cook,4134,2010,Sunderland AFC,1,0,1,3,0,0,2,0,2,26,0,0,3,0,3,29,0,0,0,0,0,0,0,0,0,0,0,0,0,0
10105,10105,Ilan,4135,2009,West Ham United,6,3,3,316,2,0,5,3,2,260,2,0,11,6,5,576,4,0,3,1,4,2,1,3,0,0,0,0,0,0
10106,10106,Mido,2636,2009,West Ham United,4,2,2,184,0,0,5,3,2,308,0,0,9,5,4,492,0,0,0,0,0,0,0,0,0,0,0,0,0,0
10107,10107,Andranik Teymourian,2038,2007,Bolton Wanderers,2,0,2,32,0,0,1,1,0,46,0,0,3,1,2,78,0,0,0,0,0,0,0,0,0,0,0,0,0,0
10108,10108,Leon Andreasen,3686,2007,Fulham FC,6,4,2,341,0,0,7,5,2,449,0,0,13,9,4,790,0,0,0,0,0,0,0,0,0,0,0,0,0,0
10109,10109,Philippe Christanval,3247,2007,Fulham FC,0,0,0,0,0,0,1,0,1,16,0,0,1,0,1,16,0,0,0,0,0,0,0,0,0,0,0,0,0,0
10110,10110,Manny Onariase,4136,2014,West Ham United,0,0,0,0,0,0,0,0,0,0,0,0,0,0,0,0,0,0,0,0,0,0,0,0,0,0,0,0,0,0
10111,10111,Josh Cullen,2947,2014,West Ham United,0,0,0,0,0,0,0,0,0,0,0,0,0,0,0,0,0,0,0,0,0,0,0,0,0,0,0,0,0,0
10112,10112,Kerim Frei,3119,2012,Fulham FC,5,2,3,179,0,0,2,0,2,52,0,0,7,2,5,231,0,0,0,0,0,0,0,0,0,0,0,0,0,0
10113,10113,Alain Goma,1080,2004,Fulham FC,8,8,0,720,0,0,7,6,1,621,0,0,15,14,1,1341,0,0,0,0,0,0,0,0,0,0,0,0,0,0
10114,10114,Ibrahima Cissé,4137,2018,Fulham FC,1,0,1,9,0,0,2,1,1,78,0,0,3,1,2,87,0,0,0,0,0,0,0,0,0,0,0,0,0,0
10115,10115,Tamás Kádár,4138,2010,Newcastle United,0,0,0,0,0,0,0,0,0,0,0,0,0,0,0,0,0,0,0,0,0,0,0,0,0,0,0,0,0,0
10116,10116,Isaiah Osbourne,2708,2007,Aston Villa,3,0,3,54,0,0,5,1,4,112,0,0,8,1,7,166,0,0,0,0,0,0,0,0,0,0,0,0,0,0
10117,10117,Bosingwa,2268,2009,Chelsea FC,3,3,0,246,0,0,5,5,0,403,0,0,8,8,0,649,0,0,0,0,0,0,0,0,0,0,0,0,0,0
10118,10118,Ronnie Stam,2878,2012,Wigan Athletic,10,6,4,568,0,0,7,5,2,446,0,0,17,11,6,1014,0,0,0,0,0,0,0,0,0,0,0,0,0,0
10119,10119,Jamie Ashdown,3122,2009,Portsmouth FC,1,1,0,90,0,0,5,4,1,361,0,0,6,5,1,451,0,0,0,0,0,0,0,0,0,0,0,0,0,0
10120,10120,John Welsh,4139,2004,Liverpool FC,1,1,0,73,0,0,2,1,1,102,0,0,3,2,1,175,0,0,0,0,0,0,0,0,0,0,0,0,0,0
10121,10121,Emerse Faé,4140,2007,Reading FC,2,1,1,92,0,0,5,2,3,189,0,0,7,3,4,281,0,0,0,0,0,0,0,0,0,0,0,0,0,0
10122,10122,Sam Woods,3710,2019,Crystal Palace,0,0,0,0,0,0,0,0,0,0,0,0,0,0,0,0,0,0,0,0,0,0,0,0,0,0,0,0,0,0
10123,10123,Christian Kalvenes,4141,2009,Burnley FC,2,1,1,36,0,0,4,2,2,242,0,0,6,3,3,278,0,0,0,0,0,0,0,0,0,0,0,0,0,0
10124,10124,Liam Cooper,4142,2009,Hull City,1,0,1,35,0,0,1,1,0,90,0,0,2,1,1,125,0,0,0,0,0,0,0,0,0,0,0,0,0,0
10125,10125,Crusat,2882,2012,Wigan Athletic,0,0,0,0,0,0,0,0,0,0,0,0,0,0,0,0,0,0,0,0,0,0,0,0,0,0,0,0,0,0
10126,10126,Kevin Poole,3502,2001,Bolton Wanderers,2,2,0,180,0,0,1,1,0,90,0,0,3,3,0,270,0,0,0,0,0,0,0,0,0,0,0,0,0,0
10127,10127,Jonathan Greening,1321,2000,Manchester United,6,3,3,253,0,0,1,0,1,20,0,0,7,3,4,273,0,0,0,0,0,0,0,0,0,0,0,0,0,0
10128,10128,Alex Palmer,3860,2017,West Bromwich Albion,0,0,0,0,0,0,0,0,0,0,0,0,0,0,0,0,0,0,0,0,0,0,0,0,0,0,0,0,0,0
10129,10129,Séamus Coleman,1467,2017,Everton FC,7,7,0,586,0,0,5,5,0,450,0,0,12,12,0,1036,0,0,0,0,0,0,0,0,0,0,0,0,0,0
10130,10130,Ramiro Funes Mori,3109,2017,Everton FC,1,0,1,44,0,0,3,1,2,75,0,0,4,1,3,119,0,0,0,0,0,0,0,0,0,0,0,0,0,0
10131,10131,Nikola Vlašić,4143,2017,Everton FC,7,5,2,364,0,0,5,2,3,212,0,0,12,7,5,576,0,0,0,0,0,0,0,0,0,0,0,0,0,0
10132,10132,Beni Baningime,4016,2017,Everton FC,5,1,4,125,0,0,3,0,3,67,0,0,8,1,7,192,0,0,0,0,0,0,0,0,0,0,0,0,0,0
10133,10133,Mark Yeates,4144,2004,Tottenham Hotspur,1,0,1,12,0,0,1,0,1,18,0,0,2,0,2,30,0,0,0,0,0,0,0,0,0,0,0,0,0,0
10134,10134,Michael Essien,1763,2009,Chelsea FC,7,7,0,630,3,0,6,5,1,475,0,0,13,12,1,1105,3,0,0,0,0,0,0,0,0,0,0,0,0,0
10135,10135,Jeffrey Bruma,2868,2009,Chelsea FC,1,0,1,24,0,0,1,0,1,34,0,0,2,0,2,58,0,0,0,0,0,0,0,0,0,0,0,0,0,0
10136,10136,Jonathan Blondel,3480,2002,Tottenham Hotspur,1,0,1,10,0,0,0,0,0,0,0,0,1,0,1,10,0,0,0,0,0,0,0,0,0,0,0,0,0,0
10137,10137,Brett Emerton,1141,2011,Blackburn Rovers,2,2,0,136,0,0,0,0,0,0,0,0,2,2,0,136,0,0,0,0,0,0,0,0,0,0,0,0,0,0
10138,10138,Bruno Ribeiro,4145,2011,Blackburn Rovers,0,0,0,0,0,0,0,0,0,0,0,0,0,0,0,0,0,0,0,0,0,0,0,0,0,0,0,0,0,0
10139,10139,Myles Anderson,4146,2011,Blackburn Rovers,0,0,0,0,0,0,0,0,0,0,0,0,0,0,0,0,0,0,0,0,0,0,0,0,0,0,0,0,0,0
10140,10140,Stefan Maierhofer,3954,2011,Wolverhampton Wanderers,0,0,0,0,0,0,1,0,1,1,0,0,1,0,1,1,0,0,0,0,0,0,0,0,0,0,0,0,0,0
10141,10141,Owen Hargreaves,3313,2011,Manchester City,1,0,1,13,0,0,0,0,0,0,0,0,1,0,1,13,0,0,0,0,0,0,0,0,0,0,0,0,0,0
10142,10142,Adam Green,3657,2003,Fulham FC,3,3,0,270,0,0,0,0,0,0,0,0,3,3,0,270,0,0,0,0,0,0,0,0,0,0,0,0,0,0
10143,10143,Bobby Petta,4147,2003,Fulham FC,6,2,4,174,0,0,3,1,2,144,0,0,9,3,6,318,0,0,0,0,0,0,0,0,0,0,0,0,0,0
10144,10144,Claus Jensen,1674,2004,Fulham FC,6,4,2,356,0,0,6,6,0,514,0,0,12,10,2,870,0,0,0,0,0,0,0,0,0,0,0,0,0,0
10145,10145,Erwin Mulder,4148,2017,Swansea City,0,0,0,0,0,0,0,0,0,0,0,0,0,0,0,0,0,0,0,0,0,0,0,0,0,0,0,0,0,0
10146,10146,Brandon Austin,4149,2019,Tottenham Hotspur,0,0,0,0,0,0,0,0,0,0,0,0,0,0,0,0,0,0,0,0,0,0,0,0,0,0,0,0,0,0
10147,10147,Zoltán Gera,1323,2005,West Bromwich Albion,5,4,1,380,0,0,9,7,2,616,2,0,14,11,3,996,2,0,0,1,1,0,2,2,0,0,0,0,0,0
10148,10148,Matt Murray,4150,2003,Wolverhampton Wanderers,0,0,0,0,0,0,1,1,0,90,0,0,1,1,0,90,0,0,0,0,0,0,0,0,0,0,0,0,0,0
10149,10149,Jon Macken,3125,2007,Derby County,2,0,2,16,0,0,1,0,1,25,0,0,3,0,3,41,0,0,0,0,0,0,0,0,0,0,0,0,0,0
10150,10150,Peter Ramage,1947,2007,Newcastle United,0,0,0,0,0,0,3,0,3,90,0,0,3,0,3,90,0,0,0,0,0,0,0,0,0,0,0,0,0,0
10151,10151,Bernard Lambourde,4151,2000,Chelsea FC,1,0,1,3,0,0,0,0,0,0,0,0,1,0,1,3,0,0,0,0,0,0,0,0,0,0,0,0,0,0
10152,10152,Antonio Valencia,1641,2018,Manchester United,3,2,1,196,0,0,3,3,0,270,0,0,6,5,1,466,0,0,0,0,0,0,0,0,0,0,0,0,0,0
10153,10153,Rami Shaaban,4152,2002,Manchester United,1,1,0,43,0,0,0,0,0,0,0,0,1,1,0,43,0,0,0,0,0,0,0,0,0,0,0,0,0,0
10154,10154,Manuel Da Costa,4013,2010,West Ham United,8,7,1,598,1,0,8,7,1,694,0,0,16,14,2,1292,1,0,0,0,0,0,0,0,0,0,0,0,0,0
10155,10155,Thomas Hitzlsperger,1792,2010,West Ham United,6,6,0,540,2,0,5,5,0,450,0,0,11,11,0,990,2,0,1,0,1,1,0,1,0,0,0,0,0,0
10156,10156,Gary O'Neil,1389,2010,West Ham United,5,4,1,334,0,0,3,3,0,258,0,0,8,7,1,592,0,0,0,0,0,0,0,0,0,0,0,0,0,0
10157,10157,Demba Ba,1544,2010,West Ham United,6,4,2,393,2,0,6,6,0,540,5,0,12,10,2,933,7,0,0,1,1,1,2,3,0,0,0,0,0,0
10158,10158,Oliver Gill,4153,2010,Manchester United,0,0,0,0,0,0,0,0,0,0,0,0,0,0,0,0,0,0,0,0,0,0,0,0,0,0,0,0,0,0
10159,10159,Carlo Cudicini,2370,2008,Chelsea FC,0,0,0,0,0,0,2,2,0,180,0,0,2,2,0,180,0,0,0,0,0,0,0,0,0,0,0,0,0,0
10160,10160,Giannelli Imbula,1583,2015,Stoke City,8,8,0,720,1,0,6,6,0,540,1,0,14,14,0,1260,2,0,0,0,0,1,1,2,0,0,0,0,0,0
10161,10161,Mohamed El Ouriachi,4154,2015,Stoke City,0,0,0,0,0,0,0,0,0,0,0,0,0,0,0,0,0,0,0,0,0,0,0,0,0,0,0,0,0,0
10162,10162,James Sinclair,4155,2006,Bolton Wanderers,0,0,0,0,0,0,2,0,2,45,0,0,2,0,2,45,0,0,0,0,0,0,0,0,0,0,0,0,0,0
10163,10163,Sam Gallagher,3689,2018,Southampton FC,1,0,1,7,0,0,3,0,3,25,0,0,4,0,4,32,0,0,0,0,0,0,0,0,0,0,0,0,0,0
10164,10164,Callum Slattery,4156,2018,Southampton FC,1,0,1,6,0,0,2,1,1,104,0,0,3,1,2,110,0,0,0,0,0,0,0,0,0,0,0,0,0,0
10165,10165,Alan O'Brien,4157,2005,Newcastle United,1,0,1,28,0,0,2,0,2,19,0,0,3,0,3,47,0,0,0,0,0,0,0,0,0,0,0,0,0,0
10166,10166,Hilário,2709,2009,Chelsea FC,2,2,0,180,0,0,1,0,1,39,0,0,3,2,1,219,0,0,0,0,0,0,0,0,0,0,0,0,0,0
10167,10167,Callum Robinson,3472,2014,Aston Villa,0,0,0,0,0,0,0,0,0,0,0,0,0,0,0,0,0,0,0,0,0,0,0,0,0,0,0,0,0,0
10168,10168,Elliott Ward,3578,2005,West Bromwich Albion,1,1,0,90,0,0,0,0,0,0,0,0,1,1,0,90,0,0,0,0,0,0,0,0,0,0,0,0,0,0
10169,10169,Kyel Reid,4158,2005,West Bromwich Albion,1,1,0,90,0,0,0,0,0,0,0,0,1,1,0,90,0,0,0,0,0,0,0,0,0,0,0,0,0,0
10170,10170,João Carlos Teixeira,3628,2013,Liverpool FC,0,0,0,0,0,0,1,0,1,8,0,0,1,0,1,8,0,0,0,0,0,0,0,0,0,0,0,0,0,0
10171,10171,Fraser Forster,1240,2019,Southampton FC,0,0,0,0,0,0,0,0,0,0,0,0,0,0,0,0,0,0,0,0,0,0,0,0,0,0,0,0,0,0
10172,10172,Andy Lonergan,4159,2019,Liverpool FC,0,0,0,0,0,0,0,0,0,0,0,0,0,0,0,0,0,0,0,0,0,0,0,0,0,0,0,0,0,0
10173,10173,Kasey Palmer,4160,2017,Huddersfield Town,2,0,2,52,0,0,2,1,1,116,0,0,4,1,3,168,0,0,0,0,0,0,0,0,0,0,0,0,0,0
10174,10174,Tim Krul,1822,2012,Newcastle United,13,13,0,1137,0,0,11,11,0,990,0,0,24,24,0,2127,0,0,0,0,0,0,0,0,0,0,0,0,0,0
10175,10175,Danny Simpson,2395,2012,Newcastle United,9,9,0,686,0,0,10,9,1,839,0,0,19,18,1,1525,0,0,0,0,0,0,0,0,0,0,0,0,0,0
10176,10176,Gaël Bigirimana,4161,2012,Newcastle United,6,0,6,161,1,0,7,3,4,243,0,0,13,3,10,404,1,0,0,0,0,0,0,0,0,0,0,0,0,0
10177,10177,Shane Ferguson,2403,2012,Newcastle United,5,3,2,247,0,0,4,1,3,97,0,0,9,4,5,344,0,0,0,0,0,0,0,0,0,0,0,0,0,0
10178,10178,Sammy Ameobi,2459,2012,Newcastle United,4,1,3,122,0,0,6,0,6,141,0,0,10,1,9,263,0,0,0,0,0,0,0,0,0,0,0,0,0,0
10179,10179,Bülent Akin,4162,2002,Bolton Wanderers,0,0,0,0,0,0,1,0,1,5,0,0,1,0,1,5,0,0,0,0,0,0,0,0,0,0,0,0,0,0
10180,10180,Dan Potts,4163,2012,West Ham United,0,0,0,0,0,0,2,1,1,117,0,0,2,1,1,117,0,0,0,0,0,0,0,0,0,0,0,0,0,0
10181,10181,Richard Kingson,2600,2007,Birmingham City,1,1,0,90,0,0,0,0,0,0,0,0,1,1,0,90,0,0,0,0,0,0,0,0,0,0,0,0,0,0
10182,10182,Stefan Schnoor,4164,2000,Derby County,4,4,0,360,0,0,4,2,2,201,0,0,8,6,2,561,0,0,0,0,0,0,0,0,0,0,0,0,0,0
10183,10183,Steven Elliott,4165,2000,Derby County,2,1,1,97,0,0,3,3,0,270,0,0,5,4,1,367,0,0,0,0,0,0,0,0,0,0,0,0,0,0
10184,10184,Ryan Taylor,2341,2005,Wigan Athletic,7,2,5,281,0,0,4,1,3,118,0,0,11,3,8,399,0,0,0,0,0,0,0,0,0,0,0,0,0,0
10185,10185,Steve McMillan,4166,2005,Wigan Athletic,1,0,1,16,0,0,1,0,1,44,0,0,2,0,2,60,0,0,0,0,0,0,0,0,0,0,0,0,0,0
10186,10186,Steve Simonsen,2918,2003,Everton FC,1,1,0,90,0,0,0,0,0,0,0,0,1,1,0,90,0,0,0,0,0,0,0,0,0,0,0,0,0,0
10187,10187,Jamie Carragher,1778,2003,Liverpool FC,9,9,0,810,0,0,10,10,0,880,0,0,19,19,0,1690,0,0,0,0,0,0,0,0,0,0,0,0,0,0
10188,10188,Milan Baroš,1961,2003,Liverpool FC,6,1,5,218,0,0,7,5,2,388,1,0,13,6,7,606,1,0,0,1,1,0,1,1,0,0,0,0,0,0
10189,10189,Héctor Bellerín,1499,2013,Arsenal FC,0,0,0,0,0,0,0,0,0,0,0,0,0,0,0,0,0,0,0,0,0,0,0,0,0,0,0,0,0,0
10190,10190,Chuba Akpom,3801,2013,Arsenal FC,0,0,0,0,0,0,1,0,1,1,0,0,1,0,1,1,0,0,0,0,0,0,0,0,0,0,0,0,0,0
10191,10191,Hayden Foxe,4035,2003,Portsmouth FC,5,4,1,390,1,0,5,4,1,348,0,0,10,8,2,738,1,0,0,0,0,0,0,0,0,0,0,0,0,0
10192,10192,Tope Obadeyi,4167,2008,Bolton Wanderers,2,0,2,29,0,0,1,0,1,12,0,0,3,0,3,41,0,0,0,0,0,0,0,0,0,0,0,0,0,0
10193,10193,Mike Pollitt,2880,2008,Wigan Athletic,2,2,0,180,0,0,1,1,0,90,0,0,3,3,0,270,0,0,0,0,0,0,0,0,0,0,0,0,0,0
10194,10194,Will Keane,2381,2016,Hull City,2,2,0,94,0,0,3,2,1,188,0,0,5,4,1,282,0,0,0,0,0,0,0,0,0,0,0,0,0,0
10195,10195,Wilfried Bony,1597,2016,Stoke City,5,5,0,374,2,0,5,4,1,316,0,0,10,9,1,690,2,0,0,0,0,1,0,1,0,0,0,0,0,0
10196,10196,Ben Clark,4168,2002,Sunderland AFC,1,0,1,26,0,0,0,0,0,0,0,0,1,0,1,26,0,0,0,0,0,0,0,0,0,0,0,0,0,0
10197,10197,Francis Benali,3384,2002,Southampton FC,1,1,0,90,0,0,1,1,0,90,0,0,2,2,0,180,0,0,0,0,0,0,0,0,0,0,0,0,0,0
10198,10198,Youri Djorkaeff,3077,2001,Bolton Wanderers,6,6,0,516,1,0,6,6,0,476,3,0,12,12,0,992,4,0,0,0,0,0,2,2,0,0,0,0,0,0
10199,10199,Ivan Toney,4169,2015,Newcastle United,2,0,2,10,0,0,0,0,0,0,0,0,2,0,2,10,0,0,0,0,0,0,0,0,0,0,0,0,0,0
10200,10200,Javi Garrido,1381,2009,Manchester City,5,4,1,359,0,0,4,3,1,274,1,0,9,7,2,633,1,0,0,0,0,0,0,0,0,0,0,0,0,0
10201,10201,Kayne Ramsay,4170,2018,Southampton FC,1,1,0,90,0,0,0,0,0,0,0,0,1,1,0,90,0,0,0,0,0,0,0,0,0,0,0,0,0,0
10202,10202,Josh Sims,3141,2018,Southampton FC,4,1,3,139,0,0,3,1,2,70,0,0,7,2,5,209,0,0,0,0,0,0,0,0,0,0,0,0,0,0
10203,10203,Chris Smalling,1640,2008,Fulham FC,1,0,1,13,0,0,0,0,0,0,0,0,1,0,1,13,0,0,0,0,0,0,0,0,0,0,0,0,0,0
10204,10204,Segundo Castillo,3953,2008,Everton FC,2,1,1,75,0,0,6,3,3,324,0,0,8,4,4,399,0,0,0,0,0,0,0,0,0,0,0,0,0,0
10205,10205,Vincent Janssen,2773,2018,Tottenham Hotspur,3,0,3,36,0,0,0,0,0,0,0,0,3,0,3,36,0,0,0,0,0,0,0,0,0,0,0,0,0,0
10206,10206,Joe Cole,1630,2015,Aston Villa,0,0,0,0,0,0,0,0,0,0,0,0,0,0,0,0,0,0,0,0,0,0,0,0,0,0,0,0,0,0
10207,10207,Lynden Gooch,3315,2015,Sunderland AFC,0,0,0,0,0,0,0,0,0,0,0,0,0,0,0,0,0,0,0,0,0,0,0,0,0,0,0,0,0,0
10208,10208,Kyle Bartley,2276,2013,Swansea City,0,0,0,0,0,0,2,1,1,91,0,0,2,1,1,91,0,0,0,0,0,0,0,0,0,0,0,0,0,0
10209,10209,Jay Fulton,3196,2013,Swansea City,1,0,1,7,0,0,1,1,0,73,0,0,2,1,1,80,0,0,0,0,0,0,0,0,0,0,0,0,0,0
10210,10210,James Daly,4171,2017,Crystal Palace,0,0,0,0,0,0,0,0,0,0,0,0,0,0,0,0,0,0,0,0,0,0,0,0,0,0,0,0,0,0
10211,10211,Daniel Sturridge,1428,2006,Manchester City,2,0,2,20,0,0,0,0,0,0,0,0,2,0,2,20,0,0,0,0,0,0,0,0,0,0,0,0,0,0
10212,10212,Stephen Bywater,1568,2005,West Ham United,1,0,1,30,0,0,0,0,0,0,0,0,1,0,1,30,0,0,0,0,0,0,0,0,0,0,0,0,0,0
10213,10213,Matt Heath,3809,2001,Leicester City,2,1,1,91,0,0,3,2,1,194,0,0,5,3,2,285,0,0,0,0,0,0,0,0,0,0,0,0,0,0
10214,10214,Michael Reiziger,3838,2005,Middlesbrough FC,2,2,0,180,0,0,2,2,0,180,0,0,4,4,0,360,0,0,0,0,0,0,0,0,0,0,0,0,0,0
10215,10215,Valentin Roberge,3188,2014,Sunderland AFC,0,0,0,0,0,0,1,1,0,90,0,0,1,1,0,90,0,0,0,0,0,0,0,0,0,0,0,0,0,0
10216,10216,Charis Mavrias,4112,2014,Sunderland AFC,0,0,0,0,0,0,0,0,0,0,0,0,0,0,0,0,0,0,0,0,0,0,0,0,0,0,0,0,0,0
10217,10217,Ben Amos,2260,2014,Manchester United,0,0,0,0,0,0,0,0,0,0,0,0,0,0,0,0,0,0,0,0,0,0,0,0,0,0,0,0,0,0
10218,10218,Reece James,2960,2014,Manchester United,0,0,0,0,0,0,0,0,0,0,0,0,0,0,0,0,0,0,0,0,0,0,0,0,0,0,0,0,0,0
10219,10219,Shinji Kagawa,2321,2014,Manchester United,0,0,0,0,0,0,0,0,0,0,0,0,0,0,0,0,0,0,0,0,0,0,0,0,0,0,0,0,0,0
10220,10220,Javier Hernández,2257,2014,Manchester United,1,1,0,46,0,0,0,0,0,0,0,0,1,1,0,46,0,0,0,0,0,0,0,0,0,0,0,0,0,0
10221,10221,Fernandinho,1202,2018,Manchester City,15,14,1,1286,1,0,14,13,1,1095,0,0,29,27,2,2381,1,0,0,0,0,0,0,0,0,0,0,0,0,0
10222,10222,Nikolaos Dabizas,2161,2002,Newcastle United,7,5,2,507,0,0,9,8,1,724,0,0,16,13,3,1231,0,0,0,0,0,0,0,0,0,0,0,0,0,0
10223,10223,Djamel Belmadi,4172,2002,Manchester City,6,2,4,268,0,0,2,0,2,63,0,0,8,2,6,331,0,0,0,0,0,0,0,0,0,0,0,0,0,0
10224,10224,Jürgen Macho,3594,2002,Sunderland AFC,6,6,0,540,0,0,7,6,1,603,0,0,13,12,1,1143,0,0,0,0,0,0,0,0,0,0,0,0,0,0
10225,10225,Jürgen Macho,3594,2000,Sunderland AFC,1,0,1,42,0,0,2,2,0,180,0,0,3,2,1,222,0,0,0,0,0,0,0,0,0,0,0,0,0,0
10226,10226,Paul Butler,2904,2000,Sunderland AFC,1,1,0,90,0,0,1,1,0,90,0,0,2,2,0,180,0,0,0,0,0,0,0,0,0,0,0,0,0,0
10227,10227,Darren Holloway,4173,2000,Sunderland AFC,1,1,0,90,0,0,2,2,0,135,0,0,3,3,0,225,0,0,0,0,0,0,0,0,0,0,0,0,0,0
10228,10228,Paul Thirlwell,1635,2000,Sunderland AFC,2,1,1,102,0,0,2,1,1,80,0,0,4,2,2,182,0,0,0,0,0,0,0,0,0,0,0,0,0,0
10229,10229,John Oster,2704,2000,Sunderland AFC,3,1,2,100,0,0,5,1,4,162,0,0,8,2,6,262,0,0,0,0,0,0,0,0,0,0,0,0,0,0
10230,10230,Lee Camp,3705,2013,West Bromwich Albion,0,0,0,0,0,0,0,0,0,0,0,0,0,0,0,0,0,0,0,0,0,0,0,0,0,0,0,0,0,0
10231,10231,Jores Okore,2664,2015,Aston Villa,7,7,0,630,0,0,5,5,0,450,0,0,12,12,0,1080,0,0,0,0,0,0,0,0,0,0,0,0,0,0
10232,10232,Keinan Davis,2853,2015,Aston Villa,0,0,0,0,0,0,0,0,0,0,0,0,0,0,0,0,0,0,0,0,0,0,0,0,0,0,0,0,0,0
10233,10233,Bongani Khumalo,4052,2011,Tottenham Hotspur,0,0,0,0,0,0,0,0,0,0,0,0,0,0,0,0,0,0,0,0,0,0,0,0,0,0,0,0,0,0
10234,10234,Adam Smith,1004,2011,Tottenham Hotspur,1,0,1,14,0,0,0,0,0,0,0,0,1,0,1,14,0,0,0,0,0,0,0,0,0,0,0,0,0,0
10235,10235,Stephen Jordan,2549,2003,Manchester City,1,0,1,8,0,0,1,0,1,1,0,0,2,0,2,9,0,0,0,0,0,0,0,0,0,0,0,0,0,0
10236,10236,Nick Chadwick,4174,2003,Everton FC,1,0,1,17,0,0,2,1,1,109,0,0,3,1,2,126,0,0,0,0,0,0,0,0,0,0,0,0,0,0
10237,10237,Gary Taylor-Fletcher,3592,2014,Leicester City,0,0,0,0,0,0,1,0,1,17,0,0,1,0,1,17,0,0,0,0,0,0,0,0,0,0,0,0,0,0
10238,10238,Tom Hopper,4175,2014,Leicester City,0,0,0,0,0,0,0,0,0,0,0,0,0,0,0,0,0,0,0,0,0,0,0,0,0,0,0,0,0,0
10239,10239,Danny Dichio,3082,2000,Sunderland AFC,7,1,6,206,1,0,8,1,7,184,0,0,15,2,13,390,1,0,0,0,0,0,0,0,0,0,0,0,0,0
10240,10240,Iván Guerrero,4176,2000,Coventry City,1,1,0,90,0,0,2,2,0,137,0,0,3,3,0,227,0,0,0,0,0,0,0,0,0,0,0,0,0,0
10241,10241,Nigel Quashie,1068,2005,West Bromwich Albion,3,3,0,258,0,0,5,5,0,450,1,0,8,8,0,708,1,0,0,0,0,0,1,1,0,0,0,0,0,0
10242,10242,Stuart Nicholson,4177,2005,West Bromwich Albion,2,0,2,26,0,0,2,0,2,32,0,0,4,0,4,58,0,0,0,0,0,0,0,0,0,0,0,0,0,0
10243,10243,Egil Østenstad,2300,2000,Manchester City,3,1,2,143,0,0,0,0,0,0,0,0,3,1,2,143,0,0,0,0,0,0,0,0,0,0,0,0,0,0
10244,10244,Ben White,4178,2018,Brighton & Hove Albion,0,0,0,0,0,0,0,0,0,0,0,0,0,0,0,0,0,0,0,0,0,0,0,0,0,0,0,0,0,0
10245,10245,Simon Davies,1125,2011,Fulham FC,3,1,2,128,0,0,3,2,1,172,0,0,6,3,3,300,0,0,0,0,0,0,0,0,0,0,0,0,0,0
10246,10246,Rafik Halliche,2652,2011,Fulham FC,0,0,0,0,0,0,0,0,0,0,0,0,0,0,0,0,0,0,0,0,0,0,0,0,0,0,0,0,0,0
10247,10247,Eggert Jónsson,4179,2011,Wolverhampton Wanderers,2,1,1,109,0,0,1,1,0,64,0,0,3,2,1,173,0,0,0,0,0,0,0,0,0,0,0,0,0,0
10248,10248,Michael Jordan Williams,4180,2014,Liverpool FC,0,0,0,0,0,0,0,0,0,0,0,0,0,0,0,0,0,0,0,0,0,0,0,0,0,0,0,0,0,0
10249,10249,Filipe Oliveira,4075,2002,Chelsea FC,0,0,0,0,0,0,3,0,3,4,0,0,3,0,3,4,0,0,0,0,0,0,0,0,0,0,0,0,0,0
10250,10250,Mark Travers,4102,2019,AFC Bournemouth,1,1,0,90,0,0,0,0,0,0,0,0,1,1,0,90,0,0,0,0,0,0,0,0,0,0,0,0,0,0
10251,10251,Sam Surridge,3940,2019,AFC Bournemouth,3,0,3,24,0,0,1,0,1,1,0,0,4,0,4,25,0,0,0,0,0,0,0,0,0,0,0,0,0,0
10252,10252,Michael Owen,1949,2011,Manchester United,0,0,0,0,0,0,1,0,1,79,0,0,1,0,1,79,0,0,0,0,0,0,0,0,0,0,0,0,0,0
10253,10253,Malcolm Christie,2137,2006,Middlesbrough FC,7,2,5,216,0,0,6,2,4,150,1,0,13,4,9,366,1,0,0,0,0,0,1,1,0,0,0,0,0,0
10254,10254,Sébastien Squillaci,2867,2012,Arsenal FC,0,0,0,0,0,0,0,0,0,0,0,0,0,0,0,0,0,0,0,0,0,0,0,0,0,0,0,0,0,0
10255,10255,Adam Armstrong,3561,2013,Newcastle United,1,0,1,9,0,0,3,0,3,21,0,0,4,0,4,30,0,0,0,0,0,0,0,0,0,0,0,0,0,0
10256,10256,Jak Alnwick,3590,2013,Newcastle United,0,0,0,0,0,0,0,0,0,0,0,0,0,0,0,0,0,0,0,0,0,0,0,0,0,0,0,0,0,0
10257,10257,Mark Clyde,4181,2003,Wolverhampton Wanderers,4,2,2,180,0,0,5,4,1,337,0,0,9,6,3,517,0,0,0,0,0,0,0,0,0,0,0,0,0,0
10258,10258,Vincent Péricard,2968,2008,Stoke City,2,0,2,23,0,0,2,1,1,96,0,0,4,1,3,119,0,0,0,0,0,0,0,0,0,0,0,0,0,0
10259,10259,Richard Naylor,4062,2000,Ipswich Town,6,2,4,261,1,0,6,3,3,282,1,0,12,5,7,543,2,0,0,1,1,1,1,2,0,0,0,0,0,0
10260,10260,Stephen Kingsley,3317,2015,Swansea City,2,2,0,176,0,0,2,2,0,180,0,0,4,4,0,356,0,0,0,0,0,0,0,0,0,0,0,0,0,0
10261,10261,André Green,4182,2015,Aston Villa,1,0,1,28,0,0,1,0,1,29,0,0,2,0,2,57,0,0,0,0,0,0,0,0,0,0,0,0,0,0
10262,10262,Nery Castillo,4183,2007,Manchester City,3,1,2,113,0,0,4,1,3,180,0,0,7,2,5,293,0,0,0,0,0,0,0,0,0,0,0,0,0,0
10263,10263,Sead Hakšabanović,4184,2017,West Ham United,0,0,0,0,0,0,0,0,0,0,0,0,0,0,0,0,0,0,0,0,0,0,0,0,0,0,0,0,0,0
10264,10264,Domingos Quina,2094,2017,West Ham United,0,0,0,0,0,0,0,0,0,0,0,0,0,0,0,0,0,0,0,0,0,0,0,0,0,0,0,0,0,0
10265,10265,James Daly,4171,2019,Crystal Palace,0,0,0,0,0,0,0,0,0,0,0,0,0,0,0,0,0,0,0,0,0,0,0,0,0,0,0,0,0,0
10266,10266,Jack Butland,1901,2013,Stoke City,2,1,1,134,0,0,1,1,0,90,0,0,3,2,1,224,0,0,0,0,0,0,0,0,0,0,0,0,0,0
10267,10267,Mathieu Debuchy,2453,2017,Arsenal FC,0,0,0,0,0,0,0,0,0,0,0,0,0,0,0,0,0,0,0,0,0,0,0,0,0,0,0,0,0,0
10268,10268,Javi Moreno,4185,2003,Bolton Wanderers,4,1,3,142,0,0,4,0,4,84,0,0,8,1,7,226,0,0,0,0,0,0,0,0,0,0,0,0,0,0
10269,10269,Jason Wilcox,1301,2003,Leeds United,3,1,2,91,0,0,3,2,1,145,0,0,6,3,3,236,0,0,0,0,0,0,0,0,0,0,0,0,0,0
10270,10270,Kyle Walker,1196,2014,Tottenham Hotspur,7,7,0,630,0,0,8,8,0,677,0,0,15,15,0,1307,0,0,0,0,0,0,0,0,0,0,0,0,0,0
10271,10271,Neil Danns,4186,2007,Birmingham City,0,0,0,0,0,0,2,0,2,21,0,0,2,0,2,21,0,0,0,0,0,0,0,0,0,0,0,0,0,0
10272,10272,Lee Cattermole,1687,2012,Sunderland AFC,5,5,0,267,0,0,5,5,0,398,0,0,10,10,0,665,0,0,0,0,0,0,0,0,0,0,0,0,0,0
10273,10273,Louis Saha,1727,2012,Sunderland AFC,6,0,6,91,0,0,5,0,5,93,0,0,11,0,11,184,0,0,0,0,0,0,0,0,0,0,0,0,0,0
10274,10274,Romain Amalfitano,4187,2012,Newcastle United,0,0,0,0,0,0,0,0,0,0,0,0,0,0,0,0,0,0,0,0,0,0,0,0,0,0,0,0,0,0
10275,10275,James Tavernier,2458,2012,Newcastle United,0,0,0,0,0,0,2,0,2,35,0,0,2,0,2,35,0,0,0,0,0,0,0,0,0,0,0,0,0,0
10276,10276,Nile Ranger,2402,2012,Newcastle United,1,0,1,3,0,0,1,0,1,3,0,0,2,0,2,6,0,0,0,0,0,0,0,0,0,0,0,0,0,0
10277,10277,Ali Koiki,4188,2019,Burnley FC,0,0,0,0,0,0,0,0,0,0,0,0,0,0,0,0,0,0,0,0,0,0,0,0,0,0,0,0,0,0
10278,10278,Jonathan Hutchinson,4189,2002,Birmingham City,0,0,0,0,0,0,1,1,0,90,0,0,1,1,0,90,0,0,0,0,0,0,0,0,0,0,0,0,0,0
10279,10279,Jordan Bowery,1977,2013,Aston Villa,5,0,5,93,0,0,4,2,2,142,0,0,9,2,7,235,0,0,0,0,0,0,0,0,0,0,0,0,0,0
10280,10280,Colin Hendry,4190,2001,Bolton Wanderers,1,1,0,83,0,0,2,2,0,122,0,0,3,3,0,205,0,0,0,0,0,0,0,0,0,0,0,0,0,0
10281,10281,Hakan Şükür,4191,2002,Blackburn Rovers,5,4,1,350,0,0,4,3,1,265,2,0,9,7,2,615,2,0,0,0,0,0,0,0,0,0,0,0,0,0
10282,10282,Abel Xavier,2824,2005,Middlesbrough FC,2,2,0,180,0,0,2,2,0,180,0,0,4,4,0,360,0,0,0,0,0,0,0,0,0,0,0,0,0,0
10283,10283,Szilárd Németh,2139,2005,Middlesbrough FC,4,0,4,125,0,0,1,1,0,69,0,0,5,1,4,194,0,0,0,0,0,0,0,0,0,0,0,0,0,0
10284,10284,Steve Bould,4192,2000,Manchester City,1,0,1,43,0,0,0,0,0,0,0,0,1,0,1,43,0,0,0,0,0,0,0,0,0,0,0,0,0,0
10285,10285,Éric Roy,4193,2000,Manchester City,1,0,1,45,0,0,0,0,0,0,0,0,1,0,1,45,0,0,0,0,0,0,0,0,0,0,0,0,0,0
10286,10286,Michael Reddy,4194,2000,Manchester City,1,0,1,5,0,0,0,0,0,0,0,0,1,0,1,5,0,0,0,0,0,0,0,0,0,0,0,0,0,0
10287,10287,Paul Gallacher,4195,2004,Norwich City,0,0,0,0,0,0,0,0,0,0,0,0,0,0,0,0,0,0,0,0,0,0,0,0,0,0,0,0,0,0
10288,10288,Carlo Nash,3303,2004,Middlesbrough FC,1,1,0,90,0,0,1,1,0,90,0,0,2,2,0,180,0,0,0,0,0,0,0,0,0,0,0,0,0,0
10289,10289,Ian Taylor,2767,2001,Aston Villa,9,3,6,457,1,0,6,4,2,401,2,0,15,7,8,858,3,0,0,0,0,0,2,2,0,0,0,0,0,0
10290,10290,Steve Banks,4196,2001,Bolton Wanderers,0,0,0,0,0,0,1,1,0,90,0,0,1,1,0,90,0,0,0,0,0,0,0,0,0,0,0,0,0,0
10291,10291,Thomas Myhre,1951,2002,Sunderland AFC,0,0,0,0,0,0,2,1,1,104,0,0,2,1,1,104,0,0,0,0,0,0,0,0,0,0,0,0,0,0
10292,10292,Kamel Ghilas,4197,2009,Hull City,6,1,5,168,1,0,7,5,2,415,0,0,13,6,7,583,1,0,3,0,3,1,0,1,0,0,0,0,0,0
10293,10293,Chris Herd,3040,2013,Aston Villa,0,0,0,0,0,0,2,2,0,171,0,0,2,2,0,171,0,0,0,0,0,0,0,0,0,0,0,0,0,0
10294,10294,Charlie MacDonald,3549,2001,Charlton Athletic,1,0,1,10,1,0,1,0,1,7,0,0,2,0,2,17,1,0,1,0,1,1,0,1,0,0,0,0,0,0
10295,10295,Danny Ward,2444,2013,Liverpool FC,0,0,0,0,0,0,0,0,0,0,0,0,0,0,0,0,0,0,0,0,0,0,0,0,0,0,0,0,0,0
10296,10296,Mathieu Debuchy,2453,2016,Arsenal FC,1,1,0,16,0,0,0,0,0,0,0,0,1,1,0,16,0,0,0,0,0,0,0,0,0,0,0,0,0,0
10297,10297,Chris Baird,1562,2003,Southampton FC,2,1,1,60,0,0,2,0,2,140,0,0,4,1,3,200,0,0,0,0,0,0,0,0,0,0,0,0,0,0
10298,10298,Léandre Griffit,4198,2003,Southampton FC,4,2,2,143,2,0,1,0,1,5,0,0,5,2,3,148,2,0,0,0,0,1,0,1,0,0,0,0,0,0
10299,10299,Darren Kenton,3531,2003,Southampton FC,3,0,3,95,0,0,4,3,1,268,0,0,7,3,4,363,0,0,0,0,0,0,0,0,0,0,0,0,0,0
10300,10300,Carl Ikeme,4199,2011,Wolverhampton Wanderers,0,0,0,0,0,0,1,0,1,39,0,0,1,0,1,39,0,0,0,0,0,0,0,0,0,0,0,0,0,0
10301,10301,Jose Baxter,2107,2011,Everton FC,1,0,1,12,0,0,0,0,0,0,0,0,1,0,1,12,0,0,0,0,0,0,0,0,0,0,0,0,0,0
10302,10302,Liam Gibson,3036,2015,Newcastle United,0,0,0,0,0,0,0,0,0,0,0,0,0,0,0,0,0,0,0,0,0,0,0,0,0,0,0,0,0,0
10303,10303,Callum Williams,4200,2015,Newcastle United,0,0,0,0,0,0,0,0,0,0,0,0,0,0,0,0,0,0,0,0,0,0,0,0,0,0,0,0,0,0
10304,10304,Seydou Doumbia,4201,2015,Newcastle United,0,0,0,0,0,0,3,0,3,29,0,0,3,0,3,29,0,0,0,0,0,0,0,0,0,0,0,0,0,0
10305,10305,Daniel Barlaser,4202,2015,Newcastle United,0,0,0,0,0,0,0,0,0,0,0,0,0,0,0,0,0,0,0,0,0,0,0,0,0,0,0,0,0,0
10306,10306,Sébastien Pocognoli,3547,2015,West Bromwich Albion,1,0,1,35,0,0,0,0,0,0,0,0,1,0,1,35,0,0,0,0,0,0,0,0,0,0,0,0,0,0
10307,10307,Steve Walsh,4203,2000,Leicester City,1,0,1,8,0,0,0,0,0,0,0,0,1,0,1,8,0,0,0,0,0,0,0,0,0,0,0,0,0,0
10308,10308,Martin Grainger,4088,2003,Birmingham City,2,1,1,166,1,0,2,2,0,129,0,0,4,3,1,295,1,0,0,0,0,1,0,1,0,0,0,0,0,0
10309,10309,Juan Foyth,1862,2019,Tottenham Hotspur,1,0,1,18,0,0,3,1,2,49,0,0,4,1,3,67,0,0,0,0,0,0,0,0,0,0,0,0,0,0
10310,10310,Stéphane Henchoz,2360,2003,Liverpool FC,6,6,0,474,0,0,11,8,3,836,0,0,17,14,3,1310,0,0,0,0,0,0,0,0,0,0,0,0,0,0
10311,10311,Dietmar Hamann,2690,2003,Liverpool FC,11,11,0,957,1,0,11,11,0,990,1,0,22,22,0,1947,2,0,0,0,0,1,1,2,0,0,0,0,0,0
10312,10312,Carlo Nash,3303,2003,Middlesbrough FC,0,0,0,0,0,0,1,1,0,90,0,0,1,1,0,90,0,0,0,0,0,0,0,0,0,0,0,0,0,0
10313,10313,Matthew Bates,1887,2003,Middlesbrough FC,0,0,0,0,0,0,0,0,0,0,0,0,0,0,0,0,0,0,0,0,0,0,0,0,0,0,0,0,0,0
10314,10314,Stephen Elliott,3224,2003,Manchester City,0,0,0,0,0,0,2,0,2,18,0,0,2,0,2,18,0,0,0,0,0,0,0,0,0,0,0,0,0,0
10315,10315,Árni Arason,4204,2003,Manchester City,0,0,0,0,0,0,0,0,0,0,0,0,0,0,0,0,0,0,0,0,0,0,0,0,0,0,0,0,0,0
10316,10316,Asamoah Gyan,1689,2011,Sunderland AFC,1,1,0,90,0,0,2,2,0,143,0,0,3,3,0,233,0,0,0,0,0,0,0,0,0,0,0,0,0,0
10317,10317,Seth Johnson,2292,2002,Leeds United,5,2,3,218,1,0,4,1,3,140,0,0,9,3,6,358,1,0,3,0,3,1,0,1,0,0,0,0,0,0
10318,10318,Bacary Sagna,1596,2011,Arsenal FC,11,10,1,865,1,0,10,10,0,836,0,0,21,20,1,1701,1,0,0,0,0,0,0,0,0,0,0,0,0,0
10319,10319,Henri Saivet,4133,2017,Newcastle United,0,0,0,0,0,0,1,1,0,84,1,0,1,1,0,84,1,0,0,0,0,0,1,1,0,0,0,0,0,0
10320,10320,Con Blatsis,4205,2000,Derby County,1,1,0,90,0,0,1,1,0,85,0,0,2,2,0,175,0,0,0,0,0,0,0,0,0,0,0,0,0,0
10321,10321,Radoslav Kováč,1278,2008,West Ham United,5,4,1,382,0,0,4,4,0,338,1,0,9,8,1,720,1,0,0,0,0,0,1,1,0,0,0,0,0,0
10322,10322,James Tomkins,1281,2008,West Ham United,5,5,0,450,1,0,7,6,1,605,0,0,12,11,1,1055,1,0,0,0,0,0,0,0,0,0,0,0,0,0
10323,10323,Junior Stanislas,1009,2008,West Ham United,5,4,1,351,2,0,4,3,1,276,0,0,9,7,2,627,2,0,3,0,3,2,0,2,0,0,0,0,0,0
10324,10324,Josh Payne,4206,2008,West Ham United,1,0,1,10,0,0,1,0,1,1,0,0,2,0,2,11,0,0,0,0,0,0,0,0,0,0,0,0,0,0
10325,10325,Karim Rekik,1419,2011,Manchester City,0,0,0,0,0,0,0,0,0,0,0,0,0,0,0,0,0,0,0,0,0,0,0,0,0,0,0,0,0,0
10326,10326,Graham Stuart,1673,2002,Charlton Athletic,2,1,1,98,0,0,2,2,0,116,0,0,4,3,1,214,0,0,0,0,0,0,0,0,0,0,0,0,0,0
10327,10327,Marcos Rojo,1651,2015,Manchester United,7,7,0,517,0,0,9,8,1,737,0,0,16,15,1,1254,0,0,0,0,0,0,0,0,0,0,0,0,0,0
10328,10328,Timothy Fosu-Mensah,2255,2015,Manchester United,4,1,3,170,0,0,4,1,3,83,0,0,8,2,6,253,0,0,0,0,0,0,0,0,0,0,0,0,0,0
10329,10329,Luke Dreher,3014,2015,Crystal Palace,0,0,0,0,0,0,0,0,0,0,0,0,0,0,0,0,0,0,0,0,0,0,0,0,0,0,0,0,0,0
10330,10330,Agustín Delgado,3369,2003,Southampton FC,2,0,2,29,0,0,2,0,2,26,0,0,4,0,4,55,0,0,0,0,0,0,0,0,0,0,0,0,0,0
10331,10331,Mario Stanić,3414,2003,Chelsea FC,1,0,1,8,0,0,1,0,1,17,0,0,2,0,2,25,0,0,0,0,0,0,0,0,0,0,0,0,0,0
10332,10332,Jihai Sun,1808,2004,Manchester City,3,2,1,150,0,0,2,1,1,92,0,0,5,3,2,242,0,0,0,0,0,0,0,0,0,0,0,0,0,0
10333,10333,Roy Carroll,1939,2002,Manchester United,4,3,1,331,0,0,6,5,1,503,0,0,10,8,2,834,0,0,0,0,0,0,0,0,0,0,0,0,0,0
10334,10334,Peter Crouch,1273,2001,Aston Villa,3,3,0,232,1,0,4,4,0,358,1,0,7,7,0,590,2,0,1,0,1,1,1,2,0,0,0,0,0,0
10335,10335,Won-hee Cho,3967,2008,Wigan Athletic,0,0,0,0,0,0,1,1,0,58,0,0,1,1,0,58,0,0,0,0,0,0,0,0,0,0,0,0,0,0
10336,10336,Erik Edman,2196,2008,Wigan Athletic,1,0,1,37,0,0,1,0,1,9,0,0,2,0,2,46,0,0,0,0,0,0,0,0,0,0,0,0,0,0
10337,10337,Andy Melville,2894,2003,Middlesbrough FC,1,1,0,90,0,0,0,0,0,0,0,0,1,1,0,90,0,0,0,0,0,0,0,0,0,0,0,0,0,0
10338,10338,Jamie Sterry,2632,2014,Newcastle United,0,0,0,0,0,0,0,0,0,0,0,0,0,0,0,0,0,0,0,0,0,0,0,0,0,0,0,0,0,0
10339,10339,Olivier Kemen,4207,2014,Newcastle United,0,0,0,0,0,0,0,0,0,0,0,0,0,0,0,0,0,0,0,0,0,0,0,0,0,0,0,0,0,0
10340,10340,Jon Routledge,4208,2008,Wigan Athletic,1,0,1,1,0,0,0,0,0,0,0,0,1,0,1,1,0,0,0,0,0,0,0,0,0,0,0,0,0,0
10341,10341,Callum McManaman,3001,2008,Wigan Athletic,1,0,1,12,0,0,0,0,0,0,0,0,1,0,1,12,0,0,0,0,0,0,0,0,0,0,0,0,0,0
10342,10342,Asmir Begović,1036,2008,Portsmouth FC,1,1,0,90,0,0,1,1,0,90,0,0,2,2,0,180,0,0,0,0,0,0,0,0,0,0,0,0,0,0
10343,10343,Jerome Thomas,1736,2008,Portsmouth FC,1,0,1,34,0,0,2,0,2,35,0,0,3,0,3,69,0,0,0,0,0,0,0,0,0,0,0,0,0,0
10344,10344,Philip Stamp,3601,2001,Middlesbrough FC,3,2,1,162,0,0,3,1,2,131,0,0,6,3,3,293,0,0,0,0,0,0,0,0,0,0,0,0,0,0
10345,10345,Caleb Folan,2613,2007,Wigan Athletic,1,0,1,12,0,0,1,1,0,66,0,0,2,1,1,78,0,0,0,0,0,0,0,0,0,0,0,0,0,0
10346,10346,Simon Royce,2832,2003,Charlton Athletic,1,1,0,90,0,0,0,0,0,0,0,0,1,1,0,90,0,0,0,0,0,0,0,0,0,0,0,0,0,0
10347,10347,Gary Rowett,1303,2003,Charlton Athletic,1,1,0,90,0,0,0,0,0,0,0,0,1,1,0,90,0,0,0,0,0,0,0,0,0,0,0,0,0,0
10348,10348,Mahamadou Diarra,3350,2012,Fulham FC,4,3,1,282,0,0,4,4,0,325,0,0,8,7,1,607,0,0,0,0,0,0,0,0,0,0,0,0,0,0
10349,10349,Charles Banya,4209,2012,Fulham FC,0,0,0,0,0,0,0,0,0,0,0,0,0,0,0,0,0,0,0,0,0,0,0,0,0,0,0,0,0,0
10350,10350,James Weir,2785,2015,Manchester United,1,0,1,1,0,0,0,0,0,0,0,0,1,0,1,1,0,0,0,0,0,0,0,0,0,0,0,0,0,0
10351,10351,Joe Riley,3898,2015,Manchester United,0,0,0,0,0,0,0,0,0,0,0,0,0,0,0,0,0,0,0,0,0,0,0,0,0,0,0,0,0,0
10352,10352,Giannis Skopelitis,3565,2004,Portsmouth FC,7,5,2,406,0,0,6,4,2,395,0,0,13,9,4,801,0,0,0,0,0,0,0,0,0,0,0,0,0,0
10353,10353,Sam Vokes,1257,2010,Wolverhampton Wanderers,0,0,0,0,0,0,2,0,2,28,0,0,2,0,2,28,0,0,0,0,0,0,0,0,0,0,0,0,0,0
10354,10354,Steve Vickers,2066,2001,Middlesbrough FC,1,1,0,90,0,0,1,1,0,62,0,0,2,2,0,152,0,0,0,0,0,0,0,0,0,0,0,0,0,0
10355,10355,Joseph-Désiré Job,2071,2001,Middlesbrough FC,2,1,1,103,0,0,2,2,0,180,0,0,4,3,1,283,0,0,0,0,0,0,0,0,0,0,0,0,0,0
10356,10356,Taylor Perry,4210,2019,Wolverhampton Wanderers,0,0,0,0,0,0,0,0,0,0,0,0,0,0,0,0,0,0,0,0,0,0,0,0,0,0,0,0,0,0
10357,10357,Elliott Bennett,3043,2013,Norwich City,2,1,1,105,0,0,1,1,0,90,0,0,3,2,1,195,0,0,0,0,0,0,0,0,0,0,0,0,0,0
10358,10358,Adam Forshaw,3007,2011,Everton FC,0,0,0,0,0,0,0,0,0,0,0,0,0,0,0,0,0,0,0,0,0,0,0,0,0,0,0,0,0,0
10359,10359,Derrick Williams,3086,2012,Aston Villa,0,0,0,0,0,0,1,0,1,25,0,0,1,0,1,25,0,0,0,0,0,0,0,0,0,0,0,0,0,0
10360,10360,Jamie Sterry,2632,2018,Newcastle United,0,0,0,0,0,0,0,0,0,0,0,0,0,0,0,0,0,0,0,0,0,0,0,0,0,0,0,0,0,0
10361,10361,Callum Roberts,4211,2018,Newcastle United,0,0,0,0,0,0,0,0,0,0,0,0,0,0,0,0,0,0,0,0,0,0,0,0,0,0,0,0,0,0
10362,10362,Kevin Long,2350,2016,Burnley FC,2,2,0,180,0,0,1,1,0,90,0,0,3,3,0,270,0,0,0,0,0,0,0,0,0,0,0,0,0,0
10363,10363,Jason Lokilo,4212,2017,Crystal Palace,0,0,0,0,0,0,0,0,0,0,0,0,0,0,0,0,0,0,0,0,0,0,0,0,0,0,0,0,0,0
10364,10364,Keshi Anderson,4213,2017,Crystal Palace,0,0,0,0,0,0,0,0,0,0,0,0,0,0,0,0,0,0,0,0,0,0,0,0,0,0,0,0,0,0
10365,10365,Matt Hill,4214,2009,Wolverhampton Wanderers,0,0,0,0,0,0,2,2,0,180,0,0,2,2,0,180,0,0,0,0,0,0,0,0,0,0,0,0,0,0
10366,10366,Steven Mouyokolo,1608,2010,Wolverhampton Wanderers,2,1,1,92,0,0,2,1,1,67,0,0,4,2,2,159,0,0,0,0,0,0,0,0,0,0,0,0,0,0
10367,10367,David Davis,3886,2010,Wolverhampton Wanderers,0,0,0,0,0,0,0,0,0,0,0,0,0,0,0,0,0,0,0,0,0,0,0,0,0,0,0,0,0,0
10368,10368,Arnold Mvuemba,3449,2006,Portsmouth FC,1,0,1,14,0,0,6,1,5,207,1,0,7,1,6,221,1,0,0,0,0,0,0,0,0,0,0,0,0,0
10369,10369,Bruno Cheyrou,2363,2003,Liverpool FC,5,3,2,223,0,0,6,5,1,386,2,0,11,8,3,609,2,0,0,3,3,0,2,2,0,0,0,0,0,0
10370,10370,Svetoslav Todorov,2967,2003,Portsmouth FC,0,0,0,0,0,0,1,1,0,46,0,0,1,1,0,46,0,0,0,0,0,0,0,0,0,0,0,0,0,0
10371,10371,Jonás Gutiérrez,2398,2013,Newcastle United,0,0,0,0,0,0,2,1,1,63,0,0,2,1,1,63,0,0,0,0,0,0,0,0,0,0,0,0,0,0
10372,10372,Jonathan Spector,1288,2008,West Ham United,5,2,3,232,0,0,4,2,2,231,0,0,9,4,5,463,0,0,0,0,0,0,0,0,0,0,0,0,0,0
10373,10373,Walter López,4215,2008,West Ham United,2,0,2,4,0,0,3,0,3,16,0,0,5,0,5,20,0,0,0,0,0,0,0,0,0,0,0,0,0,0
10374,10374,Richard Edghill,4216,2000,Manchester City,3,3,0,230,0,0,2,2,0,180,0,0,5,5,0,410,0,0,0,0,0,0,0,0,0,0,0,0,0,0
10375,10375,Titi Camara,3949,2002,West Ham United,3,0,3,39,0,0,1,0,1,23,0,0,4,0,4,62,0,0,0,0,0,0,0,0,0,0,0,0,0,0
10376,10376,Daryl Murphy,1900,2009,Sunderland AFC,1,0,1,4,0,0,1,1,0,72,0,0,2,1,1,76,0,0,0,0,0,0,0,0,0,0,0,0,0,0
10377,10377,Conor McAleny,4217,2011,Everton FC,1,0,1,2,0,0,1,0,1,13,0,0,2,0,2,15,0,0,0,0,0,0,0,0,0,0,0,0,0,0
10378,10378,Thomas Vermaelen,2749,2010,Arsenal FC,2,2,0,180,0,0,3,3,0,270,0,0,5,5,0,450,0,0,0,0,0,0,0,0,0,0,0,0,0,0
10379,10379,Ignasi Miquel,3275,2010,Arsenal FC,0,0,0,0,0,0,0,0,0,0,0,0,0,0,0,0,0,0,0,0,0,0,0,0,0,0,0,0,0,0
10380,10380,Conor Henderson,4218,2010,Arsenal FC,0,0,0,0,0,0,0,0,0,0,0,0,0,0,0,0,0,0,0,0,0,0,0,0,0,0,0,0,0,0
10381,10381,Fabian Delph,1198,2010,Aston Villa,4,2,2,213,0,0,3,2,1,201,0,0,7,4,3,414,0,0,0,0,0,0,0,0,0,0,0,0,0,0
10382,10382,Michael Bradley,4219,2010,Aston Villa,1,0,1,1,0,0,2,0,2,27,0,0,3,0,3,28,0,0,0,0,0,0,0,0,0,0,0,0,0,0
10383,10383,Darren Ward,4220,2007,Sunderland AFC,2,2,0,180,0,0,1,1,0,90,0,0,3,3,0,270,0,0,0,0,0,0,0,0,0,0,0,0,0,0
10384,10384,Andy Cole,1113,2007,Sunderland AFC,3,2,1,126,0,0,4,1,3,110,0,0,7,3,4,236,0,0,0,0,0,0,0,0,0,0,0,0,0,0
10385,10385,Fran Mérida,3491,2008,Arsenal FC,0,0,0,0,0,0,2,0,2,20,0,0,2,0,2,20,0,0,0,0,0,0,0,0,0,0,0,0,0,0
10386,10386,Julien N'Goy,3365,2017,Stoke City,0,0,0,0,0,0,1,0,1,19,0,0,1,0,1,19,0,0,0,0,0,0,0,0,0,0,0,0,0,0
10387,10387,Piscu,3666,2012,Wigan Athletic,3,2,1,221,0,0,2,1,1,134,0,0,5,3,2,355,0,0,0,0,0,0,0,0,0,0,0,0,0,0
10388,10388,John Guidetti,1558,2010,Manchester City,0,0,0,0,0,0,0,0,0,0,0,0,0,0,0,0,0,0,0,0,0,0,0,0,0,0,0,0,0,0
10389,10389,Franck Queudrue,1329,2009,Birmingham City,3,3,0,270,0,0,3,3,0,226,0,0,6,6,0,496,0,0,0,0,0,0,0,0,0,0,0,0,0,0
10390,10390,Stuart Parnaby,1881,2009,Birmingham City,4,3,1,300,0,0,4,3,1,246,0,0,8,6,2,546,0,0,0,0,0,0,0,0,0,0,0,0,0,0
10391,10391,Remie Streete,4221,2012,Newcastle United,0,0,0,0,0,0,0,0,0,0,0,0,0,0,0,0,0,0,0,0,0,0,0,0,0,0,0,0,0,0
10392,10392,Mehdi Abeid,2928,2012,Newcastle United,0,0,0,0,0,0,0,0,0,0,0,0,0,0,0,0,0,0,0,0,0,0,0,0,0,0,0,0,0,0
10393,10393,Gunnar Nielsen,4222,2009,Manchester City,0,0,0,0,0,0,1,0,1,17,0,0,1,0,1,17,0,0,0,0,0,0,0,0,0,0,0,0,0,0
10394,10394,Lucien Aubey,4223,2007,Portsmouth FC,0,0,0,0,0,0,3,1,2,168,0,0,3,1,2,168,0,0,0,0,0,0,0,0,0,0,0,0,0,0
10395,10395,Darren Fletcher,1730,2012,Manchester United,2,1,1,91,1,0,1,1,0,90,0,0,3,2,1,181,1,0,0,0,0,1,0,1,0,0,0,0,0,0
10396,10396,Jake Eastwood,4224,2019,Sheffield United,0,0,0,0,0,0,0,0,0,0,0,0,0,0,0,0,0,0,0,0,0,0,0,0,0,0,0,0,0,0
10397,10397,Bernardo Rosa,4225,2019,West Ham United,0,0,0,0,0,0,0,0,0,0,0,0,0,0,0,0,0,0,0,0,0,0,0,0,0,0,0,0,0,0
10398,10398,Moussa Dembélé,4226,2013,Fulham FC,1,1,0,81,0,0,1,0,1,7,0,0,2,1,1,88,0,0,0,0,0,0,0,0,0,0,0,0,0,0
10399,10399,Tyias Browning,3608,2013,Everton FC,0,0,0,0,0,0,0,0,0,0,0,0,0,0,0,0,0,0,0,0,0,0,0,0,0,0,0,0,0,0
10400,10400,Kyle Lafferty,4227,2015,Norwich City,1,0,1,13,0,0,0,0,0,0,0,0,1,0,1,13,0,0,0,0,0,0,0,0,0,0,0,0,0,0
10401,10401,Nya Kirby,4228,2019,Crystal Palace,0,0,0,0,0,0,0,0,0,0,0,0,0,0,0,0,0,0,0,0,0,0,0,0,0,0,0,0,0,0
10402,10402,Garry Monk,2808,2000,Southampton FC,2,2,0,158,0,0,0,0,0,0,0,0,2,2,0,158,0,0,0,0,0,0,0,0,0,0,0,0,0,0
10403,10403,Matthew Upson,1279,2000,Arsenal FC,0,0,0,0,0,0,2,0,2,16,0,0,2,0,2,16,0,0,0,0,0,0,0,0,0,0,0,0,0,0
10404,10404,Jean Makoun,3290,2011,Aston Villa,0,0,0,0,0,0,0,0,0,0,0,0,0,0,0,0,0,0,0,0,0,0,0,0,0,0,0,0,0,0
10405,10405,Henrik Larsson,4229,2006,Manchester United,3,1,2,131,1,0,4,4,0,328,0,0,7,5,2,459,1,0,0,0,0,0,0,0,0,0,0,0,0,0
10406,10406,Quincy Owusu-Abeyie,3336,2005,Arsenal FC,1,0,1,8,0,0,3,0,3,35,0,0,4,0,4,43,0,0,0,0,0,0,0,0,0,0,0,0,0,0
10407,10407,Benjani,1391,2009,Sunderland AFC,5,1,4,91,0,0,3,0,3,31,0,0,8,1,7,122,0,0,0,0,0,0,0,0,0,0,0,0,0,0
10408,10408,Stephen Howey,3305,2003,Leicester City,6,6,0,466,1,0,7,7,0,501,0,0,13,13,0,967,1,0,0,0,0,0,0,0,0,0,0,0,0,0
10409,10409,Emanuele Giaccherini,2263,2014,Sunderland AFC,3,1,2,130,0,0,5,1,4,174,0,0,8,2,6,304,0,0,0,0,0,0,0,0,0,0,0,0,0,0
10410,10410,Nathan Tella,4230,2019,Southampton FC,0,0,0,0,0,0,1,0,1,2,0,0,1,0,1,2,0,0,0,0,0,0,0,0,0,0,0,0,0,0
10411,10411,Jordan Slew,4231,2011,Blackburn Rovers,0,0,0,0,0,0,1,0,1,1,0,0,1,0,1,1,0,0,0,0,0,0,0,0,0,0,0,0,0,0
10412,10412,Paul Gerrard,2822,2001,Everton FC,8,8,0,720,0,0,5,5,0,450,0,0,13,13,0,1170,0,0,0,0,0,0,0,0,0,0,0,0,0,0
10413,10413,Mark Pembridge,1933,2001,Everton FC,7,4,3,388,1,0,7,6,1,452,0,0,14,10,4,840,1,0,0,0,0,0,0,0,0,0,0,0,0,0
10414,10414,Konstantinos Chalkias,4232,2004,Portsmouth FC,2,2,0,180,0,0,3,3,0,270,0,0,5,5,0,450,0,0,0,0,0,0,0,0,0,0,0,0,0,0
10415,10415,Gaël Kakuta,2651,2009,Chelsea FC,1,0,1,31,0,0,0,0,0,0,0,0,1,0,1,31,0,0,0,0,0,0,0,0,0,0,0,0,0,0
10416,10416,Fabio Borini,1777,2009,Chelsea FC,4,0,4,33,0,0,0,0,0,0,0,0,4,0,4,33,0,0,0,0,0,0,0,0,0,0,0,0,0,0
10417,10417,Séamus Coleman,1467,2009,Everton FC,2,0,2,95,0,0,1,0,1,10,0,0,3,0,3,105,0,0,0,0,0,0,0,0,0,0,0,0,0,0
10418,10418,Jose Baxter,2107,2009,Everton FC,2,0,2,4,0,0,0,0,0,0,0,0,2,0,2,4,0,0,0,0,0,0,0,0,0,0,0,0,0,0
10419,10419,Conor Sammon,2879,2010,Wigan Athletic,3,0,3,94,1,0,4,1,3,114,0,0,7,1,6,208,1,0,0,0,0,1,0,1,0,0,0,0,0,0
10420,10420,Thomas Gaardsøe,1598,2001,Ipswich Town,3,2,1,189,1,0,1,1,0,90,0,0,4,3,1,279,1,0,0,0,0,0,0,0,0,0,0,0,0,0
10421,10421,Michael Mancienne,2886,2008,Chelsea FC,1,1,0,81,0,0,3,1,2,95,0,0,4,2,2,176,0,0,0,0,0,0,0,0,0,0,0,0,0,0
10422,10422,Ricardo Quaresma,4233,2008,Chelsea FC,2,1,1,72,0,0,2,0,2,59,0,0,4,1,3,131,0,0,0,0,0,0,0,0,0,0,0,0,0,0
10423,10423,Piscu,3666,2010,Wigan Athletic,0,0,0,0,0,0,1,1,0,69,0,0,1,1,0,69,0,0,0,0,0,0,0,0,0,0,0,0,0,0
10424,10424,Joe Gomez,1180,2016,Liverpool FC,0,0,0,0,0,0,0,0,0,0,0,0,0,0,0,0,0,0,0,0,0,0,0,0,0,0,0,0,0,0
10425,10425,Rhian Brewster,4234,2016,Liverpool FC,0,0,0,0,0,0,0,0,0,0,0,0,0,0,0,0,0,0,0,0,0,0,0,0,0,0,0,0,0,0
10426,10426,Gary Madine,4235,2018,Cardiff City,3,0,3,17,0,0,2,0,2,15,0,0,5,0,5,32,0,0,0,0,0,0,0,0,0,0,0,0,0,0
10427,10427,Dean Kiely,2334,2008,West Bromwich Albion,2,2,0,180,0,0,1,1,0,90,0,0,3,3,0,270,0,0,0,0,0,0,0,0,0,0,0,0,0,0
10428,10428,Mauro Zárate,2504,2016,Watford FC,2,2,0,132,0,0,1,1,0,74,0,0,3,3,0,206,0,0,0,0,0,0,0,0,0,0,0,0,0,0
10429,10429,Giedrius Arlauskis,3183,2016,Watford FC,0,0,0,0,0,0,0,0,0,0,0,0,0,0,0,0,0,0,0,0,0,0,0,0,0,0,0,0,0,0
10430,10430,Lee Nicholls,4236,2010,Wigan Athletic,0,0,0,0,0,0,0,0,0,0,0,0,0,0,0,0,0,0,0,0,0,0,0,0,0,0,0,0,0,0
10431,10431,Thierry Henry,2357,2011,Arsenal FC,1,0,1,22,1,0,3,0,3,72,1,0,4,0,4,94,2,0,0,3,3,0,1,1,0,0,0,0,0,0
10432,10432,Peter Odemwingie,1551,2014,Stoke City,3,0,3,39,0,0,4,1,3,175,0,0,7,1,6,214,0,0,0,0,0,0,0,0,0,0,0,0,0,0
10433,10433,Maik Taylor,2501,2001,Fulham FC,1,0,1,9,0,0,1,1,0,90,0,0,2,1,1,99,0,0,0,0,0,0,0,0,0,0,0,0,0,0
10434,10434,Mario Espartero,4237,2001,Bolton Wanderers,0,0,0,0,0,0,3,0,3,56,0,0,3,0,3,56,0,0,0,0,0,0,0,0,0,0,0,0,0,0
10435,10435,Kelland Watts,4238,2019,Newcastle United,1,0,1,16,0,0,0,0,0,0,0,0,1,0,1,16,0,0,0,0,0,0,0,0,0,0,0,0,0,0
10436,10436,Mark Noble,2204,2005,West Ham United,2,1,1,96,0,0,3,3,0,229,0,0,5,4,1,325,0,0,0,0,0,0,0,0,0,0,0,0,0,0
10437,10437,Bradley Johnson,1373,2015,Norwich City,2,1,1,103,0,0,2,0,2,48,0,0,4,1,3,151,0,0,0,0,0,0,0,0,0,0,0,0,0,0
10438,10438,Gary Hooper,1377,2015,Norwich City,1,0,1,10,0,0,1,0,1,1,0,0,2,0,2,11,0,0,0,0,0,0,0,0,0,0,0,0,0,0
10439,10439,Jonathan Woodgate,1882,2010,Tottenham Hotspur,0,0,0,0,0,0,0,0,0,0,0,0,0,0,0,0,0,0,0,0,0,0,0,0,0,0,0,0,0,0
10440,10440,Louis Moult,4239,2009,Stoke City,0,0,0,0,0,0,1,0,1,5,0,0,1,0,1,5,0,0,0,0,0,0,0,0,0,0,0,0,0,0
10441,10441,Maurice Edu,4240,2012,Stoke City,0,0,0,0,0,0,1,0,1,10,0,0,1,0,1,10,0,0,0,0,0,0,0,0,0,0,0,0,0,0
10442,10442,Adil Nabi,4241,2014,West Bromwich Albion,0,0,0,0,0,0,0,0,0,0,0,0,0,0,0,0,0,0,0,0,0,0,0,0,0,0,0,0,0,0
10443,10443,Antoine Sibierski,1810,2008,Wigan Athletic,0,0,0,0,0,0,2,0,2,16,0,0,2,0,2,16,0,0,0,0,0,0,0,0,0,0,0,0,0,0
10444,10444,Giuseppe Rossi,3511,2005,Manchester United,4,1,3,119,0,0,1,0,1,12,1,0,5,1,4,131,1,0,0,0,0,0,0,0,0,0,0,0,0,0
10445,10445,Gonzalo Sorondo,3438,2005,Charlton Athletic,4,4,0,319,0,0,3,3,0,270,0,0,7,7,0,589,0,0,0,0,0,0,0,0,0,0,0,0,0,0
10446,10446,Osei Sankofa,3498,2005,Charlton Athletic,2,1,1,142,0,0,2,2,0,160,0,0,4,3,1,302,0,0,0,0,0,0,0,0,0,0,0,0,0,0
10447,10447,Lloyd Sam,4097,2005,Charlton Athletic,1,0,1,31,0,0,1,0,1,44,0,0,2,0,2,75,0,0,0,0,0,0,0,0,0,0,0,0,0,0
10448,10448,Enric Vallès,4242,2010,Birmingham City,0,0,0,0,0,0,0,0,0,0,0,0,0,0,0,0,0,0,0,0,0,0,0,0,0,0,0,0,0,0
10449,10449,Nathan Redmond,1244,2010,Birmingham City,0,0,0,0,0,0,0,0,0,0,0,0,0,0,0,0,0,0,0,0,0,0,0,0,0,0,0,0,0,0
10450,10450,Akwasi Asante,4243,2010,Birmingham City,0,0,0,0,0,0,0,0,0,0,0,0,0,0,0,0,0,0,0,0,0,0,0,0,0,0,0,0,0,0
10451,10451,Rory Donnelly,4244,2013,Swansea City,0,0,0,0,0,0,0,0,0,0,0,0,0,0,0,0,0,0,0,0,0,0,0,0,0,0,0,0,0,0
10452,10452,Sam Mantom,4245,2011,West Bromwich Albion,0,0,0,0,0,0,0,0,0,0,0,0,0,0,0,0,0,0,0,0,0,0,0,0,0,0,0,0,0,0
10453,10453,Lazar Marković,3249,2018,Fulham FC,0,0,0,0,0,0,1,0,1,44,0,0,1,0,1,44,0,0,0,0,0,0,0,0,0,0,0,0,0,0
10454,10454,Quinton Fortune,2782,2002,Manchester United,4,3,1,274,0,0,4,1,3,143,0,0,8,4,4,417,0,0,0,0,0,0,0,0,0,0,0,0,0,0
10455,10455,Scott Sinclair,1420,2006,Chelsea FC,1,1,0,53,0,0,1,0,1,10,0,0,2,1,1,63,0,0,0,0,0,0,0,0,0,0,0,0,0,0
10456,10456,David Healy,1567,2008,Sunderland AFC,6,0,6,94,1,0,4,0,4,49,0,0,10,0,10,143,1,0,0,0,0,0,0,0,0,0,0,0,0,0
10457,10457,Matt Mills,4246,2005,Manchester City,0,0,0,0,0,0,1,0,1,6,0,0,1,0,1,6,0,0,0,0,0,0,0,0,0,0,0,0,0,0
10458,10458,Curtis Davies,2224,2009,Aston Villa,1,1,0,90,0,0,1,1,0,90,1,0,2,2,0,180,1,0,0,0,0,0,0,0,0,0,0,0,0,0
10459,10459,Habib Beye,2173,2009,Aston Villa,3,3,0,248,0,0,3,2,1,198,0,0,6,5,1,446,0,0,0,0,0,0,0,0,0,0,0,0,0,0
10460,10460,Marc Albrighton,1448,2009,Aston Villa,3,0,3,58,0,0,0,0,0,0,0,0,3,0,3,58,0,0,0,0,0,0,0,0,0,0,0,0,0,0
10461,10461,Nathan Delfouneso,2175,2009,Aston Villa,6,0,6,136,0,0,3,0,3,53,1,0,9,0,9,189,1,0,0,3,3,0,1,1,0,0,0,0,0,0
10462,10462,Jimmy Kébé,3134,2007,Reading FC,1,0,1,33,0,0,4,1,3,111,0,0,5,1,4,144,0,0,0,0,0,0,0,0,0,0,0,0,0,0
10463,10463,Kasey Keller,1117,2001,Tottenham Hotspur,3,3,0,270,0,0,5,5,0,450,0,0,8,8,0,720,0,0,0,0,0,0,0,0,0,0,0,0,0,0
10464,10464,James Vaughan,3240,2005,Fulham FC,1,0,1,13,0,0,0,0,0,0,0,0,1,0,1,13,0,0,0,0,0,0,0,0,0,0,0,0,0,0
10465,10465,Bernard Diomède,4247,2000,Liverpool FC,1,1,0,72,0,0,1,0,1,36,0,0,2,1,1,108,0,0,0,0,0,0,0,0,0,0,0,0,0,0
10466,10466,Tyrone Mears,1572,2011,Bolton Wanderers,0,0,0,0,0,0,1,1,0,90,0,0,1,1,0,90,0,0,0,0,0,0,0,0,0,0,0,0,0,0
10467,10467,Hilário,2709,2012,Chelsea FC,0,0,0,0,0,0,0,0,0,0,0,0,0,0,0,0,0,0,0,0,0,0,0,0,0,0,0,0,0,0
10468,10468,Carlo Nash,3303,2013,Norwich City,0,0,0,0,0,0,0,0,0,0,0,0,0,0,0,0,0,0,0,0,0,0,0,0,0,0,0,0,0,0
10469,10469,Matt Worthington,4248,2016,AFC Bournemouth,0,0,0,0,0,0,1,0,1,16,0,0,1,0,1,16,0,0,0,0,0,0,0,0,0,0,0,0,0,0
10470,10470,Aaron Ramsdale,3339,2016,AFC Bournemouth,0,0,0,0,0,0,0,0,0,0,0,0,0,0,0,0,0,0,0,0,0,0,0,0,0,0,0,0,0,0
10471,10471,Sam Surridge,3940,2016,AFC Bournemouth,0,0,0,0,0,0,0,0,0,0,0,0,0,0,0,0,0,0,0,0,0,0,0,0,0,0,0,0,0,0
10472,10472,Ian Pearce,1082,2007,Fulham FC,0,0,0,0,0,0,1,0,1,35,0,0,1,0,1,35,0,0,0,0,0,0,0,0,0,0,0,0,0,0
10473,10473,Collins John,1089,2007,Fulham FC,1,0,1,11,0,0,1,0,1,25,0,0,2,0,2,36,0,0,0,0,0,0,0,0,0,0,0,0,0,0
10474,10474,Daniel Agger,1776,2007,Liverpool FC,2,2,0,180,0,0,3,2,1,254,0,0,5,4,1,434,0,0,0,0,0,0,0,0,0,0,0,0,0,0
10475,10475,Matt Miazga,4249,2015,Chelsea FC,0,0,0,0,0,0,2,2,0,136,0,0,2,2,0,136,0,0,0,0,0,0,0,0,0,0,0,0,0,0
10476,10476,Jake Clarke-Salter,4250,2015,Chelsea FC,0,0,0,0,0,0,1,0,1,16,0,0,1,0,1,16,0,0,0,0,0,0,0,0,0,0,0,0,0,0
10477,10477,Dionatan Teixeira,3872,2015,Stoke City,0,0,0,0,0,0,1,0,1,44,0,0,1,0,1,44,0,0,0,0,0,0,0,0,0,0,0,0,0,0
10478,10478,Fabio Daprelà,4251,2009,West Ham United,4,2,2,182,0,0,3,2,1,189,0,0,7,4,3,371,0,0,0,0,0,0,0,0,0,0,0,0,0,0
10479,10479,Josh Morris,3719,2011,Blackburn Rovers,0,0,0,0,0,0,2,0,2,79,0,0,2,0,2,79,0,0,0,0,0,0,0,0,0,0,0,0,0,0
10480,10480,Danny Hay,4252,2000,Leeds United,2,0,2,119,0,0,2,2,0,180,0,0,4,2,2,299,0,0,0,0,0,0,0,0,0,0,0,0,0,0
10481,10481,Jacob Burns,4253,2000,Leeds United,2,2,0,180,0,0,2,1,1,117,0,0,4,3,1,297,0,0,0,0,0,0,0,0,0,0,0,0,0,0
10482,10482,Adam Johnson,1405,2006,Middlesbrough FC,5,2,3,201,0,0,7,1,6,147,0,0,12,3,9,348,0,0,0,0,0,0,0,0,0,0,0,0,0,0
10483,10483,Jason McCarthy,4254,2014,Southampton FC,0,0,0,0,0,0,1,0,1,3,0,0,1,0,1,3,0,0,0,0,0,0,0,0,0,0,0,0,0,0
10484,10484,Emmanuel Olisadebe,4255,2005,Portsmouth FC,1,0,1,29,0,0,1,0,1,37,0,0,2,0,2,66,0,0,0,0,0,0,0,0,0,0,0,0,0,0
10485,10485,Adrian Mutu,2371,2004,Chelsea FC,0,0,0,0,0,0,2,0,2,49,0,0,2,0,2,49,0,0,0,0,0,0,0,0,0,0,0,0,0,0
10486,10486,Fraser Forster,1240,2018,Southampton FC,0,0,0,0,0,0,1,1,0,90,0,0,1,1,0,90,0,0,0,0,0,0,0,0,0,0,0,0,0,0
10487,10487,Alfie Jones,4256,2018,Southampton FC,0,0,0,0,0,0,0,0,0,0,0,0,0,0,0,0,0,0,0,0,0,0,0,0,0,0,0,0,0,0
10488,10488,Demeaco Duhaney,4257,2018,Huddersfield Town,1,1,0,46,0,0,0,0,0,0,0,0,1,1,0,46,0,0,0,0,0,0,0,0,0,0,0,0,0,0
10489,10489,Ross Turnbull,2217,2009,Chelsea FC,1,1,0,90,0,0,1,1,0,90,0,0,2,2,0,180,0,0,0,0,0,0,0,0,0,0,0,0,0,0
10490,10490,Kieron Dyer,2033,2009,West Ham United,4,1,3,136,0,0,6,3,3,222,0,0,10,4,6,358,0,0,0,0,0,0,0,0,0,0,0,0,0,0
10491,10491,James Coppinger,4258,2000,Newcastle United,1,0,1,11,0,0,0,0,0,0,0,0,1,0,1,11,0,0,0,0,0,0,0,0,0,0,0,0,0,0
10492,10492,James Wilson,2378,2015,Manchester United,0,0,0,0,0,0,1,0,1,8,0,0,1,0,1,8,0,0,0,0,0,0,0,0,0,0,0,0,0,0
10493,10493,Alan O'Brien,4157,2004,Newcastle United,1,1,0,90,0,0,0,0,0,0,0,0,1,1,0,90,0,0,0,0,0,0,0,0,0,0,0,0,0,0
10494,10494,Steve Harper,2231,2004,Newcastle United,1,1,0,90,0,0,1,1,0,90,0,0,2,2,0,180,0,0,0,0,0,0,0,0,0,0,0,0,0,0
10495,10495,Darren Ward,4220,2004,Norwich City,0,0,0,0,0,0,1,0,1,27,0,0,1,0,1,27,0,0,0,0,0,0,0,0,0,0,0,0,0,0
10496,10496,Harry Winks,1857,2013,Tottenham Hotspur,0,0,0,0,0,0,0,0,0,0,0,0,0,0,0,0,0,0,0,0,0,0,0,0,0,0,0,0,0,0
10497,10497,Johann Vogel,3117,2007,Blackburn Rovers,3,3,0,237,0,0,3,3,0,231,0,0,6,6,0,468,0,0,0,0,0,0,0,0,0,0,0,0,0,0
10498,10498,Anderson,2018,2006,Everton FC,1,0,1,2,0,0,0,0,0,0,0,0,1,0,1,2,0,0,0,0,0,0,0,0,0,0,0,0,0,0
10499,10499,Ishmel Demontagnac,4259,2010,Blackpool FC,0,0,0,0,0,0,1,0,1,33,0,0,1,0,1,33,0,0,0,0,0,0,0,0,0,0,0,0,0,0
10500,10500,Greg Cunningham,3152,2009,Manchester City,1,0,1,1,0,0,1,0,1,1,0,0,2,0,2,2,0,0,0,0,0,0,0,0,0,0,0,0,0,0
10501,10501,Jack Collison,1285,2010,West Ham United,2,1,1,116,0,0,1,1,0,84,0,0,3,2,1,200,0,0,0,0,0,0,0,0,0,0,0,0,0,0
10502,10502,Mauro Fórmica,3422,2010,Blackburn Rovers,0,0,0,0,0,0,0,0,0,0,0,0,0,0,0,0,0,0,0,0,0,0,0,0,0,0,0,0,0,0
10503,10503,Alexander Sørloth,2703,2017,Crystal Palace,2,2,0,180,0,0,2,2,0,180,0,0,4,4,0,360,0,0,0,0,0,0,0,0,0,0,0,0,0,0
10504,10504,Paulo Gazzaniga,1156,2017,Tottenham Hotspur,1,1,0,90,0,0,0,0,0,0,0,0,1,1,0,90,0,0,0,0,0,0,0,0,0,0,0,0,0,0
10505,10505,Alfie Whiteman,3399,2017,Tottenham Hotspur,0,0,0,0,0,0,0,0,0,0,0,0,0,0,0,0,0,0,0,0,0,0,0,0,0,0,0,0,0,0
10506,10506,Benjamin Mendy,2674,2018,Manchester City,5,5,0,450,0,0,5,5,0,450,0,0,10,10,0,900,0,0,0,0,0,0,0,0,0,0,0,0,0,0
10507,10507,Mark Gower,2810,2012,Swansea City,0,0,0,0,0,0,1,0,1,6,0,0,1,0,1,6,0,0,0,0,0,0,0,0,0,0,0,0,0,0
10508,10508,Stephen Dobbie,3175,2012,Swansea City,0,0,0,0,0,0,0,0,0,0,0,0,0,0,0,0,0,0,0,0,0,0,0,0,0,0,0,0,0,0
10509,10509,Nicky Maynard,3460,2012,West Ham United,0,0,0,0,0,0,0,0,0,0,0,0,0,0,0,0,0,0,0,0,0,0,0,0,0,0,0,0,0,0
10510,10510,Martin Hansen,4260,2010,Liverpool FC,0,0,0,0,0,0,0,0,0,0,0,0,0,0,0,0,0,0,0,0,0,0,0,0,0,0,0,0,0,0
10511,10511,Declan Rice,2206,2016,West Ham United,0,0,0,0,0,0,1,0,1,1,0,0,1,0,1,1,0,0,0,0,0,0,0,0,0,0,0,0,0,0
10512,10512,Tony McMahon,1332,2007,Middlesbrough FC,1,0,1,15,0,0,0,0,0,0,0,0,1,0,1,15,0,0,0,0,0,0,0,0,0,0,0,0,0,0
10513,10513,Yıldıray Baştürk,4261,2009,Blackburn Rovers,0,0,0,0,0,0,1,1,0,46,0,0,1,1,0,46,0,0,0,0,0,0,0,0,0,0,0,0,0,0
10514,10514,Jacopo Sala,4262,2010,Chelsea FC,0,0,0,0,0,0,0,0,0,0,0,0,0,0,0,0,0,0,0,0,0,0,0,0,0,0,0,0,0,0
10515,10515,Nico Vaesen,2619,2005,Birmingham City,2,2,0,180,0,0,2,2,0,180,0,0,4,4,0,360,0,0,0,0,0,0,0,0,0,0,0,0,0,0
10516,10516,Kevin Gibbens,4263,2000,Southampton FC,1,0,1,1,0,0,2,1,1,72,0,0,3,1,2,73,0,0,0,0,0,0,0,0,0,0,0,0,0,0
10517,10517,Simon Lappin,4264,2011,Norwich City,2,2,0,136,0,0,2,2,0,156,0,0,4,4,0,292,0,0,0,0,0,0,0,0,0,0,0,0,0,0
10518,10518,Iain Turner,3933,2005,Everton FC,2,2,0,180,0,0,1,0,1,36,0,0,3,2,1,216,0,0,0,0,0,0,0,0,0,0,0,0,0,0
10519,10519,Victor Anichebe,1751,2005,Everton FC,2,0,2,29,1,0,0,0,0,0,0,0,2,0,2,29,1,0,0,0,0,0,0,0,0,0,0,0,0,0
10520,10520,Williams Martínez,4265,2005,West Bromwich Albion,0,0,0,0,0,0,2,1,1,135,1,0,2,1,1,135,1,0,0,0,0,0,0,0,0,0,0,0,0,0
10521,10521,Jared Hodgkiss,4266,2005,West Bromwich Albion,0,0,0,0,0,0,1,0,1,27,0,0,1,0,1,27,0,0,0,0,0,0,0,0,0,0,0,0,0,0
10522,10522,Grant McCann,4267,2001,West Ham United,1,0,1,7,0,0,2,0,2,65,0,0,3,0,3,72,0,0,0,0,0,0,0,0,0,0,0,0,0,0
10523,10523,Alan Maybury,4268,2001,Leeds United,0,0,0,0,0,0,1,0,1,15,0,0,1,0,1,15,0,0,0,0,0,0,0,0,0,0,0,0,0,0
10524,10524,Doneil Henry,4269,2015,West Ham United,0,0,0,0,0,0,0,0,0,0,0,0,0,0,0,0,0,0,0,0,0,0,0,0,0,0,0,0,0,0
10525,10525,Lamine Koné,3136,2015,Sunderland AFC,8,8,0,685,2,0,7,7,0,630,0,0,15,15,0,1315,2,0,0,0,0,0,0,0,0,0,0,0,0,0
10526,10526,Jan Kirchhoff,3552,2015,Sunderland AFC,8,8,0,561,0,0,7,6,1,523,0,0,15,14,1,1084,0,0,0,0,0,0,0,0,0,0,0,0,0,0
10527,10527,Wahbi Khazri,3137,2015,Sunderland AFC,8,7,1,641,2,0,6,6,0,437,0,0,14,13,1,1078,2,0,0,0,0,2,0,2,0,0,0,0,0,0
10528,10528,Dame N'Doye,3176,2015,Sunderland AFC,5,2,3,218,1,0,6,3,3,349,0,0,11,5,6,567,1,0,0,0,0,1,0,1,0,0,0,0,0,0
10529,10529,Jordan Pickford,1046,2015,Sunderland AFC,0,0,0,0,0,0,2,2,0,180,0,0,2,2,0,180,0,0,0,0,0,0,0,0,0,0,0,0,0,0
10530,10530,Mark Yeates,4144,2003,Tottenham Hotspur,0,0,0,0,0,0,1,1,0,90,0,0,1,1,0,90,0,0,0,0,0,0,0,0,0,0,0,0,0,0
10531,10531,Alex Dobre,4270,2019,AFC Bournemouth,0,0,0,0,0,0,0,0,0,0,0,0,0,0,0,0,0,0,0,0,0,0,0,0,0,0,0,0,0,0
10532,10532,Federico Bessone,4271,2011,Swansea City,1,0,1,4,0,0,0,0,0,0,0,0,1,0,1,4,0,0,0,0,0,0,0,0,0,0,0,0,0,0
10533,10533,Bjørn Helge Riise,3294,2011,Fulham FC,0,0,0,0,0,0,0,0,0,0,0,0,0,0,0,0,0,0,0,0,0,0,0,0,0,0,0,0,0,0
10534,10534,Chris Herd,3040,2014,Aston Villa,0,0,0,0,0,0,0,0,0,0,0,0,0,0,0,0,0,0,0,0,0,0,0,0,0,0,0,0,0,0
10535,10535,Steve Simonsen,2918,2009,Stoke City,2,1,1,139,0,0,1,1,0,90,0,0,3,2,1,229,0,0,0,0,0,0,0,0,0,0,0,0,0,0
10536,10536,Gaël Clichy,1230,2005,Arsenal FC,2,1,1,97,0,0,4,3,1,278,0,0,6,4,2,375,0,0,0,0,0,0,0,0,0,0,0,0,0,0
10537,10537,Ben Alnwick,4272,2005,Sunderland AFC,3,3,0,270,0,0,2,2,0,180,0,0,5,5,0,450,0,0,0,0,0,0,0,0,0,0,0,0,0,0
10538,10538,Michael Johnson,3030,2008,Manchester City,1,1,0,90,0,0,1,1,0,81,0,0,2,2,0,171,0,0,0,0,0,0,0,0,0,0,0,0,0,0
10539,10539,Darron Gibson,2538,2008,Manchester United,2,0,2,48,0,0,1,1,0,90,1,0,3,1,2,138,1,0,0,3,3,0,1,1,0,0,0,0,0,0
10540,10540,Robert Milsom,4273,2008,Fulham FC,0,0,0,0,0,0,1,0,1,10,0,0,1,0,1,10,0,0,0,0,0,0,0,0,0,0,0,0,0,0
10541,10541,Wayne Brown,3924,2008,Fulham FC,0,0,0,0,0,0,1,0,1,4,0,0,1,0,1,4,0,0,0,0,0,0,0,0,0,0,0,0,0,0
10542,10542,Harry Winks,1857,2015,Tottenham Hotspur,0,0,0,0,0,0,0,0,0,0,0,0,0,0,0,0,0,0,0,0,0,0,0,0,0,0,0,0,0,0
10543,10543,Kostas Konstantinidis,4274,2001,Bolton Wanderers,1,1,0,90,0,0,2,2,0,149,0,0,3,3,0,239,0,0,0,0,0,0,0,0,0,0,0,0,0,0
10544,10544,Brian Murphy,2168,2014,Queens Park Rangers,0,0,0,0,0,0,0,0,0,0,0,0,0,0,0,0,0,0,0,0,0,0,0,0,0,0,0,0,0,0
10545,10545,Lennard Sowah,4275,2009,Portsmouth FC,3,2,1,206,0,0,2,1,1,134,0,0,5,3,2,340,0,0,0,0,0,0,0,0,0,0,0,0,0,0
10546,10546,Joel Ward,1019,2009,Portsmouth FC,2,0,2,54,0,0,1,1,0,90,0,0,3,1,2,144,0,0,0,0,0,0,0,0,0,0,0,0,0,0
10547,10547,Matt Ritchie,1008,2009,Portsmouth FC,1,0,1,2,0,0,1,1,0,80,0,0,2,1,1,82,0,0,0,0,0,0,0,0,0,0,0,0,0,0
10548,10548,Danny Welbeck,1506,2008,Manchester United,2,0,2,29,1,0,1,1,0,87,0,0,3,1,2,116,1,0,0,0,0,0,0,0,0,0,0,0,0,0
10549,10549,Matt Oakley,1573,2003,Southampton FC,4,4,0,360,0,0,3,3,0,270,0,0,7,7,0,630,0,0,0,0,0,0,0,0,0,0,0,0,0,0
10550,10550,Campabadal,4276,2012,Wigan Athletic,1,0,1,2,0,0,0,0,0,0,0,0,1,0,1,2,0,0,0,0,0,0,0,0,0,0,0,0,0,0
10551,10551,Conor Masterson,4277,2017,Liverpool FC,0,0,0,0,0,0,0,0,0,0,0,0,0,0,0,0,0,0,0,0,0,0,0,0,0,0,0,0,0,0
10552,10552,Curtis Jones,2310,2017,Liverpool FC,0,0,0,0,0,0,0,0,0,0,0,0,0,0,0,0,0,0,0,0,0,0,0,0,0,0,0,0,0,0
10553,10553,Timothy Fosu-Mensah,2255,2019,Manchester United,1,1,0,46,0,0,2,1,1,91,0,0,3,2,1,137,0,0,0,0,0,0,0,0,0,0,0,0,0,0
10554,10554,Stuart Taylor,1684,2017,Southampton FC,0,0,0,0,0,0,0,0,0,0,0,0,0,0,0,0,0,0,0,0,0,0,0,0,0,0,0,0,0,0
10555,10555,Luton Shelton,4278,2006,Sheffield United,0,0,0,0,0,0,4,2,2,201,0,0,4,2,2,201,0,0,0,0,0,0,0,0,0,0,0,0,0,0
10556,10556,Oliver Shenton,2383,2015,Stoke City,0,0,0,0,0,0,0,0,0,0,0,0,0,0,0,0,0,0,0,0,0,0,0,0,0,0,0,0,0,0
10557,10557,Jos Hooiveld,2869,2014,Southampton FC,0,0,0,0,0,0,0,0,0,0,0,0,0,0,0,0,0,0,0,0,0,0,0,0,0,0,0,0,0,0
10558,10558,Jack Stephens,2329,2014,Southampton FC,0,0,0,0,0,0,0,0,0,0,0,0,0,0,0,0,0,0,0,0,0,0,0,0,0,0,0,0,0,0
10559,10559,Saphir Taïder,4279,2014,Southampton FC,0,0,0,0,0,0,0,0,0,0,0,0,0,0,0,0,0,0,0,0,0,0,0,0,0,0,0,0,0,0
10560,10560,Damien Johnson,2503,2001,Blackburn Rovers,4,4,0,306,1,0,2,2,0,125,0,0,6,6,0,431,1,0,0,0,0,0,0,0,0,0,0,0,0,0
10561,10561,Ravel Morrison,3419,2019,Sheffield United,1,0,1,12,0,0,0,0,0,0,0,0,1,0,1,12,0,0,0,0,0,0,0,0,0,0,0,0,0,0
10562,10562,James Collins,1618,2007,West Ham United,2,2,0,180,0,0,1,0,1,18,0,0,3,2,1,198,0,0,0,0,0,0,0,0,0,0,0,0,0,0
10563,10563,Andrew Davies,2295,2007,Middlesbrough FC,1,1,0,90,0,0,3,2,1,187,0,0,4,3,1,277,0,0,0,0,0,0,0,0,0,0,0,0,0,0
10564,10564,Sam Sodje,4280,2006,Reading FC,0,0,0,0,0,0,3,2,1,190,0,0,3,2,1,190,0,0,0,0,0,0,0,0,0,0,0,0,0,0
10565,10565,Marcos Alonso,1846,2010,Bolton Wanderers,1,1,0,90,0,0,3,3,0,270,0,0,4,4,0,360,0,0,0,0,0,0,0,0,0,0,0,0,0,0
10566,10566,Nick Barmby,2133,2003,Leeds United,3,1,2,111,0,0,3,0,3,39,0,0,6,1,5,150,0,0,0,0,0,0,0,0,0,0,0,0,0,0
10567,10567,Cyril Chapuis,4281,2003,Leeds United,1,0,1,44,0,0,0,0,0,0,0,0,1,0,1,44,0,0,0,0,0,0,0,0,0,0,0,0,0,0
10568,10568,Scott Sinclair,1420,2007,Chelsea FC,1,0,1,14,0,0,0,0,0,0,0,0,1,0,1,14,0,0,0,0,0,0,0,0,0,0,0,0,0,0
10569,10569,Javier Hernández,2257,2019,West Ham United,1,0,1,24,0,0,1,1,0,83,1,0,2,1,1,107,1,0,0,0,0,0,1,1,0,0,0,0,0,0
10570,10570,Lee Roche,4282,2002,Manchester United,1,0,1,21,0,0,0,0,0,0,0,0,1,0,1,21,0,0,0,0,0,0,0,0,0,0,0,0,0,0
10571,10571,Kieran Richardson,1898,2002,Manchester United,2,0,2,41,0,0,0,0,0,0,0,0,2,0,2,41,0,0,0,0,0,0,0,0,0,0,0,0,0,0
10572,10572,Jamal Campbell-Ryce,3920,2002,Charlton Athletic,0,0,0,0,0,0,1,0,1,4,0,0,1,0,1,4,0,0,0,0,0,0,0,0,0,0,0,0,0,0
10573,10573,Johan Cavalli,4283,2006,Watford FC,2,1,1,73,0,0,1,1,0,75,0,0,3,2,1,148,0,0,0,0,0,0,0,0,0,0,0,0,0,0
10574,10574,Sam Winnall,4284,2010,Wolverhampton Wanderers,0,0,0,0,0,0,0,0,0,0,0,0,0,0,0,0,0,0,0,0,0,0,0,0,0,0,0,0,0,0
10575,10575,Anthony Gardner,1120,2008,Hull City,3,3,0,270,0,0,3,3,0,270,0,0,6,6,0,540,0,0,0,0,0,0,0,0,0,0,0,0,0,0
10576,10576,Oguchi Onyewu,4285,2006,Newcastle United,5,4,1,377,0,0,6,3,3,367,0,0,11,7,4,744,0,0,0,0,0,0,0,0,0,0,0,0,0,0
10577,10577,Luque,2713,2006,Newcastle United,4,0,4,41,0,0,2,0,2,21,0,0,6,0,6,62,0,0,0,0,0,0,0,0,0,0,0,0,0,0
10578,10578,Marc Guehi,4286,2019,Chelsea FC,0,0,0,0,0,0,0,0,0,0,0,0,0,0,0,0,0,0,0,0,0,0,0,0,0,0,0,0,0,0
10579,10579,Steven Reid,1140,2009,Blackburn Rovers,3,1,2,107,0,0,1,0,1,17,0,0,4,1,3,124,0,0,0,0,0,0,0,0,0,0,0,0,0,0
10580,10580,Toni Kallio,2037,2009,Fulham FC,0,0,0,0,0,0,1,0,1,44,0,0,1,0,1,44,0,0,0,0,0,0,0,0,0,0,0,0,0,0
10581,10581,Marc Guehi,4286,2018,Chelsea FC,0,0,0,0,0,0,0,0,0,0,0,0,0,0,0,0,0,0,0,0,0,0,0,0,0,0,0,0,0,0
10582,10582,Richard Wright,2977,2012,Manchester City,0,0,0,0,0,0,0,0,0,0,0,0,0,0,0,0,0,0,0,0,0,0,0,0,0,0,0,0,0,0
10583,10583,Nicola Ventola,4287,2004,Crystal Palace,2,0,2,56,1,0,1,0,1,20,0,0,3,0,3,76,1,0,0,0,0,1,0,1,0,0,0,0,0,0
10584,10584,David N'Gog,1895,2013,Swansea City,1,0,1,17,0,0,2,0,2,26,0,0,3,0,3,43,0,0,0,0,0,0,0,0,0,0,0,0,0,0
10585,10585,Philippe Senderos,1228,2010,Fulham FC,1,1,0,90,0,0,2,2,0,180,0,0,3,3,0,270,0,0,0,0,0,0,0,0,0,0,0,0,0,0
10586,10586,Artim Shakiri,4288,2004,West Bromwich Albion,1,1,0,75,0,0,2,1,1,104,0,0,3,2,1,179,0,0,0,0,0,0,0,0,0,0,0,0,0,0
10587,10587,Tony Hibbert,1744,2001,Everton FC,4,2,2,202,0,0,6,5,1,348,0,0,10,7,3,550,0,0,0,0,0,0,0,0,0,0,0,0,0,0
10588,10588,Daniel Braaten,4289,2007,Bolton Wanderers,1,0,1,15,1,0,5,0,5,129,0,0,6,0,6,144,1,0,0,0,0,0,0,0,0,0,0,0,0,0
10589,10589,Nick Chadwick,4174,2001,Everton FC,4,1,3,146,3,0,5,1,4,76,0,0,9,2,7,222,3,0,0,0,0,1,0,1,0,0,0,0,0,0
10590,10590,Lloyd Isgrove,3533,2016,Southampton FC,0,0,0,0,0,0,0,0,0,0,0,0,0,0,0,0,0,0,0,0,0,0,0,0,0,0,0,0,0,0
10591,10591,Tomas Danilevičius,4290,2000,Arsenal FC,1,0,1,11,0,0,1,0,1,26,0,0,2,0,2,37,0,0,0,0,0,0,0,0,0,0,0,0,0,0
10592,10592,Steve Simonsen,2918,2000,Everton FC,1,0,1,1,0,0,0,0,0,0,0,0,1,0,1,1,0,0,0,0,0,0,0,0,0,0,0,0,0,0
10593,10593,Miroslav Stoch,4291,2008,Chelsea FC,3,0,3,19,0,0,1,0,1,5,0,0,4,0,4,24,0,0,0,0,0,0,0,0,0,0,0,0,0,0
10594,10594,Craig Fagan,1576,2002,Birmingham City,0,0,0,0,0,0,1,0,1,9,0,0,1,0,1,9,0,0,0,0,0,0,0,0,0,0,0,0,0,0
10595,10595,Andy Oakes,3354,2004,Bolton Wanderers,1,1,0,90,0,0,0,0,0,0,0,0,1,1,0,90,0,0,0,0,0,0,0,0,0,0,0,0,0,0
10596,10596,Owen Hargreaves,3313,2010,Manchester United,1,1,0,9,0,0,0,0,0,0,0,0,1,1,0,9,0,0,0,0,0,0,0,0,0,0,0,0,0,0
10597,10597,Moreira,4292,2011,Swansea City,0,0,0,0,0,0,0,0,0,0,0,0,0,0,0,0,0,0,0,0,0,0,0,0,0,0,0,0,0,0
10598,10598,Kenji Gorré,4293,2015,Swansea City,0,0,0,0,0,0,0,0,0,0,0,0,0,0,0,0,0,0,0,0,0,0,0,0,0,0,0,0,0,0
10599,10599,Cesc Fàbregas,1526,2018,Chelsea FC,4,0,4,73,0,0,2,1,1,102,0,0,6,1,5,175,0,0,0,0,0,0,0,0,0,0,0,0,0,0
10600,10600,Idan Tal,1721,2001,Everton FC,3,0,3,77,0,0,4,1,3,110,0,0,7,1,6,187,0,0,0,0,0,0,0,0,0,0,0,0,0,0
10601,10601,Paul Okon,2070,2001,Middlesbrough FC,1,0,1,20,0,0,3,1,2,79,0,0,4,1,3,99,0,0,0,0,0,0,0,0,0,0,0,0,0,0
10602,10602,Hámilton Ricard,2073,2001,Middlesbrough FC,3,2,1,187,0,0,6,4,2,318,0,0,9,6,3,505,0,0,0,0,0,0,0,0,0,0,0,0,0,0
10603,10603,Hilário,2709,2008,Chelsea FC,1,1,0,90,0,0,0,0,0,0,0,0,1,1,0,90,0,0,0,0,0,0,0,0,0,0,0,0,0,0
10604,10604,Jason Brown,3748,2008,Blackburn Rovers,2,2,0,180,0,0,2,1,1,134,0,0,4,3,1,314,0,0,0,0,0,0,0,0,0,0,0,0,0,0
10605,10605,Daniel Redmond,4294,2012,Wigan Athletic,0,0,0,0,0,0,0,0,0,0,0,0,0,0,0,0,0,0,0,0,0,0,0,0,0,0,0,0,0,0
10606,10606,Ed de Goey,3051,2002,Chelsea FC,1,1,0,90,0,0,1,1,0,90,0,0,2,2,0,180,0,0,0,0,0,0,0,0,0,0,0,0,0,0
10607,10607,Jamie Slabber,4295,2002,Tottenham Hotspur,1,0,1,11,0,0,0,0,0,0,0,0,1,0,1,11,0,0,0,0,0,0,0,0,0,0,0,0,0,0
10608,10608,Stuart Taylor,1684,2007,Aston Villa,2,1,1,114,0,0,2,2,0,180,0,0,4,3,1,294,0,0,0,0,0,0,0,0,0,0,0,0,0,0
10609,10609,Nathan Eccleston,4296,2010,Liverpool FC,0,0,0,0,0,0,1,0,1,10,0,0,1,0,1,10,0,0,0,0,0,0,0,0,0,0,0,0,0,0
10610,10610,Will Ferry,4297,2019,Southampton FC,0,0,0,0,0,0,0,0,0,0,0,0,0,0,0,0,0,0,0,0,0,0,0,0,0,0,0,0,0,0
10611,10611,Daniel Amartey,2666,2018,Leicester City,5,3,2,307,0,0,4,4,0,333,0,0,9,7,2,640,0,0,0,0,0,0,0,0,0,0,0,0,0,0
10612,10612,Cameron Dummigan,4298,2014,Burnley FC,0,0,0,0,0,0,0,0,0,0,0,0,0,0,0,0,0,0,0,0,0,0,0,0,0,0,0,0,0,0
10613,10613,Fernando Torres,1539,2014,Chelsea FC,0,0,0,0,0,0,0,0,0,0,0,0,0,0,0,0,0,0,0,0,0,0,0,0,0,0,0,0,0,0
10614,10614,Russell Hoult,1315,2005,West Bromwich Albion,0,0,0,0,0,0,1,0,1,29,0,0,1,0,1,29,0,0,0,0,0,0,0,0,0,0,0,0,0,0
10615,10615,Massimo Luongo,4299,2011,Tottenham Hotspur,0,0,0,0,0,0,0,0,0,0,0,0,0,0,0,0,0,0,0,0,0,0,0,0,0,0,0,0,0,0
10616,10616,Cameron Lancaster,4300,2011,Tottenham Hotspur,1,0,1,12,0,0,0,0,0,0,0,0,1,0,1,12,0,0,0,0,0,0,0,0,0,0,0,0,0,0
10617,10617,Dedryck Boyata,1679,2009,Manchester City,2,0,2,35,0,0,1,1,0,90,0,0,3,1,2,125,0,0,0,0,0,0,0,0,0,0,0,0,0,0
10618,10618,Sam Johnstone,3408,2012,Manchester United,0,0,0,0,0,0,0,0,0,0,0,0,0,0,0,0,0,0,0,0,0,0,0,0,0,0,0,0,0,0
10619,10619,Jesse Lingard,1646,2014,Manchester United,1,1,0,24,0,0,0,0,0,0,0,0,1,1,0,24,0,0,0,0,0,0,0,0,0,0,0,0,0,0
10620,10620,Nani,2258,2014,Manchester United,1,0,1,44,0,0,0,0,0,0,0,0,1,0,1,44,0,0,0,0,0,0,0,0,0,0,0,0,0,0
10621,10621,Josh Sheehan,4301,2014,Swansea City,0,0,0,0,0,0,0,0,0,0,0,0,0,0,0,0,0,0,0,0,0,0,0,0,0,0,0,0,0,0
10622,10622,Stefan Moore,3065,2004,Aston Villa,2,0,2,19,0,0,0,0,0,0,0,0,2,0,2,19,0,0,0,0,0,0,0,0,0,0,0,0,0,0
10623,10623,Lee Carsley,1803,2005,Everton FC,2,1,1,101,0,0,3,2,1,196,0,0,5,3,2,297,0,0,0,0,0,0,0,0,0,0,0,0,0,0
10624,10624,Calum Davenport,1394,2005,Tottenham Hotspur,2,1,1,93,0,0,2,0,2,11,0,0,4,1,3,104,0,0,0,0,0,0,0,0,0,0,0,0,0,0
10625,10625,Jon Otsemobor,4302,2003,Liverpool FC,2,2,0,180,0,0,2,2,0,118,0,0,4,4,0,298,0,0,0,0,0,0,0,0,0,0,0,0,0,0
10626,10626,Tony Hibbert,1744,2000,Everton FC,1,0,1,45,0,0,1,0,1,9,0,0,2,0,2,54,0,0,0,0,0,0,0,0,0,0,0,0,0,0
10627,10627,Axel Tuanzebe,3211,2015,Manchester United,0,0,0,0,0,0,0,0,0,0,0,0,0,0,0,0,0,0,0,0,0,0,0,0,0,0,0,0,0,0
10628,10628,Cristian Gamboa,3568,2015,West Bromwich Albion,0,0,0,0,0,0,1,0,1,27,0,0,1,0,1,27,0,0,0,0,0,0,0,0,0,0,0,0,0,0
10629,10629,Tyler Roberts,4303,2015,West Bromwich Albion,1,0,1,17,0,0,0,0,0,0,0,0,1,0,1,17,0,0,0,0,0,0,0,0,0,0,0,0,0,0
10630,10630,Lloyd Isgrove,3533,2013,Southampton FC,0,0,0,0,0,0,0,0,0,0,0,0,0,0,0,0,0,0,0,0,0,0,0,0,0,0,0,0,0,0
10631,10631,Fraser Forster,1240,2011,Newcastle United,0,0,0,0,0,0,0,0,0,0,0,0,0,0,0,0,0,0,0,0,0,0,0,0,0,0,0,0,0,0
10632,10632,Vegard Heggem,4304,2000,West Ham United,1,0,1,18,0,0,0,0,0,0,0,0,1,0,1,18,0,0,0,0,0,0,0,0,0,0,0,0,0,0
10633,10633,Jerzy Dudek,2899,2006,Liverpool FC,1,1,0,90,0,0,1,1,0,90,0,0,2,2,0,180,0,0,0,0,0,0,0,0,0,0,0,0,0,0
10634,10634,Jack Wilshere,1694,2008,Arsenal FC,0,0,0,0,0,0,1,0,1,6,0,0,1,0,1,6,0,0,0,0,0,0,0,0,0,0,0,0,0,0
10635,10635,Ian Bennett,2580,2003,Birmingham City,2,2,0,180,0,0,4,2,2,281,0,0,6,4,2,461,0,0,0,0,0,0,0,0,0,0,0,0,0,0
10636,10636,Johan Djourou,1229,2009,Arsenal FC,1,0,1,28,0,0,0,0,0,0,0,0,1,0,1,28,0,0,0,0,0,0,0,0,0,0,0,0,0,0
10637,10637,Henri Lansbury,2851,2009,Arsenal FC,1,0,1,13,0,0,0,0,0,0,0,0,1,0,1,13,0,0,0,0,0,0,0,0,0,0,0,0,0,0
10638,10638,Fredrik Stoor,3563,2009,Fulham FC,0,0,0,0,0,0,2,0,2,24,0,0,2,0,2,24,0,0,0,0,0,0,0,0,0,0,0,0,0,0
10639,10639,Ki-hyeon Seol,1563,2009,Fulham FC,0,0,0,0,0,0,2,0,2,3,0,0,2,0,2,3,0,0,0,0,0,0,0,0,0,0,0,0,0,0
10640,10640,Serge Gnabry,2943,2015,West Bromwich Albion,1,0,1,12,0,0,0,0,0,0,0,0,1,0,1,12,0,0,0,0,0,0,0,0,0,0,0,0,0,0
10641,10641,César Martín,4305,2006,Bolton Wanderers,0,0,0,0,0,0,1,0,1,1,0,0,1,0,1,1,0,0,0,0,0,0,0,0,0,0,0,0,0,0
10642,10642,Lloyd Dyer,3881,2015,Watford FC,0,0,0,0,0,0,0,0,0,0,0,0,0,0,0,0,0,0,0,0,0,0,0,0,0,0,0,0,0,0
10643,10643,Leroy Lita,2593,2012,Swansea City,0,0,0,0,0,0,0,0,0,0,0,0,0,0,0,0,0,0,0,0,0,0,0,0,0,0,0,0,0,0
10644,10644,Kelly Youga,4306,2006,Charlton Athletic,0,0,0,0,0,0,1,1,0,90,0,0,1,1,0,90,0,0,0,0,0,0,0,0,0,0,0,0,0,0
10645,10645,Loïc Rémy,2455,2016,Crystal Palace,3,1,2,108,0,0,2,0,2,23,0,0,5,1,4,131,0,0,0,0,0,0,0,0,0,0,0,0,0,0
10646,10646,Gary Cahill,1533,2018,Chelsea FC,1,0,1,1,0,0,1,0,1,21,0,0,2,0,2,22,0,0,0,0,0,0,0,0,0,0,0,0,0,0
10647,10647,Patrick van Aanholt,2254,2011,Wigan Athletic,1,1,0,90,0,0,2,2,0,180,0,0,3,3,0,270,0,0,0,0,0,0,0,0,0,0,0,0,0,0
10648,10648,Tom Carroll,2816,2011,Tottenham Hotspur,0,0,0,0,0,0,0,0,0,0,0,0,0,0,0,0,0,0,0,0,0,0,0,0,0,0,0,0,0,0
10649,10649,Peter Canero,4307,2003,Leicester City,3,1,2,133,0,0,4,1,3,108,0,0,7,2,5,241,0,0,0,0,0,0,0,0,0,0,0,0,0,0
10650,10650,Nuno Morais,4074,2006,Chelsea FC,2,0,2,19,0,0,0,0,0,0,0,0,2,0,2,19,0,0,0,0,0,0,0,0,0,0,0,0,0,0
10651,10651,Sam Hutchinson,3894,2006,Chelsea FC,1,0,1,1,0,0,0,0,0,0,0,0,1,0,1,1,0,0,0,0,0,0,0,0,0,0,0,0,0,0
10652,10652,Ben Sahar,4308,2006,Chelsea FC,3,0,3,65,0,0,0,0,0,0,0,0,3,0,3,65,0,0,0,0,0,0,0,0,0,0,0,0,0,0
10653,10653,Harry Wilson,3341,2016,Liverpool FC,0,0,0,0,0,0,0,0,0,0,0,0,0,0,0,0,0,0,0,0,0,0,0,0,0,0,0,0,0,0
10654,10654,Branko Strupar,3451,2001,Derby County,5,3,2,261,2,0,6,4,2,316,2,0,11,7,4,577,4,0,0,0,0,0,1,1,0,0,0,0,0,0
10655,10655,Steven Elliott,4165,2001,Derby County,2,0,2,15,0,0,3,2,1,113,0,0,5,2,3,128,0,0,0,0,0,0,0,0,0,0,0,0,0,0
10656,10656,Leigh Griffiths,4309,2010,Wolverhampton Wanderers,0,0,0,0,0,0,0,0,0,0,0,0,0,0,0,0,0,0,0,0,0,0,0,0,0,0,0,0,0,0
10657,10657,Caoimhin Kelleher,4310,2019,Liverpool FC,0,0,0,0,0,0,0,0,0,0,0,0,0,0,0,0,0,0,0,0,0,0,0,0,0,0,0,0,0,0
10658,10658,Nathan Holland,2211,2018,West Ham United,0,0,0,0,0,0,0,0,0,0,0,0,0,0,0,0,0,0,0,0,0,0,0,0,0,0,0,0,0,0
10659,10659,Alan Blayney,4311,2003,Southampton FC,1,1,0,90,0,0,1,1,0,90,0,0,2,2,0,180,0,0,0,0,0,0,0,0,0,0,0,0,0,0
10660,10660,Alan O'Brien,4157,2006,Newcastle United,1,1,0,90,0,0,1,0,1,23,0,0,2,1,1,113,0,0,0,0,0,0,0,0,0,0,0,0,0,0
10661,10661,Carlo Nash,3303,2010,Stoke City,0,0,0,0,0,0,0,0,0,0,0,0,0,0,0,0,0,0,0,0,0,0,0,0,0,0,0,0,0,0
10662,10662,Tom Soares,1991,2010,Stoke City,0,0,0,0,0,0,0,0,0,0,0,0,0,0,0,0,0,0,0,0,0,0,0,0,0,0,0,0,0,0
10663,10663,Michael Tonge,1997,2010,Stoke City,1,0,1,1,0,0,1,0,1,23,0,0,2,0,2,24,0,0,0,0,0,0,0,0,0,0,0,0,0,0
10664,10664,Jo Tessem,2696,2003,Southampton FC,3,1,2,118,0,0,0,0,0,0,0,0,3,1,2,118,0,0,0,0,0,0,0,0,0,0,0,0,0,0
10665,10665,Stephan Andersen,3225,2004,Charlton Athletic,1,1,0,90,0,0,0,0,0,0,0,0,1,1,0,90,0,0,0,0,0,0,0,0,0,0,0,0,0,0
10666,10666,Olufela Olomola,4312,2015,Southampton FC,0,0,0,0,0,0,0,0,0,0,0,0,0,0,0,0,0,0,0,0,0,0,0,0,0,0,0,0,0,0
10667,10667,Mikael Mandron,4024,2015,Sunderland AFC,0,0,0,0,0,0,0,0,0,0,0,0,0,0,0,0,0,0,0,0,0,0,0,0,0,0,0,0,0,0
10668,10668,Jon Harley,3053,2003,Fulham FC,2,1,1,136,0,0,1,1,0,90,0,0,3,2,1,226,0,0,0,0,0,0,0,0,0,0,0,0,0,0
10669,10669,John Welsh,4139,2003,Liverpool FC,1,0,1,8,0,0,0,0,0,0,0,0,1,0,1,8,0,0,0,0,0,0,0,0,0,0,0,0,0,0
10670,10670,Brian Deane,2072,2003,Leicester City,3,0,3,78,0,0,2,0,2,37,0,0,5,0,5,115,0,0,0,0,0,0,0,0,0,0,0,0,0,0
10671,10671,Neil Danns,4186,2002,Blackburn Rovers,2,1,1,46,0,0,0,0,0,0,0,0,2,1,1,46,0,0,0,0,0,0,0,0,0,0,0,0,0,0
10672,10672,Dean Windass,2814,2002,Middlesbrough FC,0,0,0,0,0,0,1,0,1,13,0,0,1,0,1,13,0,0,0,0,0,0,0,0,0,0,0,0,0,0
10673,10673,Suso,3811,2014,Liverpool FC,0,0,0,0,0,0,0,0,0,0,0,0,0,0,0,0,0,0,0,0,0,0,0,0,0,0,0,0,0,0
10674,10674,Charlie Rowan,4313,2016,Watford FC,0,0,0,0,0,0,0,0,0,0,0,0,0,0,0,0,0,0,0,0,0,0,0,0,0,0,0,0,0,0
10675,10675,Carl Stewart,4314,2016,Watford FC,0,0,0,0,0,0,0,0,0,0,0,0,0,0,0,0,0,0,0,0,0,0,0,0,0,0,0,0,0,0
10676,10676,Jeremain Lens,2819,2016,Sunderland AFC,1,0,1,44,0,0,1,0,1,23,0,0,2,0,2,67,0,0,0,0,0,0,0,0,0,0,0,0,0,0
10677,10677,Frédéric Nimani,4315,2009,Burnley FC,0,0,0,0,0,0,2,0,2,44,0,0,2,0,2,44,0,0,0,0,0,0,0,0,0,0,0,0,0,0
10678,10678,Sam McQueen,1246,2014,Southampton FC,0,0,0,0,0,0,0,0,0,0,0,0,0,0,0,0,0,0,0,0,0,0,0,0,0,0,0,0,0,0
10679,10679,Fredrik Stoor,3563,2008,Fulham FC,0,0,0,0,0,0,2,0,2,52,0,0,2,0,2,52,0,0,0,0,0,0,0,0,0,0,0,0,0,0
10680,10680,Alec Chamberlain,4316,2006,Watford FC,1,0,1,1,0,0,0,0,0,0,0,0,1,0,1,1,0,0,0,0,0,0,0,0,0,0,0,0,0,0
10681,10681,Theo Robinson,4317,2006,Watford FC,1,0,1,3,0,0,0,0,0,0,0,0,1,0,1,3,0,0,0,0,0,0,0,0,0,0,0,0,0,0
10682,10682,Michael Owen,1949,2006,Newcastle United,1,1,0,90,0,0,2,2,0,157,0,0,3,3,0,247,0,0,0,0,0,0,0,0,0,0,0,0,0,0
10683,10683,Matt Targett,1158,2013,Southampton FC,0,0,0,0,0,0,0,0,0,0,0,0,0,0,0,0,0,0,0,0,0,0,0,0,0,0,0,0,0,0
10684,10684,Jérémie Boga,4318,2014,Chelsea FC,0,0,0,0,0,0,0,0,0,0,0,0,0,0,0,0,0,0,0,0,0,0,0,0,0,0,0,0,0,0
10685,10685,Dominic Solanke,1194,2014,Chelsea FC,0,0,0,0,0,0,0,0,0,0,0,0,0,0,0,0,0,0,0,0,0,0,0,0,0,0,0,0,0,0
10686,10686,Jordan Pickford,1046,2014,Sunderland AFC,0,0,0,0,0,0,0,0,0,0,0,0,0,0,0,0,0,0,0,0,0,0,0,0,0,0,0,0,0,0
10687,10687,Tomasz Kuszczak,1786,2011,Manchester United,0,0,0,0,0,0,0,0,0,0,0,0,0,0,0,0,0,0,0,0,0,0,0,0,0,0,0,0,0,0
10688,10688,Will Keane,2381,2011,Manchester United,1,0,1,5,0,0,0,0,0,0,0,0,1,0,1,5,0,0,0,0,0,0,0,0,0,0,0,0,0,0
10689,10689,Collins Mbesuma,4319,2005,Portsmouth FC,2,0,2,18,0,0,2,0,2,33,0,0,4,0,4,51,0,0,0,0,0,0,0,0,0,0,0,0,0,0
10690,10690,Steve De Ridder,4320,2012,Southampton FC,3,0,3,45,0,0,1,0,1,3,0,0,4,0,4,48,0,0,0,0,0,0,0,0,0,0,0,0,0,0
10691,10691,Mat Sadler,3634,2005,Birmingham City,4,4,0,360,0,0,4,4,0,360,0,0,8,8,0,720,0,0,0,0,0,0,0,0,0,0,0,0,0,0
10692,10692,Alexis Nicolas,4321,2003,Chelsea FC,2,1,1,91,0,0,0,0,0,0,0,0,2,1,1,91,0,0,0,0,0,0,0,0,0,0,0,0,0,0
10693,10693,Paul Gallagher,1142,2005,Blackburn Rovers,1,0,1,10,0,0,0,0,0,0,0,0,1,0,1,10,0,0,0,0,0,0,0,0,0,0,0,0,0,0
10694,10694,Luke McGee,4322,2016,Tottenham Hotspur,0,0,0,0,0,0,0,0,0,0,0,0,0,0,0,0,0,0,0,0,0,0,0,0,0,0,0,0,0,0
10695,10695,Chris Gunter,2506,2008,Tottenham Hotspur,1,1,0,55,0,0,2,1,1,74,0,0,3,2,1,129,0,0,0,0,0,0,0,0,0,0,0,0,0,0
10696,10696,Garry Monk,2808,2002,Charlton Athletic,1,1,0,66,0,0,0,0,0,0,0,0,1,1,0,66,0,0,0,0,0,0,0,0,0,0,0,0,0,0
10697,10697,Lee Lucas,4323,2011,Swansea City,0,0,0,0,0,0,0,0,0,0,0,0,0,0,0,0,0,0,0,0,0,0,0,0,0,0,0,0,0,0
10698,10698,Mamady Sidibe,1994,2011,Stoke City,0,0,0,0,0,0,0,0,0,0,0,0,0,0,0,0,0,0,0,0,0,0,0,0,0,0,0,0,0,0
10699,10699,Stuart Holden,2529,2009,Bolton Wanderers,2,1,1,115,0,0,0,0,0,0,0,0,2,1,1,115,0,0,0,0,0,0,0,0,0,0,0,0,0,0
10700,10700,Angel Gomes,3278,2018,Manchester United,2,0,2,25,0,0,0,0,0,0,0,0,2,0,2,25,0,0,0,0,0,0,0,0,0,0,0,0,0,0
10701,10701,Danny Higginbotham,1990,2011,Stoke City,1,1,0,90,0,0,1,0,1,21,0,0,2,1,1,111,0,0,0,0,0,0,0,0,0,0,0,0,0,0
10702,10702,Sean Goss,4324,2015,Manchester United,0,0,0,0,0,0,0,0,0,0,0,0,0,0,0,0,0,0,0,0,0,0,0,0,0,0,0,0,0,0
10703,10703,Matty Pattison,3510,2005,Newcastle United,1,1,0,80,0,0,1,1,0,68,0,0,2,2,0,148,0,0,0,0,0,0,0,0,0,0,0,0,0,0
10704,10704,Luciano Figueroa,4325,2003,Birmingham City,1,0,1,3,0,0,0,0,0,0,0,0,1,0,1,3,0,0,0,0,0,0,0,0,0,0,0,0,0,0
10705,10705,Jon Stanković,3215,2017,Huddersfield Town,0,0,0,0,0,0,0,0,0,0,0,0,0,0,0,0,0,0,0,0,0,0,0,0,0,0,0,0,0,0
10706,10706,Daniele Padelli,4326,2006,Liverpool FC,1,1,0,90,0,0,0,0,0,0,0,0,1,1,0,90,0,0,0,0,0,0,0,0,0,0,0,0,0,0
10707,10707,Darren Randolph,2637,2006,Charlton Athletic,0,0,0,0,0,0,1,1,0,90,0,0,1,1,0,90,0,0,0,0,0,0,0,0,0,0,0,0,0,0
10708,10708,Lloyd Sam,4097,2006,Charlton Athletic,3,1,2,106,0,0,4,2,2,184,0,0,7,3,4,290,0,0,0,0,0,0,0,0,0,0,0,0,0,0
10709,10709,Anthony Grant,4327,2004,Chelsea FC,0,0,0,0,0,0,1,0,1,1,0,0,1,0,1,1,0,0,0,0,0,0,0,0,0,0,0,0,0,0
10710,10710,Max Sanders,4328,2018,Brighton & Hove Albion,0,0,0,0,0,0,0,0,0,0,0,0,0,0,0,0,0,0,0,0,0,0,0,0,0,0,0,0,0,0
10711,10711,Josh Benson,3757,2018,Burnley FC,0,0,0,0,0,0,0,0,0,0,0,0,0,0,0,0,0,0,0,0,0,0,0,0,0,0,0,0,0,0
10712,10712,Martin Kelly,1034,2009,Liverpool FC,1,0,1,20,0,0,0,0,0,0,0,0,1,0,1,20,0,0,0,0,0,0,0,0,0,0,0,0,0,0
10713,10713,Jack Rose,3000,2015,West Bromwich Albion,0,0,0,0,0,0,0,0,0,0,0,0,0,0,0,0,0,0,0,0,0,0,0,0,0,0,0,0,0,0
10714,10714,Brown Ideye,2999,2015,West Bromwich Albion,0,0,0,0,0,0,0,0,0,0,0,0,0,0,0,0,0,0,0,0,0,0,0,0,0,0,0,0,0,0
10715,10715,Brek Shea,3641,2013,Stoke City,0,0,0,0,0,0,1,0,1,31,0,0,1,0,1,31,0,0,0,0,0,0,0,0,0,0,0,0,0,0
10716,10716,Léandre Griffit,4198,2004,Southampton FC,2,0,2,32,0,0,0,0,0,0,0,0,2,0,2,32,0,0,0,0,0,0,0,0,0,0,0,0,0,0
10717,10717,Dan Potts,4163,2013,West Ham United,0,0,0,0,0,0,0,0,0,0,0,0,0,0,0,0,0,0,0,0,0,0,0,0,0,0,0,0,0,0
10718,10718,Daniel Johnson,2599,2013,Aston Villa,0,0,0,0,0,0,0,0,0,0,0,0,0,0,0,0,0,0,0,0,0,0,0,0,0,0,0,0,0,0
10719,10719,Andy Morrison,4329,2000,Manchester City,2,2,0,126,0,0,1,1,0,90,0,0,3,3,0,216,0,0,0,0,0,0,0,0,0,0,0,0,0,0
10720,10720,Danny Allsopp,4330,2000,West Ham United,1,0,1,15,0,0,0,0,0,0,0,0,1,0,1,15,0,0,0,0,0,0,0,0,0,0,0,0,0,0
10721,10721,Dael Fry,4331,2016,Middlesbrough FC,0,0,0,0,0,0,0,0,0,0,0,0,0,0,0,0,0,0,0,0,0,0,0,0,0,0,0,0,0,0
10722,10722,Andrew Davies,2295,2008,Stoke City,1,0,1,16,0,0,1,0,1,32,0,0,2,0,2,48,0,0,0,0,0,0,0,0,0,0,0,0,0,0
10723,10723,Will Norris,4332,2018,Wolverhampton Wanderers,1,0,1,1,0,0,0,0,0,0,0,0,1,0,1,1,0,0,0,0,0,0,0,0,0,0,0,0,0,0
10724,10724,Michael Johnson,3030,2009,Manchester City,1,0,1,1,0,0,0,0,0,0,0,0,1,0,1,1,0,0,0,0,0,0,0,0,0,0,0,0,0,0
10725,10725,Jemal Johnson,4333,2005,Blackburn Rovers,2,0,2,4,0,0,1,0,1,9,0,0,3,0,3,13,0,0,0,0,0,0,0,0,0,0,0,0,0,0
10726,10726,Alex Palmer,3860,2014,West Bromwich Albion,0,0,0,0,0,0,0,0,0,0,0,0,0,0,0,0,0,0,0,0,0,0,0,0,0,0,0,0,0,0
10727,10727,Tyler Roberts,4303,2014,West Bromwich Albion,0,0,0,0,0,0,0,0,0,0,0,0,0,0,0,0,0,0,0,0,0,0,0,0,0,0,0,0,0,0
10728,10728,Jamie McMaster,4334,2002,Leeds United,2,0,2,10,0,0,2,0,2,39,0,0,4,0,4,49,0,0,0,0,0,0,0,0,0,0,0,0,0,0
10729,10729,Tobias Linderoth,2797,2002,Everton FC,1,0,1,35,0,0,4,2,2,261,0,0,5,2,3,296,0,0,0,0,0,0,0,0,0,0,0,0,0,0
10730,10730,Glen Little,2595,2003,Bolton Wanderers,2,0,2,18,0,0,2,0,2,12,0,0,4,0,4,30,0,0,0,0,0,0,0,0,0,0,0,0,0,0
10731,10731,Jardel,4335,2003,Bolton Wanderers,3,0,3,80,0,0,4,0,4,79,0,0,7,0,7,159,0,0,0,0,0,0,0,0,0,0,0,0,0,0
10732,10732,Tommy Smith,2121,2013,Cardiff City,0,0,0,0,0,0,0,0,0,0,0,0,0,0,0,0,0,0,0,0,0,0,0,0,0,0,0,0,0,0
10733,10733,Neil Mellor,3391,2002,Liverpool FC,1,1,0,60,0,0,2,0,2,41,0,0,3,1,2,101,0,0,0,0,0,0,0,0,0,0,0,0,0,0
10734,10734,Jon Walters,1555,2002,Bolton Wanderers,4,0,4,36,0,0,0,0,0,0,0,0,4,0,4,36,0,0,0,0,0,0,0,0,0,0,0,0,0,0
10735,10735,Imants Bleidelis,4336,2001,Southampton FC,1,0,1,1,0,0,0,0,0,0,0,0,1,0,1,1,0,0,0,0,0,0,0,0,0,0,0,0,0,0
10736,10736,Matt Le Tissier,4034,2001,Southampton FC,2,0,2,20,0,0,2,0,2,25,0,0,4,0,4,45,0,0,0,0,0,0,0,0,0,0,0,0,0,0
10737,10737,Sander Westerveld,2687,2001,Liverpool FC,0,0,0,0,0,0,1,1,0,90,0,0,1,1,0,90,0,0,0,0,0,0,0,0,0,0,0,0,0,0
10738,10738,Markus Babbel,2688,2001,Liverpool FC,1,1,0,45,0,0,1,1,0,46,0,0,2,2,0,91,0,0,0,0,0,0,0,0,0,0,0,0,0,0
10739,10739,Erik Hagen,4337,2007,Wigan Athletic,0,0,0,0,0,0,1,1,0,73,0,0,1,1,0,73,0,0,0,0,0,0,0,0,0,0,0,0,0,0
10740,10740,Ronnie Wallwork,1600,2001,Manchester United,1,0,1,8,0,0,0,0,0,0,0,0,1,0,1,8,0,0,0,0,0,0,0,0,0,0,0,0,0,0
10741,10741,Ricky van Wolfswinkel,3674,2015,Norwich City,0,0,0,0,0,0,0,0,0,0,0,0,0,0,0,0,0,0,0,0,0,0,0,0,0,0,0,0,0,0
10742,10742,Jonathan Grounds,4077,2008,Middlesbrough FC,1,1,0,54,0,0,1,1,0,90,0,0,2,2,0,144,0,0,0,0,0,0,0,0,0,0,0,0,0,0
10743,10743,Gwion Edwards,4338,2011,Swansea City,0,0,0,0,0,0,0,0,0,0,0,0,0,0,0,0,0,0,0,0,0,0,0,0,0,0,0,0,0,0
10744,10744,Eddie Johnson,3295,2007,Fulham FC,3,2,1,194,0,0,3,2,1,189,0,0,6,4,2,383,0,0,0,0,0,0,0,0,0,0,0,0,0,0
10745,10745,Mart Poom,3370,2002,Sunderland AFC,1,1,0,90,0,0,3,3,0,270,0,0,4,4,0,360,0,0,0,0,0,0,0,0,0,0,0,0,0,0
10746,10746,Jonjo Dickman,4339,2002,Sunderland AFC,0,0,0,0,0,0,1,0,1,44,0,0,1,0,1,44,0,0,0,0,0,0,0,0,0,0,0,0,0,0
10747,10747,Markus Babbel,2688,2002,Liverpool FC,1,1,0,90,0,0,1,1,0,45,0,0,2,2,0,135,0,0,0,0,0,0,0,0,0,0,0,0,0,0
10748,10748,Darren Bent,1958,2001,Ipswich Town,4,1,3,160,1,0,1,1,0,69,0,0,5,2,3,229,1,0,3,0,3,1,0,1,0,0,0,0,0,0
10749,10749,Stewart Downing,1335,2001,Middlesbrough FC,1,0,1,45,0,0,2,2,0,156,0,0,3,2,1,201,0,0,0,0,0,0,0,0,0,0,0,0,0,0
10750,10750,Mark Hudson,2970,2001,Middlesbrough FC,1,0,1,1,0,0,1,0,1,4,0,0,2,0,2,5,0,0,0,0,0,0,0,0,0,0,0,0,0,0
10751,10751,Martyn Waghorn,4094,2007,Sunderland AFC,1,1,0,90,0,0,2,0,2,15,0,0,3,1,2,105,0,0,0,0,0,0,0,0,0,0,0,0,0,0
10752,10752,Jindřich Staněk,4340,2015,Everton FC,0,0,0,0,0,0,0,0,0,0,0,0,0,0,0,0,0,0,0,0,0,0,0,0,0,0,0,0,0,0
10753,10753,Nathan Eccleston,4296,2011,Liverpool FC,0,0,0,0,0,0,0,0,0,0,0,0,0,0,0,0,0,0,0,0,0,0,0,0,0,0,0,0,0,0
10754,10754,Kaine Hayden,4341,2019,Aston Villa,0,0,0,0,0,0,0,0,0,0,0,0,0,0,0,0,0,0,0,0,0,0,0,0,0,0,0,0,0,0
10755,10755,Ulrich Le Pen,4342,2001,Ipswich Town,1,0,1,11,0,0,0,0,0,0,0,0,1,0,1,11,0,0,0,0,0,0,0,0,0,0,0,0,0,0
10756,10756,Juan Cuadrado,3420,2015,Chelsea FC,0,0,0,0,0,0,1,0,1,26,0,0,1,0,1,26,0,0,0,0,0,0,0,0,0,0,0,0,0,0
10757,10757,Wayne Routledge,1758,2008,Aston Villa,0,0,0,0,0,0,1,0,1,17,0,0,1,0,1,17,0,0,0,0,0,0,0,0,0,0,0,0,0,0
10758,10758,Emmanuel Mayuka,2872,2013,Southampton FC,0,0,0,0,0,0,0,0,0,0,0,0,0,0,0,0,0,0,0,0,0,0,0,0,0,0,0,0,0,0
10759,10759,Josh Vickers,4343,2015,Swansea City,0,0,0,0,0,0,0,0,0,0,0,0,0,0,0,0,0,0,0,0,0,0,0,0,0,0,0,0,0,0
10760,10760,Boško Balaban,4344,2001,Aston Villa,4,0,4,76,0,0,4,0,4,54,0,0,8,0,8,130,0,0,0,0,0,0,0,0,0,0,0,0,0,0
10761,10761,Emerson Hyndman,3938,2017,AFC Bournemouth,0,0,0,0,0,0,1,1,0,59,0,0,1,1,0,59,0,0,0,0,0,0,0,0,0,0,0,0,0,0
10762,10762,Connor Mahoney,4345,2017,AFC Bournemouth,0,0,0,0,0,0,0,0,0,0,0,0,0,0,0,0,0,0,0,0,0,0,0,0,0,0,0,0,0,0
10763,10763,Jed Steer,1447,2012,Norwich City,0,0,0,0,0,0,0,0,0,0,0,0,0,0,0,0,0,0,0,0,0,0,0,0,0,0,0,0,0,0
10764,10764,Trevor Sinclair,1628,2004,Manchester City,2,2,0,153,1,0,2,0,2,41,0,0,4,2,2,194,1,0,0,0,0,0,0,0,0,0,0,0,0,0
10765,10765,Sébastien Puygrenier,4346,2008,Bolton Wanderers,4,2,2,171,1,0,3,3,0,209,0,0,7,5,2,380,1,0,0,0,0,1,0,1,0,0,0,0,0,0
10766,10766,David Cornell,3839,2013,Swansea City,0,0,0,0,0,0,0,0,0,0,0,0,0,0,0,0,0,0,0,0,0,0,0,0,0,0,0,0,0,0
10767,10767,Lasse Vigen,4347,2013,Fulham FC,0,0,0,0,0,0,0,0,0,0,0,0,0,0,0,0,0,0,0,0,0,0,0,0,0,0,0,0,0,0
10768,10768,Chung-yong Lee,2126,2011,Bolton Wanderers,1,0,1,8,0,0,1,0,1,9,0,0,2,0,2,17,0,0,0,0,0,0,0,0,0,0,0,0,0,0
10769,10769,Scott Allan,4348,2011,West Bromwich Albion,0,0,0,0,0,0,0,0,0,0,0,0,0,0,0,0,0,0,0,0,0,0,0,0,0,0,0,0,0,0
10770,10770,Raúl Meireles,2992,2012,Chelsea FC,2,1,1,94,0,0,1,0,1,7,0,0,3,1,2,101,0,0,0,0,0,0,0,0,0,0,0,0,0,0
10771,10771,Michael Essien,1763,2012,Chelsea FC,0,0,0,0,0,0,0,0,0,0,0,0,0,0,0,0,0,0,0,0,0,0,0,0,0,0,0,0,0,0
10772,10772,Andreas Weimann,1441,2010,Aston Villa,1,0,1,4,0,0,0,0,0,0,0,0,1,0,1,4,0,0,0,0,0,0,0,0,0,0,0,0,0,0
10773,10773,Alessandro Diamanti,1287,2010,West Ham United,0,0,0,0,0,0,1,0,1,16,0,0,1,0,1,16,0,0,0,0,0,0,0,0,0,0,0,0,0,0
10774,10774,Rory Donnelly,4244,2012,Swansea City,0,0,0,0,0,0,0,0,0,0,0,0,0,0,0,0,0,0,0,0,0,0,0,0,0,0,0,0,0,0
10775,10775,Kevin Kyle,1636,2000,Sunderland AFC,1,0,1,21,0,0,2,0,2,38,0,0,3,0,3,59,0,0,0,0,0,0,0,0,0,0,0,0,0,0
10776,10776,Oubiña,4349,2007,Birmingham City,1,0,1,5,0,0,1,1,0,13,0,0,2,1,1,18,0,0,0,0,0,0,0,0,0,0,0,0,0,0
10777,10777,Anthony Gardner,1120,2007,Tottenham Hotspur,2,2,0,180,1,0,2,2,0,180,0,0,4,4,0,360,1,0,0,0,0,1,0,1,0,0,0,0,0,0
10778,10778,Titi Camara,3949,2000,West Ham United,2,1,1,96,0,0,4,4,0,297,0,0,6,5,1,393,0,0,0,0,0,0,0,0,0,0,0,0,0,0
10779,10779,Dwight McNeil,2349,2017,Burnley FC,1,0,1,1,0,0,0,0,0,0,0,0,1,0,1,1,0,0,0,0,0,0,0,0,0,0,0,0,0,0
10780,10780,Djair Parfitt-Williams,4350,2015,West Ham United,0,0,0,0,0,0,0,0,0,0,0,0,0,0,0,0,0,0,0,0,0,0,0,0,0,0,0,0,0,0
10781,10781,Ahmed Fathi,4351,2006,Sheffield United,2,1,1,108,0,0,1,1,0,90,0,0,3,2,1,198,0,0,0,0,0,0,0,0,0,0,0,0,0,0
10782,10782,Martin Djetou,1079,2005,Bolton Wanderers,0,0,0,0,0,0,3,1,2,94,0,0,3,1,2,94,0,0,0,0,0,0,0,0,0,0,0,0,0,0
10783,10783,Ryan Bennett,1382,2011,Norwich City,4,4,0,360,0,0,4,4,0,360,0,0,8,8,0,720,0,0,0,0,0,0,0,0,0,0,0,0,0,0
10784,10784,Jonny Howson,1374,2011,Norwich City,5,5,0,437,1,0,6,6,0,512,0,0,11,11,0,949,1,0,0,0,0,1,0,1,0,0,0,0,0,0
10785,10785,Vladimir Stojković,4352,2009,Wigan Athletic,2,2,0,180,0,0,2,2,0,180,0,0,4,4,0,360,0,0,0,0,0,0,0,0,0,0,0,0,0,0
10786,10786,Philippe Senderos,1228,2009,Everton FC,1,0,1,1,0,0,1,1,0,90,0,0,2,1,1,91,0,0,0,0,0,0,0,0,0,0,0,0,0,0
10787,10787,Johnnie Jackson,3392,2004,Tottenham Hotspur,5,3,2,260,0,0,3,0,3,13,0,0,8,3,5,273,0,0,0,0,0,0,0,0,0,0,0,0,0,0
10788,10788,Julien Faubert,1283,2007,West Ham United,5,3,2,263,0,0,2,1,1,82,0,0,7,4,3,345,0,0,0,0,0,0,0,0,0,0,0,0,0,0
10789,10789,John Eustace,2101,2002,Middlesbrough FC,0,0,0,0,0,0,1,0,1,3,0,0,1,0,1,3,0,0,0,0,0,0,0,0,0,0,0,0,0,0
10790,10790,Abdeslam Ouaddou,3848,2001,Fulham FC,2,2,0,180,0,0,5,2,3,204,0,0,7,4,3,384,0,0,0,0,0,0,0,0,0,0,0,0,0,0
10791,10791,Matthew Kennedy,4353,2012,Everton FC,0,0,0,0,0,0,0,0,0,0,0,0,0,0,0,0,0,0,0,0,0,0,0,0,0,0,0,0,0,0
10792,10792,Erik Edman,2196,2007,Wigan Athletic,3,3,0,270,0,0,2,2,0,131,0,0,5,5,0,401,0,0,0,0,0,0,0,0,0,0,0,0,0,0
10793,10793,Thomas James,4354,2013,Cardiff City,1,0,1,1,0,0,0,0,0,0,0,0,1,0,1,1,0,0,0,0,0,0,0,0,0,0,0,0,0,0
10794,10794,Rhys Healey,3154,2013,Cardiff City,1,0,1,13,0,0,0,0,0,0,0,0,1,0,1,13,0,0,0,0,0,0,0,0,0,0,0,0,0,0
10795,10795,Nathan Aké,1037,2013,Chelsea FC,0,0,0,0,0,0,1,0,1,11,0,0,1,0,1,11,0,0,0,0,0,0,0,0,0,0,0,0,0,0
10796,10796,John Swift,4355,2013,Chelsea FC,0,0,0,0,0,0,1,0,1,1,0,0,1,0,1,1,0,0,0,0,0,0,0,0,0,0,0,0,0,0
10797,10797,Scott McDonald,4356,2001,Southampton FC,1,0,1,13,0,0,1,0,1,14,0,0,2,0,2,27,0,0,0,0,0,0,0,0,0,0,0,0,0,0
10798,10798,Glen Little,2595,2008,Portsmouth FC,3,3,0,178,0,0,2,1,1,115,0,0,5,4,1,293,0,0,0,0,0,0,0,0,0,0,0,0,0,0
10799,10799,Alan Blayney,4311,2004,Southampton FC,1,1,0,90,0,0,0,0,0,0,0,0,1,1,0,90,0,0,0,0,0,0,0,0,0,0,0,0,0,0
10800,10800,Ignasi Miquel,3275,2012,Arsenal FC,0,0,0,0,0,0,1,0,1,3,0,0,1,0,1,3,0,0,0,0,0,0,0,0,0,0,0,0,0,0
10801,10801,Miloš Veljković,4357,2013,Tottenham Hotspur,2,0,2,29,0,0,0,0,0,0,0,0,2,0,2,29,0,0,0,0,0,0,0,0,0,0,0,0,0,0
10802,10802,Amine Linganzi,4358,2010,Blackburn Rovers,0,0,0,0,0,0,1,0,1,38,0,0,1,0,1,38,0,0,0,0,0,0,0,0,0,0,0,0,0,0
10803,10803,Aaron Doran,3624,2010,Blackburn Rovers,0,0,0,0,0,0,0,0,0,0,0,0,0,0,0,0,0,0,0,0,0,0,0,0,0,0,0,0,0,0
10804,10804,Ryan Taylor,2341,2012,Newcastle United,0,0,0,0,0,0,1,0,1,27,0,0,1,0,1,27,0,0,0,0,0,0,0,0,0,0,0,0,0,0
10805,10805,Younès Kaboul,2408,2012,Tottenham Hotspur,0,0,0,0,0,0,1,1,0,90,0,0,1,1,0,90,0,0,0,0,0,0,0,0,0,0,0,0,0,0
10806,10806,Rafael van der Vaart,2405,2012,Tottenham Hotspur,1,1,0,62,0,0,1,0,1,22,0,0,2,1,1,84,0,0,0,0,0,0,0,0,0,0,0,0,0,0
10807,10807,Carlo Cudicini,2370,2012,Tottenham Hotspur,0,0,0,0,0,0,0,0,0,0,0,0,0,0,0,0,0,0,0,0,0,0,0,0,0,0,0,0,0,0
10808,10808,Tosin Adarabioyo,2778,2016,Manchester City,0,0,0,0,0,0,0,0,0,0,0,0,0,0,0,0,0,0,0,0,0,0,0,0,0,0,0,0,0,0
10809,10809,Jerome Thomas,1736,2003,Charlton Athletic,1,0,1,44,0,0,0,0,0,0,0,0,1,0,1,44,0,0,0,0,0,0,0,0,0,0,0,0,0,0
10810,10810,Peter Clarke,4359,2001,Everton FC,2,2,0,131,0,0,5,3,2,307,0,0,7,5,2,438,0,0,0,0,0,0,0,0,0,0,0,0,0,0
10811,10811,Danny Cadamarteri,3773,2001,Everton FC,0,0,0,0,0,0,3,2,1,112,0,0,3,2,1,112,0,0,0,0,0,0,0,0,0,0,0,0,0,0
10812,10812,Alexander Cleland,3926,2001,Everton FC,1,0,1,5,0,0,2,0,2,66,0,0,3,0,3,71,0,0,0,0,0,0,0,0,0,0,0,0,0,0
10813,10813,Kieran Lee,4360,2006,Manchester United,0,0,0,0,0,0,1,1,0,90,0,0,1,1,0,90,0,0,0,0,0,0,0,0,0,0,0,0,0,0
10814,10814,Fangzhuo Dong,4361,2006,Manchester United,0,0,0,0,0,0,1,1,0,72,0,0,1,1,0,72,0,0,0,0,0,0,0,0,0,0,0,0,0,0
10815,10815,Alan Kelly,4362,2001,Blackburn Rovers,1,1,0,90,0,0,1,1,0,90,0,0,2,2,0,180,0,0,0,0,0,0,0,0,0,0,0,0,0,0
10816,10816,Jake Gray,4363,2015,Crystal Palace,0,0,0,0,0,0,0,0,0,0,0,0,0,0,0,0,0,0,0,0,0,0,0,0,0,0,0,0,0,0
10817,10817,Ellis Simms,4364,2019,Everton FC,0,0,0,0,0,0,0,0,0,0,0,0,0,0,0,0,0,0,0,0,0,0,0,0,0,0,0,0,0,0
10818,10818,Emiliano Viviano,4365,2013,Arsenal FC,0,0,0,0,0,0,0,0,0,0,0,0,0,0,0,0,0,0,0,0,0,0,0,0,0,0,0,0,0,0
10819,10819,Scott Parker,1282,2004,Chelsea FC,3,1,2,112,0,0,1,0,1,13,0,0,4,1,3,125,0,0,0,0,0,0,0,0,0,0,0,0,0,0
10820,10820,Diego Forlán,2783,2004,Manchester United,0,0,0,0,0,0,1,0,1,17,0,0,1,0,1,17,0,0,0,0,0,0,0,0,0,0,0,0,0,0
10821,10821,Jonjoe Kenny,1050,2015,Everton FC,1,0,1,61,0,0,0,0,0,0,0,0,1,0,1,61,0,0,0,0,0,0,0,0,0,0,0,0,0,0
10822,10822,Tony Andreu,4366,2015,Norwich City,0,0,0,0,0,0,0,0,0,0,0,0,0,0,0,0,0,0,0,0,0,0,0,0,0,0,0,0,0,0
10823,10823,Jack Grealish,1870,2013,Aston Villa,0,0,0,0,0,0,1,0,1,2,0,0,1,0,1,2,0,0,0,0,0,0,0,0,0,0,0,0,0,0
10824,10824,Ross Turnbull,2217,2007,Middlesbrough FC,2,2,0,180,0,0,1,1,0,90,0,0,3,3,0,270,0,0,0,0,0,0,0,0,0,0,0,0,0,0
10825,10825,Steve Harper,2231,2011,Newcastle United,0,0,0,0,0,0,0,0,0,0,0,0,0,0,0,0,0,0,0,0,0,0,0,0,0,0,0,0,0,0
10826,10826,Liam Fontaine,4367,2004,Fulham FC,0,0,0,0,0,0,1,0,1,1,0,0,1,0,1,1,0,0,0,0,0,0,0,0,0,0,0,0,0,0
10827,10827,Billy McKinlay,2837,2004,Fulham FC,1,0,1,5,0,0,1,1,0,90,0,0,2,1,1,95,0,0,0,0,0,0,0,0,0,0,0,0,0,0
10828,10828,Hatem Ben Arfa,2457,2010,Newcastle United,2,1,1,79,0,0,2,2,0,91,1,0,4,3,1,170,1,0,0,3,3,0,1,1,0,0,0,0,0,0
10829,10829,Jack Collison,1285,2007,West Ham United,0,0,0,0,0,0,1,0,1,53,0,0,1,0,1,53,0,0,0,0,0,0,0,0,0,0,0,0,0,0
10830,10830,Ben Alnwick,4272,2009,Tottenham Hotspur,0,0,0,0,0,0,1,1,0,90,0,0,1,1,0,90,0,0,0,0,0,0,0,0,0,0,0,0,0,0
10831,10831,Vince Grella,3623,2011,Blackburn Rovers,0,0,0,0,0,0,1,0,1,11,0,0,1,0,1,11,0,0,0,0,0,0,0,0,0,0,0,0,0,0
10832,10832,Jason Lowe,3426,2010,Blackburn Rovers,0,0,0,0,0,0,1,0,1,66,0,0,1,0,1,66,0,0,0,0,0,0,0,0,0,0,0,0,0,0
10833,10833,Danny Ward,2444,2009,Bolton Wanderers,1,0,1,7,0,0,1,0,1,9,0,0,2,0,2,16,0,0,0,0,0,0,0,0,0,0,0,0,0,0
10834,10834,Carlton Cole,2326,2001,Chelsea FC,2,1,1,103,0,0,1,1,0,75,1,0,3,2,1,178,1,0,0,0,0,0,1,1,0,0,0,0,0,0
10835,10835,Robert Huth,1884,2001,Chelsea FC,1,0,1,45,0,0,0,0,0,0,0,0,1,0,1,45,0,0,0,0,0,0,0,0,0,0,0,0,0,0
10836,10836,Jacob Butterfield,4368,2012,Norwich City,0,0,0,0,0,0,0,0,0,0,0,0,0,0,0,0,0,0,0,0,0,0,0,0,0,0,0,0,0,0
10837,10837,Jaap Stam,1107,2001,Manchester United,1,1,0,90,0,0,0,0,0,0,0,0,1,1,0,90,0,0,0,0,0,0,0,0,0,0,0,0,0,0
10838,10838,Kevin Betsy,4369,2001,Fulham FC,0,0,0,0,0,0,1,0,1,6,0,0,1,0,1,6,0,0,0,0,0,0,0,0,0,0,0,0,0,0
10839,10839,Zeshan Rehman,1934,2003,Fulham FC,0,0,0,0,0,0,1,0,1,1,0,0,1,0,1,1,0,0,0,0,0,0,0,0,0,0,0,0,0,0
10840,10840,Tony Warner,3268,2007,Fulham FC,2,2,0,180,0,0,1,1,0,90,0,0,3,3,0,270,0,0,0,0,0,0,0,0,0,0,0,0,0,0
10841,10841,Sean Davis,1087,2010,Bolton Wanderers,1,1,0,90,0,0,0,0,0,0,0,0,1,1,0,90,0,0,0,0,0,0,0,0,0,0,0,0,0,0
10842,10842,Nick Powell,2876,2014,Leicester City,2,0,2,26,0,0,1,0,1,14,0,0,3,0,3,40,0,0,0,0,0,0,0,0,0,0,0,0,0,0
10843,10843,Tom Lawrence,3730,2013,Manchester United,1,1,0,70,0,0,0,0,0,0,0,0,1,1,0,70,0,0,0,0,0,0,0,0,0,0,0,0,0,0
10844,10844,James Wilson,2378,2013,Manchester United,1,1,0,64,2,0,0,0,0,0,0,0,1,1,0,64,2,0,0,0,0,1,0,1,0,0,0,0,0,0
10845,10845,Michael Keane,1047,2013,Manchester United,0,0,0,0,0,0,0,0,0,0,0,0,0,0,0,0,0,0,0,0,0,0,0,0,0,0,0,0,0,0
10846,10846,Michael Kightly,1259,2010,Wolverhampton Wanderers,2,0,2,49,0,0,2,1,1,111,0,0,4,1,3,160,0,0,0,0,0,0,0,0,0,0,0,0,0,0
10847,10847,Raimond van der Gouw,3788,2002,West Ham United,0,0,0,0,0,0,0,0,0,0,0,0,0,0,0,0,0,0,0,0,0,0,0,0,0,0,0,0,0,0
10848,10848,Mikkel Bischoff,4370,2002,Manchester City,1,1,0,61,0,0,0,0,0,0,0,0,1,1,0,61,0,0,0,0,0,0,0,0,0,0,0,0,0,0
10849,10849,Chris Shuker,4371,2002,Manchester City,2,1,1,81,0,0,1,0,1,27,0,0,3,1,2,108,0,0,0,0,0,0,0,0,0,0,0,0,0,0
10850,10850,Gonzalo Sorondo,3438,2006,Charlton Athletic,0,0,0,0,0,0,1,0,1,61,0,0,1,0,1,61,0,0,0,0,0,0,0,0,0,0,0,0,0,0
10851,10851,Joe Tupper,4372,2018,Crystal Palace,0,0,0,0,0,0,0,0,0,0,0,0,0,0,0,0,0,0,0,0,0,0,0,0,0,0,0,0,0,0
10852,10852,Mike Pollitt,2880,2007,Wigan Athletic,0,0,0,0,0,0,1,1,0,90,0,0,1,1,0,90,0,0,0,0,0,0,0,0,0,0,0,0,0,0
10853,10853,James Vaughan,3240,2010,Everton FC,0,0,0,0,0,0,1,0,1,17,0,0,1,0,1,17,0,0,0,0,0,0,0,0,0,0,0,0,0,0
10854,10854,Eduardo,3544,2017,Chelsea FC,0,0,0,0,0,0,0,0,0,0,0,0,0,0,0,0,0,0,0,0,0,0,0,0,0,0,0,0,0,0
10855,10855,Dujon Sterling,4373,2017,Chelsea FC,0,0,0,0,0,0,0,0,0,0,0,0,0,0,0,0,0,0,0,0,0,0,0,0,0,0,0,0,0,0
10856,10856,Lukas Jutkiewicz,1494,2008,Everton FC,1,0,1,4,0,0,0,0,0,0,0,0,1,0,1,4,0,0,0,0,0,0,0,0,0,0,0,0,0,0
10857,10857,Joe Murphy,4374,2002,West Bromwich Albion,0,0,0,0,0,0,2,1,1,145,0,0,2,1,1,145,0,0,0,0,0,0,0,0,0,0,0,0,0,0
10858,10858,Adam Morgan,4375,2012,Liverpool FC,0,0,0,0,0,0,0,0,0,0,0,0,0,0,0,0,0,0,0,0,0,0,0,0,0,0,0,0,0,0
10859,10859,Patrice Luzi,4376,2003,Liverpool FC,0,0,0,0,0,0,1,0,1,13,0,0,1,0,1,13,0,0,0,0,0,0,0,0,0,0,0,0,0,0
10860,10860,Francisco Santos,4377,2012,Everton FC,0,0,0,0,0,0,0,0,0,0,0,0,0,0,0,0,0,0,0,0,0,0,0,0,0,0,0,0,0,0
10861,10861,Reece Burke,3447,2017,West Ham United,0,0,0,0,0,0,0,0,0,0,0,0,0,0,0,0,0,0,0,0,0,0,0,0,0,0,0,0,0,0
10862,10862,Alan Mahon,1347,2002,Blackburn Rovers,0,0,0,0,0,0,2,0,2,28,0,0,2,0,2,28,0,0,0,0,0,0,0,0,0,0,0,0,0,0
10863,10863,Mat Sadler,3634,2002,Birmingham City,1,1,0,90,0,0,1,1,0,68,0,0,2,2,0,158,0,0,0,0,0,0,0,0,0,0,0,0,0,0
10864,10864,Adam Legzdins,4378,2017,Burnley FC,0,0,0,0,0,0,0,0,0,0,0,0,0,0,0,0,0,0,0,0,0,0,0,0,0,0,0,0,0,0
10865,10865,Adam Federici,1014,2006,Reading FC,0,0,0,0,0,0,2,0,2,111,0,0,2,0,2,111,0,0,0,0,0,0,0,0,0,0,0,0,0,0
10866,10866,Andy Barrowman,4379,2003,Birmingham City,1,0,1,3,0,0,0,0,0,0,0,0,1,0,1,3,0,0,0,0,0,0,0,0,0,0,0,0,0,0
10867,10867,Joseph Anang,4380,2019,West Ham United,0,0,0,0,0,0,0,0,0,0,0,0,0,0,0,0,0,0,0,0,0,0,0,0,0,0,0,0,0,0
10868,10868,Peter Ramage,1947,2011,Queens Park Rangers,0,0,0,0,0,0,0,0,0,0,0,0,0,0,0,0,0,0,0,0,0,0,0,0,0,0,0,0,0,0
10869,10869,Ian Evatt,2608,2001,Derby County,2,0,2,78,0,0,1,1,0,90,0,0,3,1,2,168,0,0,0,0,0,0,0,0,0,0,0,0,0,0
10870,10870,Gary Twigg,4381,2001,Derby County,0,0,0,0,0,0,1,0,1,24,0,0,1,0,1,24,0,0,0,0,0,0,0,0,0,0,0,0,0,0
10871,10871,Marvin Robinson,4382,2001,Derby County,1,0,1,14,0,0,1,0,1,32,1,0,2,0,2,46,1,0,0,1,1,0,1,1,0,0,0,0,0,0
10872,10872,Quinton Fortune,2782,2000,Manchester United,3,3,0,270,2,0,4,3,1,268,0,0,7,6,1,538,2,0,0,0,0,0,0,0,0,0,0,0,0,0
10873,10873,Michael Stewart,4038,2000,Manchester United,1,1,0,64,0,0,2,2,0,175,0,0,3,3,0,239,0,0,0,0,0,0,0,0,0,0,0,0,0,0
10874,10874,Elliot Lee,3524,2013,West Ham United,1,0,1,2,0,0,0,0,0,0,0,0,1,0,1,2,0,0,0,0,0,0,0,0,0,0,0,0,0,0
10875,10875,Owen Otasowie,4383,2019,Wolverhampton Wanderers,0,0,0,0,0,0,0,0,0,0,0,0,0,0,0,0,0,0,0,0,0,0,0,0,0,0,0,0,0,0
10876,10876,Kenji Gorré,4293,2014,Swansea City,0,0,0,0,0,0,1,0,1,6,0,0,1,0,1,6,0,0,0,0,0,0,0,0,0,0,0,0,0,0
10877,10877,Raheem Hanley,4384,2014,Swansea City,0,0,0,0,0,0,0,0,0,0,0,0,0,0,0,0,0,0,0,0,0,0,0,0,0,0,0,0,0,0
10878,10878,Jonathan Williams,3415,2015,Crystal Palace,1,0,1,10,0,0,0,0,0,0,0,0,1,0,1,10,0,0,0,0,0,0,0,0,0,0,0,0,0,0
10879,10879,Christian Bassedas,3776,2001,Newcastle United,1,0,1,15,0,0,1,1,0,84,0,0,2,1,1,99,0,0,0,0,0,0,0,0,0,0,0,0,0,0
10880,10880,Kerrea Gilbert,4385,2005,Arsenal FC,1,1,0,27,0,0,1,1,0,73,0,0,2,2,0,100,0,0,0,0,0,0,0,0,0,0,0,0,0,0
10881,10881,Ognjen Koroman,3858,2006,Portsmouth FC,0,0,0,0,0,0,1,0,1,17,0,0,1,0,1,17,0,0,0,0,0,0,0,0,0,0,0,0,0,0
10882,10882,Jazz Richards,1703,2013,Swansea City,0,0,0,0,0,0,0,0,0,0,0,0,0,0,0,0,0,0,0,0,0,0,0,0,0,0,0,0,0,0
10883,10883,Will Atkinson,4386,2009,Hull City,1,1,0,90,0,0,1,1,0,90,1,0,2,2,0,180,1,0,0,0,0,0,1,1,0,0,0,0,0,0
10884,10884,Johnny Gorman,4387,2011,Wolverhampton Wanderers,0,0,0,0,0,0,1,0,1,1,0,0,1,0,1,1,0,0,0,0,0,0,0,0,0,0,0,0,0,0
10885,10885,Jack Price,4388,2011,Wolverhampton Wanderers,0,0,0,0,0,0,0,0,0,0,0,0,0,0,0,0,0,0,0,0,0,0,0,0,0,0,0,0,0,0
10886,10886,Ján Kozák,4389,2005,West Bromwich Albion,4,2,2,195,0,0,2,2,0,153,0,0,6,4,2,348,0,0,0,0,0,0,0,0,0,0,0,0,0,0
10887,10887,Tony Caig,4390,2000,Charlton Athletic,1,0,1,45,0,0,0,0,0,0,0,0,1,0,1,45,0,0,0,0,0,0,0,0,0,0,0,0,0,0
10888,10888,Cody Cropper,4391,2013,Southampton FC,0,0,0,0,0,0,0,0,0,0,0,0,0,0,0,0,0,0,0,0,0,0,0,0,0,0,0,0,0,0
10889,10889,David Cotterill,3529,2007,Wigan Athletic,1,1,0,60,0,0,1,1,0,39,0,0,2,2,0,99,0,0,0,0,0,0,0,0,0,0,0,0,0,0
10890,10890,Marco Amelia,4392,2015,Chelsea FC,0,0,0,0,0,0,0,0,0,0,0,0,0,0,0,0,0,0,0,0,0,0,0,0,0,0,0,0,0,0
10891,10891,Papy Djilobodji,3314,2015,Chelsea FC,0,0,0,0,0,0,0,0,0,0,0,0,0,0,0,0,0,0,0,0,0,0,0,0,0,0,0,0,0,0
10892,10892,Danny Rose,1399,2009,Tottenham Hotspur,1,1,0,46,1,0,0,0,0,0,0,0,1,1,0,46,1,0,0,0,0,1,0,1,0,0,0,0,0,0
10893,10893,Ricardo Rocha,2954,2007,Tottenham Hotspur,2,1,1,162,0,0,3,3,0,263,0,0,5,4,1,425,0,0,0,0,0,0,0,0,0,0,0,0,0,0
10894,10894,Fousséni Diabaté,2566,2018,Leicester City,0,0,0,0,0,0,1,1,0,55,0,0,1,1,0,55,0,0,0,0,0,0,0,0,0,0,0,0,0,0
10895,10895,Josh Knight,4393,2018,Leicester City,0,0,0,0,0,0,0,0,0,0,0,0,0,0,0,0,0,0,0,0,0,0,0,0,0,0,0,0,0,0
10896,10896,David May,3319,2000,Manchester United,0,0,0,0,0,0,2,1,1,99,0,0,2,1,1,99,0,0,0,0,0,0,0,0,0,0,0,0,0,0
10897,10897,Mitchell Beeney,4394,2014,Chelsea FC,0,0,0,0,0,0,0,0,0,0,0,0,0,0,0,0,0,0,0,0,0,0,0,0,0,0,0,0,0,0
10898,10898,Jamal Blackman,3650,2011,Chelsea FC,0,0,0,0,0,0,0,0,0,0,0,0,0,0,0,0,0,0,0,0,0,0,0,0,0,0,0,0,0,0
10899,10899,Kevin-Prince Boateng,3159,2008,Tottenham Hotspur,1,0,1,14,0,0,0,0,0,0,0,0,1,0,1,14,0,0,0,0,0,0,0,0,0,0,0,0,0,0
10900,10900,Jordan Mustoe,4132,2012,Wigan Athletic,0,0,0,0,0,0,0,0,0,0,0,0,0,0,0,0,0,0,0,0,0,0,0,0,0,0,0,0,0,0
10901,10901,Gary Gardner,1449,2012,Aston Villa,0,0,0,0,0,0,2,0,2,19,0,0,2,0,2,19,0,0,0,0,0,0,0,0,0,0,0,0,0,0
10902,10902,Tommie Hoban,3815,2016,Watford FC,0,0,0,0,0,0,0,0,0,0,0,0,0,0,0,0,0,0,0,0,0,0,0,0,0,0,0,0,0,0
10903,10903,Amaury Bischoff,4395,2008,Arsenal FC,0,0,0,0,0,0,1,0,1,26,0,0,1,0,1,26,0,0,0,0,0,0,0,0,0,0,0,0,0,0
10904,10904,Mark Randall,1239,2008,Arsenal FC,0,0,0,0,0,0,1,0,1,8,0,0,1,0,1,8,0,0,0,0,0,0,0,0,0,0,0,0,0,0
10905,10905,Tom Robson,2527,2015,Sunderland AFC,0,0,0,0,0,0,1,1,0,90,0,0,1,1,0,90,0,0,0,0,0,0,0,0,0,0,0,0,0,0
10906,10906,Rees Greenwood,4396,2015,Sunderland AFC,0,0,0,0,0,0,1,1,0,52,0,0,1,1,0,52,0,0,0,0,0,0,0,0,0,0,0,0,0,0
10907,10907,George Honeyman,3139,2015,Sunderland AFC,0,0,0,0,0,0,1,0,1,38,0,0,1,0,1,38,0,0,0,0,0,0,0,0,0,0,0,0,0,0
10908,10908,Rayhaan Tulloch,4397,2017,West Bromwich Albion,0,0,0,0,0,0,0,0,0,0,0,0,0,0,0,0,0,0,0,0,0,0,0,0,0,0,0,0,0,0
10909,10909,Mehdi Abeid,2928,2011,Newcastle United,0,0,0,0,0,0,0,0,0,0,0,0,0,0,0,0,0,0,0,0,0,0,0,0,0,0,0,0,0,0
10910,10910,Danny Drinkwater,2522,2018,Chelsea FC,0,0,0,0,0,0,0,0,0,0,0,0,0,0,0,0,0,0,0,0,0,0,0,0,0,0,0,0,0,0
10911,10911,Nick Chadwick,4174,2002,Everton FC,1,0,1,15,0,0,0,0,0,0,0,0,1,0,1,15,0,0,0,0,0,0,0,0,0,0,0,0,0,0
10912,10912,David Meyler,2225,2012,Sunderland AFC,0,0,0,0,0,0,3,0,3,64,0,0,3,0,3,64,0,0,0,0,0,0,0,0,0,0,0,0,0,0
10913,10913,Dominic Matteo,1293,2005,Blackburn Rovers,3,3,0,270,0,0,3,3,0,237,0,0,6,6,0,507,0,0,0,0,0,0,0,0,0,0,0,0,0,0
10914,10914,Gary Flitcroft,1135,2005,Blackburn Rovers,1,0,1,1,0,0,1,1,0,61,0,0,2,1,1,62,0,0,0,0,0,0,0,0,0,0,0,0,0,0
10915,10915,Amr Zaki,3656,2009,Hull City,3,0,3,69,0,0,3,2,1,157,0,0,6,2,4,226,0,0,0,0,0,0,0,0,0,0,0,0,0,0
10916,10916,Geoffrey Mujangi Bia,3630,2009,Wolverhampton Wanderers,1,0,1,14,0,0,2,1,1,47,0,0,3,1,2,61,0,0,0,0,0,0,0,0,0,0,0,0,0,0
10917,10917,Patrick Foletti,4398,2001,Derby County,1,1,0,90,0,0,1,0,1,58,0,0,2,1,1,148,0,0,0,0,0,0,0,0,0,0,0,0,0,0
10918,10918,Pablo Marí,4399,2019,Arsenal FC,1,1,0,90,0,0,1,1,0,24,0,0,2,2,0,114,0,0,0,0,0,0,0,0,0,0,0,0,0,0
10919,10919,Joshua King,1040,2010,Manchester United,0,0,0,0,0,0,0,0,0,0,0,0,0,0,0,0,0,0,0,0,0,0,0,0,0,0,0,0,0,0
10920,10920,Martin Cranie,3103,2003,Southampton FC,0,0,0,0,0,0,1,1,0,90,0,0,1,1,0,90,0,0,0,0,0,0,0,0,0,0,0,0,0,0
10921,10921,Adel Taarabt,2165,2008,Tottenham Hotspur,1,0,1,3,0,0,0,0,0,0,0,0,1,0,1,3,0,0,0,0,0,0,0,0,0,0,0,0,0,0
10922,10922,Erik Edman,2196,2005,Tottenham Hotspur,1,1,0,90,0,0,2,2,0,180,0,0,3,3,0,270,0,0,0,0,0,0,0,0,0,0,0,0,0,0
10923,10923,Frédéric Kanouté,1130,2005,Tottenham Hotspur,0,0,0,0,0,0,1,0,1,9,0,0,1,0,1,9,0,0,0,0,0,0,0,0,0,0,0,0,0,0
10924,10924,Tommy Miller,3221,2001,Ipswich Town,2,2,0,180,0,0,6,3,3,334,0,0,8,5,3,514,0,0,0,0,0,0,0,0,0,0,0,0,0,0
10925,10925,Jermaine Pennant,1514,2012,Stoke City,1,1,0,66,0,0,0,0,0,0,0,0,1,1,0,66,0,0,0,0,0,0,0,0,0,0,0,0,0,0
10926,10926,Adam Blakeman,4400,2011,Bolton Wanderers,0,0,0,0,0,0,0,0,0,0,0,0,0,0,0,0,0,0,0,0,0,0,0,0,0,0,0,0,0,0
10927,10927,James Tomkins,1281,2007,West Ham United,3,3,0,270,0,0,3,2,1,197,0,0,6,5,1,467,0,0,0,0,0,0,0,0,0,0,0,0,0,0
10928,10928,Cole Kpekawa,4401,2014,Queens Park Rangers,0,0,0,0,0,0,1,0,1,5,0,0,1,0,1,5,0,0,0,0,0,0,0,0,0,0,0,0,0,0
10929,10929,Michael Petrasso,4402,2014,Queens Park Rangers,0,0,0,0,0,0,0,0,0,0,0,0,0,0,0,0,0,0,0,0,0,0,0,0,0,0,0,0,0,0
10930,10930,Gavin Kilkenny,4403,2019,AFC Bournemouth,0,0,0,0,0,0,0,0,0,0,0,0,0,0,0,0,0,0,0,0,0,0,0,0,0,0,0,0,0,0
10931,10931,Martín Herrera,4404,2002,Fulham FC,1,1,0,90,0,0,1,0,1,51,0,0,2,1,1,141,0,0,0,0,0,0,0,0,0,0,0,0,0,0
10932,10932,Des Lyttle,4405,2002,West Bromwich Albion,2,1,1,107,0,0,2,1,1,95,0,0,4,2,2,202,0,0,0,0,0,0,0,0,0,0,0,0,0,0
10933,10933,Leo Chambers,2762,2013,West Ham United,0,0,0,0,0,0,0,0,0,0,0,0,0,0,0,0,0,0,0,0,0,0,0,0,0,0,0,0,0,0
10934,10934,Pape Souaré,1021,2018,Crystal Palace,0,0,0,0,0,0,1,0,1,1,0,0,1,0,1,1,0,0,0,0,0,0,0,0,0,0,0,0,0,0
10935,10935,Conor McAleny,4217,2015,Everton FC,0,0,0,0,0,0,0,0,0,0,0,0,0,0,0,0,0,0,0,0,0,0,0,0,0,0,0,0,0,0
10936,10936,Gabriele Angella,4406,2015,Watford FC,0,0,0,0,0,0,0,0,0,0,0,0,0,0,0,0,0,0,0,0,0,0,0,0,0,0,0,0,0,0
10937,10937,Daniel Pudil,4407,2015,Watford FC,0,0,0,0,0,0,0,0,0,0,0,0,0,0,0,0,0,0,0,0,0,0,0,0,0,0,0,0,0,0
10938,10938,José Dominguez,4408,2000,Tottenham Hotspur,1,0,1,19,0,0,1,0,1,6,0,0,2,0,2,25,0,0,0,0,0,0,0,0,0,0,0,0,0,0
10939,10939,James Keene,4409,2004,Portsmouth FC,1,0,1,30,0,0,1,1,0,81,0,0,2,1,1,111,0,0,0,0,0,0,0,0,0,0,0,0,0,0
10940,10940,Manuel Almunia,2039,2006,Arsenal FC,1,1,0,90,0,0,0,0,0,0,0,0,1,1,0,90,0,0,0,0,0,0,0,0,0,0,0,0,0,0
10941,10941,Luke Moore,1796,2003,Newcastle United,1,0,1,40,0,0,0,0,0,0,0,0,1,0,1,40,0,0,0,0,0,0,0,0,0,0,0,0,0,0
10942,10942,Jack Rose,3000,2016,West Bromwich Albion,0,0,0,0,0,0,0,0,0,0,0,0,0,0,0,0,0,0,0,0,0,0,0,0,0,0,0,0,0,0
10943,10943,Adam Reach,4410,2016,Middlesbrough FC,0,0,0,0,0,0,0,0,0,0,0,0,0,0,0,0,0,0,0,0,0,0,0,0,0,0,0,0,0,0
10944,10944,Alan Smith,1300,2008,Newcastle United,3,2,1,185,0,0,3,2,1,209,0,0,6,4,2,394,0,0,0,0,0,0,0,0,0,0,0,0,0,0
10945,10945,Richard Wright,2977,2003,Everton FC,2,2,0,115,0,0,1,1,0,90,0,0,3,3,0,205,0,0,0,0,0,0,0,0,0,0,0,0,0,0
10946,10946,Jonathan Douglas,1138,2004,Blackburn Rovers,0,0,0,0,0,0,1,0,1,45,0,0,1,0,1,45,0,0,0,0,0,0,0,0,0,0,0,0,0,0
10947,10947,Lewis Bate,4411,2019,Chelsea FC,0,0,0,0,0,0,0,0,0,0,0,0,0,0,0,0,0,0,0,0,0,0,0,0,0,0,0,0,0,0
10948,10948,Paul Gallagher,1142,2002,Blackburn Rovers,1,0,1,12,0,0,0,0,0,0,0,0,1,0,1,12,0,0,0,0,0,0,0,0,0,0,0,0,0,0
10949,10949,Darren Ambrose,1956,2001,Ipswich Town,0,0,0,0,0,0,1,0,1,5,0,0,1,0,1,5,0,0,0,0,0,0,0,0,0,0,0,0,0,0
10950,10950,Ritchie De Laet,2514,2008,Manchester United,0,0,0,0,0,0,1,1,0,79,0,0,1,1,0,79,0,0,0,0,0,0,0,0,0,0,0,0,0,0
10951,10951,Lee Martin,4412,2008,Manchester United,0,0,0,0,0,0,1,1,0,90,0,0,1,1,0,90,0,0,0,0,0,0,0,0,0,0,0,0,0,0
10952,10952,Rodrigo Possebon,4413,2008,Manchester United,1,0,1,27,0,0,2,0,2,25,0,0,3,0,3,52,0,0,0,0,0,0,0,0,0,0,0,0,0,0
10953,10953,Khalilou Fadiga,4105,2004,Bolton Wanderers,3,0,3,32,0,0,2,0,2,88,0,0,5,0,5,120,0,0,0,0,0,0,0,0,0,0,0,0,0,0
10954,10954,Ahmed Elmohamady,1690,2012,Sunderland AFC,0,0,0,0,0,0,2,0,2,22,0,0,2,0,2,22,0,0,0,0,0,0,0,0,0,0,0,0,0,0
10955,10955,Carl Stewart,4314,2017,Watford FC,0,0,0,0,0,0,0,0,0,0,0,0,0,0,0,0,0,0,0,0,0,0,0,0,0,0,0,0,0,0
10956,10956,John Stones,1197,2012,Everton FC,0,0,0,0,0,0,0,0,0,0,0,0,0,0,0,0,0,0,0,0,0,0,0,0,0,0,0,0,0,0
10957,10957,Steven Sidwell,1622,2015,Stoke City,1,0,1,12,0,0,0,0,0,0,0,0,1,0,1,12,0,0,0,0,0,0,0,0,0,0,0,0,0,0
10958,10958,Nigel Martyn,1290,2002,Leeds United,0,0,0,0,0,0,0,0,0,0,0,0,0,0,0,0,0,0,0,0,0,0,0,0,0,0,0,0,0,0
10959,10959,Tim Flowers,1302,2002,Manchester City,0,0,0,0,0,0,0,0,0,0,0,0,0,0,0,0,0,0,0,0,0,0,0,0,0,0,0,0,0,0
10960,10960,Rekeem Harper,3213,2017,West Bromwich Albion,1,0,1,20,0,0,0,0,0,0,0,0,1,0,1,20,0,0,0,0,0,0,0,0,0,0,0,0,0,0
10961,10961,Matt Butcher,2828,2015,AFC Bournemouth,0,0,0,0,0,0,0,0,0,0,0,0,0,0,0,0,0,0,0,0,0,0,0,0,0,0,0,0,0,0
10962,10962,Jacob Mellis,4414,2010,Chelsea FC,0,0,0,0,0,0,0,0,0,0,0,0,0,0,0,0,0,0,0,0,0,0,0,0,0,0,0,0,0,0
10963,10963,Fabio Borini,1777,2010,Chelsea FC,0,0,0,0,0,0,0,0,0,0,0,0,0,0,0,0,0,0,0,0,0,0,0,0,0,0,0,0,0,0
10964,10964,Leonardo Campana,4415,2019,Wolverhampton Wanderers,0,0,0,0,0,0,0,0,0,0,0,0,0,0,0,0,0,0,0,0,0,0,0,0,0,0,0,0,0,0
10965,10965,Frank Fielding,4416,2010,Blackburn Rovers,0,0,0,0,0,0,0,0,0,0,0,0,0,0,0,0,0,0,0,0,0,0,0,0,0,0,0,0,0,0
10966,10966,Rhian Brewster,4234,2019,Liverpool FC,0,0,0,0,0,0,0,0,0,0,0,0,0,0,0,0,0,0,0,0,0,0,0,0,0,0,0,0,0,0
10967,10967,Jesse Lingard,1646,2013,Manchester United,0,0,0,0,0,0,0,0,0,0,0,0,0,0,0,0,0,0,0,0,0,0,0,0,0,0,0,0,0,0
10968,10968,Lee Lucas,4323,2013,Swansea City,0,0,0,0,0,0,0,0,0,0,0,0,0,0,0,0,0,0,0,0,0,0,0,0,0,0,0,0,0,0
10969,10969,Dominic Gape,4417,2014,Southampton FC,1,0,1,2,0,0,0,0,0,0,0,0,1,0,1,2,0,0,0,0,0,0,0,0,0,0,0,0,0,0
10970,10970,Sebastian Prödl,2366,2019,Watford FC,1,1,0,57,0,0,0,0,0,0,0,0,1,1,0,57,0,0,0,0,0,0,0,0,0,0,0,0,0,0
10971,10971,Chris Wood,2348,2008,West Bromwich Albion,0,0,0,0,0,0,2,0,2,16,0,0,2,0,2,16,0,0,0,0,0,0,0,0,0,0,0,0,0,0
10972,10972,Neil Moss,4068,2001,Southampton FC,1,1,0,90,0,0,1,1,0,90,0,0,2,2,0,180,0,0,0,0,0,0,0,0,0,0,0,0,0,0
10973,10973,Garry Monk,2808,2001,Southampton FC,2,1,1,120,0,0,0,0,0,0,0,0,2,1,1,120,0,0,0,0,0,0,0,0,0,0,0,0,0,0
10974,10974,Pape Souaré,1021,2016,Crystal Palace,2,2,0,180,0,0,1,1,0,90,0,0,3,3,0,270,0,0,0,0,0,0,0,0,0,0,0,0,0,0
10975,10975,Keshi Anderson,4213,2016,Crystal Palace,0,0,0,0,0,0,0,0,0,0,0,0,0,0,0,0,0,0,0,0,0,0,0,0,0,0,0,0,0,0
10976,10976,Freddie Ladapo,4418,2016,Crystal Palace,0,0,0,0,0,0,0,0,0,0,0,0,0,0,0,0,0,0,0,0,0,0,0,0,0,0,0,0,0,0
10977,10977,Jordan Laidler,4419,2012,Sunderland AFC,0,0,0,0,0,0,0,0,0,0,0,0,0,0,0,0,0,0,0,0,0,0,0,0,0,0,0,0,0,0
10978,10978,Jonathan Henly,4420,2012,Reading FC,0,0,0,0,0,0,0,0,0,0,0,0,0,0,0,0,0,0,0,0,0,0,0,0,0,0,0,0,0,0
10979,10979,Ryan Seager,4092,2015,Southampton FC,0,0,0,0,0,0,0,0,0,0,0,0,0,0,0,0,0,0,0,0,0,0,0,0,0,0,0,0,0,0
10980,10980,Ryan Giles,3293,2019,Wolverhampton Wanderers,0,0,0,0,0,0,0,0,0,0,0,0,0,0,0,0,0,0,0,0,0,0,0,0,0,0,0,0,0,0
10981,10981,Lloyd Jones,4421,2013,Liverpool FC,0,0,0,0,0,0,0,0,0,0,0,0,0,0,0,0,0,0,0,0,0,0,0,0,0,0,0,0,0,0
10982,10982,George Honeyman,3139,2014,Sunderland AFC,0,0,0,0,0,0,0,0,0,0,0,0,0,0,0,0,0,0,0,0,0,0,0,0,0,0,0,0,0,0
10983,10983,Larnell Cole,4033,2011,Manchester United,0,0,0,0,0,0,0,0,0,0,0,0,0,0,0,0,0,0,0,0,0,0,0,0,0,0,0,0,0,0
10984,10984,Amine Linganzi,4358,2011,Blackburn Rovers,0,0,0,0,0,0,0,0,0,0,0,0,0,0,0,0,0,0,0,0,0,0,0,0,0,0,0,0,0,0
10985,10985,Karim Bagheri,4422,2000,Charlton Athletic,0,0,0,0,0,0,1,0,1,18,0,0,1,0,1,18,0,0,0,0,0,0,0,0,0,0,0,0,0,0
10986,10986,Rony Lopes,4423,2013,Manchester City,0,0,0,0,0,0,0,0,0,0,0,0,0,0,0,0,0,0,0,0,0,0,0,0,0,0,0,0,0,0
10987,10987,Mikael Mandron,4024,2014,Sunderland AFC,1,0,1,4,0,0,0,0,0,0,0,0,1,0,1,4,0,0,0,0,0,0,0,0,0,0,0,0,0,0
10988,10988,Jordan Rossiter,3521,2014,Liverpool FC,0,0,0,0,0,0,0,0,0,0,0,0,0,0,0,0,0,0,0,0,0,0,0,0,0,0,0,0,0,0
10989,10989,Ritchie De Laet,2514,2009,Manchester United,1,1,0,90,0,0,1,1,0,58,0,0,2,2,0,148,0,0,0,0,0,0,0,0,0,0,0,0,0,0
10990,10990,Danny Welbeck,1506,2009,Manchester United,4,1,3,120,0,0,1,0,1,18,0,0,5,1,4,138,0,0,0,0,0,0,0,0,0,0,0,0,0,0
10991,10991,Sammy Ameobi,2459,2010,Newcastle United,0,0,0,0,0,0,1,0,1,8,0,0,1,0,1,8,0,0,0,0,0,0,0,0,0,0,0,0,0,0
10992,10992,Lamine Diatta,4424,2007,Newcastle United,1,0,1,8,0,0,1,0,1,1,0,0,2,0,2,9,0,0,0,0,0,0,0,0,0,0,0,0,0,0
10993,10993,George Friend,3002,2009,Wolverhampton Wanderers,0,0,0,0,0,0,1,1,0,61,0,0,1,1,0,61,0,0,0,0,0,0,0,0,0,0,0,0,0,0
10994,10994,Simon Church,4425,2012,Reading FC,0,0,0,0,0,0,0,0,0,0,0,0,0,0,0,0,0,0,0,0,0,0,0,0,0,0,0,0,0,0
10995,10995,Rory Delap,1993,2012,Stoke City,0,0,0,0,0,0,1,0,1,10,0,0,1,0,1,10,0,0,0,0,0,0,0,0,0,0,0,0,0,0
10996,10996,Jamie Ness,4426,2012,Stoke City,0,0,0,0,0,0,0,0,0,0,0,0,0,0,0,0,0,0,0,0,0,0,0,0,0,0,0,0,0,0
10997,10997,Brendan Galloway,3717,2014,Everton FC,1,1,0,84,0,0,1,1,0,90,0,0,2,2,0,174,0,0,0,0,0,0,0,0,0,0,0,0,0,0
10998,10998,Joshua Onomah,2800,2014,Tottenham Hotspur,0,0,0,0,0,0,0,0,0,0,0,0,0,0,0,0,0,0,0,0,0,0,0,0,0,0,0,0,0,0
10999,10999,Harry Winks,1857,2014,Tottenham Hotspur,0,0,0,0,0,0,0,0,0,0,0,0,0,0,0,0,0,0,0,0,0,0,0,0,0,0,0,0,0,0
11000,11000,Stefan Wessels,4427,2007,Everton FC,1,1,0,90,0,0,1,1,0,90,0,0,2,2,0,180,0,0,0,0,0,0,0,0,0,0,0,0,0,0
11001,11001,Jonathan Leko,3553,2017,West Bromwich Albion,0,0,0,0,0,0,0,0,0,0,0,0,0,0,0,0,0,0,0,0,0,0,0,0,0,0,0,0,0,0
11002,11002,Diego Gavilán,4428,2000,Newcastle United,1,0,1,5,0,0,0,0,0,0,0,0,1,0,1,5,0,0,0,0,0,0,0,0,0,0,0,0,0,0
11003,11003,Ben Foster,1653,2007,Manchester United,0,0,0,0,0,0,1,1,0,90,0,0,1,1,0,90,0,0,0,0,0,0,0,0,0,0,0,0,0,0
11004,11004,Tom Thorpe,4429,2014,Manchester United,1,0,1,1,0,0,0,0,0,0,0,0,1,0,1,1,0,0,0,0,0,0,0,0,0,0,0,0,0,0
11005,11005,Ryan Ledson,2298,2014,Everton FC,0,0,0,0,0,0,0,0,0,0,0,0,0,0,0,0,0,0,0,0,0,0,0,0,0,0,0,0,0,0
11006,11006,Sebastian Lletget,4006,2014,West Ham United,0,0,0,0,0,0,0,0,0,0,0,0,0,0,0,0,0,0,0,0,0,0,0,0,0,0,0,0,0,0
11007,11007,Paul Rachubka,3843,2000,Manchester United,1,1,0,90,0,0,0,0,0,0,0,0,1,1,0,90,0,0,0,0,0,0,0,0,0,0,0,0,0,0
11008,11008,Kevin Ellison,4430,2000,Leicester City,0,0,0,0,0,0,1,0,1,6,0,0,1,0,1,6,0,0,0,0,0,0,0,0,0,0,0,0,0,0
11009,11009,Martin Brittain,4431,2003,Newcastle United,0,0,0,0,0,0,1,0,1,16,0,0,1,0,1,16,0,0,0,0,0,0,0,0,0,0,0,0,0,0
11010,11010,Luke Thomas,4432,2019,Leicester City,2,2,0,178,0,0,1,1,0,90,0,0,3,3,0,268,0,0,0,0,0,0,0,0,0,0,0,0,0,0
11011,11011,George Hirst,4433,2019,Leicester City,1,0,1,2,0,0,1,0,1,7,0,0,2,0,2,9,0,0,0,0,0,0,0,0,0,0,0,0,0,0
11012,11012,Matty James,2516,2019,Leicester City,1,0,1,5,0,0,0,0,0,0,0,0,1,0,1,5,0,0,0,0,0,0,0,0,0,0,0,0,0,0
11013,11013,Claudio Bravo,1208,2018,Manchester City,0,0,0,0,0,0,0,0,0,0,0,0,0,0,0,0,0,0,0,0,0,0,0,0,0,0,0,0,0,0
11014,11014,Piotr Świerczewski,4434,2002,Birmingham City,1,0,1,38,0,0,0,0,0,0,0,0,1,0,1,38,0,0,0,0,0,0,0,0,0,0,0,0,0,0
11015,11015,Ethan Ebanks-Landell,4435,2010,Wolverhampton Wanderers,0,0,0,0,0,0,0,0,0,0,0,0,0,0,0,0,0,0,0,0,0,0,0,0,0,0,0,0,0,0
11016,11016,Nathan Rooney,4436,2010,Wolverhampton Wanderers,0,0,0,0,0,0,0,0,0,0,0,0,0,0,0,0,0,0,0,0,0,0,0,0,0,0,0,0,0,0
11017,11017,Bright Enobakhare,4437,2018,Wolverhampton Wanderers,0,0,0,0,0,0,0,0,0,0,0,0,0,0,0,0,0,0,0,0,0,0,0,0,0,0,0,0,0,0
11018,11018,Sandro,2409,2018,Everton FC,0,0,0,0,0,0,0,0,0,0,0,0,0,0,0,0,0,0,0,0,0,0,0,0,0,0,0,0,0,0
11019,11019,Aiden McGeady,2242,2015,Everton FC,0,0,0,0,0,0,0,0,0,0,0,0,0,0,0,0,0,0,0,0,0,0,0,0,0,0,0,0,0,0
11020,11020,Remie Streete,4221,2014,Newcastle United,0,0,0,0,0,0,0,0,0,0,0,0,0,0,0,0,0,0,0,0,0,0,0,0,0,0,0,0,0,0
11021,11021,Facundo Ferreyra,4438,2014,Newcastle United,0,0,0,0,0,0,0,0,0,0,0,0,0,0,0,0,0,0,0,0,0,0,0,0,0,0,0,0,0,0
11022,11022,Scott Minto,2463,2000,West Ham United,0,0,0,0,0,0,1,1,0,89,0,0,1,1,0,89,0,0,0,0,0,0,0,0,0,0,0,0,0,0
11023,11023,Grant McCann,4267,2000,West Ham United,0,0,0,0,0,0,1,0,1,1,0,0,1,0,1,1,0,0,0,0,0,0,0,0,0,0,0,0,0,0
11024,11024,Jermain Defoe,1127,2000,West Ham United,0,0,0,0,0,0,1,0,1,22,0,0,1,0,1,22,0,0,0,0,0,0,0,0,0,0,0,0,0,0
11025,11025,Brandon Barker,4439,2015,Manchester City,0,0,0,0,0,0,0,0,0,0,0,0,0,0,0,0,0,0,0,0,0,0,0,0,0,0,0,0,0,0
11026,11026,Christian Negouai,4440,2004,Manchester City,0,0,0,0,0,0,1,0,1,10,0,0,1,0,1,10,0,0,0,0,0,0,0,0,0,0,0,0,0,0
11027,11027,Grant Hanley,1837,2009,Blackburn Rovers,0,0,0,0,0,0,1,1,0,90,0,0,1,1,0,90,0,0,0,0,0,0,0,0,0,0,0,0,0,0
11028,11028,Amine Linganzi,4358,2009,Blackburn Rovers,0,0,0,0,0,0,1,1,0,46,0,0,1,1,0,46,0,0,0,0,0,0,0,0,0,0,0,0,0,0
11029,11029,Albert Jarrett,4441,2006,Watford FC,0,0,0,0,0,0,1,0,1,19,0,0,1,0,1,19,0,0,0,0,0,0,0,0,0,0,0,0,0,0
11030,11030,Adam Matthews,4442,2015,Sunderland AFC,0,0,0,0,0,0,1,0,1,36,0,0,1,0,1,36,0,0,0,0,0,0,0,0,0,0,0,0,0,0
11031,11031,Donald Love,3316,2015,Manchester United,0,0,0,0,0,0,1,0,1,53,0,0,1,0,1,53,0,0,0,0,0,0,0,0,0,0,0,0,0,0
11032,11032,Will Keane,2381,2015,Manchester United,0,0,0,0,0,0,1,0,1,4,0,0,1,0,1,4,0,0,0,0,0,0,0,0,0,0,0,0,0,0
11033,11033,Victor Moses,1434,2018,Chelsea FC,1,0,1,17,0,0,1,0,1,9,0,0,2,0,2,26,0,0,0,0,0,0,0,0,0,0,0,0,0,0
11034,11034,Janoi Donacien,4443,2013,Aston Villa,0,0,0,0,0,0,0,0,0,0,0,0,0,0,0,0,0,0,0,0,0,0,0,0,0,0,0,0,0,0
11035,11035,Fernando Forestieri,4444,2015,Watford FC,0,0,0,0,0,0,0,0,0,0,0,0,0,0,0,0,0,0,0,0,0,0,0,0,0,0,0,0,0,0
11036,11036,Marlon King,2119,2009,Wigan Athletic,1,0,1,1,0,0,2,0,2,13,0,0,3,0,3,14,0,0,0,0,0,0,0,0,0,0,0,0,0,0
11037,11037,Tyrone Mings,2772,2015,AFC Bournemouth,1,0,1,44,0,0,0,0,0,0,0,0,1,0,1,44,0,0,0,0,0,0,0,0,0,0,0,0,0,0
11038,11038,Danny Livesey,4445,2002,Bolton Wanderers,1,0,1,60,0,0,1,0,1,15,0,0,2,0,2,75,0,0,0,0,0,0,0,0,0,0,0,0,0,0
11039,11039,Ragnvald Soma,4446,2000,West Ham United,1,1,0,90,0,0,3,1,2,100,0,0,4,2,2,190,0,0,0,0,0,0,0,0,0,0,0,0,0,0
11040,11040,Neil Danns,4186,2003,Blackburn Rovers,1,0,1,16,0,0,0,0,0,0,0,0,1,0,1,16,0,0,0,0,0,0,0,0,0,0,0,0,0,0
11041,11041,Pegguy Arphexad,4447,2001,Liverpool FC,1,1,0,90,0,0,1,0,1,35,0,0,2,1,1,125,0,0,0,0,0,0,0,0,0,0,0,0,0,0
11042,11042,Alex Song,1233,2005,Arsenal FC,2,0,2,16,0,0,3,3,0,238,0,0,5,3,2,254,0,0,0,0,0,0,0,0,0,0,0,0,0,0
11043,11043,Emile Smith-Rowe,1474,2018,Arsenal FC,0,0,0,0,0,0,0,0,0,0,0,0,0,0,0,0,0,0,0,0,0,0,0,0,0,0,0,0,0,0
11044,11044,Joe Mason,4448,2013,Cardiff City,0,0,0,0,0,0,0,0,0,0,0,0,0,0,0,0,0,0,0,0,0,0,0,0,0,0,0,0,0,0
11045,11045,Paul Ritchie,3853,2002,Manchester City,0,0,0,0,0,0,0,0,0,0,0,0,0,0,0,0,0,0,0,0,0,0,0,0,0,0,0,0,0,0
11046,11046,Alan Kelly,4362,2002,Blackburn Rovers,0,0,0,0,0,0,1,1,0,90,0,0,1,1,0,90,0,0,0,0,0,0,0,0,0,0,0,0,0,0
11047,11047,Djimi Traoré,2364,2007,Portsmouth FC,2,1,1,134,0,0,1,0,1,1,0,0,3,1,2,135,0,0,0,0,0,0,0,0,0,0,0,0,0,0
11048,11048,Martin Cranie,3103,2007,Portsmouth FC,2,1,1,54,0,0,0,0,0,0,0,0,2,1,1,54,0,0,0,0,0,0,0,0,0,0,0,0,0,0
11049,11049,Kyle Naughton,2273,2009,Tottenham Hotspur,0,0,0,0,0,0,1,0,1,1,0,0,1,0,1,1,0,0,0,0,0,0,0,0,0,0,0,0,0,0
11050,11050,Phil Ifil,4449,2004,Tottenham Hotspur,1,1,0,90,0,0,1,1,0,90,0,0,2,2,0,180,0,0,0,0,0,0,0,0,0,0,0,0,0,0
11051,11051,Chuba Akpom,3801,2016,Liverpool FC,0,0,0,0,0,0,0,0,0,0,0,0,0,0,0,0,0,0,0,0,0,0,0,0,0,0,0,0,0,0
11052,11052,George McCartney,1340,2000,Sunderland AFC,0,0,0,0,0,0,2,1,1,105,0,0,2,1,1,105,0,0,0,0,0,0,0,0,0,0,0,0,0,0
11053,11053,Nacho Monreal,1498,2019,Arsenal FC,1,1,0,90,0,0,2,2,0,180,0,0,3,3,0,270,0,0,0,0,0,0,0,0,0,0,0,0,0,0
11054,11054,Steve Marlet,2896,2003,Fulham FC,1,1,0,89,1,0,0,0,0,0,0,0,1,1,0,89,1,0,0,0,0,1,0,1,0,0,0,0,0,0
11055,11055,Carlos Marinelli,2698,2003,Middlesbrough FC,0,0,0,0,0,0,1,1,0,54,1,0,1,1,0,54,1,0,0,0,0,0,1,1,0,0,0,0,0,0
11056,11056,Zeshan Rehman,1934,2005,Fulham FC,1,1,0,90,0,0,2,2,0,180,0,0,3,3,0,270,0,0,0,0,0,0,0,0,0,0,0,0,0,0
11057,11057,Daniele Daino,4450,2001,Derby County,1,1,0,90,0,0,1,1,0,77,0,0,2,2,0,167,0,0,0,0,0,0,0,0,0,0,0,0,0,0
11058,11058,Adam Reed,4451,2010,Sunderland AFC,0,0,0,0,0,0,0,0,0,0,0,0,0,0,0,0,0,0,0,0,0,0,0,0,0,0,0,0,0,0
11059,11059,Olufela Olomola,4312,2016,Southampton FC,0,0,0,0,0,0,0,0,0,0,0,0,0,0,0,0,0,0,0,0,0,0,0,0,0,0,0,0,0,0
11060,11060,Jermaine Beckford,3620,2011,Everton FC,1,1,0,64,0,0,1,0,1,5,0,0,2,1,1,69,0,0,0,0,0,0,0,0,0,0,0,0,0,0
11061,11061,Tommy Wright,4452,2001,Leicester City,1,0,1,4,0,0,0,0,0,0,0,0,1,0,1,4,0,0,0,0,0,0,0,0,0,0,0,0,0,0
11062,11062,Jesse Lingard,1646,2012,Manchester United,0,0,0,0,0,0,0,0,0,0,0,0,0,0,0,0,0,0,0,0,0,0,0,0,0,0,0,0,0,0
11063,11063,Emanuele Giaccherini,2263,2015,Sunderland AFC,0,0,0,0,0,0,0,0,0,0,0,0,0,0,0,0,0,0,0,0,0,0,0,0,0,0,0,0,0,0
11064,11064,Michael Obafemi,2328,2017,Southampton FC,1,0,1,8,0,0,0,0,0,0,0,0,1,0,1,8,0,0,0,0,0,0,0,0,0,0,0,0,0,0
11065,11065,Tom Soares,1991,2011,Stoke City,0,0,0,0,0,0,0,0,0,0,0,0,0,0,0,0,0,0,0,0,0,0,0,0,0,0,0,0,0,0
11066,11066,Colin Hendry,4190,2000,Coventry City,2,1,1,98,0,0,0,0,0,0,0,0,2,1,1,98,0,0,0,0,0,0,0,0,0,0,0,0,0,0
11067,11067,Christian Saydee,4453,2019,AFC Bournemouth,0,0,0,0,0,0,0,0,0,0,0,0,0,0,0,0,0,0,0,0,0,0,0,0,0,0,0,0,0,0
11068,11068,Patrik Berger,2689,2002,Liverpool FC,1,0,1,10,0,0,1,0,1,27,0,0,2,0,2,37,0,0,0,0,0,0,0,0,0,0,0,0,0,0
11069,11069,Reto Ziegler,1938,2006,Tottenham Hotspur,0,0,0,0,0,0,1,0,1,32,0,0,1,0,1,32,0,0,0,0,0,0,0,0,0,0,0,0,0,0
11070,11070,Adrien Silva,2565,2018,Leicester City,1,0,1,8,0,0,1,1,0,80,0,0,2,1,1,88,0,0,0,0,0,0,0,0,0,0,0,0,0,0
11071,11071,Ola Aina,3281,2015,Chelsea FC,0,0,0,0,0,0,0,0,0,0,0,0,0,0,0,0,0,0,0,0,0,0,0,0,0,0,0,0,0,0
11072,11072,Kasey Palmer,4160,2015,Chelsea FC,0,0,0,0,0,0,0,0,0,0,0,0,0,0,0,0,0,0,0,0,0,0,0,0,0,0,0,0,0,0
11073,11073,Charlie Colkett,4454,2015,Chelsea FC,0,0,0,0,0,0,0,0,0,0,0,0,0,0,0,0,0,0,0,0,0,0,0,0,0,0,0,0,0,0
11074,11074,Ferdinand Coly,4455,2002,Birmingham City,1,1,0,68,0,0,0,0,0,0,0,0,1,1,0,68,0,0,0,0,0,0,0,0,0,0,0,0,0,0
11075,11075,Lovre Kalinić,4456,2019,Aston Villa,0,0,0,0,0,0,0,0,0,0,0,0,0,0,0,0,0,0,0,0,0,0,0,0,0,0,0,0,0,0
11076,11076,Niall Mason,4457,2015,Aston Villa,0,0,0,0,0,0,0,0,0,0,0,0,0,0,0,0,0,0,0,0,0,0,0,0,0,0,0,0,0,0
11077,11077,Joe Bennett,2978,2008,Middlesbrough FC,0,0,0,0,0,0,1,0,1,44,0,0,1,0,1,44,0,0,0,0,0,0,0,0,0,0,0,0,0,0
11078,11078,Jonathan Franks,4458,2008,Middlesbrough FC,0,0,0,0,0,0,1,0,1,10,0,0,1,0,1,10,0,0,0,0,0,0,0,0,0,0,0,0,0,0
11079,11079,Stephen Darby,4459,2009,Liverpool FC,1,0,1,1,0,0,0,0,0,0,0,0,1,0,1,1,0,0,0,0,0,0,0,0,0,0,0,0,0,0
11080,11080,Kenedy,2932,2019,Chelsea FC,0,0,0,0,0,0,0,0,0,0,0,0,0,0,0,0,0,0,0,0,0,0,0,0,0,0,0,0,0,0
11081,11081,Ben Johnson,4056,2017,West Ham United,0,0,0,0,0,0,0,0,0,0,0,0,0,0,0,0,0,0,0,0,0,0,0,0,0,0,0,0,0,0
11082,11082,Toni Martínez,4460,2017,West Ham United,0,0,0,0,0,0,0,0,0,0,0,0,0,0,0,0,0,0,0,0,0,0,0,0,0,0,0,0,0,0
11083,11083,Ricardo,4461,2002,Manchester United,1,0,1,45,0,0,0,0,0,0,0,0,1,0,1,45,0,0,0,0,0,0,0,0,0,0,0,0,0,0
11084,11084,Gary Doherty,2792,2001,Tottenham Hotspur,3,2,1,186,0,0,4,2,2,201,0,0,7,4,3,387,0,0,0,0,0,0,0,0,0,0,0,0,0,0
11085,11085,Peter Whittingham,2969,2006,Aston Villa,1,0,1,31,0,0,1,1,0,51,0,0,2,1,1,82,0,0,0,0,0,0,0,0,0,0,0,0,0,0
11086,11086,Julian Gray,2653,2008,Fulham FC,1,0,1,5,0,0,0,0,0,0,0,0,1,0,1,5,0,0,0,0,0,0,0,0,0,0,0,0,0,0
11087,11087,Darnell Johnson,4462,2019,Leicester City,0,0,0,0,0,0,0,0,0,0,0,0,0,0,0,0,0,0,0,0,0,0,0,0,0,0,0,0,0,0
11088,11088,Jamar Loza,4463,2013,Norwich City,1,0,1,32,0,0,0,0,0,0,0,0,1,0,1,32,0,0,0,0,0,0,0,0,0,0,0,0,0,0
11089,11089,Abou Diaby,2434,2013,Arsenal FC,0,0,0,0,0,0,1,0,1,16,0,0,1,0,1,16,0,0,0,0,0,0,0,0,0,0,0,0,0,0
11090,11090,Ryan Fulton,4464,2015,Liverpool FC,0,0,0,0,0,0,0,0,0,0,0,0,0,0,0,0,0,0,0,0,0,0,0,0,0,0,0,0,0,0
11091,11091,Stuart Taylor,1684,2011,Manchester City,0,0,0,0,0,0,0,0,0,0,0,0,0,0,0,0,0,0,0,0,0,0,0,0,0,0,0,0,0,0
11092,11092,Thibaud Verlinden,4465,2016,Stoke City,0,0,0,0,0,0,0,0,0,0,0,0,0,0,0,0,0,0,0,0,0,0,0,0,0,0,0,0,0,0
11093,11093,Johnnie Jackson,3392,2005,Tottenham Hotspur,1,0,1,45,0,0,0,0,0,0,0,0,1,0,1,45,0,0,0,0,0,0,0,0,0,0,0,0,0,0
11094,11094,Jack Colback,1404,2009,Sunderland AFC,0,0,0,0,0,0,1,0,1,13,0,0,1,0,1,13,0,0,0,0,0,0,0,0,0,0,0,0,0,0
11095,11095,Cristian Ceballos,4466,2012,Tottenham Hotspur,0,0,0,0,0,0,0,0,0,0,0,0,0,0,0,0,0,0,0,0,0,0,0,0,0,0,0,0,0,0
11096,11096,Theofanis Gekas,4467,2008,Portsmouth FC,1,0,1,1,0,0,0,0,0,0,0,0,1,0,1,1,0,0,0,0,0,0,0,0,0,0,0,0,0,0
11097,11097,Duncan Watmore,2820,2014,Sunderland AFC,0,0,0,0,0,0,0,0,0,0,0,0,0,0,0,0,0,0,0,0,0,0,0,0,0,0,0,0,0,0
11098,11098,Serge Gnabry,2943,2012,Arsenal FC,0,0,0,0,0,0,1,0,1,7,0,0,1,0,1,7,0,0,0,0,0,0,0,0,0,0,0,0,0,0
11099,11099,Dong-won Ji,3576,2012,Sunderland AFC,0,0,0,0,0,0,0,0,0,0,0,0,0,0,0,0,0,0,0,0,0,0,0,0,0,0,0,0,0,0
11100,11100,Georges-Kévin N'Koudou,2801,2018,Tottenham Hotspur,0,0,0,0,0,0,1,0,1,4,0,0,1,0,1,4,0,0,0,0,0,0,0,0,0,0,0,0,0,0
11101,11101,Kazaiah Sterling,2996,2018,Tottenham Hotspur,0,0,0,0,0,0,0,0,0,0,0,0,0,0,0,0,0,0,0,0,0,0,0,0,0,0,0,0,0,0
11102,11102,Jørgen Nielsen,4468,2000,Liverpool FC,0,0,0,0,0,0,0,0,0,0,0,0,0,0,0,0,0,0,0,0,0,0,0,0,0,0,0,0,0,0
11103,11103,Imants Bleidelis,4336,2000,Southampton FC,1,0,1,6,0,0,0,0,0,0,0,0,1,0,1,6,0,0,0,0,0,0,0,0,0,0,0,0,0,0
11104,11104,Nick Powell,2876,2015,Manchester United,0,0,0,0,0,0,1,0,1,16,0,0,1,0,1,16,0,0,0,0,0,0,0,0,0,0,0,0,0,0
11105,11105,Nathan Eccleston,4296,2009,Liverpool FC,0,0,0,0,0,0,1,0,1,12,0,0,1,0,1,12,0,0,0,0,0,0,0,0,0,0,0,0,0,0
11106,11106,John Johnson,4469,2008,Middlesbrough FC,1,0,1,36,0,0,0,0,0,0,0,0,1,0,1,36,0,0,0,0,0,0,0,0,0,0,0,0,0,0
11107,11107,Andy Campbell,2074,2001,Middlesbrough FC,1,0,1,45,0,0,3,0,3,67,0,0,4,0,4,112,0,0,0,0,0,0,0,0,0,0,0,0,0,0
11108,11108,Stephen Clemence,1516,2001,Tottenham Hotspur,2,1,1,97,0,0,3,2,1,96,0,0,5,3,2,193,0,0,0,0,0,0,0,0,0,0,0,0,0,0
11109,11109,Gary O'Neil,1389,2003,Portsmouth FC,1,1,0,90,2,0,1,1,0,59,0,0,2,2,0,149,2,0,0,0,0,1,0,1,0,0,0,0,0,0
11110,11110,Luke Cundle,4470,2019,Wolverhampton Wanderers,0,0,0,0,0,0,0,0,0,0,0,0,0,0,0,0,0,0,0,0,0,0,0,0,0,0,0,0,0,0
11111,11111,Ángelo Balanta,4471,2011,Queens Park Rangers,0,0,0,0,0,0,0,0,0,0,0,0,0,0,0,0,0,0,0,0,0,0,0,0,0,0,0,0,0,0
11112,11112,Mickaël Tavares,4472,2012,Fulham FC,0,0,0,0,0,0,0,0,0,0,0,0,0,0,0,0,0,0,0,0,0,0,0,0,0,0,0,0,0,0
11113,11113,Jarosław Fojut,4473,2005,Bolton Wanderers,0,0,0,0,0,0,1,0,1,4,0,0,1,0,1,4,0,0,0,0,0,0,0,0,0,0,0,0,0,0
11114,11114,Heiðar Helguson,1759,2008,Bolton Wanderers,0,0,0,0,0,0,1,0,1,26,0,0,1,0,1,26,0,0,0,0,0,0,0,0,0,0,0,0,0,0
11115,11115,Aristote Nsiala,4474,2010,Everton FC,0,0,0,0,0,0,0,0,0,0,0,0,0,0,0,0,0,0,0,0,0,0,0,0,0,0,0,0,0,0
11116,11116,Conor McAleny,4217,2010,Everton FC,0,0,0,0,0,0,0,0,0,0,0,0,0,0,0,0,0,0,0,0,0,0,0,0,0,0,0,0,0,0
11117,11117,Reece Oxford,2789,2017,West Ham United,1,0,1,4,0,0,0,0,0,0,0,0,1,0,1,4,0,0,0,0,0,0,0,0,0,0,0,0,0,0
11118,11118,Tyreece John-Jules,4475,2019,Arsenal FC,0,0,0,0,0,0,0,0,0,0,0,0,0,0,0,0,0,0,0,0,0,0,0,0,0,0,0,0,0,0
11119,11119,Darren Pratley,3818,2003,Fulham FC,0,0,0,0,0,0,1,0,1,16,0,0,1,0,1,16,0,0,0,0,0,0,0,0,0,0,0,0,0,0
11120,11120,Adalberto Peñaranda,3638,2019,Watford FC,0,0,0,0,0,0,0,0,0,0,0,0,0,0,0,0,0,0,0,0,0,0,0,0,0,0,0,0,0,0
11121,11121,Alexandre Jankewitz,4476,2019,Southampton FC,0,0,0,0,0,0,0,0,0,0,0,0,0,0,0,0,0,0,0,0,0,0,0,0,0,0,0,0,0,0
11122,11122,Sam Field,1665,2015,West Bromwich Albion,1,0,1,4,0,0,0,0,0,0,0,0,1,0,1,4,0,0,0,0,0,0,0,0,0,0,0,0,0,0
11123,11123,Adam Bolder,3867,2000,Derby County,1,0,1,4,0,0,1,0,1,1,0,0,2,0,2,5,0,0,0,0,0,0,0,0,0,0,0,0,0,0
11124,11124,Deon Burton,3374,2003,Portsmouth FC,0,0,0,0,0,0,1,0,1,18,0,0,1,0,1,18,0,0,0,0,0,0,0,0,0,0,0,0,0,0
11125,11125,Jordan Spence,2760,2010,West Ham United,1,1,0,90,0,0,1,1,0,90,0,0,2,2,0,180,0,0,0,0,0,0,0,0,0,0,0,0,0,0
11126,11126,Dylan Tombides,4477,2010,West Ham United,0,0,0,0,0,0,0,0,0,0,0,0,0,0,0,0,0,0,0,0,0,0,0,0,0,0,0,0,0,0
11127,11127,Rafik Halliche,2652,2012,Fulham FC,0,0,0,0,0,0,0,0,0,0,0,0,0,0,0,0,0,0,0,0,0,0,0,0,0,0,0,0,0,0
11128,11128,Liam O'Neil,3856,2014,West Bromwich Albion,0,0,0,0,0,0,0,0,0,0,0,0,0,0,0,0,0,0,0,0,0,0,0,0,0,0,0,0,0,0
11129,11129,Scott Golbourne,4478,2007,Reading FC,0,0,0,0,0,0,1,1,0,62,0,0,1,1,0,62,0,0,0,0,0,0,0,0,0,0,0,0,0,0
11130,11130,John Halls,4479,2007,Reading FC,0,0,0,0,0,0,1,0,1,7,0,0,1,0,1,7,0,0,0,0,0,0,0,0,0,0,0,0,0,0
11131,11131,David May,3319,2002,Manchester United,0,0,0,0,0,0,1,0,1,2,0,0,1,0,1,2,0,0,0,0,0,0,0,0,0,0,0,0,0,0
11132,11132,Michael Stewart,4038,2002,Manchester United,0,0,0,0,0,0,1,0,1,1,0,0,1,0,1,1,0,0,0,0,0,0,0,0,0,0,0,0,0,0
11133,11133,Chris Kettings,4480,2010,Blackpool FC,0,0,0,0,0,0,0,0,0,0,0,0,0,0,0,0,0,0,0,0,0,0,0,0,0,0,0,0,0,0
11134,11134,Tyias Browning,3608,2018,Everton FC,0,0,0,0,0,0,0,0,0,0,0,0,0,0,0,0,0,0,0,0,0,0,0,0,0,0,0,0,0,0
11135,11135,Ryan Schofield,4481,2018,Huddersfield Town,0,0,0,0,0,0,0,0,0,0,0,0,0,0,0,0,0,0,0,0,0,0,0,0,0,0,0,0,0,0
11136,11136,Conor McAleny,4217,2014,Everton FC,0,0,0,0,0,0,0,0,0,0,0,0,0,0,0,0,0,0,0,0,0,0,0,0,0,0,0,0,0,0
11137,11137,Jayson Molumby,4079,2017,Brighton & Hove Albion,0,0,0,0,0,0,0,0,0,0,0,0,0,0,0,0,0,0,0,0,0,0,0,0,0,0,0,0,0,0
11138,11138,Danny Graham,2317,2006,Watford FC,1,0,1,10,0,0,0,0,0,0,0,0,1,0,1,10,0,0,0,0,0,0,0,0,0,0,0,0,0,0
11139,11139,Paul Gallagher,1142,2009,Blackburn Rovers,1,0,1,15,0,0,0,0,0,0,0,0,1,0,1,15,0,0,0,0,0,0,0,0,0,0,0,0,0,0
11140,11140,Mbulelo Mabizela,3479,2004,Tottenham Hotspur,1,1,0,67,0,0,0,0,0,0,0,0,1,1,0,67,0,0,0,0,0,0,0,0,0,0,0,0,0,0
11141,11141,George Evans,3963,2015,Manchester City,0,0,0,0,0,0,0,0,0,0,0,0,0,0,0,0,0,0,0,0,0,0,0,0,0,0,0,0,0,0
11142,11142,Moses Makasi,4482,2017,West Ham United,0,0,0,0,0,0,0,0,0,0,0,0,0,0,0,0,0,0,0,0,0,0,0,0,0,0,0,0,0,0
11143,11143,Anthony Stokes,3488,2008,Sunderland AFC,1,0,1,28,0,0,1,0,1,12,0,0,2,0,2,40,0,0,0,0,0,0,0,0,0,0,0,0,0,0
11144,11144,Tom Robson,2527,2016,Sunderland AFC,0,0,0,0,0,0,0,0,0,0,0,0,0,0,0,0,0,0,0,0,0,0,0,0,0,0,0,0,0,0
11145,11145,Josh Robson,4483,2016,Sunderland AFC,0,0,0,0,0,0,0,0,0,0,0,0,0,0,0,0,0,0,0,0,0,0,0,0,0,0,0,0,0,0
11146,11146,Jacob Maddox,4484,2019,Southampton FC,0,0,0,0,0,0,0,0,0,0,0,0,0,0,0,0,0,0,0,0,0,0,0,0,0,0,0,0,0,0
11147,11147,Michael Ledger,4485,2016,Sunderland AFC,0,0,0,0,0,0,0,0,0,0,0,0,0,0,0,0,0,0,0,0,0,0,0,0,0,0,0,0,0,0
11148,11148,Anderson,2018,2014,Manchester United,0,0,0,0,0,0,1,0,1,20,0,0,1,0,1,20,0,0,0,0,0,0,0,0,0,0,0,0,0,0
11149,11149,Cameron Carter-Vickers,3747,2017,Tottenham Hotspur,0,0,0,0,0,0,0,0,0,0,0,0,0,0,0,0,0,0,0,0,0,0,0,0,0,0,0,0,0,0
11150,11150,Tom Carroll,2816,2013,Tottenham Hotspur,0,0,0,0,0,0,0,0,0,0,0,0,0,0,0,0,0,0,0,0,0,0,0,0,0,0,0,0,0,0
11151,11151,Curtis Jones,2310,2018,Liverpool FC,0,0,0,0,0,0,0,0,0,0,0,0,0,0,0,0,0,0,0,0,0,0,0,0,0,0,0,0,0,0
11152,11152,Josh Pask,4486,2017,West Ham United,0,0,0,0,0,0,0,0,0,0,0,0,0,0,0,0,0,0,0,0,0,0,0,0,0,0,0,0,0,0
11153,11153,Grady Diangana,3518,2017,West Ham United,0,0,0,0,0,0,0,0,0,0,0,0,0,0,0,0,0,0,0,0,0,0,0,0,0,0,0,0,0,0
11154,11154,Charlie Ward,4487,2013,Stoke City,0,0,0,0,0,0,0,0,0,0,0,0,0,0,0,0,0,0,0,0,0,0,0,0,0,0,0,0,0,0
11155,11155,Michael Duberry,2291,2001,Leeds United,0,0,0,0,0,0,2,2,0,180,0,0,2,2,0,180,0,0,0,0,0,0,0,0,0,0,0,0,0,0
11156,11156,Javier Mascherano,1893,2010,Liverpool FC,1,1,0,79,0,0,0,0,0,0,0,0,1,1,0,79,0,0,0,0,0,0,0,0,0,0,0,0,0,0
11157,11157,Diego Cavalieri,4120,2010,Liverpool FC,0,0,0,0,0,0,0,0,0,0,0,0,0,0,0,0,0,0,0,0,0,0,0,0,0,0,0,0,0,0
11158,11158,Luke Chadwick,3302,2002,Manchester United,0,0,0,0,0,0,1,0,1,27,0,0,1,0,1,27,0,0,0,0,0,0,0,0,0,0,0,0,0,0
11159,11159,Jemal Johnson,4333,2004,Blackburn Rovers,1,0,1,28,0,0,2,0,2,59,0,0,3,0,3,87,0,0,0,0,0,0,0,0,0,0,0,0,0,0
11160,11160,Egil Østenstad,2300,2001,Blackburn Rovers,2,2,0,121,0,0,2,0,2,41,0,0,4,2,2,162,0,0,0,0,0,0,0,0,0,0,0,0,0,0
11161,11161,Horacio Carbonari,3372,2001,Derby County,2,2,0,156,0,0,1,1,0,90,0,0,3,3,0,246,0,0,0,0,0,0,0,0,0,0,0,0,0,0
11162,11162,Liam Agnew,4096,2013,Sunderland AFC,0,0,0,0,0,0,0,0,0,0,0,0,0,0,0,0,0,0,0,0,0,0,0,0,0,0,0,0,0,0
11163,11163,Adam King,4488,2013,Swansea City,0,0,0,0,0,0,0,0,0,0,0,0,0,0,0,0,0,0,0,0,0,0,0,0,0,0,0,0,0,0
11164,11164,Rory Watson,4489,2014,Hull City,0,0,0,0,0,0,0,0,0,0,0,0,0,0,0,0,0,0,0,0,0,0,0,0,0,0,0,0,0,0
11165,11165,Callum Willock,4490,2002,Fulham FC,1,0,1,38,0,0,1,0,1,14,0,0,2,0,2,52,0,0,0,0,0,0,0,0,0,0,0,0,0,0
11166,11166,Filip Benković,4491,2019,Leicester City,0,0,0,0,0,0,0,0,0,0,0,0,0,0,0,0,0,0,0,0,0,0,0,0,0,0,0,0,0,0
11167,11167,Joe Keenan,4492,2001,Chelsea FC,0,0,0,0,0,0,1,0,1,14,0,0,1,0,1,14,0,0,0,0,0,0,0,0,0,0,0,0,0,0
11168,11168,Carl Robinson,3220,2003,Chelsea FC,1,0,1,5,0,0,0,0,0,0,0,0,1,0,1,5,0,0,0,0,0,0,0,0,0,0,0,0,0,0
11169,11169,Malcolm Christie,2137,2004,Middlesbrough FC,1,1,0,69,0,0,1,1,0,66,1,0,2,2,0,135,1,0,0,0,0,0,1,1,0,0,0,0,0,0
11170,11170,Matthew Bates,1887,2004,Middlesbrough FC,2,0,2,2,0,0,0,0,0,0,0,0,2,0,2,2,0,0,0,0,0,0,0,0,0,0,0,0,0,0
11171,11171,Ali Koiki,4188,2018,Burnley FC,0,0,0,0,0,0,0,0,0,0,0,0,0,0,0,0,0,0,0,0,0,0,0,0,0,0,0,0,0,0
11172,11172,Gio McGregor,4493,2019,Crystal Palace,0,0,0,0,0,0,0,0,0,0,0,0,0,0,0,0,0,0,0,0,0,0,0,0,0,0,0,0,0,0
11173,11173,Alan Wright,2766,2006,Sheffield United,0,0,0,0,0,0,1,1,0,90,0,0,1,1,0,90,0,0,0,0,0,0,0,0,0,0,0,0,0,0
11174,11174,Lee Barnard,4494,2005,Tottenham Hotspur,2,0,2,56,0,0,1,0,1,12,0,0,3,0,3,68,0,0,0,0,0,0,0,0,0,0,0,0,0,0
11175,11175,Jordan Cook,4134,2011,Sunderland AFC,0,0,0,0,0,0,0,0,0,0,0,0,0,0,0,0,0,0,0,0,0,0,0,0,0,0,0,0,0,0
11176,11176,Brian Kerr,3983,2000,Newcastle United,0,0,0,0,0,0,1,0,1,1,0,0,1,0,1,1,0,0,0,0,0,0,0,0,0,0,0,0,0,0
11177,11177,John Ruddy,1367,2005,Everton FC,1,0,1,80,0,0,0,0,0,0,0,0,1,0,1,80,0,0,0,0,0,0,0,0,0,0,0,0,0,0
11178,11178,Grant Leadbitter,1219,2009,Sunderland AFC,1,0,1,28,0,0,0,0,0,0,0,0,1,0,1,28,0,0,0,0,0,0,0,0,0,0,0,0,0,0
11179,11179,Andriy Shevchenko,1765,2009,Chelsea FC,0,0,0,0,0,0,1,0,1,3,0,0,1,0,1,3,0,0,0,0,0,0,0,0,0,0,0,0,0,0
11180,11180,Taher El-Khalej,2045,2002,Charlton Athletic,3,2,1,195,0,0,0,0,0,0,0,0,3,2,1,195,0,0,0,0,0,0,0,0,0,0,0,0,0,0
11181,11181,De Pedro,4495,2004,Blackburn Rovers,1,1,0,46,0,0,1,0,1,13,0,0,2,1,1,59,0,0,0,0,0,0,0,0,0,0,0,0,0,0
11182,11182,Jacob Burns,4253,2002,Leeds United,1,1,0,90,0,0,1,1,0,37,0,0,2,2,0,127,0,0,0,0,0,0,0,0,0,0,0,0,0,0
11183,11183,Andre Wisdom,2625,2010,Liverpool FC,0,0,0,0,0,0,0,0,0,0,0,0,0,0,0,0,0,0,0,0,0,0,0,0,0,0,0,0,0,0
11184,11184,Henri Lansbury,2851,2011,Arsenal FC,1,0,1,19,0,0,0,0,0,0,0,0,1,0,1,19,0,0,0,0,0,0,0,0,0,0,0,0,0,0
11185,11185,Jon Walters,1555,2018,Burnley FC,0,0,0,0,0,0,0,0,0,0,0,0,0,0,0,0,0,0,0,0,0,0,0,0,0,0,0,0,0,0
11186,11186,Jack Robinson,3118,2009,Liverpool FC,0,0,0,0,0,0,1,0,1,3,0,0,1,0,1,3,0,0,0,0,0,0,0,0,0,0,0,0,0,0
11187,11187,Stefan Postma,3271,2004,Aston Villa,0,0,0,0,0,0,3,2,1,224,0,0,3,2,1,224,0,0,0,0,0,0,0,0,0,0,0,0,0,0
11188,11188,Giovani dos Santos,2499,2009,Tottenham Hotspur,1,0,1,12,0,0,0,0,0,0,0,0,1,0,1,12,0,0,0,0,0,0,0,0,0,0,0,0,0,0
11189,11189,Jonathan Douglas,1138,2002,Blackburn Rovers,1,0,1,1,0,0,0,0,0,0,0,0,1,0,1,1,0,0,0,0,0,0,0,0,0,0,0,0,0,0
11190,11190,Stig Tøfting,4050,2001,Bolton Wanderers,3,3,0,251,0,0,3,3,0,225,0,0,6,6,0,476,0,0,0,0,0,0,0,0,0,0,0,0,0,0
11191,11191,Tony McMahon,1332,2005,Middlesbrough FC,1,1,0,90,0,0,2,2,0,72,0,0,3,3,0,162,0,0,0,0,0,0,0,0,0,0,0,0,0,0
11192,11192,Leon Best,2399,2004,Southampton FC,1,0,1,14,0,0,2,1,1,65,0,0,3,1,2,79,0,0,0,0,0,0,0,0,0,0,0,0,0,0
11193,11193,Dominic Ball,4496,2014,Tottenham Hotspur,0,0,0,0,0,0,0,0,0,0,0,0,0,0,0,0,0,0,0,0,0,0,0,0,0,0,0,0,0,0
11194,11194,Cristian Ceballos,4466,2014,Tottenham Hotspur,0,0,0,0,0,0,0,0,0,0,0,0,0,0,0,0,0,0,0,0,0,0,0,0,0,0,0,0,0,0
11195,11195,Rob Lainton,4497,2010,Bolton Wanderers,0,0,0,0,0,0,0,0,0,0,0,0,0,0,0,0,0,0,0,0,0,0,0,0,0,0,0,0,0,0
11196,11196,Danny Hoesen,4498,2010,Fulham FC,0,0,0,0,0,0,0,0,0,0,0,0,0,0,0,0,0,0,0,0,0,0,0,0,0,0,0,0,0,0
11197,11197,Brad Jones,1431,2006,Middlesbrough FC,1,1,0,90,0,0,1,1,0,90,0,0,2,2,0,180,0,0,0,0,0,0,0,0,0,0,0,0,0,0
11198,11198,Kieran Agard,4499,2009,Everton FC,0,0,0,0,0,0,1,0,1,1,0,0,1,0,1,1,0,0,0,0,0,0,0,0,0,0,0,0,0,0
11199,11199,Chris Kirkland,2056,2001,Liverpool FC,1,1,0,90,0,0,0,0,0,0,0,0,1,1,0,90,0,0,0,0,0,0,0,0,0,0,0,0,0,0
11200,11200,Peter Clarke,4359,2000,Everton FC,0,0,0,0,0,0,1,0,1,58,0,0,1,0,1,58,0,0,0,0,0,0,0,0,0,0,0,0,0,0
11201,11201,Dominic Solanke,1194,2016,Chelsea FC,0,0,0,0,0,0,0,0,0,0,0,0,0,0,0,0,0,0,0,0,0,0,0,0,0,0,0,0,0,0
11202,11202,Aaron Mitchell,4500,2014,Queens Park Rangers,0,0,0,0,0,0,0,0,0,0,0,0,0,0,0,0,0,0,0,0,0,0,0,0,0,0,0,0,0,0
11203,11203,Román Golobart,4117,2010,Wigan Athletic,0,0,0,0,0,0,0,0,0,0,0,0,0,0,0,0,0,0,0,0,0,0,0,0,0,0,0,0,0,0
11204,11204,Jason Scotland,2063,2010,Wigan Athletic,0,0,0,0,0,0,0,0,0,0,0,0,0,0,0,0,0,0,0,0,0,0,0,0,0,0,0,0,0,0
11205,11205,Robert Huth,1884,2002,Chelsea FC,1,1,0,90,0,0,1,1,0,90,0,0,2,2,0,180,0,0,0,0,0,0,0,0,0,0,0,0,0,0
11206,11206,Marcus Browne,2644,2017,West Ham United,0,0,0,0,0,0,0,0,0,0,0,0,0,0,0,0,0,0,0,0,0,0,0,0,0,0,0,0,0,0
11207,11207,Tom Beadling,4501,2015,Sunderland AFC,0,0,0,0,0,0,0,0,0,0,0,0,0,0,0,0,0,0,0,0,0,0,0,0,0,0,0,0,0,0
11208,11208,Joey O'Brien,2412,2004,Bolton Wanderers,1,0,1,8,0,0,0,0,0,0,0,0,1,0,1,8,0,0,0,0,0,0,0,0,0,0,0,0,0,0
11209,11209,James Vaughan,3240,2004,Everton FC,1,0,1,16,1,0,1,0,1,10,0,0,2,0,2,26,1,0,0,0,0,0,0,0,0,0,0,0,0,0
11210,11210,Dominic Samuel,4502,2012,Reading FC,0,0,0,0,0,0,1,0,1,18,0,0,1,0,1,18,0,0,0,0,0,0,0,0,0,0,0,0,0,0
11211,11211,Jordan Obita,4503,2012,Reading FC,0,0,0,0,0,0,0,0,0,0,0,0,0,0,0,0,0,0,0,0,0,0,0,0,0,0,0,0,0,0
11212,11212,Lloyd Isgrove,3533,2012,Southampton FC,0,0,0,0,0,0,0,0,0,0,0,0,0,0,0,0,0,0,0,0,0,0,0,0,0,0,0,0,0,0
11213,11213,Calum Chambers,1470,2012,Southampton FC,0,0,0,0,0,0,0,0,0,0,0,0,0,0,0,0,0,0,0,0,0,0,0,0,0,0,0,0,0,0
11214,11214,Florent Cuvelier,4504,2012,Stoke City,0,0,0,0,0,0,0,0,0,0,0,0,0,0,0,0,0,0,0,0,0,0,0,0,0,0,0,0,0,0
11215,11215,Andy Marriott,4505,2002,Birmingham City,0,0,0,0,0,0,1,1,0,90,0,0,1,1,0,90,0,0,0,0,0,0,0,0,0,0,0,0,0,0
11216,11216,Sam Gallagher,3689,2014,Southampton FC,0,0,0,0,0,0,0,0,0,0,0,0,0,0,0,0,0,0,0,0,0,0,0,0,0,0,0,0,0,0
11217,11217,Clinton Morrison,1521,2005,Birmingham City,0,0,0,0,0,0,1,0,1,3,0,0,1,0,1,3,0,0,0,0,0,0,0,0,0,0,0,0,0,0
11218,11218,Ragnvald Soma,4446,2001,West Ham United,0,0,0,0,0,0,3,1,2,125,0,0,3,1,2,125,0,0,0,0,0,0,0,0,0,0,0,0,0,0
11219,11219,Federico Fazio,1163,2015,Tottenham Hotspur,0,0,0,0,0,0,0,0,0,0,0,0,0,0,0,0,0,0,0,0,0,0,0,0,0,0,0,0,0,0
11220,11220,Csaba Somogyi,4506,2012,Fulham FC,0,0,0,0,0,0,0,0,0,0,0,0,0,0,0,0,0,0,0,0,0,0,0,0,0,0,0,0,0,0
11221,11221,Ciaran Clark,1437,2009,Aston Villa,1,1,0,90,0,0,0,0,0,0,0,0,1,1,0,90,0,0,0,0,0,0,0,0,0,0,0,0,0,0
11222,11222,David Stockdale,2558,2009,Fulham FC,1,1,0,90,0,0,0,0,0,0,0,0,1,1,0,90,0,0,0,0,0,0,0,0,0,0,0,0,0,0
11223,11223,Jason Brown,3748,2006,Blackburn Rovers,1,0,1,44,0,0,0,0,0,0,0,0,1,0,1,44,0,0,0,0,0,0,0,0,0,0,0,0,0,0
11224,11224,Robbie Stockdale,2697,2003,Middlesbrough FC,1,0,1,38,0,0,1,0,1,44,0,0,2,0,2,82,0,0,0,0,0,0,0,0,0,0,0,0,0,0
11225,11225,David Wheater,2218,2006,Middlesbrough FC,1,1,0,90,1,0,1,0,1,2,0,0,2,1,1,92,1,0,0,0,0,1,0,1,0,0,0,0,0,0
11226,11226,George Dobson,4507,2015,West Ham United,0,0,0,0,0,0,0,0,0,0,0,0,0,0,0,0,0,0,0,0,0,0,0,0,0,0,0,0,0,0
11227,11227,Conor Coady,2144,2012,Liverpool FC,0,0,0,0,0,0,1,0,1,1,0,0,1,0,1,1,0,0,0,0,0,0,0,0,0,0,0,0,0,0
11228,11228,Gomes,1266,2013,Tottenham Hotspur,0,0,0,0,0,0,0,0,0,0,0,0,0,0,0,0,0,0,0,0,0,0,0,0,0,0,0,0,0,0
11229,11229,Nathan Ashton,4508,2007,Fulham FC,1,1,0,90,0,0,0,0,0,0,0,0,1,1,0,90,0,0,0,0,0,0,0,0,0,0,0,0,0,0
11230,11230,Jake Livermore,1657,2009,Tottenham Hotspur,0,0,0,0,0,0,1,0,1,1,0,0,1,0,1,1,0,0,0,0,0,0,0,0,0,0,0,0,0,0
11231,11231,Luca de la Torre,4509,2018,Fulham FC,0,0,0,0,0,0,0,0,0,0,0,0,0,0,0,0,0,0,0,0,0,0,0,0,0,0,0,0,0,0
11232,11232,Lewis Cass,4510,2018,Newcastle United,0,0,0,0,0,0,0,0,0,0,0,0,0,0,0,0,0,0,0,0,0,0,0,0,0,0,0,0,0,0
11233,11233,Kelland Watts,4238,2018,Newcastle United,0,0,0,0,0,0,0,0,0,0,0,0,0,0,0,0,0,0,0,0,0,0,0,0,0,0,0,0,0,0
11234,11234,James Husband,4511,2016,Middlesbrough FC,0,0,0,0,0,0,1,1,0,59,0,0,1,1,0,59,0,0,0,0,0,0,0,0,0,0,0,0,0,0
11235,11235,Jan Kromkamp,3558,2006,Liverpool FC,0,0,0,0,0,0,1,1,0,90,0,0,1,1,0,90,0,0,0,0,0,0,0,0,0,0,0,0,0,0
11236,11236,Graham Kavanagh,1816,2006,Wigan Athletic,1,0,1,12,0,0,1,0,1,3,0,0,2,0,2,15,0,0,0,0,0,0,0,0,0,0,0,0,0,0
11237,11237,David Connolly,1970,2006,Wigan Athletic,1,0,1,70,0,0,1,0,1,1,0,0,2,0,2,71,0,0,0,0,0,0,0,0,0,0,0,0,0,0
11238,11238,Greg Halford,1968,2010,Wolverhampton Wanderers,1,0,1,1,0,0,1,0,1,20,0,0,2,0,2,21,0,0,0,0,0,0,0,0,0,0,0,0,0,0
11239,11239,Andy Keogh,3519,2010,Wolverhampton Wanderers,1,0,1,41,0,0,0,0,0,0,0,0,1,0,1,41,0,0,0,0,0,0,0,0,0,0,0,0,0,0
11240,11240,Freddie Ladapo,4418,2017,Crystal Palace,0,0,0,0,0,0,1,0,1,16,0,0,1,0,1,16,0,0,0,0,0,0,0,0,0,0,0,0,0,0
11241,11241,Jordon Mutch,1024,2017,Crystal Palace,0,0,0,0,0,0,0,0,0,0,0,0,0,0,0,0,0,0,0,0,0,0,0,0,0,0,0,0,0,0
11242,11242,Matthias Fanimo,4512,2012,West Ham United,0,0,0,0,0,0,0,0,0,0,0,0,0,0,0,0,0,0,0,0,0,0,0,0,0,0,0,0,0,0
11243,11243,Graham Burke,3874,2011,Aston Villa,0,0,0,0,0,0,0,0,0,0,0,0,0,0,0,0,0,0,0,0,0,0,0,0,0,0,0,0,0,0
11244,11244,Ryan Fredericks,2202,2013,Tottenham Hotspur,0,0,0,0,0,0,0,0,0,0,0,0,0,0,0,0,0,0,0,0,0,0,0,0,0,0,0,0,0,0
11245,11245,Danny Graham,2317,2005,Middlesbrough FC,2,0,2,19,0,0,1,1,0,81,0,0,3,1,2,100,0,0,0,0,0,0,0,0,0,0,0,0,0,0
11246,11246,Rob Lainton,4497,2011,Bolton Wanderers,0,0,0,0,0,0,0,0,0,0,0,0,0,0,0,0,0,0,0,0,0,0,0,0,0,0,0,0,0,0
11247,11247,Gilles De Bilde,4513,2000,Aston Villa,1,1,0,67,0,0,3,3,0,236,0,0,4,4,0,303,0,0,0,0,0,0,0,0,0,0,0,0,0,0
11248,11248,Maynor Figueroa,2057,2007,Wigan Athletic,2,1,1,91,0,0,0,0,0,0,0,0,2,1,1,91,0,0,0,0,0,0,0,0,0,0,0,0,0,0
11249,11249,Jamie Ness,4426,2013,Stoke City,0,0,0,0,0,0,0,0,0,0,0,0,0,0,0,0,0,0,0,0,0,0,0,0,0,0,0,0,0,0
11250,11250,Aaron Ramsdale,3339,2017,AFC Bournemouth,0,0,0,0,0,0,0,0,0,0,0,0,0,0,0,0,0,0,0,0,0,0,0,0,0,0,0,0,0,0
11251,11251,John-Kymani Gordon,4514,2019,Crystal Palace,0,0,0,0,0,0,0,0,0,0,0,0,0,0,0,0,0,0,0,0,0,0,0,0,0,0,0,0,0,0
11252,11252,Tom Edwards,2377,2016,Stoke City,0,0,0,0,0,0,0,0,0,0,0,0,0,0,0,0,0,0,0,0,0,0,0,0,0,0,0,0,0,0
11253,11253,Nathaniel Chalobah,2330,2011,Chelsea FC,0,0,0,0,0,0,0,0,0,0,0,0,0,0,0,0,0,0,0,0,0,0,0,0,0,0,0,0,0,0
11254,11254,Joseph-Désiré Job,2071,2005,Middlesbrough FC,0,0,0,0,0,0,1,0,1,12,0,0,1,0,1,12,0,0,0,0,0,0,0,0,0,0,0,0,0,0
11255,11255,Matt Mills,4246,2006,Manchester City,0,0,0,0,0,0,1,1,0,60,0,0,1,1,0,60,0,0,0,0,0,0,0,0,0,0,0,0,0,0
11256,11256,Alton Thelwell,3022,2001,Tottenham Hotspur,2,0,2,58,0,0,0,0,0,0,0,0,2,0,2,58,0,0,0,0,0,0,0,0,0,0,0,0,0,0
11257,11257,Matthew Briggs,2559,2006,Fulham FC,0,0,0,0,0,0,1,0,1,13,0,0,1,0,1,13,0,0,0,0,0,0,0,0,0,0,0,0,0,0
11258,11258,Graham Stack,4515,2003,Arsenal FC,0,0,0,0,0,0,0,0,0,0,0,0,0,0,0,0,0,0,0,0,0,0,0,0,0,0,0,0,0,0
11259,11259,Richard Wright,2977,2006,Everton FC,0,0,0,0,0,0,1,1,0,90,0,0,1,1,0,90,0,0,0,0,0,0,0,0,0,0,0,0,0,0
11260,11260,Loïc Damour,4516,2018,Cardiff City,1,0,1,4,0,0,1,0,1,17,0,0,2,0,2,21,0,0,0,0,0,0,0,0,0,0,0,0,0,0
11261,11261,Kevin Cooper,4517,2003,Wolverhampton Wanderers,1,0,1,44,0,0,0,0,0,0,0,0,1,0,1,44,0,0,0,0,0,0,0,0,0,0,0,0,0,0
11262,11262,Delroy Facey,3991,2003,Bolton Wanderers,0,0,0,0,0,0,1,0,1,15,0,0,1,0,1,15,0,0,0,0,0,0,0,0,0,0,0,0,0,0
11263,11263,David Cornell,3839,2014,Swansea City,0,0,0,0,0,0,0,0,0,0,0,0,0,0,0,0,0,0,0,0,0,0,0,0,0,0,0,0,0,0
11264,11264,Ross Turnbull,2217,2005,Middlesbrough FC,0,0,0,0,0,0,2,2,0,180,0,0,2,2,0,180,0,0,0,0,0,0,0,0,0,0,0,0,0,0
11265,11265,Marcus Browne,2644,2015,West Ham United,0,0,0,0,0,0,0,0,0,0,0,0,0,0,0,0,0,0,0,0,0,0,0,0,0,0,0,0,0,0
11266,11266,Mineiro,4518,2008,Chelsea FC,1,0,1,15,0,0,0,0,0,0,0,0,1,0,1,15,0,0,0,0,0,0,0,0,0,0,0,0,0,0
11267,11267,Martyn Waghorn,4094,2008,Sunderland AFC,0,0,0,0,0,0,1,1,0,46,0,0,1,1,0,46,0,0,0,0,0,0,0,0,0,0,0,0,0,0
11268,11268,Jordan Henderson,1426,2008,Sunderland AFC,0,0,0,0,0,0,1,0,1,44,0,0,1,0,1,44,0,0,0,0,0,0,0,0,0,0,0,0,0,0
11269,11269,Dennis Cirkin,4519,2019,Tottenham Hotspur,0,0,0,0,0,0,0,0,0,0,0,0,0,0,0,0,0,0,0,0,0,0,0,0,0,0,0,0,0,0
11270,11270,Gerry Taggart,2647,2001,Leicester City,1,0,1,13,0,0,0,0,0,0,0,0,1,0,1,13,0,0,0,0,0,0,0,0,0,0,0,0,0,0
11271,11271,Tommy Williamson,4520,2001,Leicester City,1,0,1,1,0,0,0,0,0,0,0,0,1,0,1,1,0,0,0,0,0,0,0,0,0,0,0,0,0,0
11272,11272,Ryan Fredericks,2202,2011,Tottenham Hotspur,0,0,0,0,0,0,0,0,0,0,0,0,0,0,0,0,0,0,0,0,0,0,0,0,0,0,0,0,0,0
11273,11273,Harry Kane,1169,2011,Tottenham Hotspur,0,0,0,0,0,0,0,0,0,0,0,0,0,0,0,0,0,0,0,0,0,0,0,0,0,0,0,0,0,0
11274,11274,Adnan Januzaj,2259,2012,Manchester United,0,0,0,0,0,0,0,0,0,0,0,0,0,0,0,0,0,0,0,0,0,0,0,0,0,0,0,0,0,0
11275,11275,Keith Branagan,2724,2000,Ipswich Town,2,2,0,180,0,0,0,0,0,0,0,0,2,2,0,180,0,0,0,0,0,0,0,0,0,0,0,0,0,0
11276,11276,Daniel Bachmann,3485,2015,Stoke City,0,0,0,0,0,0,0,0,0,0,0,0,0,0,0,0,0,0,0,0,0,0,0,0,0,0,0,0,0,0
11277,11277,James Tavernier,2458,2011,Newcastle United,0,0,0,0,0,0,0,0,0,0,0,0,0,0,0,0,0,0,0,0,0,0,0,0,0,0,0,0,0,0
11278,11278,Darron Gibson,2538,2013,Everton FC,0,0,0,0,0,0,1,0,1,27,0,0,1,0,1,27,0,0,0,0,0,0,0,0,0,0,0,0,0,0
11279,11279,Diego Poyet,3417,2015,West Ham United,0,0,0,0,0,0,0,0,0,0,0,0,0,0,0,0,0,0,0,0,0,0,0,0,0,0,0,0,0,0
11280,11280,Mamady Sidibe,1994,2010,Stoke City,1,0,1,5,0,0,1,0,1,76,0,0,2,0,2,81,0,0,0,0,0,0,0,0,0,0,0,0,0,0
11281,11281,Ben Alnwick,4272,2010,Tottenham Hotspur,0,0,0,0,0,0,0,0,0,0,0,0,0,0,0,0,0,0,0,0,0,0,0,0,0,0,0,0,0,0
11282,11282,Kyle Naughton,2273,2010,Tottenham Hotspur,0,0,0,0,0,0,0,0,0,0,0,0,0,0,0,0,0,0,0,0,0,0,0,0,0,0,0,0,0,0
11283,11283,Mo Camara,4521,2007,Derby County,0,0,0,0,0,0,1,1,0,63,0,0,1,1,0,63,0,0,0,0,0,0,0,0,0,0,0,0,0,0
11284,11284,Bob Malcolm,4522,2007,Derby County,0,0,0,0,0,0,1,1,0,59,0,0,1,1,0,59,0,0,0,0,0,0,0,0,0,0,0,0,0,0
11285,11285,Bojan Djordjic,4523,2000,Manchester United,0,0,0,0,0,0,1,0,1,13,0,0,1,0,1,13,0,0,0,0,0,0,0,0,0,0,0,0,0,0
11286,11286,Sam Williamson,4524,2007,Manchester City,1,0,1,36,0,0,0,0,0,0,0,0,1,0,1,36,0,0,0,0,0,0,0,0,0,0,0,0,0,0
11287,11287,Chris Baird,1562,2002,Southampton FC,1,0,1,4,0,0,2,1,1,154,0,0,3,1,2,158,0,0,0,0,0,0,0,0,0,0,0,0,0,0
11288,11288,Steve Harper,2231,2002,Newcastle United,0,0,0,0,0,0,0,0,0,0,0,0,0,0,0,0,0,0,0,0,0,0,0,0,0,0,0,0,0,0
11289,11289,Thomas Myhre,1951,2006,Charlton Athletic,1,1,0,90,0,0,0,0,0,0,0,0,1,1,0,90,0,0,0,0,0,0,0,0,0,0,0,0,0,0
11290,11290,DJ Campbell,2167,2012,Queens Park Rangers,0,0,0,0,0,0,0,0,0,0,0,0,0,0,0,0,0,0,0,0,0,0,0,0,0,0,0,0,0,0
11291,11291,Mehdi Nafti,1517,2005,Birmingham City,0,0,0,0,0,0,1,1,0,71,0,0,1,1,0,71,0,0,0,0,0,0,0,0,0,0,0,0,0,0
11292,11292,Richard Jackson,3357,2000,Derby County,1,0,1,45,0,0,1,1,0,45,0,0,2,1,1,90,0,0,0,0,0,0,0,0,0,0,0,0,0,0
11293,11293,Gláuber,4525,2008,Manchester City,1,0,1,6,0,0,0,0,0,0,0,0,1,0,1,6,0,0,0,0,0,0,0,0,0,0,0,0,0,0
11294,11294,Vladimír Weiss,2672,2008,Manchester City,1,0,1,19,0,0,0,0,0,0,0,0,1,0,1,19,0,0,0,0,0,0,0,0,0,0,0,0,0,0
11295,11295,Isaiah Osbourne,2708,2010,Aston Villa,0,0,0,0,0,0,0,0,0,0,0,0,0,0,0,0,0,0,0,0,0,0,0,0,0,0,0,0,0,0
11296,11296,Filipe Oliveira,4075,2003,Chelsea FC,1,0,1,11,0,0,0,0,0,0,0,0,1,0,1,11,0,0,0,0,0,0,0,0,0,0,0,0,0,0
11297,11297,Jason Kennedy,2860,2004,Middlesbrough FC,1,0,1,4,0,0,0,0,0,0,0,0,1,0,1,4,0,0,0,0,0,0,0,0,0,0,0,0,0,0
11298,11298,Ryan Tunnicliffe,4032,2012,Manchester United,0,0,0,0,0,0,0,0,0,0,0,0,0,0,0,0,0,0,0,0,0,0,0,0,0,0,0,0,0,0
11299,11299,Ryan Donaldson,2542,2011,Newcastle United,0,0,0,0,0,0,0,0,0,0,0,0,0,0,0,0,0,0,0,0,0,0,0,0,0,0,0,0,0,0
11300,11300,Jerome Sinclair,1931,2015,Liverpool FC,0,0,0,0,0,0,0,0,0,0,0,0,0,0,0,0,0,0,0,0,0,0,0,0,0,0,0,0,0,0
11301,11301,Hiram Boateng,3611,2013,Crystal Palace,0,0,0,0,0,0,0,0,0,0,0,0,0,0,0,0,0,0,0,0,0,0,0,0,0,0,0,0,0,0
11302,11302,Alan Miller,4526,2000,Coventry City,0,0,0,0,0,0,1,0,1,67,0,0,1,0,1,67,0,0,0,0,0,0,0,0,0,0,0,0,0,0
11303,11303,Péter Kurucz,4527,2009,West Ham United,1,0,1,16,0,0,0,0,0,0,0,0,1,0,1,16,0,0,0,0,0,0,0,0,0,0,0,0,0,0
11304,11304,Alan Blayney,4311,2002,Southampton FC,0,0,0,0,0,0,0,0,0,0,0,0,0,0,0,0,0,0,0,0,0,0,0,0,0,0,0,0,0,0
11305,11305,Kemar Roofe,3486,2011,West Bromwich Albion,0,0,0,0,0,0,0,0,0,0,0,0,0,0,0,0,0,0,0,0,0,0,0,0,0,0,0,0,0,0
11306,11306,Martin Olsson,1372,2007,Blackburn Rovers,1,0,1,11,0,0,1,0,1,6,0,0,2,0,2,17,0,0,0,0,0,0,0,0,0,0,0,0,0,0
11307,11307,Miles Addison,4528,2007,Derby County,0,0,0,0,0,0,1,1,0,90,0,0,1,1,0,90,0,0,0,0,0,0,0,0,0,0,0,0,0,0
11308,11308,James Horsfield,4529,2015,Manchester City,0,0,0,0,0,0,0,0,0,0,0,0,0,0,0,0,0,0,0,0,0,0,0,0,0,0,0,0,0,0
11309,11309,Mile Jedinak,1030,2016,Crystal Palace,1,1,0,90,0,0,0,0,0,0,0,0,1,1,0,90,0,0,0,0,0,0,0,0,0,0,0,0,0,0
11310,11310,Erdal Rakip,4530,2017,Crystal Palace,0,0,0,0,0,0,0,0,0,0,0,0,0,0,0,0,0,0,0,0,0,0,0,0,0,0,0,0,0,0
11311,11311,Jesse Joronen,4531,2013,Fulham FC,0,0,0,0,0,0,0,0,0,0,0,0,0,0,0,0,0,0,0,0,0,0,0,0,0,0,0,0,0,0
11312,11312,Marcus Bettinelli,4017,2013,Fulham FC,0,0,0,0,0,0,0,0,0,0,0,0,0,0,0,0,0,0,0,0,0,0,0,0,0,0,0,0,0,0
11313,11313,Nya Kirby,4228,2017,Crystal Palace,0,0,0,0,0,0,0,0,0,0,0,0,0,0,0,0,0,0,0,0,0,0,0,0,0,0,0,0,0,0
11314,11314,Abou Diaby,2434,2014,Arsenal FC,0,0,0,0,0,0,0,0,0,0,0,0,0,0,0,0,0,0,0,0,0,0,0,0,0,0,0,0,0,0
11315,11315,Fabrice Fernandes,2695,2005,Bolton Wanderers,0,0,0,0,0,0,1,0,1,15,0,0,1,0,1,15,0,0,0,0,0,0,0,0,0,0,0,0,0,0
11316,11316,Russell Anderson,4532,2007,Sunderland AFC,0,0,0,0,0,0,1,0,1,28,0,0,1,0,1,28,0,0,0,0,0,0,0,0,0,0,0,0,0,0
11317,11317,Alejandro Faurlín,2166,2014,Queens Park Rangers,1,1,0,69,0,0,1,0,1,23,0,0,2,1,1,92,0,0,0,0,0,0,0,0,0,0,0,0,0,0
11318,11318,Robert Snodgrass,2207,2014,Hull City,0,0,0,0,0,0,1,1,0,41,0,0,1,1,0,41,0,0,0,0,0,0,0,0,0,0,0,0,0,0
11319,11319,Angelos Basinas,3403,2008,Portsmouth FC,2,2,0,156,0,0,1,1,0,71,0,0,3,3,0,227,0,0,0,0,0,0,0,0,0,0,0,0,0,0
11320,11320,Stephen Bywater,1568,2000,West Ham United,0,0,0,0,0,0,1,1,0,90,0,0,1,1,0,90,0,0,0,0,0,0,0,0,0,0,0,0,0,0
11321,11321,Joe Powell,4533,2018,West Ham United,0,0,0,0,0,0,0,0,0,0,0,0,0,0,0,0,0,0,0,0,0,0,0,0,0,0,0,0,0,0
11322,11322,Gareth Evans,4534,2000,Leeds United,1,0,1,33,0,0,0,0,0,0,0,0,1,0,1,33,0,0,0,0,0,0,0,0,0,0,0,0,0,0
11323,11323,Markus Suttner,2661,2018,Brighton & Hove Albion,0,0,0,0,0,0,0,0,0,0,0,0,0,0,0,0,0,0,0,0,0,0,0,0,0,0,0,0,0,0
11324,11324,Jed Steer,1447,2014,Aston Villa,1,1,0,90,0,0,0,0,0,0,0,0,1,1,0,90,0,0,0,0,0,0,0,0,0,0,0,0,0,0
11325,11325,André Green,4182,2014,Aston Villa,0,0,0,0,0,0,0,0,0,0,0,0,0,0,0,0,0,0,0,0,0,0,0,0,0,0,0,0,0,0
11326,11326,Levi Lumeka,4535,2017,Crystal Palace,0,0,0,0,0,0,1,0,1,25,0,0,1,0,1,25,0,0,0,0,0,0,0,0,0,0,0,0,0,0
11327,11327,Curtis Good,4536,2012,Newcastle United,0,0,0,0,0,0,0,0,0,0,0,0,0,0,0,0,0,0,0,0,0,0,0,0,0,0,0,0,0,0
11328,11328,Blessing Kaku,4537,2004,Bolton Wanderers,0,0,0,0,0,0,1,0,1,25,0,0,1,0,1,25,0,0,0,0,0,0,0,0,0,0,0,0,0,0
11329,11329,Jarosław Jach,4538,2017,Crystal Palace,0,0,0,0,0,0,0,0,0,0,0,0,0,0,0,0,0,0,0,0,0,0,0,0,0,0,0,0,0,0
11330,11330,Simon Lappin,4264,2012,Norwich City,0,0,0,0,0,0,0,0,0,0,0,0,0,0,0,0,0,0,0,0,0,0,0,0,0,0,0,0,0,0
11331,11331,James Vaughan,3240,2012,Norwich City,0,0,0,0,0,0,0,0,0,0,0,0,0,0,0,0,0,0,0,0,0,0,0,0,0,0,0,0,0,0
11332,11332,Matthew Connolly,2170,2018,Cardiff City,0,0,0,0,0,0,0,0,0,0,0,0,0,0,0,0,0,0,0,0,0,0,0,0,0,0,0,0,0,0
11333,11333,Sam Johnstone,3408,2013,Manchester United,0,0,0,0,0,0,0,0,0,0,0,0,0,0,0,0,0,0,0,0,0,0,0,0,0,0,0,0,0,0
11334,11334,Luke Garbutt,2297,2017,Everton FC,0,0,0,0,0,0,0,0,0,0,0,0,0,0,0,0,0,0,0,0,0,0,0,0,0,0,0,0,0,0
11335,11335,Jay O’Shea,4539,2009,Birmingham City,0,0,0,0,0,0,1,0,1,9,0,0,1,0,1,9,0,0,0,0,0,0,0,0,0,0,0,0,0,0
11336,11336,Liam Miller,1224,2005,Manchester United,0,0,0,0,0,0,1,0,1,1,0,0,1,0,1,1,0,0,0,0,0,0,0,0,0,0,0,0,0,0
11337,11337,Danny Mills,1292,2006,Manchester City,1,0,1,10,0,0,0,0,0,0,0,0,1,0,1,10,0,0,0,0,0,0,0,0,0,0,0,0,0,0
11338,11338,Karim El Ahmadi,1439,2014,Aston Villa,0,0,0,0,0,0,0,0,0,0,0,0,0,0,0,0,0,0,0,0,0,0,0,0,0,0,0,0,0,0
11339,11339,Steve Simonsen,2918,2002,Everton FC,1,1,0,90,0,0,1,1,0,90,0,0,2,2,0,180,0,0,0,0,0,0,0,0,0,0,0,0,0,0
11340,11340,Jon Flanagan,1263,2017,Liverpool FC,0,0,0,0,0,0,0,0,0,0,0,0,0,0,0,0,0,0,0,0,0,0,0,0,0,0,0,0,0,0
11341,11341,Stefan Malz,4540,2000,Arsenal FC,0,0,0,0,0,0,1,0,1,17,0,0,1,0,1,17,0,0,0,0,0,0,0,0,0,0,0,0,0,0
11342,11342,Ricardo Vaz Tê,3416,2007,Bolton Wanderers,1,1,0,46,0,0,0,0,0,0,0,0,1,1,0,46,0,0,0,0,0,0,0,0,0,0,0,0,0,0
11343,11343,Mark Hughes,1353,2006,Everton FC,1,0,1,1,0,0,0,0,0,0,0,0,1,0,1,1,0,0,0,0,0,0,0,0,0,0,0,0,0,0
11344,11344,Joe Keenan,4492,2002,Chelsea FC,1,0,1,1,0,0,0,0,0,0,0,0,1,0,1,1,0,0,0,0,0,0,0,0,0,0,0,0,0,0
11345,11345,Alex Cochrane,4541,2019,Brighton & Hove Albion,0,0,0,0,0,0,0,0,0,0,0,0,0,0,0,0,0,0,0,0,0,0,0,0,0,0,0,0,0,0
11346,11346,Abdul Razak,1421,2010,Manchester City,1,0,1,1,0,0,0,0,0,0,0,0,1,0,1,1,0,0,0,0,0,0,0,0,0,0,0,0,0,0
11347,11347,Mason Springthorpe,3998,2012,Everton FC,0,0,0,0,0,0,0,0,0,0,0,0,0,0,0,0,0,0,0,0,0,0,0,0,0,0,0,0,0,0
11348,11348,Rony Lopes,4423,2012,Manchester City,0,0,0,0,0,0,0,0,0,0,0,0,0,0,0,0,0,0,0,0,0,0,0,0,0,0,0,0,0,0
11349,11349,Tiago Ilori,3233,2015,Aston Villa,0,0,0,0,0,0,0,0,0,0,0,0,0,0,0,0,0,0,0,0,0,0,0,0,0,0,0,0,0,0
11350,11350,Samir Nasri,1358,2016,Manchester City,1,0,1,15,0,0,0,0,0,0,0,0,1,0,1,15,0,0,0,0,0,0,0,0,0,0,0,0,0,0
11351,11351,Diego Penny,4542,2009,Burnley FC,1,0,1,75,0,0,0,0,0,0,0,0,1,0,1,75,0,0,0,0,0,0,0,0,0,0,0,0,0,0
11352,11352,Rob Davies,4543,2005,West Bromwich Albion,0,0,0,0,0,0,1,1,0,90,0,0,1,1,0,90,0,0,0,0,0,0,0,0,0,0,0,0,0,0
11353,11353,Hilário,2709,2010,Chelsea FC,0,0,0,0,0,0,0,0,0,0,0,0,0,0,0,0,0,0,0,0,0,0,0,0,0,0,0,0,0,0
11354,11354,Lewis Baker,3693,2013,Chelsea FC,0,0,0,0,0,0,0,0,0,0,0,0,0,0,0,0,0,0,0,0,0,0,0,0,0,0,0,0,0,0
11355,11355,Peter Clarke,4359,2003,Everton FC,0,0,0,0,0,0,1,1,0,90,0,0,1,1,0,90,0,0,0,0,0,0,0,0,0,0,0,0,0,0
11356,11356,Michael Harriman,3669,2012,Queens Park Rangers,0,0,0,0,0,0,1,1,0,90,0,0,1,1,0,90,0,0,0,0,0,0,0,0,0,0,0,0,0,0
11357,11357,Elvis Hammond,4011,2004,Fulham FC,1,0,1,33,0,0,0,0,0,0,0,0,1,0,1,33,0,0,0,0,0,0,0,0,0,0,0,0,0,0
11358,11358,Espen Baardsen,4544,2002,Everton FC,0,0,0,0,0,0,1,1,0,90,0,0,1,1,0,90,0,0,0,0,0,0,0,0,0,0,0,0,0,0
11359,11359,Leon Osman,1747,2002,Everton FC,1,0,1,2,0,0,1,0,1,1,0,0,2,0,2,3,0,0,0,0,0,0,0,0,0,0,0,0,0,0
11360,11360,Alex Palmer,3860,2015,West Bromwich Albion,0,0,0,0,0,0,0,0,0,0,0,0,0,0,0,0,0,0,0,0,0,0,0,0,0,0,0,0,0,0
11361,11361,Andy Johnson,1322,2014,Crystal Palace,0,0,0,0,0,0,0,0,0,0,0,0,0,0,0,0,0,0,0,0,0,0,0,0,0,0,0,0,0,0
11362,11362,Damien Johnson,2503,2009,Birmingham City,1,0,1,2,0,0,0,0,0,0,0,0,1,0,1,2,0,0,0,0,0,0,0,0,0,0,0,0,0,0
11363,11363,Max Stryjek,4545,2016,Sunderland AFC,0,0,0,0,0,0,0,0,0,0,0,0,0,0,0,0,0,0,0,0,0,0,0,0,0,0,0,0,0,0
11364,11364,Boa Morte,1085,2009,West Ham United,1,1,0,64,1,0,0,0,0,0,0,0,1,1,0,64,1,0,0,0,0,1,0,1,0,0,0,0,0,0
11365,11365,Jordan Spence,2760,2009,West Ham United,1,0,1,2,0,0,0,0,0,0,0,0,1,0,1,2,0,0,0,0,0,0,0,0,0,0,0,0,0,0
11366,11366,Gilberto,3158,2008,Tottenham Hotspur,1,0,1,26,0,0,1,1,0,46,0,0,2,1,1,72,0,0,0,0,0,0,0,0,0,0,0,0,0,0
11367,11367,Gary Charles,4546,2000,West Ham United,1,0,1,45,0,0,0,0,0,0,0,0,1,0,1,45,0,0,0,0,0,0,0,0,0,0,0,0,0,0
11368,11368,Tony Cottee,4547,2000,Leicester City,0,0,0,0,0,0,2,0,2,24,0,0,2,0,2,24,0,0,0,0,0,0,0,0,0,0,0,0,0,0
11369,11369,Alfie Lewis,4548,2019,West Ham United,0,0,0,0,0,0,0,0,0,0,0,0,0,0,0,0,0,0,0,0,0,0,0,0,0,0,0,0,0,0
11370,11370,Nicky Weaver,1875,2004,Manchester City,1,0,1,2,0,0,0,0,0,0,0,0,1,0,1,2,0,0,0,0,0,0,0,0,0,0,0,0,0,0
11371,11371,Daniel Batty,4549,2016,Hull City,0,0,0,0,0,0,0,0,0,0,0,0,0,0,0,0,0,0,0,0,0,0,0,0,0,0,0,0,0,0
11372,11372,Conor Coady,2144,2010,Liverpool FC,0,0,0,0,0,0,0,0,0,0,0,0,0,0,0,0,0,0,0,0,0,0,0,0,0,0,0,0,0,0
11373,11373,Nathan Ferguson,4550,2017,West Bromwich Albion,0,0,0,0,0,0,0,0,0,0,0,0,0,0,0,0,0,0,0,0,0,0,0,0,0,0,0,0,0,0
11374,11374,Riccardo Calder,4551,2014,Aston Villa,0,0,0,0,0,0,0,0,0,0,0,0,0,0,0,0,0,0,0,0,0,0,0,0,0,0,0,0,0,0
11375,11375,Lacina Traoré,4552,2013,Everton FC,0,0,0,0,0,0,1,0,1,1,0,0,1,0,1,1,0,0,0,0,0,0,0,0,0,0,0,0,0,0
11376,11376,Conor McAleny,4217,2013,Everton FC,0,0,0,0,0,0,0,0,0,0,0,0,0,0,0,0,0,0,0,0,0,0,0,0,0,0,0,0,0,0
11377,11377,Quincy Owusu-Abeyie,3336,2004,Arsenal FC,1,1,0,74,0,0,0,0,0,0,0,0,1,1,0,74,0,0,0,0,0,0,0,0,0,0,0,0,0,0
11378,11378,Sergi Canós,4553,2015,Liverpool FC,0,0,0,0,0,0,1,0,1,9,0,0,1,0,1,9,0,0,0,0,0,0,0,0,0,0,0,0,0,0
11379,11379,Stuart Taylor,1684,2004,Arsenal FC,0,0,0,0,0,0,0,0,0,0,0,0,0,0,0,0,0,0,0,0,0,0,0,0,0,0,0,0,0,0
11380,11380,Wayne Henderson,4554,2004,Aston Villa,0,0,0,0,0,0,0,0,0,0,0,0,0,0,0,0,0,0,0,0,0,0,0,0,0,0,0,0,0,0
11381,11381,Jacob Butterfield,4368,2013,Norwich City,0,0,0,0,0,0,0,0,0,0,0,0,0,0,0,0,0,0,0,0,0,0,0,0,0,0,0,0,0,0
11382,11382,Mark Crossley,1932,2003,Fulham FC,1,1,0,90,0,0,0,0,0,0,0,0,1,1,0,90,0,0,0,0,0,0,0,0,0,0,0,0,0,0
11383,11383,Chris David,4555,2013,Fulham FC,1,0,1,67,1,0,0,0,0,0,0,0,1,0,1,67,1,0,1,0,1,1,0,1,0,0,0,0,0,0
11384,11384,George Williams,4556,2013,Fulham FC,0,0,0,0,0,0,0,0,0,0,0,0,0,0,0,0,0,0,0,0,0,0,0,0,0,0,0,0,0,0
11385,11385,Abdelhamid Sabiri,3194,2018,Huddersfield Town,0,0,0,0,0,0,2,1,1,61,0,0,2,1,1,61,0,0,0,0,0,0,0,0,0,0,0,0,0,0
11386,11386,Rushian Hepburn-Murphy,1873,2014,Aston Villa,0,0,0,0,0,0,1,0,1,7,0,0,1,0,1,7,0,0,0,0,0,0,0,0,0,0,0,0,0,0
11387,11387,Dave Raven,4557,2004,Liverpool FC,0,0,0,0,0,0,1,0,1,23,0,0,1,0,1,23,0,0,0,0,0,0,0,0,0,0,0,0,0,0
11388,11388,Jason Denayer,3135,2015,Manchester City,0,0,0,0,0,0,0,0,0,0,0,0,0,0,0,0,0,0,0,0,0,0,0,0,0,0,0,0,0,0
11389,11389,Phil Ifil,4449,2006,Tottenham Hotspur,0,0,0,0,0,0,1,1,0,90,0,0,1,1,0,90,0,0,0,0,0,0,0,0,0,0,0,0,0,0
11390,11390,Marek Čech,3296,2011,West Bromwich Albion,0,0,0,0,0,0,0,0,0,0,0,0,0,0,0,0,0,0,0,0,0,0,0,0,0,0,0,0,0,0
11391,11391,Matt Derbyshire,2247,2004,Blackburn Rovers,1,0,1,8,0,0,0,0,0,0,0,0,1,0,1,8,0,0,0,0,0,0,0,0,0,0,0,0,0,0
11392,11392,Owen Hargreaves,3313,2009,Manchester United,0,0,0,0,0,0,1,0,1,1,0,0,1,0,1,1,0,0,0,0,0,0,0,0,0,0,0,0,0,0
11393,11393,Moses Makasi,4482,2016,West Ham United,0,0,0,0,0,0,0,0,0,0,0,0,0,0,0,0,0,0,0,0,0,0,0,0,0,0,0,0,0,0
11394,11394,Daniel Kemp,4558,2016,West Ham United,0,0,0,0,0,0,0,0,0,0,0,0,0,0,0,0,0,0,0,0,0,0,0,0,0,0,0,0,0,0
11395,11395,Gaël Bigirimana,4161,2013,Newcastle United,0,0,0,0,0,0,0,0,0,0,0,0,0,0,0,0,0,0,0,0,0,0,0,0,0,0,0,0,0,0
11396,11396,Haris Vučkić,3708,2013,Newcastle United,0,0,0,0,0,0,0,0,0,0,0,0,0,0,0,0,0,0,0,0,0,0,0,0,0,0,0,0,0,0
11397,11397,Kyle Walker-Peters,3113,2015,Tottenham Hotspur,0,0,0,0,0,0,0,0,0,0,0,0,0,0,0,0,0,0,0,0,0,0,0,0,0,0,0,0,0,0
11398,11398,Luke Daniels,2303,2014,West Bromwich Albion,0,0,0,0,0,0,0,0,0,0,0,0,0,0,0,0,0,0,0,0,0,0,0,0,0,0,0,0,0,0
11399,11399,Fitz Hall,2024,2007,Wigan Athletic,0,0,0,0,0,0,1,0,1,39,0,0,1,0,1,39,0,0,0,0,0,0,0,0,0,0,0,0,0,0
11400,11400,Philippe Sandler,4559,2018,Manchester City,0,0,0,0,0,0,0,0,0,0,0,0,0,0,0,0,0,0,0,0,0,0,0,0,0,0,0,0,0,0
11401,11401,Ben Johnson,4056,2018,West Ham United,0,0,0,0,0,0,1,1,0,63,0,0,1,1,0,63,0,0,0,0,0,0,0,0,0,0,0,0,0,0
11402,11402,David Healy,1567,2000,Manchester United,1,0,1,31,0,0,0,0,0,0,0,0,1,0,1,31,0,0,0,0,0,0,0,0,0,0,0,0,0,0
11403,11403,Ricardo Vaz Tê,3416,2003,Bolton Wanderers,0,0,0,0,0,0,1,0,1,23,0,0,1,0,1,23,0,0,0,0,0,0,0,0,0,0,0,0,0,0
11404,11404,Jesse Lingard,1646,2011,Manchester United,0,0,0,0,0,0,0,0,0,0,0,0,0,0,0,0,0,0,0,0,0,0,0,0,0,0,0,0,0,0
11405,11405,Ľubomír Šatka,3754,2013,Newcastle United,0,0,0,0,0,0,0,0,0,0,0,0,0,0,0,0,0,0,0,0,0,0,0,0,0,0,0,0,0,0
11406,11406,Eddie Lewis,1574,2001,Fulham FC,0,0,0,0,0,0,1,1,0,90,0,0,1,1,0,90,0,0,0,0,0,0,0,0,0,0,0,0,0,0
11407,11407,Callum Willock,4490,2001,Fulham FC,0,0,0,0,0,0,1,0,1,7,0,0,1,0,1,7,0,0,0,0,0,0,0,0,0,0,0,0,0,0
11408,11408,Linvoy Primus,1065,2008,Portsmouth FC,1,0,1,1,0,0,0,0,0,0,0,0,1,0,1,1,0,0,0,0,0,0,0,0,0,0,0,0,0,0
11409,11409,Paul Murray,4560,2001,Southampton FC,0,0,0,0,0,0,1,0,1,8,0,0,1,0,1,8,0,0,0,0,0,0,0,0,0,0,0,0,0,0
11410,11410,Olivier Kapo,1963,2009,Wigan Athletic,0,0,0,0,0,0,1,0,1,31,0,0,1,0,1,31,0,0,0,0,0,0,0,0,0,0,0,0,0,0
11411,11411,Arturo Lupoli,4561,2005,Arsenal FC,0,0,0,0,0,0,1,0,1,8,0,0,1,0,1,8,0,0,0,0,0,0,0,0,0,0,0,0,0,0
11412,11412,Dan N'Lundulu,4562,2019,Southampton FC,0,0,0,0,0,0,0,0,0,0,0,0,0,0,0,0,0,0,0,0,0,0,0,0,0,0,0,0,0,0
11413,11413,Kemar Roofe,3486,2013,West Bromwich Albion,0,0,0,0,0,0,0,0,0,0,0,0,0,0,0,0,0,0,0,0,0,0,0,0,0,0,0,0,0,0
11414,11414,Zech Medley,2513,2018,Arsenal FC,0,0,0,0,0,0,0,0,0,0,0,0,0,0,0,0,0,0,0,0,0,0,0,0,0,0,0,0,0,0
11415,11415,Kyle Jameson,4563,2017,West Bromwich Albion,0,0,0,0,0,0,0,0,0,0,0,0,0,0,0,0,0,0,0,0,0,0,0,0,0,0,0,0,0,0
11416,11416,Kaspars Gorkšs,3742,2011,Queens Park Rangers,0,0,0,0,0,0,0,0,0,0,0,0,0,0,0,0,0,0,0,0,0,0,0,0,0,0,0,0,0,0
11417,11417,Petter Vaagan Moen,4564,2011,Queens Park Rangers,0,0,0,0,0,0,0,0,0,0,0,0,0,0,0,0,0,0,0,0,0,0,0,0,0,0,0,0,0,0
11418,11418,John Curtis,2461,2004,Portsmouth FC,0,0,0,0,0,0,1,0,1,20,0,0,1,0,1,20,0,0,0,0,0,0,0,0,0,0,0,0,0,0
11419,11419,Jake Gray,4363,2014,Crystal Palace,0,0,0,0,0,0,0,0,0,0,0,0,0,0,0,0,0,0,0,0,0,0,0,0,0,0,0,0,0,0
11420,11420,Osei Sankofa,3498,2002,Charlton Athletic,0,0,0,0,0,0,1,0,1,17,0,0,1,0,1,17,0,0,0,0,0,0,0,0,0,0,0,0,0,0
11421,11421,Joe Hart,1363,2006,Manchester City,1,1,0,90,0,0,0,0,0,0,0,0,1,1,0,90,0,0,0,0,0,0,0,0,0,0,0,0,0,0
11422,11422,Mustapha Hadji,2103,2003,Aston Villa,0,0,0,0,0,0,1,0,1,25,0,0,1,0,1,25,0,0,0,0,0,0,0,0,0,0,0,0,0,0
11423,11423,Joe Rothwell,4565,2015,Manchester United,0,0,0,0,0,0,0,0,0,0,0,0,0,0,0,0,0,0,0,0,0,0,0,0,0,0,0,0,0,0
11424,11424,Dean Gordon,3550,2001,Middlesbrough FC,0,0,0,0,0,0,1,0,1,35,0,0,1,0,1,35,0,0,0,0,0,0,0,0,0,0,0,0,0,0
11425,11425,Kyel Reid,4158,2007,West Ham United,1,0,1,11,0,0,0,0,0,0,0,0,1,0,1,11,0,0,0,0,0,0,0,0,0,0,0,0,0,0
11426,11426,Ian Evatt,2608,2000,Derby County,1,0,1,12,0,0,0,0,0,0,0,0,1,0,1,12,0,0,0,0,0,0,0,0,0,0,0,0,0,0
11427,11427,Darren Ambrose,1956,2002,Newcastle United,0,0,0,0,0,0,1,0,1,14,0,0,1,0,1,14,0,0,0,0,0,0,0,0,0,0,0,0,0,0
11428,11428,Michael Chopra,1226,2002,Newcastle United,0,0,0,0,0,0,1,0,1,8,0,0,1,0,1,8,0,0,0,0,0,0,0,0,0,0,0,0,0,0
11429,11429,Luke Croll,4566,2015,Crystal Palace,0,0,0,0,0,0,0,0,0,0,0,0,0,0,0,0,0,0,0,0,0,0,0,0,0,0,0,0,0,0
11430,11430,Freddie Sears,2246,2009,West Ham United,1,0,1,12,0,0,0,0,0,0,0,0,1,0,1,12,0,0,0,0,0,0,0,0,0,0,0,0,0,0
11431,11431,Danny Pugh,2756,2002,Manchester United,1,0,1,5,0,0,0,0,0,0,0,0,1,0,1,5,0,0,0,0,0,0,0,0,0,0,0,0,0,0
11432,11432,Gerhard Tremmel,1706,2015,Swansea City,0,0,0,0,0,0,0,0,0,0,0,0,0,0,0,0,0,0,0,0,0,0,0,0,0,0,0,0,0,0
11433,11433,Jeff Smith,4567,2001,Bolton Wanderers,0,0,0,0,0,0,1,0,1,31,0,0,1,0,1,31,0,0,0,0,0,0,0,0,0,0,0,0,0,0
11434,11434,Shay Logan,4568,2008,Manchester City,0,0,0,0,0,0,1,1,0,90,0,0,1,1,0,90,0,0,0,0,0,0,0,0,0,0,0,0,0,0
11435,11435,Jake Larkins,4569,2010,West Ham United,0,0,0,0,0,0,0,0,0,0,0,0,0,0,0,0,0,0,0,0,0,0,0,0,0,0,0,0,0,0
11436,11436,Colin Cooper,2138,2005,Middlesbrough FC,0,0,0,0,0,0,1,0,1,5,0,0,1,0,1,5,0,0,0,0,0,0,0,0,0,0,0,0,0,0
11437,11437,Josh Walker,4026,2005,Middlesbrough FC,0,0,0,0,0,0,1,0,1,28,0,0,1,0,1,28,0,0,0,0,0,0,0,0,0,0,0,0,0,0
11438,11438,Tom Craddock,3753,2005,Middlesbrough FC,0,0,0,0,0,0,1,0,1,9,0,0,1,0,1,9,0,0,0,0,0,0,0,0,0,0,0,0,0,0
11439,11439,Jack Grealish,1870,2011,Aston Villa,0,0,0,0,0,0,0,0,0,0,0,0,0,0,0,0,0,0,0,0,0,0,0,0,0,0,0,0,0,0
11440,11440,Lee Hendrie,1797,2006,Aston Villa,0,0,0,0,0,0,1,0,1,7,0,0,1,0,1,7,0,0,0,0,0,0,0,0,0,0,0,0,0,0
11441,11441,Eric Djemba-Djemba,1793,2006,Aston Villa,0,0,0,0,0,0,1,0,1,1,0,0,1,0,1,1,0,0,0,0,0,0,0,0,0,0,0,0,0,0
11442,11442,Steven Hewitt,4570,2014,Burnley FC,0,0,0,0,0,0,0,0,0,0,0,0,0,0,0,0,0,0,0,0,0,0,0,0,0,0,0,0,0,0
11443,11443,Thierry Ambrose,4571,2014,Manchester City,0,0,0,0,0,0,0,0,0,0,0,0,0,0,0,0,0,0,0,0,0,0,0,0,0,0,0,0,0,0
11444,11444,Michael Folivi,4031,2017,Watford FC,0,0,0,0,0,0,0,0,0,0,0,0,0,0,0,0,0,0,0,0,0,0,0,0,0,0,0,0,0,0
11445,11445,Ryan Garry,4572,2002,Arsenal FC,1,1,0,90,0,0,0,0,0,0,0,0,1,1,0,90,0,0,0,0,0,0,0,0,0,0,0,0,0,0
11446,11446,Stathis Tavlaridis,4573,2002,Arsenal FC,1,0,1,15,0,0,0,0,0,0,0,0,1,0,1,15,0,0,0,0,0,0,0,0,0,0,0,0,0,0
11447,11447,Justin Hoyte,3282,2002,Arsenal FC,1,0,1,1,0,0,0,0,0,0,0,0,1,0,1,1,0,0,0,0,0,0,0,0,0,0,0,0,0,0
11448,11448,Adil Nabi,4241,2012,West Bromwich Albion,0,0,0,0,0,0,0,0,0,0,0,0,0,0,0,0,0,0,0,0,0,0,0,0,0,0,0,0,0,0
11449,11449,Agustín Delgado,3369,2001,Southampton FC,1,0,1,64,0,0,0,0,0,0,0,0,1,0,1,64,0,0,0,0,0,0,0,0,0,0,0,0,0,0
11450,11450,Franck Songo'o,4046,2007,Portsmouth FC,0,0,0,0,0,0,1,0,1,26,0,0,1,0,1,26,0,0,0,0,0,0,0,0,0,0,0,0,0,0
11451,11451,Mikael Mandron,4024,2013,Sunderland AFC,0,0,0,0,0,0,0,0,0,0,0,0,0,0,0,0,0,0,0,0,0,0,0,0,0,0,0,0,0,0
11452,11452,Hiram Boateng,3611,2016,Crystal Palace,0,0,0,0,0,0,0,0,0,0,0,0,0,0,0,0,0,0,0,0,0,0,0,0,0,0,0,0,0,0
11453,11453,Robbie Elliott,1945,2002,Newcastle United,2,0,2,18,0,0,0,0,0,0,0,0,2,0,2,18,0,0,0,0,0,0,0,0,0,0,0,0,0,0
11454,11454,Grégory Vignal,2645,2002,Liverpool FC,0,0,0,0,0,0,1,0,1,11,0,0,1,0,1,11,0,0,0,0,0,0,0,0,0,0,0,0,0,0
11455,11455,Marlon Beresford,4574,2001,Middlesbrough FC,0,0,0,0,0,0,1,0,1,72,0,0,1,0,1,72,0,0,0,0,0,0,0,0,0,0,0,0,0,0
11456,11456,Jamie McClen,3971,2002,Newcastle United,1,0,1,3,0,0,0,0,0,0,0,0,1,0,1,3,0,0,0,0,0,0,0,0,0,0,0,0,0,0
11457,11457,Vladimír Labant,1631,2002,West Ham United,0,0,0,0,0,0,1,0,1,19,0,0,1,0,1,19,0,0,0,0,0,0,0,0,0,0,0,0,0,0
11458,11458,Steven Taylor,2014,2003,Newcastle United,0,0,0,0,0,0,1,1,0,90,0,0,1,1,0,90,0,0,0,0,0,0,0,0,0,0,0,0,0,0
11459,11459,Sebastian Usai,4575,2011,Blackburn Rovers,0,0,0,0,0,0,0,0,0,0,0,0,0,0,0,0,0,0,0,0,0,0,0,0,0,0,0,0,0,0
11460,11460,Shaun Byrne,4576,2001,West Ham United,0,0,0,0,0,0,1,0,1,13,0,0,1,0,1,13,0,0,0,0,0,0,0,0,0,0,0,0,0,0
11461,11461,Richard Stearman,3430,2019,Sheffield United,0,0,0,0,0,0,0,0,0,0,0,0,0,0,0,0,0,0,0,0,0,0,0,0,0,0,0,0,0,0
11462,11462,Nathan Holland,2211,2016,West Ham United,0,0,0,0,0,0,0,0,0,0,0,0,0,0,0,0,0,0,0,0,0,0,0,0,0,0,0,0,0,0
11463,11463,Mathew Birley,4577,2005,Birmingham City,0,0,0,0,0,0,1,0,1,25,0,0,1,0,1,25,0,0,0,0,0,0,0,0,0,0,0,0,0,0
11464,11464,Bruno Berner,4085,2006,Blackburn Rovers,0,0,0,0,0,0,1,1,0,90,0,0,1,1,0,90,0,0,0,0,0,0,0,0,0,0,0,0,0,0
11465,11465,Ben Roberts,4578,2002,Charlton Athletic,1,0,1,58,0,0,0,0,0,0,0,0,1,0,1,58,0,0,0,0,0,0,0,0,0,0,0,0,0,0
11466,11466,Gerhard Tremmel,1706,2016,Swansea City,0,0,0,0,0,0,0,0,0,0,0,0,0,0,0,0,0,0,0,0,0,0,0,0,0,0,0,0,0,0
11467,11467,Aiden O’Neill,1260,2017,Burnley FC,0,0,0,0,0,0,0,0,0,0,0,0,0,0,0,0,0,0,0,0,0,0,0,0,0,0,0,0,0,0
11468,11468,Terry Dunfield,4579,2000,Manchester City,1,0,1,58,0,0,0,0,0,0,0,0,1,0,1,58,0,0,0,0,0,0,0,0,0,0,0,0,0,0
11469,11469,Shefki Kuqi,2013,2006,Blackburn Rovers,0,0,0,0,0,0,1,0,1,8,0,0,1,0,1,8,0,0,0,0,0,0,0,0,0,0,0,0,0,0
11470,11470,Daniel James,2989,2016,Swansea City,0,0,0,0,0,0,0,0,0,0,0,0,0,0,0,0,0,0,0,0,0,0,0,0,0,0,0,0,0,0
11471,11471,Marlon Beresford,4574,2000,Middlesbrough FC,1,0,1,66,0,0,0,0,0,0,0,0,1,0,1,66,0,0,0,0,0,0,0,0,0,0,0,0,0,0
11472,11472,Frankie Sutherland,4580,2014,Queens Park Rangers,0,0,0,0,0,0,0,0,0,0,0,0,0,0,0,0,0,0,0,0,0,0,0,0,0,0,0,0,0,0
11473,11473,Jérémie Boga,4318,2017,Chelsea FC,1,1,0,18,0,0,0,0,0,0,0,0,1,1,0,18,0,0,0,0,0,0,0,0,0,0,0,0,0,0
11474,11474,Cameron John,4581,2018,Wolverhampton Wanderers,0,0,0,0,0,0,0,0,0,0,0,0,0,0,0,0,0,0,0,0,0,0,0,0,0,0,0,0,0,0
11475,11475,Benoît Assou-Ekotto,1269,2007,Tottenham Hotspur,0,0,0,0,0,0,1,1,0,90,0,0,1,1,0,90,0,0,0,0,0,0,0,0,0,0,0,0,0,0
